,id,stco,name,yr,H_Occ,H_Tot,H_Vac,P_18p,P_Asian,P_Black,P_Hisp,P_NonHisp,P_Other,P_Tot,P_Two,P_White,geotype,subreg
306,09001,09001,"Fairfield County, Connecticut",2000,324232,339466,15234,656353,28473,84724,104835,777732,4687,882567,14696,645152,county,CT
308,09005,09005,"Litchfield County, Connecticut",2000,71551,79267,7716,137347,2107,1837,3894,178299,517,182193,1684,172154,county,CT
310,09009,09009,"New Haven County, Connecticut",2000,319040,340732,21692,622329,19061,89286,83131,740877,3544,824008,12445,616541,county,CT
1773,34003,34003,"Bergen County, New Jersey",2000,330817,339820,9003,681064,93979,44149,91377,792741,2620,884118,13040,638953,county,INJ
1778,34013,34013,"Essex County, New Jersey",2000,283736,301011,17275,586683,29141,319883,122347,671286,5220,793633,18334,298708,county,INJ
1780,34017,34017,"Hudson County, New Jersey",2000,230546,240618,10072,471477,56370,74040,242123,366852,4768,608975,16458,215216,county,INJ
1781,34019,34019,"Hunterdon County, New Jersey",2000,43678,45032,1354,90615,2332,2638,3371,118618,261,121989,914,112473,county,ONJ
1782,34021,34021,"Mercer County, New Jersey",2000,125807,133280,7473,266424,17250,67922,33898,316863,1229,350761,5178,225284,county,ONJ
1783,34023,34023,"Middlesex County, New Jersey",2000,265815,273637,7822,572534,103788,64435,101940,648222,3057,750162,12405,464537,county,INJ
1784,34025,34025,"Monmouth County, New Jersey",2000,224236,240884,16648,454959,24257,47745,38175,577126,1728,615301,7494,495902,county,ONJ
1785,34027,34027,"Morris County, New Jersey",2000,169711,174379,4668,353374,29310,12506,36626,433586,1173,470212,5015,385582,county,INJ
1786,34029,34029,"Ocean County, New Jersey",2000,200402,248711,48309,391870,6426,14431,25638,485278,967,510916,4280,459174,county,ONJ
1787,34031,34031,"Passaic County, New Jersey",2000,163856,170048,6192,361563,17747,60528,146492,342557,2081,489049,10514,251687,county,INJ
1789,34035,34035,"Somerset County, New Jersey",2000,108984,112023,3039,221499,24870,21571,25811,271679,885,297490,3769,220584,county,INJ
1790,34037,34037,"Sussex County, New Jersey",2000,50831,56528,5697,103948,1723,1444,4822,139344,279,144166,1274,134624,county,ONJ
1791,34039,34039,"Union County, New Jersey",2000,186124,192945,6821,392600,19789,104926,103011,419530,2130,522541,9340,283345,county,INJ
1792,34041,34041,"Warren County, New Jersey",2000,38660,41157,2497,75747,1235,1838,3751,98686,223,102437,985,94405,county,ONJ
1828,36005,36005,"Bronx County, New York",2000,463212,490659,27447,935278,38558,416338,644705,687945,12189,1332650,27209,193651,county,NYC
1839,36027,36027,"Dutchess County, New York",2000,99536,106103,6567,209882,6990,25059,18060,262090,1005,280150,4123,224913,county,MHV
1849,36047,36047,"Kings County, New York",2000,880727,930866,50139,1802827,184291,848583,487878,1977448,21354,2465326,68688,854532,county,NYC
1855,36059,36059,"Nassau County, New York",2000,447387,458151,10764,1005465,62744,129860,133282,1201262,4597,1334544,17114,986947,county,LI
1856,36061,36061,"New York County, New York",2000,738644,798144,59500,1279279,143291,234698,417816,1119379,8573,1537195,28944,703873,county,NYC
1861,36071,36071,"Orange County, New York",2000,114788,122754,7966,242211,5054,25567,39738,301629,1390,341367,4858,264760,county,MHV
1865,36079,36079,"Putnam County, New York",2000,32703,35030,2327,70371,1157,1437,5976,89769,244,95745,958,85973,county,LHV
1866,36081,36081,"Queens County, New York",2000,782664,817250,34586,1720155,389303,422831,556605,1672774,35234,2229379,92511,732895,county,NYC
1868,36085,36085,"Richmond County, New York",2000,156341,163993,7652,330470,24786,39704,53550,390178,1575,443728,7797,316316,county,NYC
1869,36087,36087,"Rockland County, New York",2000,92675,94973,2298,206467,15707,30139,29182,257571,1100,286753,4972,205653,county,LHV
1877,36103,36103,"Suffolk County, New York",2000,469299,522323,53024,1049288,34355,93262,149411,1269958,5458,1419369,18478,1118405,county,LI
1878,36105,36105,"Sullivan County, New York",2000,27661,44730,17069,55514,810,5897,6839,67127,332,73966,863,59225,county,MHV
1881,36111,36111,"Ulster County, New York",2000,67499,77656,10157,135978,2169,9044,10941,166808,794,177749,2737,152064,county,MHV
1885,36119,36119,"Westchester County, New York",2000,337142,349445,12303,692662,40941,125227,144124,779335,4385,923459,17006,591776,county,LHV
160,09001,09001,"Fairfield County, Connecticut",2010,335545,361221,25676,689810,41801,92705,155025,761804,6918,916829,13664,606716,county,CT
168,09005,09005,"Litchfield County, Connecticut",2010,76640,87550,10910,148975,2877,2206,8535,181392,564,189927,2342,173403,county,CT
173,09009,09009,"New Haven County, Connecticut",2010,334502,362004,27502,669503,29933,101763,129743,732734,4381,862477,14273,582384,county,CT
493,36047,36047,"Kings County, New York",2010,916856,1000293,83437,1910322,260129,799066,496285,2008415,15904,2504700,40010,893306,county,NYC
499,36059,36059,"Nassau County, New York",2010,448528,468346,19818,1027952,101558,141305,195355,1144177,6316,1339532,17689,877309,county,LI
500,36061,36061,"New York County, New York",2010,763846,847090,83244,1351438,177624,205340,403577,1182296,7882,1585873,29957,761493,county,NYC
501,36079,36079,"Putnam County, New York",2010,35041,38224,3183,76060,1832,2047,11661,88049,306,99710,1155,82709,county,LHV
505,36071,36071,"Orange County, New York",2010,125925,137025,11100,271284,8685,33895,67185,305628,1785,372813,7004,254259,county,MHV
510,36081,36081,"Queens County, New York",2010,780117,835127,55010,1768821,508334,395881,613750,1616972,39923,2230722,56107,616727,county,NYC
512,36085,36085,"Richmond County, New York",2010,165516,176656,11140,359529,34697,44313,81051,387679,1860,468730,6640,300169,county,NYC
513,36087,36087,"Rockland County, New York",2010,99242,104057,4815,224107,19099,34623,48783,262904,1139,311687,4373,203670,county,LHV
521,36103,36103,"Suffolk County, New York",2010,499922,569985,70063,1135680,50295,102117,246239,1247111,6222,1493350,19749,1068728,county,LI
522,36105,36105,"Sullivan County, New York",2010,30139,49186,19047,59971,1033,6349,10554,66993,431,77547,1400,57780,county,MHV
525,36111,36111,"Ulster County, New York",2010,71049,83638,12589,145677,3060,9982,15909,166584,787,182493,3656,149099,county,MHV
528,36119,36119,"Westchester County, New York",2010,347232,370821,23589,721113,51123,126585,207032,742081,5116,949113,14694,544563,county,LHV
623,34041,34041,"Warren County, New Jersey",2010,41480,44925,3445,83084,2642,3592,7659,101033,266,108692,1368,93165,county,ONJ
626,34035,34035,"Somerset County, New Jersey",2010,117759,123127,5368,242609,45473,27480,42091,281353,1143,323444,5408,201849,county,INJ
627,34037,34037,"Sussex County, New Jersey",2010,54752,62057,7305,113492,2605,2448,9617,139648,340,149265,1771,132484,county,ONJ
628,34039,34039,"Union County, New Jersey",2010,188118,199489,11371,405241,24496,111705,146704,389795,2932,536499,7350,243312,county,INJ
667,36005,36005,"Bronx County, New York",2010,483449,511896,28447,1016912,47335,416695,741413,643695,12494,1385108,15962,151209,county,NYC
675,36027,36027,"Dutchess County, New York",2010,107965,118638,10673,231519,10330,27395,31267,266221,1270,297488,5414,221812,county,MHV
1807,34021,34021,"Mercer County, New Jersey",2010,133155,143169,10014,283531,32545,71378,55318,311195,1311,366513,6052,199909,county,ONJ
1808,34023,34023,"Middlesex County, New Jersey",2010,281186,294800,13614,624401,172534,71557,148975,660883,4069,809858,13999,398724,county,INJ
1809,34025,34025,"Monmouth County, New Jersey",2010,233983,258410,24427,480081,31018,43931,60939,569441,2518,630380,8539,483435,county,ONJ
1865,34027,34027,"Morris County, New Jersey",2010,180534,189842,9308,374581,43862,14134,56482,435794,1245,492276,7002,369551,county,INJ
1866,34029,34029,"Ocean County, New Jersey",2010,221111,278052,56941,441648,9924,16583,47783,528784,1104,576567,5639,495534,county,ONJ
3152,34003,34003,"Bergen County, New Jersey",2010,335730,352388,16658,700711,130491,46850,145281,759835,3610,905116,12831,566053,county,INJ
3154,34019,34019,"Hunterdon County, New Jersey",2010,47169,49487,2318,98132,4155,3233,6722,121627,290,128349,1342,112607,county,ONJ
3157,34013,34013,"Essex County, New Jersey",2010,283712,312954,29242,589051,35292,308358,159117,624852,7807,783969,13218,260177,county,INJ
3159,34017,34017,"Hudson County, New Jersey",2010,246437,270335,23898,503104,83825,71315,267853,366413,5362,634266,10401,195510,county,INJ
3160,34031,34031,"Passaic County, New Jersey",2010,166785,175966,9181,376613,24556,55480,185677,315549,2190,501226,6179,227144,county,INJ
0,CT,,Connecticut,2000,714823,759465,44642,1416029,49641,175847,191860,1696908,8748,1888768,28825,1433847,subregion,CT
1,CT,,Connecticut,2010,746687,810775,64088,1508288,74611,196674,293303,1675930,11863,1969233,30279,1362503,subregion,CT
2,INJ,,Inner New Jersey,2000,1739589,1804481,64892,3640794,374994,702038,869727,3946453,21934,4816180,88875,2758612,subregion,INJ
3,INJ,,Inner New Jersey,2010,1800261,1918901,118640,3816311,560529,706879,1152180,3834474,28358,4986654,76388,2462320,subregion,INJ
4,LHV,,Lower Hudson Valley,2000,462520,479448,16928,969500,57805,156803,179282,1126675,5729,1305957,22936,883402,subregion,LHV
5,LHV,,Lower Hudson Valley,2010,481515,513102,31587,1021280,72054,163255,267476,1093034,6561,1360510,20222,830942,subregion,LHV
6,LI,,Long Island,2000,916686,980474,63788,2054753,97099,223122,282693,2471220,10055,2753913,35592,2105352,subregion,LI
7,LI,,Long Island,2010,948450,1038331,89881,2163632,151853,243422,441594,2391288,12538,2832882,37438,1946037,subregion,LI
8,MHV,,Mid Hudson Valley,2000,309484,351243,41759,643585,15023,65567,75578,797654,3521,873232,12581,700962,subregion,MHV
9,MHV,,Mid Hudson Valley,2010,335078,388487,53409,708451,23108,77621,124915,805426,4273,930341,17474,682950,subregion,MHV
10,NYC,,New York City,2000,3021588,3200912,179324,6068009,780229,1962154,2160554,5847724,78925,8008278,225149,2801267,subregion,NYC
11,NYC,,New York City,2010,3109784,3371062,261278,6407022,1028119,1861295,2336076,5839057,78063,8175133,148676,2722904,subregion,NYC
12,ONJ,,Outer New Jersey,2000,683614,765592,81978,1383563,53223,136018,109655,1735915,4687,1845570,20125,1521862,subregion,ONJ
13,ONJ,,Outer New Jersey,2010,731650,836100,104450,1499968,82889,141165,188038,1771728,5829,1959766,24711,1517134,subregion,ONJ
1,us,,United States,2000,105480101,115904641,10424540,209128094,10123169,33947837,35305818,246116088,2890162,281421906,4602146,194552774,nation,
1,us,,United States,2010,116716292,131704730,14988438,234564071,14465124,37685848,50477594,258267944,3332939,308745538,5966481,196817552,nation,
0,900100000,09001,"County subdivisions not defined, Fairfield County, Connecticut",2000,0,0,0,0,0,0,0,0,0,0,0,0,municipality,CT
1,900100000,09001,"County subdivisions not defined, Fairfield County, Connecticut",2010,0,0,0,0,0,0,0,0,0,0,0,0,municipality,CT
2,900104720,09001,"Bethel town, Fairfield County, Connecticut",2000,13010,13306,296,26284,1262,438,1338,34796,172,36134,450,32474,municipality,CT
3,900104720,09001,"Bethel town, Fairfield County, Connecticut",2010,6938,7310,372,14208,820,315,1419,17165,162,18584,270,15598,municipality,CT
4,900108070,09001,"Bridgeport town, Fairfield County, Connecticut",2000,100614,108734,8120,199714,8918,81948,88956,190102,3344,279058,9576,86316,municipality,CT
5,900108070,09001,"Bridgeport town, Fairfield County, Connecticut",2010,51255,57012,5757,108182,4781,46472,55100,89129,2282,144229,2800,32794,municipality,CT
6,900108980,09001,"Brookfield town, Fairfield County, Connecticut",2000,11144,11562,418,22752,774,228,744,30584,40,31328,210,29332,municipality,CT
7,900108980,09001,"Brookfield town, Fairfield County, Connecticut",2010,6129,6562,433,12342,595,161,710,15742,78,16452,142,14766,municipality,CT
8,900118500,09001,"Danbury town, Fairfield County, Connecticut",2000,54366,57038,2672,117242,8136,9486,23582,126114,2480,149696,4122,101890,municipality,CT
9,900118500,09001,"Danbury town, Fairfield County, Connecticut",2010,28907,31154,2247,63851,5399,5030,20185,60708,1972,80893,1998,46309,municipality,CT
10,900118850,09001,"Darien town, Fairfield County, Connecticut",2000,13184,13584,400,26486,948,166,858,38356,64,39214,288,36890,municipality,CT
11,900118850,09001,"Darien town, Fairfield County, Connecticut",2010,6698,7074,376,13351,744,98,743,19989,51,20732,198,18898,municipality,CT
12,900123890,09001,"Easton town, Fairfield County, Connecticut",2000,4930,5022,92,10380,294,30,256,14288,22,14544,76,13866,municipality,CT
13,900123890,09001,"Easton town, Fairfield County, Connecticut",2010,2577,2715,138,5362,238,46,220,7270,18,7490,76,6892,municipality,CT
14,900126620,09001,"Fairfield town, Fairfield County, Connecticut",2000,40794,42058,1264,87462,2314,1196,2680,112000,236,114680,916,107338,municipality,CT
15,900126620,09001,"Fairfield town, Fairfield County, Connecticut",2010,20457,21648,1191,44309,2177,1015,2999,56405,198,59404,737,52278,municipality,CT
16,900133620,09001,"Greenwich town, Fairfield County, Connecticut",2000,46460,49022,2562,91114,6322,1980,7692,114510,358,122202,1392,104458,municipality,CT
17,900133620,09001,"Greenwich town, Fairfield County, Connecticut",2010,23076,25631,2555,44833,4017,1232,5964,55207,276,61171,875,48807,municipality,CT
18,900148620,09001,"Monroe town, Fairfield County, Connecticut",2000,12962,13202,240,27308,582,450,964,37530,64,38494,272,36162,municipality,CT
19,900148620,09001,"Monroe town, Fairfield County, Connecticut",2010,6735,6918,183,14314,402,259,919,18560,33,19479,221,17645,municipality,CT
20,900150580,09001,"New Canaan town, Fairfield County, Connecticut",2000,13644,14282,638,26690,886,392,676,38114,52,38790,344,36440,municipality,CT
21,900150580,09001,"New Canaan town, Fairfield County, Connecticut",2010,7010,7551,541,13409,662,194,570,19168,51,19738,229,18032,municipality,CT
22,900150860,09001,"New Fairfield town, Fairfield County, Connecticut",2000,9276,10296,1020,19524,354,106,786,27120,28,27906,208,26424,municipality,CT
23,900150860,09001,"New Fairfield town, Fairfield County, Connecticut",2010,4802,5593,791,10103,232,142,611,13270,63,13881,139,12694,municipality,CT
24,900152980,09001,"Newtown town, Fairfield County, Connecticut",2000,16650,17202,552,35398,692,830,1180,48882,80,50062,398,46882,municipality,CT
25,900152980,09001,"Newtown town, Fairfield County, Connecticut",2010,9459,10061,602,19955,645,433,1033,26527,60,27560,256,25133,municipality,CT
26,900156060,09001,"Norwalk town, Fairfield County, Connecticut",2000,65422,67506,2084,129282,5344,24462,25932,139970,520,165902,2996,106648,municipality,CT
27,900156060,09001,"Norwalk town, Fairfield County, Connecticut",2010,33217,35415,2198,66729,4045,11472,20770,64833,363,85603,1235,47718,municipality,CT
28,900163480,09001,"Redding town, Fairfield County, Connecticut",2000,5836,6172,336,11730,294,122,244,16296,44,16540,126,15710,municipality,CT
29,900163480,09001,"Redding town, Fairfield County, Connecticut",2010,3470,3811,341,6781,195,60,237,8921,30,9158,136,8500,municipality,CT
30,900163970,09001,"Ridgefield town, Fairfield County, Connecticut",2000,16866,17754,888,32822,980,266,930,46356,114,47286,274,44722,municipality,CT
31,900163970,09001,"Ridgefield town, Fairfield County, Connecticut",2010,8801,9420,619,17288,780,174,941,23697,57,24638,282,22404,municipality,CT
32,900168170,09001,"Shelton town, Fairfield County, Connecticut",2000,28380,29414,1034,58258,1574,786,2652,73550,146,76202,838,70206,municipality,CT
33,900168170,09001,"Shelton town, Fairfield County, Connecticut",2010,15325,16146,821,31221,1522,865,2353,37206,125,39559,361,34333,municipality,CT
34,900168310,09001,"Sherman town, Fairfield County, Connecticut",2000,2868,3212,344,5612,46,38,132,7522,24,7654,36,7378,municipality,CT
35,900168310,09001,"Sherman town, Fairfield County, Connecticut",2010,1388,1831,443,2749,33,12,76,3505,3,3581,42,3415,municipality,CT
36,900173070,09001,"Stamford town, Fairfield County, Connecticut",2000,90798,94634,3836,182374,11636,34842,39270,194896,874,234166,4324,143220,municipality,CT
37,900173070,09001,"Stamford town, Fairfield County, Connecticut",2010,47357,50573,3216,96182,9604,16106,29188,93455,623,122643,1716,65406,municipality,CT
38,900174190,09001,"Stratford town, Fairfield County, Connecticut",2000,39796,41192,1396,76940,1390,9530,6798,93154,318,99952,1262,80654,municipality,CT
39,900174190,09001,"Stratford town, Fairfield County, Connecticut",2010,20095,21091,996,40092,1199,6963,7114,44270,240,51384,828,35040,municipality,CT
40,900177200,09001,"Trumbull town, Fairfield County, Connecticut",2000,23822,24320,498,50660,1626,1226,1846,66640,166,68486,524,63098,municipality,CT
41,900177200,09001,"Trumbull town, Fairfield County, Connecticut",2010,12725,13157,432,26776,1559,1070,2068,33950,88,36018,361,30872,municipality,CT
42,900183430,09001,"Weston town, Fairfield County, Connecticut",2000,6624,7064,440,13416,386,174,412,19662,52,20074,164,18886,municipality,CT
43,900183430,09001,"Weston town, Fairfield County, Connecticut",2010,3379,3674,295,6869,293,130,336,9843,31,10179,177,9212,municipality,CT
44,900183500,09001,"Westport town, Fairfield County, Connecticut",2000,19172,20130,958,37118,1244,558,1204,50294,104,51498,358,48030,municipality,CT
45,900183500,09001,"Westport town, Fairfield County, Connecticut",2010,9573,10399,826,18524,1038,292,932,25459,73,26391,341,23715,municipality,CT
46,900186370,09001,"Wilton town, Fairfield County, Connecticut",2000,11846,12226,380,24140,944,194,538,34728,72,35266,238,33280,municipality,CT
47,900186370,09001,"Wilton town, Fairfield County, Connecticut",2010,6172,6475,303,12380,821,164,537,17525,41,18062,244,16255,municipality,CT
48,900502760,09005,"Barkhamsted town, Litchfield County, Connecticut",2000,2668,2872,204,5242,28,4,62,6926,22,6988,38,6834,municipality,CT
49,900502760,09005,"Barkhamsted town, Litchfield County, Connecticut",2010,1452,1589,137,2909,23,10,57,3742,9,3799,38,3662,municipality,CT
50,900504930,09005,"Bethlehem town, Litchfield County, Connecticut",2000,2492,2776,284,5118,54,18,44,6800,26,6844,62,6640,municipality,CT
51,900504930,09005,"Bethlehem town, Litchfield County, Connecticut",2010,1411,1575,164,2860,18,16,61,3546,7,3607,28,3477,municipality,CT
52,900508210,09005,"Bridgewater town, Litchfield County, Connecticut",2000,1406,1558,152,2842,26,34,18,3630,2,3648,24,3544,municipality,CT
53,900508210,09005,"Bridgewater town, Litchfield County, Connecticut",2010,735,881,146,1403,15,13,26,1701,6,1727,6,1661,municipality,CT
54,900510940,09005,"Canaan town, Litchfield County, Connecticut",2000,890,1220,330,1652,4,32,8,2154,8,2162,18,2092,municipality,CT
55,900510940,09005,"Canaan town, Litchfield County, Connecticut",2010,583,779,196,1019,3,8,19,1215,3,1234,15,1186,municipality,CT
56,900516050,09005,"Colebrook town, Litchfield County, Connecticut",2000,1132,1312,180,2220,18,20,72,2870,0,2942,4,2828,municipality,CT
57,900516050,09005,"Colebrook town, Litchfield County, Connecticut",2010,589,722,133,1172,9,4,17,1468,3,1485,12,1440,municipality,CT
58,900517240,09005,"Cornwall town, Litchfield County, Connecticut",2000,1230,1746,516,2168,20,4,42,2826,2,2868,34,2766,municipality,CT
59,900517240,09005,"Cornwall town, Litchfield County, Connecticut",2010,628,1007,379,1141,9,2,34,1386,2,1420,16,1357,municipality,CT
60,900532290,09005,"Goshen town, Litchfield County, Connecticut",2000,2132,2964,832,4168,40,26,66,5328,6,5394,20,5236,municipality,CT
61,900532290,09005,"Goshen town, Litchfield County, Connecticut",2010,1192,1664,472,2361,36,9,67,2909,8,2976,14,2842,municipality,CT
62,900537280,09005,"Harwinton town, Litchfield County, Connecticut",2000,3916,4044,128,7918,54,8,94,10472,18,10566,50,10342,municipality,CT
63,900537280,09005,"Harwinton town, Litchfield County, Connecticut",2010,2170,2282,112,4357,48,12,80,5562,13,5642,36,5453,municipality,CT
64,900540290,09005,"Kent town, Litchfield County, Connecticut",2000,2286,2926,640,4410,42,32,144,5572,48,5716,48,5402,municipality,CT
65,900540290,09005,"Kent town, Litchfield County, Connecticut",2010,1246,1665,419,2414,49,34,94,2885,25,2979,38,2739,municipality,CT
66,900543370,09005,"Litchfield town, Litchfield County, Connecticut",2000,6620,7258,638,12440,78,110,260,16372,56,16632,128,16000,municipality,CT
67,900543370,09005,"Litchfield town, Litchfield County, Connecticut",2010,3459,3975,516,6679,76,49,173,8293,36,8466,107,8025,municipality,CT
68,900549460,09005,"Morris town, Litchfield County, Connecticut",2000,1824,2362,538,3472,38,32,40,4562,12,4602,32,4448,municipality,CT
69,900549460,09005,"Morris town, Litchfield County, Connecticut",2010,958,1314,356,1904,18,11,50,2338,2,2388,27,2280,municipality,CT
70,900551350,09005,"New Hartford town, Litchfield County, Connecticut",2000,4456,4736,280,8898,90,66,164,12012,18,12176,56,11782,municipality,CT
71,900551350,09005,"New Hartford town, Litchfield County, Connecticut",2010,2632,2923,291,5338,79,18,124,6846,6,6970,57,6686,municipality,CT
72,900552630,09005,"New Milford town, Litchfield County, Connecticut",2000,20036,21420,1384,39370,1030,742,1502,52740,192,54242,700,50076,municipality,CT
73,900552630,09005,"New Milford town, Litchfield County, Connecticut",2010,10618,11731,1113,21303,772,452,1693,26449,125,28142,391,24709,municipality,CT
74,900553470,09005,"Norfolk town, Litchfield County, Connecticut",2000,1352,1742,390,2534,18,16,32,3288,24,3320,26,3204,municipality,CT
75,900553470,09005,"Norfolk town, Litchfield County, Connecticut",2010,720,967,247,1348,11,12,30,1679,3,1709,16,1637,municipality,CT
76,900554030,09005,"North Canaan town, Litchfield County, Connecticut",2000,2686,2888,202,5140,10,72,158,6542,8,6700,60,6392,municipality,CT
77,900554030,09005,"North Canaan town, Litchfield County, Connecticut",2010,1400,1587,187,2627,8,39,195,3120,4,3315,26,3043,municipality,CT
78,900560750,09005,"Plymouth town, Litchfield County, Connecticut",2000,8906,9292,386,17272,96,174,294,22974,64,23268,210,22430,municipality,CT
79,900560750,09005,"Plymouth town, Litchfield County, Connecticut",2010,4803,5109,306,9536,98,94,370,11873,26,12243,161,11494,municipality,CT
80,900565930,09005,"Roxbury town, Litchfield County, Connecticut",2000,1696,2036,340,3300,40,10,56,4216,26,4272,28,4112,municipality,CT
81,900565930,09005,"Roxbury town, Litchfield County, Connecticut",2010,936,1167,231,1826,18,13,48,2214,6,2262,27,2150,municipality,CT
82,900566420,09005,"Salisbury town, Litchfield County, Connecticut",2000,3474,4820,1346,6170,76,128,122,7832,32,7954,64,7532,municipality,CT
83,900566420,09005,"Salisbury town, Litchfield County, Connecticut",2010,1693,2593,900,3123,41,52,107,3634,4,3741,58,3479,municipality,CT
84,900567960,09005,"Sharon town, Litchfield County, Connecticut",2000,2492,3234,742,4670,34,56,116,5820,18,5936,46,5666,municipality,CT
85,900567960,09005,"Sharon town, Litchfield County, Connecticut",2010,1250,1775,525,2332,20,44,56,2726,3,2782,27,2632,municipality,CT
86,900575730,09005,"Thomaston town, Litchfield County, Connecticut",2000,5832,6028,196,11208,74,88,218,14788,22,15006,68,14536,municipality,CT
87,900575730,09005,"Thomaston town, Litchfield County, Connecticut",2010,3108,3276,168,6072,58,27,202,7685,23,7887,66,7511,municipality,CT
88,900576570,09005,"Torrington town, Litchfield County, Connecticut",2000,29486,32294,2808,54182,1268,1388,2324,68080,174,70404,850,64400,municipality,CT
89,900576570,09005,"Torrington town, Litchfield County, Connecticut",2010,15243,16761,1518,28724,777,776,3193,33190,111,36383,628,30898,municipality,CT
90,900579510,09005,"Warren town, Litchfield County, Connecticut",2000,994,1300,306,1940,20,4,6,2502,8,2508,18,2452,municipality,CT
91,900579510,09005,"Warren town, Litchfield County, Connecticut",2010,601,811,210,1147,20,8,31,1430,4,1461,4,1394,municipality,CT
92,900579720,09005,"Washington town, Litchfield County, Connecticut",2000,2832,3528,696,5440,112,42,154,7038,20,7192,86,6778,municipality,CT
93,900579720,09005,"Washington town, Litchfield County, Connecticut",2010,1512,2124,612,2905,26,20,142,3436,8,3578,37,3345,municipality,CT
94,900580490,09005,"Watertown town, Litchfield County, Connecticut",2000,16092,16596,504,32584,546,298,812,42510,86,43322,324,41256,municipality,CT
95,900580490,09005,"Watertown town, Litchfield County, Connecticut",2010,8672,9096,424,17655,376,292,838,21676,70,22514,231,20707,municipality,CT
96,900586440,09005,"Winchester town, Litchfield County, Connecticut",2000,8742,9844,1102,16360,196,178,676,20652,84,21328,272,19922,municipality,CT
97,900586440,09005,"Winchester town, Litchfield County, Connecticut",2010,4815,5613,798,8944,102,136,583,10659,25,11242,166,10230,municipality,CT
98,900587910,09005,"Woodbury town, Litchfield County, Connecticut",2000,7430,7738,308,13976,202,92,304,18092,58,18396,102,17638,municipality,CT
99,900587910,09005,"Woodbury town, Litchfield County, Connecticut",2010,4214,4564,350,7876,167,55,245,9730,32,9975,110,9366,municipality,CT
100,900900000,09009,"County subdivisions not defined, New Haven County, Connecticut",2000,0,0,0,0,0,0,0,0,0,0,0,0,municipality,CT
101,900900000,09009,"County subdivisions not defined, New Haven County, Connecticut",2010,0,0,0,0,0,0,0,0,0,0,0,0,municipality,CT
102,900901220,09009,"Ansonia town, New Haven County, Connecticut",2000,15014,15874,860,28130,418,3022,2752,34356,150,37108,634,30132,municipality,CT
103,900901220,09009,"Ansonia town, New Haven County, Connecticut",2010,7510,8148,638,14670,365,2040,3212,16037,83,19249,386,13163,municipality,CT
104,900903250,09009,"Beacon Falls town, New Haven County, Connecticut",2000,4064,4208,144,7844,108,68,224,10268,16,10492,74,10002,municipality,CT
105,900903250,09009,"Beacon Falls town, New Haven County, Connecticut",2010,2360,2509,149,4672,70,87,300,5749,8,6049,69,5515,municipality,CT
106,900904580,09009,"Bethany town, New Haven County, Connecticut",2000,3510,3584,74,7328,154,184,204,9876,48,10080,64,9426,municipality,CT
107,900904580,09009,"Bethany town, New Haven County, Connecticut",2010,1971,2044,73,4214,268,102,137,5426,18,5563,50,4988,municipality,CT
108,900907310,09009,"Branford town, New Haven County, Connecticut",2000,25086,26684,1598,45510,1556,748,1474,55892,128,57366,612,52848,municipality,CT
109,900907310,09009,"Branford town, New Haven County, Connecticut",2010,12739,13972,1233,23064,1020,507,1149,26877,101,28026,294,24955,municipality,CT
110,900914160,09009,"Cheshire town, New Haven County, Connecticut",2000,18698,19176,478,42682,1486,2540,2194,54892,170,57086,486,50210,municipality,CT
111,900914160,09009,"Cheshire town, New Haven County, Connecticut",2010,10041,10424,383,22168,1477,1374,1375,27886,55,29261,343,24637,municipality,CT
112,900919550,09009,"Derby town, New Haven County, Connecticut",2000,10504,11136,632,19408,424,882,1900,22882,56,24782,302,21218,municipality,CT
113,900919550,09009,"Derby town, New Haven County, Connecticut",2010,5388,5849,461,10194,323,891,1830,11072,59,12902,200,9599,municipality,CT
114,900922910,09009,"East Haven town, New Haven County, Connecticut",2000,22438,23396,958,43868,1074,754,2456,53922,102,56378,484,51508,municipality,CT
115,900922910,09009,"East Haven town, New Haven County, Connecticut",2010,11756,12533,777,23602,954,771,3012,26245,67,29257,299,24154,municipality,CT
116,900934950,09009,"Guilford town, New Haven County, Connecticut",2000,16302,17448,1146,31920,702,384,910,41886,44,42796,338,40418,municipality,CT
117,900934950,09009,"Guilford town, New Haven County, Connecticut",2010,8715,9596,881,17098,535,160,779,21596,32,22375,229,20640,municipality,CT
118,900935650,09009,"Hamden town, New Haven County, Connecticut",2000,44816,46928,2112,90160,4000,17284,4850,108976,346,113826,1722,85624,municipality,CT
119,900935650,09009,"Hamden town, New Haven County, Connecticut",2010,23727,25114,1387,49338,3304,11869,5327,55633,163,60960,1211,39086,municipality,CT
120,900944560,09009,"Madison town, New Haven County, Connecticut",2000,13030,14772,1742,25632,608,140,480,35236,36,35716,312,34140,municipality,CT
121,900944560,09009,"Madison town, New Haven County, Connecticut",2010,6971,8049,1078,13490,405,100,375,17894,31,18269,206,17152,municipality,CT
122,900946520,09009,"Meriden town, New Haven County, Connecticut",2000,45902,49262,3360,86556,1566,6642,24592,91896,406,116488,1864,81418,municipality,CT
123,900946520,09009,"Meriden town, New Haven County, Connecticut",2010,23977,25892,1915,46315,1250,4980,17590,43278,203,60868,1036,35809,municipality,CT
124,900946940,09009,"Middlebury town, New Haven County, Connecticut",2000,4796,4988,192,9738,166,42,158,12744,32,12902,90,12414,municipality,CT
125,900946940,09009,"Middlebury town, New Haven County, Connecticut",2010,2748,2892,144,5712,286,67,208,7367,19,7575,70,6925,municipality,CT
126,900947535,09009,"Milford town, New Haven County, Connecticut",2000,41800,43924,2124,81254,2412,1902,3500,101110,356,104610,960,95480,municipality,CT
127,900947535,09009,"Milford town, New Haven County, Connecticut",2010,21708,23074,1366,42209,2801,1238,2756,50003,185,52759,644,45135,municipality,CT
128,900949950,09009,"Naugatuck town, New Haven County, Connecticut",2000,23658,24682,1024,45328,1040,1684,2772,59206,422,61978,978,55082,municipality,CT
129,900949950,09009,"Naugatuck town, New Haven County, Connecticut",2010,12339,13061,722,24482,962,1427,2929,28933,242,31862,535,25767,municipality,CT
130,900952070,09009,"New Haven town, New Haven County, Connecticut",2000,94188,105882,11694,184360,9552,89196,52886,194366,1606,247252,6054,87958,municipality,CT
131,900952070,09009,"New Haven town, New Haven County, Connecticut",2010,48877,54967,6090,100197,5864,43332,35591,94188,828,129779,2934,41230,municipality,CT
132,900953890,09009,"North Branford town, New Haven County, Connecticut",2000,10264,10492,228,20692,248,326,500,27312,28,27812,194,26516,municipality,CT
133,900953890,09009,"North Branford town, New Haven County, Connecticut",2010,5441,5629,188,11225,225,187,421,13986,25,14407,119,13430,municipality,CT
134,900954870,09009,"North Haven town, New Haven County, Connecticut",2000,17194,17546,352,35666,1536,1004,866,45204,72,46070,338,42254,municipality,CT
135,900954870,09009,"North Haven town, New Haven County, Connecticut",2010,9135,9491,356,19089,1121,693,929,23164,50,24093,244,21056,municipality,CT
136,900957600,09009,"Orange town, New Haven County, Connecticut",2000,9478,9740,262,19958,1016,200,380,26086,32,26466,214,24624,municipality,CT
137,900957600,09009,"Orange town, New Haven County, Connecticut",2010,5123,5345,222,10710,1045,198,398,13558,39,13956,156,12120,municipality,CT
138,900958300,09009,"Oxford town, New Haven County, Connecticut",2000,6686,6840,154,14316,130,100,360,19282,52,19642,96,18904,municipality,CT
139,900958300,09009,"Oxford town, New Haven County, Connecticut",2010,4504,4746,242,9598,195,134,468,12215,33,12683,108,11745,municipality,CT
140,900962290,09009,"Prospect town, New Haven County, Connecticut",2000,6040,6188,148,13070,126,244,336,17078,62,17414,110,16536,municipality,CT
141,900962290,09009,"Prospect town, New Haven County, Connecticut",2010,3357,3474,117,7281,73,175,312,9093,25,9405,80,8740,municipality,CT
142,900967610,09009,"Seymour town, New Haven County, Connecticut",2000,12310,12712,402,23534,540,408,940,29968,98,30908,202,28720,municipality,CT
143,900967610,09009,"Seymour town, New Haven County, Connecticut",2010,6654,6968,314,12922,359,395,1064,15476,34,16540,172,14516,municipality,CT
144,900969640,09009,"Southbury town, New Haven County, Connecticut",2000,14450,15598,1148,28678,428,160,592,36542,54,37134,212,35688,municipality,CT
145,900969640,09009,"Southbury town, New Haven County, Connecticut",2010,8213,9091,878,15854,531,156,523,19381,44,19904,188,18462,municipality,CT
146,900978740,09009,"Wallingford town, New Haven County, Connecticut",2000,33394,34612,1218,65400,1498,834,3892,82160,176,86052,736,78916,municipality,CT
147,900978740,09009,"Wallingford town, New Haven County, Connecticut",2010,18032,18945,913,35657,1526,587,3562,41573,106,45135,475,38879,municipality,CT
148,900980070,09009,"Waterbury town, New Haven County, Connecticut",2000,85244,93654,8410,157634,3168,32670,46708,167834,2034,214542,5150,124812,municipality,CT
149,900980070,09009,"Waterbury town, New Haven County, Connecticut",2010,42761,47991,5230,82101,1933,19654,34446,75920,1565,110366,2687,50081,municipality,CT
150,900982870,09009,"West Haven town, New Haven County, Connecticut",2000,42180,44672,2492,80504,3024,16514,9514,95206,432,104720,2194,73042,municipality,CT
151,900982870,09009,"West Haven town, New Haven County, Connecticut",2010,21112,22446,1334,44009,2056,10205,10155,45409,293,55564,1220,31635,municipality,CT
152,900987560,09009,"Wolcott town, New Haven County, Connecticut",2000,10828,11088,260,22514,226,370,546,29884,82,30430,234,28972,municipality,CT
153,900987560,09009,"Wolcott town, New Haven County, Connecticut",2010,6007,6276,269,12772,205,261,611,16069,52,16680,191,15360,municipality,CT
154,900987700,09009,"Woodbridge town, New Haven County, Connecticut",2000,6206,6378,172,12974,916,270,276,17690,48,17966,236,16220,municipality,CT
155,900987700,09009,"Woodbridge town, New Haven County, Connecticut",2010,3336,3478,142,6860,780,173,284,8706,21,8990,127,7605,municipality,CT
156,3400300700,34003,"Allendale borough, Bergen County, New Jersey",2000,4220,4286,66,9326,816,52,340,13058,30,13398,62,12098,municipality,INJ
157,3400300700,34003,"Allendale borough, Bergen County, New Jersey",2010,2236,2388,152,4658,624,29,304,6201,12,6505,86,5450,municipality,INJ
158,3400301090,34003,"Alpine borough, Bergen County, New Jersey",2000,1416,1460,44,3288,832,66,110,4256,12,4366,52,3294,municipality,INJ
159,3400301090,34003,"Alpine borough, Bergen County, New Jersey",2010,611,670,59,1431,482,44,89,1760,2,1849,35,1197,municipality,INJ
160,3400305170,34003,"Bergenfield borough, Bergen County, New Jersey",2000,17962,18294,332,39452,10654,3330,8948,43546,296,52494,936,28330,municipality,INJ
161,3400305170,34003,"Bergenfield borough, Bergen County, New Jersey",2010,8852,9200,348,20361,6778,1724,7097,19667,100,26764,519,10546,municipality,INJ
162,3400306490,34003,"Bogota borough, Bergen County, New Jersey",2000,5748,5830,82,12322,1274,786,3518,12980,94,16498,412,10414,municipality,INJ
163,3400306490,34003,"Bogota borough, Bergen County, New Jersey",2010,2773,2888,115,6244,795,582,3169,5018,91,8187,139,3411,municipality,INJ
164,3400310480,34003,"Carlstadt borough, Bergen County, New Jersey",2000,4786,4946,160,9580,732,128,946,10888,28,11834,60,9940,municipality,INJ
165,3400310480,34003,"Carlstadt borough, Bergen County, New Jersey",2010,2378,2495,117,4889,499,122,1104,5023,29,6127,61,4312,municipality,INJ
166,3400313570,34003,"Cliffside Park borough, Bergen County, New Jersey",2000,20054,20750,696,38252,5510,712,8354,37660,162,46014,752,30524,municipality,INJ
167,3400313570,34003,"Cliffside Park borough, Bergen County, New Jersey",2010,9948,10665,717,19526,3219,584,6704,16890,223,23594,430,12434,municipality,INJ
168,3400313810,34003,"Closter borough, Bergen County, New Jersey",2000,5578,5730,152,12076,3600,152,686,16080,36,16766,174,12118,municipality,INJ
169,3400313810,34003,"Closter borough, Bergen County, New Jersey",2010,2747,2860,113,6135,2649,100,501,7872,12,8373,92,5019,municipality,INJ
170,3400315820,34003,"Cresskill borough, Bergen County, New Jersey",2000,5260,5404,144,11420,2882,140,618,14874,36,15492,214,11602,municipality,INJ
171,3400315820,34003,"Cresskill borough, Bergen County, New Jersey",2010,3002,3114,112,6277,2367,57,537,8036,10,8573,102,5500,municipality,INJ
172,3400317530,34003,"Demarest borough, Bergen County, New Jersey",2000,3202,3268,66,6888,1954,46,334,9356,16,9690,108,7232,municipality,INJ
173,3400317530,34003,"Demarest borough, Bergen County, New Jersey",2010,1597,1659,62,3540,1276,26,216,4665,7,4881,83,3273,municipality,INJ
174,3400318400,34003,"Dumont borough, Bergen County, New Jersey",2000,12740,12930,190,26478,3830,444,2926,32080,46,35006,376,27384,municipality,INJ
175,3400318400,34003,"Dumont borough, Bergen County, New Jersey",2010,6364,6542,178,13553,2599,375,2580,14899,44,17479,240,11641,municipality,INJ
176,3400319510,34003,"East Rutherford borough, Bergen County, New Jersey",2000,7288,7542,254,14054,1860,584,1856,15576,34,17432,278,12820,municipality,INJ
177,3400319510,34003,"East Rutherford borough, Bergen County, New Jersey",2010,3792,4018,226,7296,1237,336,1563,7350,32,8913,129,5616,municipality,INJ
178,3400320020,34003,"Edgewater borough, Bergen County, New Jersey",2000,7672,8554,882,12988,3530,486,1604,13750,74,15354,338,9322,municipality,INJ
179,3400320020,34003,"Edgewater borough, Bergen County, New Jersey",2010,5637,6282,645,9472,4076,519,1278,10235,57,11513,240,5343,municipality,INJ
180,3400321300,34003,"Elmwood Park borough, Bergen County, New Jersey",2000,14178,14484,306,29942,2948,758,5070,32780,82,37850,716,28276,municipality,INJ
181,3400321300,34003,"Elmwood Park borough, Bergen County, New Jersey",2010,7032,7385,353,15358,2055,884,4117,15286,91,19403,299,11957,municipality,INJ
182,3400321450,34003,"Emerson borough, Bergen County, New Jersey",2000,4746,4796,50,11054,1136,94,664,13730,16,14394,66,12418,municipality,INJ
183,3400321450,34003,"Emerson borough, Bergen County, New Jersey",2010,2480,2552,72,5631,629,64,619,6782,9,7401,94,5986,municipality,INJ
184,3400321480,34003,"Englewood city, Bergen County, New Jersey",2000,18546,19228,682,39894,2712,19774,11406,41000,278,52406,1458,16778,municipality,INJ
185,3400321480,34003,"Englewood city, Bergen County, New Jersey",2010,10057,10695,638,21124,2169,8373,7460,19687,189,27147,482,8474,municipality,INJ
186,3400321510,34003,"Englewood Cliffs borough, Bergen County, New Jersey",2000,3636,3778,142,8442,3160,144,520,10124,20,10644,118,6682,municipality,INJ
187,3400321510,34003,"Englewood Cliffs borough, Bergen County, New Jersey",2010,1824,1924,100,4143,2027,93,316,4965,3,5281,103,2739,municipality,INJ
188,3400322470,34003,"Fair Lawn borough, Bergen County, New Jersey",2000,23612,24012,400,48846,3098,416,3488,59786,100,63274,698,55474,municipality,INJ
189,3400322470,34003,"Fair Lawn borough, Bergen County, New Jersey",2010,11930,12266,336,25305,3130,464,3296,29161,75,32457,341,25151,municipality,INJ
190,3400322560,34003,"Fairview borough, Bergen County, New Jersey",2000,9722,9976,254,20912,1312,322,9822,16688,264,26510,1046,13744,municipality,INJ
191,3400322560,34003,"Fairview borough, Bergen County, New Jersey",2010,4853,5150,297,11128,612,286,7558,6277,215,13835,219,4945,municipality,INJ
192,3400324420,34003,"Fort Lee borough, Bergen County, New Jersey",2000,33088,34892,1804,58522,22242,1110,5582,65340,180,70922,1108,40700,municipality,INJ
193,3400324420,34003,"Fort Lee borough, Bergen County, New Jersey",2010,16371,17818,1447,29348,13552,805,3877,31468,128,35345,469,16514,municipality,INJ
194,3400324990,34003,"Franklin Lakes borough, Bergen County, New Jersey",2000,6644,6790,146,14866,1310,192,572,20272,44,20844,156,18570,municipality,INJ
195,3400324990,34003,"Franklin Lakes borough, Bergen County, New Jersey",2010,3527,3692,165,7689,777,136,525,10065,15,10590,120,9017,municipality,INJ
196,3400325770,34003,"Garfield city, Bergen County, New Jersey",2000,22500,23396,896,46248,1574,1556,11978,47594,154,59572,1190,43120,municipality,INJ
197,3400325770,34003,"Garfield city, Bergen County, New Jersey",2010,11073,11788,715,23377,659,1564,9830,20657,122,30487,340,17972,municipality,INJ
198,3400326640,34003,"Glen Rock borough, Bergen County, New Jersey",2000,7954,8048,94,16302,1496,412,628,22464,64,23092,166,20326,municipality,INJ
199,3400326640,34003,"Glen Rock borough, Bergen County, New Jersey",2010,3917,4016,99,8119,1050,151,527,11074,32,11601,150,9691,municipality,INJ
200,3400328680,34003,"Hackensack city, Bergen County, New Jersey",2000,36226,37890,1664,69812,6326,20184,22122,63232,418,85354,2278,34026,municipality,INJ
201,3400328680,34003,"Hackensack city, Bergen County, New Jersey",2010,18142,19375,1233,34979,4372,9693,15186,27824,250,43010,664,12845,municipality,INJ
202,3400330150,34003,"Harrington Park borough, Bergen County, New Jersey",2000,3126,3166,40,6768,1388,58,244,9236,26,9480,26,7738,municipality,INJ
203,3400330150,34003,"Harrington Park borough, Bergen County, New Jersey",2010,1592,1624,32,3360,812,31,163,4501,18,4664,48,3592,municipality,INJ
204,3400330420,34003,"Hasbrouck Heights borough, Bergen County, New Jersey",2000,9042,9234,192,18152,1542,376,1928,21396,42,23324,214,19222,municipality,INJ
205,3400330420,34003,"Hasbrouck Heights borough, Bergen County, New Jersey",2010,4433,4627,194,9205,1169,293,1760,10082,36,11842,139,8445,municipality,INJ
206,3400330540,34003,"Haworth borough, Bergen County, New Jersey",2000,2268,2292,24,4822,624,82,184,6596,12,6780,60,5818,municipality,INJ
207,3400330540,34003,"Haworth borough, Bergen County, New Jersey",2010,1110,1136,26,2426,397,37,148,3234,6,3382,59,2735,municipality,INJ
208,3400331920,34003,"Hillsdale borough, Bergen County, New Jersey",2000,7004,7094,90,14930,1022,172,858,19316,36,20174,120,17966,municipality,INJ
209,3400331920,34003,"Hillsdale borough, Bergen County, New Jersey",2010,3493,3567,74,7501,638,93,794,9425,32,10219,72,8590,municipality,INJ
210,3400332310,34003,"Ho-Ho-Kus borough, Bergen County, New Jersey",2000,2866,2930,64,5884,424,40,160,7960,36,8120,68,7392,municipality,INJ
211,3400332310,34003,"Ho-Ho-Kus borough, Bergen County, New Jersey",2010,1401,1462,61,2885,235,9,168,3910,9,4078,57,3600,municipality,INJ
212,3400340020,34003,"Leonia borough, Bergen County, New Jersey",2000,6542,6686,144,13450,4634,370,2270,15558,30,17828,278,10246,municipality,INJ
213,3400340020,34003,"Leonia borough, Bergen County, New Jersey",2010,3284,3428,144,6942,3122,169,1489,7448,38,8937,178,3941,municipality,INJ
214,3400340680,34003,"Little Ferry borough, Bergen County, New Jersey",2000,8732,8898,166,17232,3684,974,3282,18318,76,21600,576,13008,municipality,INJ
215,3400340680,34003,"Little Ferry borough, Bergen County, New Jersey",2010,4239,4439,200,8533,2550,366,2442,8184,58,10626,194,5016,municipality,INJ
216,3400341100,34003,"Lodi borough, Bergen County, New Jersey",2000,19056,19816,760,37730,4222,1538,8618,39324,200,47942,810,32554,municipality,INJ
217,3400341100,34003,"Lodi borough, Bergen County, New Jersey",2010,9471,10127,656,18989,2036,1589,7360,16776,140,24136,419,12592,municipality,INJ
218,3400342090,34003,"Lyndhurst township, Bergen County, New Jersey",2000,15754,16206,452,31380,2084,196,3488,35278,102,38766,564,32332,municipality,INJ
219,3400342090,34003,"Lyndhurst township, Bergen County, New Jersey",2010,8337,8787,450,16671,1333,325,3769,16785,132,20554,286,14709,municipality,INJ
220,3400342750,34003,"Mahwah township, Bergen County, New Jersey",2000,18680,19154,474,37434,3020,1020,2056,46068,376,48124,542,41110,municipality,INJ
221,3400342750,34003,"Mahwah township, Bergen County, New Jersey",2010,9505,9868,363,20754,2014,616,1622,24268,141,25890,409,21088,municipality,INJ
222,3400344880,34003,"Maywood borough, Bergen County, New Jersey",2000,7420,7554,134,15028,1358,494,2230,16816,60,19046,244,14660,municipality,INJ
223,3400344880,34003,"Maywood borough, Bergen County, New Jersey",2010,3649,3769,120,7544,1042,460,1785,7770,49,9555,138,6081,municipality,INJ
224,3400346110,34003,"Midland Park borough, Bergen County, New Jersey",2000,5226,5300,74,10516,308,58,512,13382,30,13894,64,12922,municipality,INJ
225,3400346110,34003,"Midland Park borough, Bergen County, New Jersey",2010,2756,2861,105,5391,192,51,474,6654,11,7128,98,6302,municipality,INJ
226,3400347610,34003,"Montvale borough, Bergen County, New Jersey",2000,5018,5180,162,10418,746,60,434,13634,26,14068,86,12716,municipality,INJ
227,3400347610,34003,"Montvale borough, Bergen County, New Jersey",2010,2778,2872,94,5745,861,70,419,7425,15,7844,84,6395,municipality,INJ
228,3400347700,34003,"Moonachie borough, Bergen County, New Jersey",2000,2082,2148,66,4358,350,44,698,4810,12,5508,118,4286,municipality,INJ
229,3400347700,34003,"Moonachie borough, Bergen County, New Jersey",2010,1005,1053,48,2206,267,23,660,2048,8,2708,42,1708,municipality,INJ
230,3400351660,34003,"New Milford borough, Bergen County, New Jersey",2000,12692,12874,182,25790,4804,792,2652,30148,58,32800,478,24016,municipality,INJ
231,3400351660,34003,"New Milford borough, Bergen County, New Jersey",2010,6141,6362,221,12938,3163,507,2227,14114,46,16341,238,10160,municipality,INJ
232,3400352320,34003,"North Arlington borough, Bergen County, New Jersey",2000,12784,13058,274,24890,1682,116,3210,27152,68,30362,410,24876,municipality,INJ
233,3400352320,34003,"North Arlington borough, Bergen County, New Jersey",2010,6295,6573,278,12684,1201,148,3211,12181,112,15392,153,10567,municipality,INJ
234,3400353430,34003,"Northvale borough, Bergen County, New Jersey",2000,3150,3192,42,6916,1252,64,422,8498,14,8920,62,7106,municipality,INJ
235,3400353430,34003,"Northvale borough, Bergen County, New Jersey",2010,1564,1635,71,3473,1110,46,378,4262,9,4640,58,3039,municipality,INJ
236,3400353610,34003,"Norwood borough, Bergen County, New Jersey",2000,3714,3776,62,8538,2184,96,344,11158,32,11502,134,8712,municipality,INJ
237,3400353610,34003,"Norwood borough, Bergen County, New Jersey",2010,1927,2007,80,4394,1551,64,260,5451,15,5711,55,3766,municipality,INJ
238,3400353850,34003,"Oakland borough, Bergen County, New Jersey",2000,8510,8690,180,18588,670,188,966,23966,34,24932,192,22882,municipality,INJ
239,3400353850,34003,"Oakland borough, Bergen County, New Jersey",2010,4335,4470,135,9442,532,104,681,12073,30,12754,134,11273,municipality,INJ
240,3400354870,34003,"Old Tappan borough, Bergen County, New Jersey",2000,3556,3608,52,8008,1714,60,302,10662,10,10964,54,8824,municipality,INJ
241,3400354870,34003,"Old Tappan borough, Bergen County, New Jersey",2010,1931,1995,64,4175,1276,40,288,5462,6,5750,68,4072,municipality,INJ
242,3400354990,34003,"Oradell borough, Bergen County, New Jersey",2000,5578,5666,88,12040,1298,68,498,15596,6,16094,130,14094,municipality,INJ
243,3400354990,34003,"Oradell borough, Bergen County, New Jersey",2010,2749,2831,82,5894,895,46,397,7581,12,7978,91,6537,municipality,INJ
244,3400355770,34003,"Palisades Park borough, Bergen County, New Jersey",2000,12494,12772,278,27522,14020,352,5626,28520,122,34146,690,13336,municipality,INJ
245,3400355770,34003,"Palisades Park borough, Bergen County, New Jersey",2010,6934,7362,428,16379,11312,283,3575,16047,78,19622,161,4213,municipality,INJ
246,3400355950,34003,"Paramus borough, Bergen County, New Jersey",2000,16164,16418,254,39510,8838,556,2506,48968,58,51474,650,38866,municipality,INJ
247,3400355950,34003,"Paramus borough, Bergen County, New Jersey",2010,8630,8915,285,20674,5850,335,1913,24429,81,26342,537,17626,municipality,INJ
248,3400356130,34003,"Park Ridge borough, Bergen County, New Jersey",2000,6322,6516,194,13328,672,134,926,16490,18,17416,110,15556,municipality,INJ
249,3400356130,34003,"Park Ridge borough, Bergen County, New Jersey",2010,3283,3428,145,6667,524,80,669,7976,21,8645,63,7288,municipality,INJ
250,3400361680,34003,"Ramsey borough, Bergen County, New Jersey",2000,10626,10800,174,20948,1666,220,840,27862,34,28702,250,25692,municipality,INJ
251,3400361680,34003,"Ramsey borough, Bergen County, New Jersey",2010,5363,5550,187,10627,959,90,866,13607,28,14473,139,12391,municipality,INJ
252,3400362910,34003,"Ridgefield borough, Bergen County, New Jersey",2000,8040,8240,200,16930,3762,142,2988,18672,74,21660,316,14378,municipality,INJ
253,3400362910,34003,"Ridgefield borough, Bergen County, New Jersey",2010,3905,4145,240,8651,3199,95,2362,8670,39,11032,122,5215,municipality,INJ
254,3400362940,34003,"Ridgefield Park village, Bergen County, New Jersey",2000,10024,10268,244,19990,2014,892,5726,20020,68,25746,370,16676,municipality,INJ
255,3400362940,34003,"Ridgefield Park village, Bergen County, New Jersey",2010,4851,5164,313,9935,1447,581,4605,8124,57,12729,157,5882,municipality,INJ
256,3400363000,34003,"Ridgewood village, Bergen County, New Jersey",2000,17206,17604,398,34922,4310,790,1884,47988,80,49872,480,42328,municipality,INJ
257,3400363000,34003,"Ridgewood village, Bergen County, New Jersey",2010,8456,8743,287,17306,3237,373,1316,23642,47,24958,424,19561,municipality,INJ
258,3400363360,34003,"River Edge borough, Bergen County, New Jersey",2000,8330,8420,90,16624,2756,216,1162,20730,36,21892,206,17516,municipality,INJ
259,3400363360,34003,"River Edge borough, Bergen County, New Jersey",2010,4134,4261,127,8396,2505,156,869,10471,24,11340,117,7669,municipality,INJ
260,3400363690,34003,"River Vale township, Bergen County, New Jersey",2000,6550,6624,74,13752,1112,100,608,18290,22,18898,116,16940,municipality,INJ
261,3400363690,34003,"River Vale township, Bergen County, New Jersey",2010,3421,3521,100,7086,809,64,481,9178,12,9659,107,8186,municipality,INJ
262,3400363990,34003,"Rochelle Park township, Bergen County, New Jersey",2000,4122,4222,100,8994,654,50,948,10108,10,11056,94,9300,municipality,INJ
263,3400363990,34003,"Rochelle Park township, Bergen County, New Jersey",2010,2087,2170,83,4524,481,147,904,4626,9,5530,71,3918,municipality,INJ
264,3400364170,34003,"Rockleigh borough, Bergen County, New Jersey",2000,148,160,12,576,30,26,38,744,2,782,14,672,municipality,INJ
265,3400364170,34003,"Rockleigh borough, Bergen County, New Jersey",2010,75,86,11,445,8,10,20,511,1,531,5,487,municipality,INJ
266,3400365280,34003,"Rutherford borough, Bergen County, New Jersey",2000,14110,14428,318,28698,4108,950,3110,33110,102,36220,558,27392,municipality,INJ
267,3400365280,34003,"Rutherford borough, Bergen County, New Jersey",2010,6949,7278,329,14272,2340,454,2543,15518,73,18061,353,12298,municipality,INJ
268,3400365340,34003,"Saddle Brook township, Bergen County, New Jersey",2000,10124,10322,198,20998,1222,324,1650,24660,50,26310,264,22800,municipality,INJ
269,3400365340,34003,"Saddle Brook township, Bergen County, New Jersey",2010,5286,5485,199,10906,1102,268,1666,11993,48,13659,157,10418,municipality,INJ
270,3400365400,34003,"Saddle River borough, Bergen County, New Jersey",2000,2236,2366,130,4964,458,48,164,6238,24,6402,86,5622,municipality,INJ
271,3400365400,34003,"Saddle River borough, Bergen County, New Jersey",2010,1216,1341,125,2487,291,60,162,2990,12,3152,57,2570,municipality,INJ
272,3400368970,34003,"South Hackensack township, Bergen County, New Jersey",2000,1622,1660,38,3614,258,94,678,3820,20,4498,52,3396,municipality,INJ
273,3400368970,34003,"South Hackensack township, Bergen County, New Jersey",2010,845,879,34,1856,121,98,792,1586,6,2378,35,1326,municipality,INJ
274,3400372360,34003,"Teaneck township, Bergen County, New Jersey",2000,26836,27438,602,58278,5582,21810,8206,70314,400,78520,2048,40474,municipality,INJ
275,3400372360,34003,"Teaneck township, Bergen County, New Jersey",2010,13470,14024,554,29823,3574,10266,6575,33201,218,39776,797,18346,municipality,INJ
276,3400372420,34003,"Tenafly borough, Bergen County, New Jersey",2000,9548,9794,246,19800,5258,244,1284,26328,80,27612,394,20352,municipality,INJ
277,3400372420,34003,"Tenafly borough, Bergen County, New Jersey",2010,4766,4980,214,9972,3794,123,776,13712,44,14488,276,9475,municipality,INJ
278,3400372480,34003,"Teterboro borough, Bergen County, New Jersey",2000,14,16,2,24,0,0,0,36,0,36,6,30,municipality,INJ
279,3400372480,34003,"Teterboro borough, Bergen County, New Jersey",2010,25,27,2,51,2,2,24,43,2,67,6,31,municipality,INJ
280,3400375140,34003,"Upper Saddle River borough, Bergen County, New Jersey",2000,4994,5120,126,10736,968,144,338,15144,30,15482,130,13872,municipality,INJ
281,3400375140,34003,"Upper Saddle River borough, Bergen County, New Jersey",2010,2639,2776,137,5693,822,108,355,7853,22,8208,92,6809,municipality,INJ
282,3400376400,34003,"Waldwick borough, Bergen County, New Jersey",2000,6856,6990,134,14340,868,114,1022,18222,20,19244,130,17090,municipality,INJ
283,3400376400,34003,"Waldwick borough, Bergen County, New Jersey",2010,3420,3537,117,7196,478,74,830,8795,17,9625,104,8122,municipality,INJ
284,3400376490,34003,"Wallington borough, Bergen County, New Jersey",2000,9504,9812,308,18902,1148,568,1552,21614,30,23166,402,19466,municipality,INJ
285,3400376490,34003,"Wallington borough, Bergen County, New Jersey",2010,4637,4946,309,9296,610,303,1225,10110,31,11335,118,9048,municipality,INJ
286,3400377135,34003,"Washington township, Bergen County, New Jersey",2000,6438,6490,52,13810,992,156,598,17278,40,17876,128,15962,municipality,INJ
287,3400377135,34003,"Washington township, Bergen County, New Jersey",2010,3261,3341,80,7015,581,93,495,8607,10,9102,84,7839,municipality,INJ
288,3400380270,34003,"Westwood borough, Bergen County, New Jersey",2000,8970,9220,250,17262,964,1248,1320,20678,62,21998,182,18222,municipality,INJ
289,3400380270,34003,"Westwood borough, Bergen County, New Jersey",2010,4438,4636,198,8521,802,466,1263,9645,10,10908,122,8245,municipality,INJ
290,3400382300,34003,"Woodcliff Lake borough, Bergen County, New Jersey",2000,3648,3684,36,8054,514,98,268,11222,2,11490,60,10548,municipality,INJ
291,3400382300,34003,"Woodcliff Lake borough, Bergen County, New Jersey",2010,1916,1980,64,4131,371,47,310,5420,8,5730,48,4946,municipality,INJ
292,3400382570,34003,"Wood-Ridge borough, Bergen County, New Jersey",2000,6048,6174,126,12042,764,122,1112,14176,18,15288,148,13124,municipality,INJ
293,3400382570,34003,"Wood-Ridge borough, Bergen County, New Jersey",2010,2939,3051,112,5986,538,95,1000,6626,24,7626,71,5898,municipality,INJ
294,3400383050,34003,"Wyckoff township, Bergen County, New Jersey",2000,11082,11276,194,23674,1222,146,752,32264,68,33016,204,30624,municipality,INJ
295,3400383050,34003,"Wyckoff township, Bergen County, New Jersey",2010,5646,5827,181,12081,705,81,737,15959,17,16696,151,15005,municipality,INJ
296,3401304695,34013,"Belleville township, Essex County, New Jersey",2000,27462,28288,826,56164,8048,3416,17014,54842,370,71856,1670,41338,municipality,INJ
297,3401304695,34013,"Belleville township, Essex County, New Jersey",2010,13395,14327,932,28146,4251,2794,14133,21793,361,35926,519,13868,municipality,INJ
298,3401306260,34013,"Bloomfield township, Essex County, New Jersey",2000,38034,39016,982,75288,7960,10664,13802,81564,754,95366,2114,60072,municipality,INJ
299,3401306260,34013,"Bloomfield township, Essex County, New Jersey",2010,18387,19470,1083,37306,3846,8092,11606,35709,523,47315,957,22291,municipality,INJ
300,3401309250,34013,"Caldwell borough, Essex County, New Jersey",2000,6622,6792,170,12430,616,330,704,14464,36,15168,110,13372,municipality,INJ
301,3401309250,34013,"Caldwell borough, Essex County, New Jersey",2010,3359,3510,151,6375,366,233,786,7036,18,7822,113,6306,municipality,INJ
302,3401311200,34013,"Cedar Grove township, Essex County, New Jersey",2000,8806,8940,134,19868,1332,728,786,23814,26,24600,174,21554,municipality,INJ
303,3401311200,34013,"Cedar Grove township, Essex County, New Jersey",2010,4523,4661,138,9909,800,294,727,11684,17,12411,98,10475,municipality,INJ
304,3401313045,34013,"City of Orange township, Essex County, New Jersey",2000,23770,25330,1560,47520,828,48636,8194,57542,528,65736,2546,5004,municipality,INJ
305,3401313045,34013,"City of Orange township, Essex County, New Jersey",2010,11202,12222,1020,22615,448,21067,6531,23603,286,30134,445,1357,municipality,INJ
306,3401319390,34013,"East Orange city, Essex County, New Jersey",2000,52048,56970,4922,100376,588,123208,6568,133080,910,139648,4626,3748,municipality,INJ
307,3401319390,34013,"East Orange city, Essex County, New Jersey",2010,24945,28803,3858,47776,436,55702,5095,59175,550,64270,1065,1422,municipality,INJ
308,3401321840,34013,"Essex Fells borough, Essex County, New Jersey",2000,1474,1522,48,3040,44,20,52,4272,8,4324,52,4148,municipality,INJ
309,3401321840,34013,"Essex Fells borough, Essex County, New Jersey",2010,728,758,30,1481,43,20,42,2071,1,2113,31,1976,municipality,INJ
310,3401322385,34013,"Fairfield township, Essex County, New Jersey",2000,4592,4652,60,11012,398,72,488,13638,16,14126,64,13088,municipality,INJ
311,3401322385,34013,"Fairfield township, Essex County, New Jersey",2010,2645,2723,78,5780,183,46,384,7082,3,7466,50,6800,municipality,INJ
312,3401326610,34013,"Glen Ridge borough, Essex County, New Jersey",2000,4916,4980,64,10078,482,684,502,14040,58,14542,146,12670,municipality,INJ
313,3401326610,34013,"Glen Ridge borough, Essex County, New Jersey",2010,2476,2541,65,5102,348,356,377,7150,29,7527,164,6253,municipality,INJ
314,3401334450,34013,"Irvington township, Essex County, New Jersey",2000,44064,48232,4168,87382,1322,97704,10172,111218,734,121390,4528,6930,municipality,INJ
315,3401334450,34013,"Irvington township, Essex County, New Jersey",2010,20093,23196,3103,40235,462,45285,5716,48210,336,53926,698,1429,municipality,INJ
316,3401340890,34013,"Livingston township, Essex County, New Jersey",2000,18600,18914,314,40214,7928,650,1390,53392,96,54782,418,44300,municipality,INJ
317,3401340890,34013,"Livingston township, Essex County, New Jersey",2010,9990,10284,294,21433,5609,632,1192,28174,57,29366,341,21535,municipality,INJ
318,3401343800,34013,"Maplewood township, Essex County, New Jersey",2000,16904,17230,326,34350,1320,15288,2496,45240,256,47736,1612,26764,municipality,INJ
319,3401343800,34013,"Maplewood township, Essex County, New Jersey",2010,8240,8608,368,17109,722,8189,1595,22272,131,23867,645,12585,municipality,INJ
320,3401346380,34013,"Millburn township, Essex County, New Jersey",2000,14030,14316,286,27578,3316,424,808,38722,80,39530,378,34524,municipality,INJ
321,3401346380,34013,"Millburn township, Essex County, New Jersey",2010,6813,7106,293,13647,3149,303,703,19446,32,20149,375,15587,municipality,INJ
322,3401347500,34013,"Montclair township, Essex County, New Jersey",2000,30040,31062,1022,58026,2428,24388,3990,73964,578,77954,2034,44536,municipality,INJ
323,3401347500,34013,"Montclair township, Essex County, New Jersey",2010,15089,15911,822,28072,1416,9902,2810,34859,284,37669,1337,21920,municipality,INJ
324,3401351000,34013,"Newark city, Essex County, New Jersey",2000,182764,200282,17518,394254,6276,284166,161244,385848,5264,547092,12242,77900,municipality,INJ
325,3401351000,34013,"Newark city, Essex County, New Jersey",2010,94542,109520,14978,206253,4318,138074,93746,183394,4680,277140,4200,32122,municipality,INJ
326,3401352620,34013,"North Caldwell borough, Essex County, New Jersey",2000,4140,4216,76,11346,694,2106,318,14432,12,14750,112,11508,municipality,INJ
327,3401352620,34013,"North Caldwell borough, Essex County, New Jersey",2010,2092,2134,42,4498,350,41,260,5923,1,6183,58,5473,municipality,INJ
328,3401353680,34013,"Nutley township, Essex County, New Jersey",2000,21768,22236,468,42792,3868,968,3660,51064,138,54724,500,45590,municipality,INJ
329,3401353680,34013,"Nutley township, Essex County, New Jersey",2010,11314,11789,475,22492,2789,541,3354,25016,97,28370,393,21196,municipality,INJ
330,3401364590,34013,"Roseland borough, Essex County, New Jersey",2000,4284,4374,90,8414,500,76,242,10354,16,10596,68,9694,municipality,INJ
331,3401364590,34013,"Roseland borough, Essex County, New Jersey",2010,2345,2432,87,4598,333,101,262,5557,11,5819,44,5068,municipality,INJ
332,3401369274,34013,"South Orange Village township, Essex County, New Jersey",2000,11044,11342,298,26374,1318,10300,1674,32254,144,33928,750,19742,municipality,INJ
333,3401369274,34013,"South Orange Village township, Essex County, New Jersey",2010,5516,5815,299,12483,829,4484,993,15205,110,16198,551,9231,municipality,INJ
334,3401375815,34013,"Verona township, Essex County, New Jersey",2000,11170,11438,268,20980,914,394,934,26132,40,27066,264,24520,municipality,INJ
335,3401375815,34013,"Verona township, Essex County, New Jersey",2010,5315,5523,208,10238,535,239,795,12537,30,13332,164,11569,municipality,INJ
336,3401378510,34013,"West Caldwell township, Essex County, New Jersey",2000,7980,8088,108,16926,864,200,628,21838,34,22466,140,20600,municipality,INJ
337,3401378510,34013,"West Caldwell township, Essex County, New Jersey",2010,3913,4009,96,8239,418,122,523,10236,19,10759,103,9574,municipality,INJ
338,3401379800,34013,"West Orange township, Essex County, New Jersey",2000,32960,33802,842,68954,7238,15344,9028,80858,342,89886,2120,55814,municipality,INJ
339,3401379800,34013,"West Orange township, Essex County, New Jersey",2010,16790,17612,822,35264,3641,11841,7487,38720,231,46207,867,22140,municipality,INJ
340,3401703580,34017,"Bayonne city, Hudson County, New Jersey",2000,51090,53652,2562,96340,5058,6196,22030,101654,446,123684,3520,86434,municipality,INJ
341,3401703580,34017,"Bayonne city, Hudson County, New Jersey",2010,25237,27799,2562,48862,4803,4730,16251,46773,310,63024,1109,35821,municipality,INJ
342,3401719360,34017,"East Newark borough, Hudson County, New Jersey",2000,1534,1598,64,3522,118,44,2260,2494,92,4754,124,2116,municipality,INJ
343,3401719360,34017,"East Newark borough, Hudson County, New Jersey",2010,759,794,35,1877,188,17,1477,929,32,2406,24,668,municipality,INJ
344,3401728650,34017,"Guttenberg town, Hudson County, New Jersey",2000,8986,9300,314,17040,1558,614,11742,9872,94,21614,636,6970,municipality,INJ
345,3401728650,34017,"Guttenberg town, Hudson County, New Jersey",2010,4473,4839,366,8881,803,330,7245,3931,69,11176,107,2622,municipality,INJ
346,3401730210,34017,"Harrison town, Hudson County, New Jersey",2000,10272,10508,236,22640,3400,174,10666,18182,448,28848,648,13512,municipality,INJ
347,3401730210,34017,"Harrison town, Hudson County, New Jersey",2010,4869,5228,359,10789,2198,173,6017,7603,242,13620,172,4818,municipality,INJ
348,3401732250,34017,"Hoboken city, Hudson County, New Jersey",2000,38836,39830,994,69086,3296,2598,15566,61588,196,77154,1106,54392,municipality,INJ
349,3401732250,34017,"Hoboken city, Hudson County, New Jersey",2010,25041,26855,1814,43892,3516,1289,7602,42403,161,50005,830,36607,municipality,INJ
350,3401736000,34017,"Jersey City city, Hudson County, New Jersey",2000,177264,187296,10032,361304,77246,128778,135904,344206,5758,480110,18952,113472,municipality,INJ
351,3401736000,34017,"Jersey City city, Hudson County, New Jersey",2010,96859,108720,11861,195249,58106,59060,68256,179341,3104,247597,5835,53236,municipality,INJ
352,3401736510,34017,"Kearny town, Hudson County, New Jersey",2000,27078,27744,666,63628,4412,2884,22150,58876,850,81026,1880,48850,municipality,INJ
353,3401736510,34017,"Kearny town, Hudson County, New Jersey",2010,13462,14180,718,32253,1746,1721,16253,24431,588,40684,560,19816,municipality,INJ
354,3401752470,34017,"North Bergen township, Hudson County, New Jersey",2000,42472,44018,1546,89774,7422,1800,66520,49664,646,116184,2942,36854,municipality,INJ
355,3401752470,34017,"North Bergen township, Hudson County, New Jersey",2010,22062,23912,1850,47710,3835,1065,41569,19204,311,60773,623,13370,municipality,INJ
356,3401766570,34017,"Secaucus town, Hudson County, New Jersey",2000,12428,12770,342,25732,3748,1302,3906,27956,78,31862,484,22344,municipality,INJ
357,3401766570,34017,"Secaucus town, Hudson County, New Jersey",2010,6297,6846,549,13125,3269,575,3025,13239,57,16264,247,9091,municipality,INJ
358,3401774630,34017,"Union City city, Hudson County, New Jersey",2000,45744,47482,1738,100234,2666,1750,110452,23724,490,134176,1038,17780,municipality,INJ
359,3401774630,34017,"Union City city, Hudson County, New Jersey",2010,22814,24931,2117,50692,1447,1070,56291,10164,268,66455,339,7040,municipality,INJ
360,3401777930,34017,"Weehawken township, Hudson County, New Jersey",2000,11950,12318,368,22530,1232,624,10974,16028,140,27002,500,13532,municipality,INJ
361,3401777930,34017,"Weehawken township, Hudson County, New Jersey",2010,5712,6213,501,10510,1010,412,5055,7499,51,12554,176,5850,municipality,INJ
362,3401779610,34017,"West New York town, Hudson County, New Jersey",2000,33438,34720,1282,71124,2584,1316,72076,19460,298,91536,1086,14176,municipality,INJ
363,3401779610,34017,"West New York town, Hudson County, New Jersey",2010,18852,20018,1166,39264,2904,873,38812,10896,169,49708,379,6571,municipality,INJ
364,3401900550,34019,"Alexandria township, Hunterdon County, New Jersey",2000,3070,3196,126,6756,68,72,162,9234,22,9396,54,9018,municipality,ONJ
365,3401900550,34019,"Alexandria township, Hunterdon County, New Jersey",2010,1758,1865,107,3677,90,98,159,4779,12,4938,29,4550,municipality,ONJ
366,3401905650,34019,"Bethlehem township, Hunterdon County, New Jersey",2000,2532,2606,74,5386,78,62,124,7516,12,7640,24,7340,municipality,ONJ
367,3401905650,34019,"Bethlehem township, Hunterdon County, New Jersey",2010,1344,1386,42,2879,75,39,160,3819,7,3979,28,3670,municipality,ONJ
368,3401906370,34019,"Bloomsbury borough, Hunterdon County, New Jersey",2000,644,684,40,1244,6,6,26,1746,4,1772,8,1722,municipality,ONJ
369,3401906370,34019,"Bloomsbury borough, Hunterdon County, New Jersey",2010,337,358,21,635,16,9,35,835,0,870,11,799,municipality,ONJ
370,3401909280,34019,"Califon borough, Hunterdon County, New Jersey",2000,802,820,18,1544,16,0,10,2100,0,2110,12,2072,municipality,ONJ
371,3401909280,34019,"Califon borough, Hunterdon County, New Jersey",2010,394,419,25,773,9,3,14,1062,1,1076,26,1023,municipality,ONJ
372,3401913720,34019,"Clinton town, Hunterdon County, New Jersey",2000,2136,2190,54,3876,196,70,216,5048,30,5264,42,4710,municipality,ONJ
373,3401913720,34019,"Clinton town, Hunterdon County, New Jersey",2010,1057,1098,41,2013,181,36,169,2550,3,2719,31,2299,municipality,ONJ
374,3401913750,34019,"Clinton township, Hunterdon County, New Jersey",2000,8258,8468,210,19118,606,1716,1014,24900,96,25914,202,22280,municipality,ONJ
375,3401913750,34019,"Clinton township, Hunterdon County, New Jersey",2010,4568,4737,169,10236,523,734,755,12723,56,13478,171,11239,municipality,ONJ
376,3401917170,34019,"Delaware township, Hunterdon County, New Jersey",2000,3286,3402,116,6858,92,36,102,8854,12,8956,30,8684,municipality,ONJ
377,3401917170,34019,"Delaware township, Hunterdon County, New Jersey",2010,1788,1927,139,3648,41,26,112,4451,7,4563,53,4324,municipality,ONJ
378,3401918820,34019,"East Amwell township, Hunterdon County, New Jersey",2000,3162,3248,86,6656,82,64,136,8774,10,8910,62,8556,municipality,ONJ
379,3401918820,34019,"East Amwell township, Hunterdon County, New Jersey",2010,1518,1580,62,3130,57,50,113,3900,5,4013,28,3760,municipality,ONJ
380,3401923700,34019,"Flemington borough, Hunterdon County, New Jersey",2000,3608,3752,144,6534,262,254,922,7478,48,8400,98,6816,municipality,ONJ
381,3401923700,34019,"Flemington borough, Hunterdon County, New Jersey",2010,1815,1926,111,3559,257,159,1198,3383,22,4581,82,2863,municipality,ONJ
382,3401924870,34019,"Franklin township, Hunterdon County, New Jersey",2000,2182,2250,68,4488,46,24,134,5846,10,5980,32,5734,municipality,ONJ
383,3401924870,34019,"Franklin township, Hunterdon County, New Jersey",2010,1137,1204,67,2407,37,18,110,3085,12,3195,10,3008,municipality,ONJ
384,3401925350,34019,"Frenchtown borough, Hunterdon County, New Jersey",2000,1226,1260,34,2306,36,12,78,2898,6,2976,18,2826,municipality,ONJ
385,3401925350,34019,"Frenchtown borough, Hunterdon County, New Jersey",2010,596,656,60,1086,13,10,70,1303,1,1373,11,1268,municipality,ONJ
386,3401926550,34019,"Glen Gardner borough, Hunterdon County, New Jersey",2000,1610,1658,48,2842,56,34,130,3674,14,3804,32,3538,municipality,ONJ
387,3401926550,34019,"Glen Gardner borough, Hunterdon County, New Jersey",2010,768,825,57,1341,31,28,90,1614,1,1704,20,1534,municipality,ONJ
388,3401929460,34019,"Hampton borough, Hunterdon County, New Jersey",2000,1118,1148,30,2296,30,146,88,3004,6,3092,52,2770,municipality,ONJ
389,3401929460,34019,"Hampton borough, Hunterdon County, New Jersey",2010,570,612,42,1099,26,32,75,1326,7,1401,14,1247,municipality,ONJ
390,3401931320,34019,"High Bridge borough, Hunterdon County, New Jersey",2000,2856,2956,100,5464,108,58,160,7392,26,7552,42,7158,municipality,ONJ
391,3401931320,34019,"High Bridge borough, Hunterdon County, New Jersey",2010,1418,1481,63,2763,114,47,219,3429,4,3648,37,3227,municipality,ONJ
392,3401932460,34019,"Holland township, Hunterdon County, New Jersey",2000,3762,3884,122,7712,44,44,174,10074,18,10248,52,9916,municipality,ONJ
393,3401932460,34019,"Holland township, Hunterdon County, New Jersey",2010,1972,2066,94,4015,41,29,142,5149,9,5291,24,5046,municipality,ONJ
394,3401937065,34019,"Kingwood township, Hunterdon County, New Jersey",2000,2680,2844,164,5500,58,46,140,7424,8,7564,42,7270,municipality,ONJ
395,3401937065,34019,"Kingwood township, Hunterdon County, New Jersey",2010,1446,1569,123,2957,41,23,92,3753,7,3845,41,3641,municipality,ONJ
396,3401938610,34019,"Lambertville city, Hunterdon County, New Jersey",2000,3720,3922,202,6548,64,148,240,7496,26,7736,68,7190,municipality,ONJ
397,3401938610,34019,"Lambertville city, Hunterdon County, New Jersey",2010,1958,2075,117,3372,51,70,381,3525,4,3906,31,3369,municipality,ONJ
398,3401939630,34019,"Lebanon borough, Hunterdon County, New Jersey",2000,916,954,38,1616,66,14,44,2086,4,2130,6,1996,municipality,ONJ
399,3401939630,34019,"Lebanon borough, Hunterdon County, New Jersey",2010,602,664,62,1072,71,22,68,1290,6,1358,20,1171,municipality,ONJ
400,3401939660,34019,"Lebanon township, Hunterdon County, New Jersey",2000,3926,4040,114,8664,106,90,200,11432,14,11632,72,11150,municipality,ONJ
401,3401939660,34019,"Lebanon township, Hunterdon County, New Jersey",2010,2296,2439,143,5097,97,107,205,6383,27,6588,56,6096,municipality,ONJ
402,3401946260,34019,"Milford borough, Hunterdon County, New Jersey",2000,938,968,30,1784,10,4,48,2342,2,2390,12,2314,municipality,ONJ
403,3401946260,34019,"Milford borough, Hunterdon County, New Jersey",2010,520,552,32,979,12,3,27,1206,3,1233,11,1177,municipality,ONJ
404,3401961920,34019,"Raritan township, Hunterdon County, New Jersey",2000,13878,14188,310,28020,1384,474,1104,38514,60,39618,426,36170,municipality,ONJ
405,3401961920,34019,"Raritan township, Hunterdon County, New Jersey",2010,8056,8288,232,16380,1315,438,1138,21047,35,22185,266,18993,municipality,ONJ
406,3401962250,34019,"Readington township, Hunterdon County, New Jersey",2000,11352,11588,236,23236,810,236,648,30958,44,31606,254,29614,municipality,ONJ
407,3401962250,34019,"Readington township, Hunterdon County, New Jersey",2010,5971,6191,220,12076,578,205,633,15493,25,16126,155,14530,municipality,ONJ
408,3401970980,34019,"Stockton borough, Hunterdon County, New Jersey",2000,492,516,24,882,10,0,6,1114,0,1120,2,1102,municipality,ONJ
409,3401970980,34019,"Stockton borough, Hunterdon County, New Jersey",2010,237,259,22,433,5,0,3,535,0,538,3,527,municipality,ONJ
410,3401972510,34019,"Tewksbury township, Hunterdon County, New Jersey",2000,3972,4104,132,8182,204,54,170,10912,18,11082,46,10590,municipality,ONJ
411,3401972510,34019,"Tewksbury township, Hunterdon County, New Jersey",2010,2189,2323,134,4476,175,48,209,5784,13,5993,65,5483,municipality,ONJ
412,3401974420,34019,"Union township, Hunterdon County, New Jersey",2000,3332,3450,118,9960,194,1582,632,11688,28,12320,118,9766,municipality,ONJ
413,3401974420,34019,"Union township, Hunterdon County, New Jersey",2010,1752,1830,78,4822,244,502,359,5549,18,5908,79,4706,municipality,ONJ
414,3401978230,34019,"West Amwell township, Hunterdon County, New Jersey",2000,1898,1968,70,3758,32,30,34,4732,4,4766,22,4644,municipality,ONJ
415,3401978230,34019,"West Amwell township, Hunterdon County, New Jersey",2010,1102,1157,55,3207,55,497,186,3654,5,3840,40,3057,municipality,ONJ
416,3402119780,34021,"East Windsor township, Mercer County, New Jersey",2000,18896,19760,864,37870,4730,4244,7118,42720,204,49838,676,32866,municipality,ONJ
417,3402119780,34021,"East Windsor township, Mercer County, New Jersey",2010,10224,10851,627,20618,4786,2220,5340,21850,110,27190,433,14301,municipality,ONJ
418,3402122185,34021,"Ewing township, Mercer County, New Jersey",2000,25102,25848,746,58526,1610,17414,3172,68242,204,71414,1078,47936,municipality,ONJ
419,3402122185,34021,"Ewing township, Mercer County, New Jersey",2010,13171,13926,755,29946,1520,9586,2727,33063,142,35790,627,21188,municipality,ONJ
420,3402129310,34021,"Hamilton township, Mercer County, New Jersey",2000,67046,69070,2024,133818,4452,13814,8942,165276,424,174218,2350,144236,municipality,ONJ
421,3402129310,34021,"Hamilton township, Mercer County, New Jersey",2010,34534,36170,1636,69740,2890,10042,9613,78851,245,88464,1144,64530,municipality,ONJ
422,3402131620,34021,"Hightstown borough, Mercer County, New Jersey",2000,4002,4162,160,8084,238,846,2092,8340,50,10432,172,7034,municipality,ONJ
423,3402131620,34021,"Hightstown borough, Mercer County, New Jersey",2010,1976,2108,132,4181,218,413,1664,3830,22,5494,89,3088,municipality,ONJ
424,3402133150,34021,"Hopewell borough, Mercer County, New Jersey",2000,1626,1672,46,3006,40,44,94,3976,26,4070,26,3840,municipality,ONJ
425,3402133150,34021,"Hopewell borough, Mercer County, New Jersey",2010,778,817,39,1460,13,29,71,1851,7,1922,16,1786,municipality,ONJ
426,3402133180,34021,"Hopewell township, Mercer County, New Jersey",2000,10996,11258,262,23666,1278,1810,790,31420,96,32210,280,27956,municipality,ONJ
427,3402133180,34021,"Hopewell township, Mercer County, New Jersey",2010,6282,6551,269,12728,1532,354,573,16731,33,17304,261,14551,municipality,ONJ
428,3402139510,34021,"Lawrence township, Mercer County, New Jersey",2000,21594,22360,766,45672,4594,5338,2688,55630,286,58318,762,44650,municipality,ONJ
429,3402139510,34021,"Lawrence township, Mercer County, New Jersey",2010,12524,13239,715,26780,4711,3493,2503,30969,136,33472,626,22003,municipality,ONJ
430,3402157600,34021,"Pennington borough, Mercer County, New Jersey",2000,2026,2080,54,3844,54,142,64,5328,10,5392,30,5092,municipality,ONJ
431,3402157600,34021,"Pennington borough, Mercer County, New Jersey",2010,1031,1083,52,1903,46,45,37,2548,2,2585,23,2432,municipality,ONJ
432,3402160900,34021,"Princeton borough, Mercer County, New Jersey",2000,18740,19438,698,49790,5308,3438,3712,56748,276,60460,1254,46472,municipality,ONJ
433,3402160900,34021,"Princeton borough, Mercer County, New Jersey",2010,9521,10302,781,23377,3955,1547,2392,26180,127,28572,757,19794,municipality,ONJ
434,3402163850,34021,"Robbinsville township, Mercer County, New Jersey",2000,8148,8326,178,15180,880,586,558,19992,60,20550,192,18274,municipality,ONJ
435,3402163850,34021,"Robbinsville township, Mercer County, New Jersey",2010,5087,5277,190,9722,1728,407,564,13078,38,13642,197,10708,municipality,ONJ
436,3402174000,34021,"Trenton city, Mercer County, New Jersey",2000,58874,67686,8812,123514,1368,86994,36782,134024,712,170806,2906,42044,municipality,ONJ
437,3402174000,34021,"Trenton city, Mercer County, New Jersey",2010,28578,33035,4457,63635,923,42286,28621,56292,355,84913,1286,11442,municipality,ONJ
438,3402180240,34021,"West Windsor township, Mercer County, New Jersey",2000,14564,14900,336,29878,9948,1174,1784,42030,110,43814,630,30168,municipality,ONJ
439,3402180240,34021,"West Windsor township, Mercer County, New Jersey",2010,9449,9810,361,19441,10223,956,1213,25952,94,27165,593,14086,municipality,ONJ
440,3402310750,34023,"Carteret borough, Middlesex County, New Jersey",2000,14078,14640,562,30962,3410,3712,9678,31740,172,41418,736,23710,municipality,INJ
441,3402310750,34023,"Carteret borough, Middlesex County, New Jersey",2010,7591,8148,557,17053,4308,3056,7066,15778,165,22844,437,7812,municipality,INJ
442,3402315550,34023,"Cranbury township, Middlesex County, New Jersey",2000,2182,2242,60,4490,478,144,110,6344,6,6454,74,5642,municipality,INJ
443,3402315550,34023,"Cranbury township, Middlesex County, New Jersey",2010,1320,1371,51,2806,530,130,99,3758,7,3857,60,3031,municipality,INJ
444,3402318490,34023,"Dunellen borough, Middlesex County, New Jersey",2000,4902,5040,138,10248,484,482,2020,11626,46,13646,160,10454,municipality,INJ
445,3402318490,34023,"Dunellen borough, Middlesex County, New Jersey",2010,2566,2683,117,5512,323,549,1933,5294,28,7227,103,4291,municipality,INJ
446,3402319000,34023,"East Brunswick township, Middlesex County, New Jersey",2000,32744,33280,536,69176,15168,2564,3914,89598,194,93512,1664,70008,municipality,INJ
447,3402319000,34023,"East Brunswick township, Middlesex County, New Jersey",2010,16810,17367,557,36051,10812,1741,3184,44328,166,47512,722,30887,municipality,INJ
448,3402320230,34023,"Edison township, Middlesex County, New Jersey",2000,70272,72036,1764,150730,57082,12916,12452,182922,758,195374,3244,108922,municipality,INJ
449,3402320230,34023,"Edison township, Middlesex County, New Jersey",2010,34972,36302,1330,77308,43092,6631,8112,91855,419,99967,2136,39577,municipality,INJ
450,3402330840,34023,"Helmetta borough, Middlesex County, New Jersey",2000,1492,1538,46,2844,88,80,194,3456,4,3650,22,3262,municipality,INJ
451,3402330840,34023,"Helmetta borough, Middlesex County, New Jersey",2010,891,920,29,1725,102,72,164,2014,5,2178,25,1810,municipality,INJ
452,3402331470,34023,"Highland Park borough, Middlesex County, New Jersey",2000,11798,12142,344,21910,3806,2134,2290,25708,178,27998,556,19034,municipality,INJ
453,3402331470,34023,"Highland Park borough, Middlesex County, New Jersey",2010,5875,6203,328,11025,2494,1018,1252,12730,50,13982,282,8886,municipality,INJ
454,3402334890,34023,"Jamesburg borough, Middlesex County, New Jersey",2000,4352,4480,128,9082,266,1030,1212,10838,60,12050,154,9328,municipality,INJ
455,3402334890,34023,"Jamesburg borough, Middlesex County, New Jersey",2010,2172,2267,95,4418,264,488,1324,4591,39,5915,83,3717,municipality,INJ
456,3402345690,34023,"Metuchen borough, Middlesex County, New Jersey",2000,9984,10208,224,19698,1844,1336,1016,24664,106,25680,412,20966,municipality,INJ
457,3402345690,34023,"Metuchen borough, Middlesex County, New Jersey",2010,5243,5440,197,10292,1744,617,935,12639,48,13574,278,9952,municipality,INJ
458,3402345900,34023,"Middlesex borough, Middlesex County, New Jersey",2000,10096,10260,164,20822,1124,880,2470,24964,62,27434,300,22598,municipality,INJ
459,3402345900,34023,"Middlesex borough, Middlesex County, New Jersey",2010,4984,5148,164,10568,804,645,2246,11389,37,13635,155,9748,municipality,INJ
460,3402346620,34023,"Milltown borough, Middlesex County, New Jersey",2000,5254,5340,86,10798,430,90,522,13478,26,14000,118,12814,municipality,INJ
461,3402346620,34023,"Milltown borough, Middlesex County, New Jersey",2010,2599,2698,99,5391,227,77,445,6448,13,6893,57,6074,municipality,INJ
462,3402347280,34023,"Monroe township, Middlesex County, New Jersey",2000,25072,26518,1446,47042,1296,1584,1332,54666,140,55998,260,51386,municipality,INJ
463,3402347280,34023,"Monroe township, Middlesex County, New Jersey",2010,16497,18002,1505,31755,4911,1486,1673,37459,84,39132,402,30576,municipality,INJ
464,3402351210,34023,"New Brunswick city, Middlesex County, New Jersey",2000,26114,27786,1672,77648,5088,20086,37894,59252,552,97146,1598,31928,municipality,INJ
465,3402351210,34023,"New Brunswick city, Middlesex County, New Jersey",2010,14119,15053,934,43560,4122,7743,27553,27628,299,55181,703,14761,municipality,INJ
466,3402352560,34023,"North Brunswick township, Middlesex County, New Jersey",2000,27270,27864,594,55868,10284,10740,7550,65024,346,72574,1542,42112,municipality,INJ
467,3402352560,34023,"North Brunswick township, Middlesex County, New Jersey",2010,14551,15045,494,31196,9865,6625,7223,33519,257,40742,826,15946,municipality,INJ
468,3402354705,34023,"Old Bridge township, Middlesex County, New Jersey",2000,42876,43792,916,89644,13040,6104,9156,111756,404,120912,2152,90056,municipality,INJ
469,3402354705,34023,"Old Bridge township, Middlesex County, New Jersey",2010,23777,24638,861,50479,9319,3770,7064,58311,321,65375,1119,43782,municipality,INJ
470,3402358200,34023,"Perth Amboy city, Middlesex County, New Jersey",2000,29124,30472,1348,67662,1338,7580,66066,28540,532,94606,1252,17838,municipality,INJ
471,3402358200,34023,"Perth Amboy city, Middlesex County, New Jersey",2010,15419,16556,1137,36945,806,3742,39685,11129,191,50814,286,6104,municipality,INJ
472,3402359010,34023,"Piscataway township, Middlesex County, New Jersey",2000,33000,33892,892,78860,24944,19970,8004,92960,524,100964,2158,45364,municipality,INJ
473,3402359010,34023,"Piscataway township, Middlesex County, New Jersey",2010,17050,17777,727,44775,18654,11053,6289,49755,333,56044,1444,18271,municipality,INJ
474,3402359280,34023,"Plainsboro township, Middlesex County, New Jersey",2000,17484,18266,782,30478,12286,2980,1874,38556,158,40430,708,22424,municipality,INJ
475,3402359280,34023,"Plainsboro township, Middlesex County, New Jersey",2010,9402,10089,687,17322,10608,1749,1429,21570,112,22999,486,8615,municipality,INJ
476,3402365790,34023,"Sayreville borough, Middlesex County, New Jersey",2000,29910,30470,560,61726,8494,6668,5884,74870,236,80754,1336,58136,municipality,INJ
477,3402365790,34023,"Sayreville borough, Middlesex County, New Jersey",2010,15636,16393,757,33054,6841,4287,5258,37446,291,42704,677,25350,municipality,INJ
478,3402368550,34023,"South Amboy city, Middlesex County, New Jersey",2000,5934,6220,286,11980,216,114,1068,14758,42,15826,144,14242,municipality,INJ
479,3402368550,34023,"South Amboy city, Middlesex County, New Jersey",2010,3372,3576,204,6834,345,347,1158,7473,19,8631,124,6638,municipality,INJ
480,3402368790,34023,"South Brunswick township, Middlesex County, New Jersey",2000,26856,27724,868,54010,13598,5772,3836,71632,238,75468,1240,50784,municipality,INJ
481,3402368790,34023,"South Brunswick township, Middlesex County, New Jersey",2010,15069,15708,639,31383,15571,3172,2624,40793,161,43417,911,20978,municipality,INJ
482,3402369390,34023,"South Plainfield borough, Middlesex County, New Jersey",2000,14302,14614,312,32650,3264,3596,3776,39844,408,43620,772,31804,municipality,INJ
483,3402369390,34023,"South Plainfield borough, Middlesex County, New Jersey",2010,7876,8093,217,18011,3422,2266,3097,20288,252,23385,498,13850,municipality,INJ
484,3402369420,34023,"South River borough, Middlesex County, New Jersey",2000,11212,11538,326,23586,1074,1784,2960,27684,166,30644,670,23990,municipality,INJ
485,3402369420,34023,"South River borough, Middlesex County, New Jersey",2010,5652,5957,305,12393,758,1028,2913,13095,248,16008,324,10737,municipality,INJ
486,3402369810,34023,"Spotswood borough, Middlesex County, New Jersey",2000,6198,6316,118,12234,460,216,690,15070,20,15760,100,14274,municipality,INJ
487,3402369810,34023,"Spotswood borough, Middlesex County, New Jersey",2010,3128,3242,114,6516,419,227,687,7570,18,8257,106,6800,municipality,INJ
488,3402382000,34023,"Woodbridge township, Middlesex County, New Jersey",2000,69124,70596,1472,150920,28014,16308,17912,176494,736,194406,3438,127998,municipality,INJ
489,3402382000,34023,"Woodbridge township, Middlesex County, New Jersey",2010,34615,36124,1509,78029,22193,9038,15562,84023,506,99585,1755,50531,municipality,INJ
490,3402500000,34025,"County subdivisions not defined, Monmouth County, New Jersey",2000,0,0,0,0,0,0,0,0,0,0,0,0,municipality,ONJ
491,3402500000,34025,"County subdivisions not defined, Monmouth County, New Jersey",2010,0,0,0,0,0,0,0,0,0,0,0,0,municipality,ONJ
492,3402500070,34025,"Aberdeen township, Monmouth County, New Jersey",2000,12842,13116,274,26370,1906,4080,2450,32458,108,34908,478,25886,municipality,ONJ
493,3402500070,34025,"Aberdeen township, Monmouth County, New Jersey",2010,6876,7102,226,14003,1162,2041,1900,16310,80,18210,270,12757,municipality,ONJ
494,3402500730,34025,"Allenhurst borough, Monmouth County, New Jersey",2000,570,740,170,1164,6,12,36,1400,4,1436,8,1370,municipality,ONJ
495,3402500730,34025,"Allenhurst borough, Monmouth County, New Jersey",2010,217,365,148,420,5,5,22,474,0,496,3,461,municipality,ONJ
496,3402500760,34025,"Allentown borough, Monmouth County, New Jersey",2000,1416,1436,20,2758,24,240,72,3692,30,3764,36,3362,municipality,ONJ
497,3402500760,34025,"Allentown borough, Monmouth County, New Jersey",2010,704,735,31,1375,27,76,65,1763,2,1828,29,1629,municipality,ONJ
498,3402501960,34025,"Asbury Park city, Monmouth County, New Jersey",2000,13508,15488,1980,23682,236,20472,5274,28586,166,33860,1418,6294,municipality,ONJ
499,3402501960,34025,"Asbury Park city, Monmouth County, New Jersey",2010,6725,8076,1351,12288,72,7955,4115,12001,110,16116,353,3511,municipality,ONJ
500,3402502110,34025,"Atlantic Highlands borough, Monmouth County, New Jersey",2000,3938,4112,174,7400,114,210,330,9080,8,9410,84,8664,municipality,ONJ
501,3402502110,34025,"Atlantic Highlands borough, Monmouth County, New Jersey",2010,1870,2002,132,3526,91,62,225,4160,11,4385,59,3937,municipality,ONJ
502,3402502440,34025,"Avon-by-the-Sea borough, Monmouth County, New Jersey",2000,2086,2774,688,3662,40,16,108,4380,10,4488,16,4298,municipality,ONJ
503,3402502440,34025,"Avon-by-the-Sea borough, Monmouth County, New Jersey",2010,901,1321,420,1582,12,6,71,1830,2,1901,16,1794,municipality,ONJ
504,3402504930,34025,"Belmar borough, Monmouth County, New Jersey",2000,5892,7992,2100,10014,122,400,828,11262,36,12090,156,10548,municipality,ONJ
505,3402504930,34025,"Belmar borough, Monmouth County, New Jersey",2010,2695,3931,1236,4820,52,184,971,4823,11,5794,56,4520,municipality,ONJ
506,3402506970,34025,"Bradley Beach borough, Monmouth County, New Jersey",2000,4594,6264,1670,7862,138,334,1230,8356,36,9586,146,7702,municipality,ONJ
507,3402506970,34025,"Bradley Beach borough, Monmouth County, New Jersey",2010,2098,3180,1082,3663,78,189,840,3458,16,4298,61,3114,municipality,ONJ
508,3402507750,34025,"Brielle borough, Monmouth County, New Jersey",2000,3876,4246,370,7466,66,340,324,9462,16,9786,92,8948,municipality,ONJ
509,3402507750,34025,"Brielle borough, Monmouth County, New Jersey",2010,1805,2034,229,3526,43,121,152,4622,8,4774,54,4396,municipality,ONJ
510,3402514560,34025,"Colts Neck township, Monmouth County, New Jersey",2000,7026,7228,202,17462,890,1832,1040,23622,82,24662,240,20578,municipality,ONJ
511,3402514560,34025,"Colts Neck township, Monmouth County, New Jersey",2010,3277,3735,458,7255,463,163,359,9783,8,10142,107,9042,municipality,ONJ
512,3402516660,34025,"Deal borough, Monmouth County, New Jersey",2000,868,1906,1038,1702,6,24,108,2032,14,2140,18,1970,municipality,ONJ
513,3402516660,34025,"Deal borough, Monmouth County, New Jersey",2010,333,926,593,643,26,11,55,695,2,750,7,649,municipality,ONJ
514,3402519840,34025,"Eatontown borough, Monmouth County, New Jersey",2000,11560,12682,1122,21592,2602,3144,1856,26160,162,28016,640,19612,municipality,ONJ
515,3402519840,34025,"Eatontown borough, Monmouth County, New Jersey",2010,5319,5723,404,10072,1097,1475,1571,11138,110,12709,327,8129,municipality,ONJ
516,3402521570,34025,"Englishtown borough, Monmouth County, New Jersey",2000,1286,1360,74,2502,154,134,220,3308,6,3528,28,2986,municipality,ONJ
517,3402521570,34025,"Englishtown borough, Monmouth County, New Jersey",2010,621,647,26,1376,121,43,148,1699,2,1847,20,1513,municipality,ONJ
518,3402522440,34025,"Fair Haven borough, Monmouth County, New Jersey",2000,3996,4074,78,7952,112,480,158,11716,12,11874,90,11022,municipality,ONJ
519,3402522440,34025,"Fair Haven borough, Monmouth County, New Jersey",2010,1970,2065,95,4017,66,151,165,5956,11,6121,67,5661,municipality,ONJ
520,3402522950,34025,"Farmingdale borough, Monmouth County, New Jersey",2000,1250,1276,26,2318,74,36,122,3052,2,3174,24,2916,municipality,ONJ
521,3402522950,34025,"Farmingdale borough, Monmouth County, New Jersey",2010,547,578,31,1043,42,35,92,1237,7,1329,21,1132,municipality,ONJ
522,3402525200,34025,"Freehold borough, Monmouth County, New Jersey",2000,7390,7642,252,16516,536,3270,6162,15790,40,21952,238,11706,municipality,ONJ
523,3402525200,34025,"Freehold borough, Monmouth County, New Jersey",2010,4006,4249,243,9095,342,1391,5167,6885,37,12052,158,4957,municipality,ONJ
524,3402525230,34025,"Freehold township, Monmouth County, New Jersey",2000,21628,22064,436,47128,3224,3100,3274,59800,130,63074,604,52742,municipality,ONJ
525,3402525230,34025,"Freehold township, Monmouth County, New Jersey",2010,12577,13140,563,27387,2530,1860,2808,33376,100,36184,459,28427,municipality,ONJ
526,3402530690,34025,"Hazlet township, Monmouth County, New Jersey",2000,14488,14812,324,31864,1438,420,2508,40248,80,42756,332,37978,municipality,ONJ
527,3402530690,34025,"Hazlet township, Monmouth County, New Jersey",2010,7140,7417,277,15712,675,279,1601,18733,39,20334,190,17550,municipality,ONJ
528,3402531500,34025,"Highlands borough, Monmouth County, New Jersey",2000,4900,5640,740,8280,100,104,414,9780,34,10194,110,9432,municipality,ONJ
529,3402531500,34025,"Highlands borough, Monmouth County, New Jersey",2010,2623,3146,523,4296,64,70,324,4681,13,5005,73,4461,municipality,ONJ
530,3402532640,34025,"Holmdel township, Monmouth County, New Jersey",2000,9894,10274,380,22558,5496,202,774,30788,64,31562,342,24684,municipality,ONJ
531,3402532640,34025,"Holmdel township, Monmouth County, New Jersey",2010,5584,5792,208,12450,3201,135,621,16152,44,16773,274,12498,municipality,ONJ
532,3402533300,34025,"Howell township, Monmouth County, New Jersey",2000,32126,33144,1018,67630,3470,3338,5220,92586,218,97806,1034,84526,municipality,ONJ
533,3402533300,34025,"Howell township, Monmouth County, New Jersey",2010,17260,17979,719,37624,2283,1767,4153,46922,142,51075,642,42088,municipality,ONJ
534,3402534200,34025,"Interlaken borough, Monmouth County, New Jersey",2000,772,794,22,1478,4,0,20,1780,2,1800,12,1762,municipality,ONJ
535,3402534200,34025,"Interlaken borough, Monmouth County, New Jersey",2010,361,393,32,701,4,0,14,806,0,820,5,797,municipality,ONJ
536,3402536480,34025,"Keansburg borough, Monmouth County, New Jersey",2000,7744,8538,794,15628,262,414,1706,19758,60,21464,216,18806,municipality,ONJ
537,3402536480,34025,"Keansburg borough, Monmouth County, New Jersey",2010,3805,4318,513,7741,169,582,1493,8612,33,10105,212,7616,municipality,ONJ
538,3402536810,34025,"Keyport borough, Monmouth County, New Jersey",2000,6528,6800,272,11838,324,1002,1678,13458,32,15136,234,11866,municipality,ONJ
539,3402536810,34025,"Keyport borough, Monmouth County, New Jersey",2010,3067,3272,205,5804,171,479,1322,5918,33,7240,93,5142,municipality,ONJ
540,3402537560,34025,"Lake Como borough, Monmouth County, New Jersey",2000,1648,2214,566,2826,46,268,366,3246,24,3612,56,2852,municipality,ONJ
541,3402537560,34025,"Lake Como borough, Monmouth County, New Jersey",2010,785,1115,330,1415,21,106,322,1437,11,1759,22,1277,municipality,ONJ
542,3402540770,34025,"Little Silver borough, Monmouth County, New Jersey",2000,4464,4576,112,8958,186,38,162,12178,26,12340,80,11848,municipality,ONJ
543,3402540770,34025,"Little Silver borough, Monmouth County, New Jersey",2010,2146,2278,132,4289,102,14,179,5771,16,5950,62,5577,municipality,ONJ
544,3402541010,34025,"Loch Arbour village, Monmouth County, New Jersey",2000,240,312,72,462,4,12,4,556,0,560,10,530,municipality,ONJ
545,3402541010,34025,"Loch Arbour village, Monmouth County, New Jersey",2010,82,159,77,156,3,3,7,187,0,194,3,178,municipality,ONJ
546,3402541310,34025,"Long Branch city, Monmouth County, New Jersey",2000,25188,27966,2778,47780,1008,10942,12954,49726,580,62680,1534,35662,municipality,ONJ
547,3402541310,34025,"Long Branch city, Monmouth County, New Jersey",2010,11753,14170,2417,24063,633,3946,8624,22095,830,30719,747,15939,municipality,ONJ
548,3402542990,34025,"Manalapan township, Monmouth County, New Jersey",2000,21562,22132,570,46566,3006,1282,2366,64480,136,66846,530,59526,municipality,ONJ
549,3402542990,34025,"Manalapan township, Monmouth County, New Jersey",2010,13263,13735,472,28853,2670,872,2202,36670,81,38872,362,32685,municipality,ONJ
550,3402543050,34025,"Manasquan borough, Monmouth County, New Jersey",2000,5200,7062,1862,9616,56,50,566,12054,14,12620,48,11886,municipality,ONJ
551,3402543050,34025,"Manasquan borough, Monmouth County, New Jersey",2010,2374,3500,1126,4521,36,14,414,5483,7,5897,21,5405,municipality,ONJ
552,3402544070,34025,"Marlboro township, Monmouth County, New Jersey",2000,22956,23792,836,50818,9204,1442,2102,70694,116,72796,590,59342,municipality,ONJ
553,3402544070,34025,"Marlboro township, Monmouth County, New Jersey",2010,13001,13436,435,28616,6921,814,1619,38572,65,40191,410,30362,municipality,ONJ
554,3402544520,34025,"Matawan borough, Monmouth County, New Jersey",2000,7062,7280,218,13800,1416,1106,1150,16670,58,17820,246,13844,municipality,ONJ
555,3402544520,34025,"Matawan borough, Monmouth County, New Jersey",2010,3358,3606,248,6819,557,576,949,7861,21,8810,183,6524,municipality,ONJ
556,3402545990,34025,"Middletown township, Monmouth County, New Jersey",2000,46472,47682,1210,97772,3406,1538,4530,128124,180,132654,866,122134,municipality,ONJ
557,3402545990,34025,"Middletown township, Monmouth County, New Jersey",2010,23962,24959,997,50288,1717,814,3569,62953,110,66522,610,59702,municipality,ONJ
558,3402546560,34025,"Millstone township, Monmouth County, New Jersey",2000,5416,5594,178,12056,608,538,630,17310,48,17940,122,15994,municipality,ONJ
559,3402546560,34025,"Millstone township, Monmouth County, New Jersey",2010,3301,3434,133,7564,472,363,579,9987,28,10566,131,8993,municipality,ONJ
560,3402547130,34025,"Monmouth Beach borough, Monmouth County, New Jersey",2000,3266,3938,672,5728,62,38,136,7054,2,7190,30,6922,municipality,ONJ
561,3402547130,34025,"Monmouth Beach borough, Monmouth County, New Jersey",2010,1494,1981,487,2619,24,11,62,3217,4,3279,29,3149,municipality,ONJ
562,3402549890,34025,"Neptune township, Monmouth County, New Jersey",2000,21814,24434,2620,42584,644,20620,3074,52306,196,55380,1128,29718,municipality,ONJ
563,3402549890,34025,"Neptune township, Monmouth County, New Jersey",2010,11201,12991,1790,22167,628,10377,2607,25328,117,27935,628,13578,municipality,ONJ
564,3402549920,34025,"Neptune City borough, Monmouth County, New Jersey",2000,4442,4684,242,8192,282,962,554,9882,34,10436,180,8424,municipality,ONJ
565,3402549920,34025,"Neptune City borough, Monmouth County, New Jersey",2010,2133,2312,179,3971,213,490,491,4378,15,4869,89,3571,municipality,ONJ
566,3402554270,34025,"Ocean township, Monmouth County, New Jersey",2000,20508,21512,1004,40176,3366,2932,2430,51488,242,53918,844,44104,municipality,ONJ
567,3402554270,34025,"Ocean township, Monmouth County, New Jersey",2010,10611,11541,930,21103,1775,2038,2453,24838,113,27291,465,20447,municipality,ONJ
568,3402554570,34025,"Oceanport borough, Monmouth County, New Jersey",2000,4086,4228,142,8768,92,220,240,11374,12,11614,88,10962,municipality,ONJ
569,3402554570,34025,"Oceanport borough, Monmouth County, New Jersey",2010,2227,2390,163,4470,88,161,236,5596,13,5832,58,5276,municipality,ONJ
570,3402562430,34025,"Red Bank borough, Monmouth County, New Jersey",2000,10402,10900,498,19540,518,4574,4054,19634,64,23688,352,14126,municipality,ONJ
571,3402562430,34025,"Red Bank borough, Monmouth County, New Jersey",2010,4929,5381,452,9719,223,1408,4198,8008,68,12206,162,6147,municipality,ONJ
572,3402564410,34025,"Roosevelt borough, Monmouth County, New Jersey",2000,674,702,28,1348,38,46,84,1782,24,1866,64,1610,municipality,ONJ
573,3402564410,34025,"Roosevelt borough, Monmouth County, New Jersey",2010,314,327,13,673,28,8,52,830,7,882,11,776,municipality,ONJ
574,3402565130,34025,"Rumson borough, Monmouth County, New Jersey",2000,4904,5220,316,9724,152,34,198,14076,8,14274,64,13818,municipality,ONJ
575,3402565130,34025,"Rumson borough, Monmouth County, New Jersey",2010,2344,2585,241,4806,88,18,173,6949,8,7122,64,6771,municipality,ONJ
576,3402566240,34025,"Sea Bright borough, Monmouth County, New Jersey",2000,2006,2404,398,3230,82,62,164,3472,4,3636,22,3302,municipality,ONJ
577,3402566240,34025,"Sea Bright borough, Monmouth County, New Jersey",2010,792,1211,419,1252,32,11,78,1334,4,1412,8,1279,municipality,ONJ
578,3402566330,34025,"Sea Girt borough, Monmouth County, New Jersey",2000,1884,2570,686,3432,4,4,60,4236,0,4296,14,4214,municipality,ONJ
579,3402566330,34025,"Sea Girt borough, Monmouth County, New Jersey",2010,823,1291,468,1477,4,0,30,1798,3,1828,5,1786,municipality,ONJ
580,3402567350,34025,"Shrewsbury borough, Monmouth County, New Jersey",2000,2414,2446,32,4970,118,22,138,7042,8,7180,56,6838,municipality,ONJ
581,3402567350,34025,"Shrewsbury borough, Monmouth County, New Jersey",2010,1261,1310,49,2782,79,24,95,3714,13,3809,25,3573,municipality,ONJ
582,3402567365,34025,"Shrewsbury township, Monmouth County, New Jersey",2000,1042,1092,50,1744,218,352,146,2050,8,2196,78,1394,municipality,ONJ
583,3402567365,34025,"Shrewsbury township, Monmouth County, New Jersey",2010,583,648,65,927,75,147,161,980,3,1141,28,727,municipality,ONJ
584,3402570110,34025,"Spring Lake borough, Monmouth County, New Jersey",2000,2926,3860,934,5580,20,24,52,7082,4,7134,30,7004,municipality,ONJ
585,3402570110,34025,"Spring Lake borough, Monmouth County, New Jersey",2010,1253,2048,795,2347,30,8,57,2936,9,2993,14,2875,municipality,ONJ
586,3402570140,34025,"Spring Lake Heights borough, Monmouth County, New Jersey",2000,5022,5900,878,8694,38,114,222,10232,24,10454,30,10026,municipality,ONJ
587,3402570140,34025,"Spring Lake Heights borough, Monmouth County, New Jersey",2010,2316,2972,656,3933,51,25,155,4558,8,4713,27,4447,municipality,ONJ
588,3402573020,34025,"Tinton Falls borough, Monmouth County, New Jersey",2000,11766,12422,656,22430,1480,3832,1414,28692,96,30106,492,22792,municipality,ONJ
589,3402573020,34025,"Tinton Falls borough, Monmouth County, New Jersey",2010,8355,8766,411,14498,829,1610,1118,16774,26,17892,306,14003,municipality,ONJ
590,3402574540,34025,"Union Beach borough, Monmouth County, New Jersey",2000,4286,4458,172,9426,160,104,1076,12222,32,13298,184,11742,municipality,ONJ
591,3402574540,34025,"Union Beach borough, Monmouth County, New Jersey",2010,2143,2269,126,4746,108,85,686,5559,29,6245,110,5227,municipality,ONJ
592,3402574900,34025,"Upper Freehold township, Monmouth County, New Jersey",2000,2874,3002,128,6182,120,90,302,8262,34,8564,126,7892,municipality,ONJ
593,3402574900,34025,"Upper Freehold township, Monmouth County, New Jersey",2010,2363,2458,95,5066,300,134,254,6648,18,6902,80,6116,municipality,ONJ
594,3402576460,34025,"Wall township, Monmouth County, New Jersey",2000,18874,19914,1040,37774,636,298,782,49740,90,50522,264,48452,municipality,ONJ
595,3402576460,34025,"Wall township, Monmouth County, New Jersey",2010,10051,10883,832,20009,420,611,908,25256,49,26164,251,23925,municipality,ONJ
596,3402579310,34025,"West Long Branch borough, Monmouth County, New Jersey",2000,4896,5070,174,12916,200,342,482,16034,40,16516,264,15188,municipality,ONJ
597,3402579310,34025,"West Long Branch borough, Monmouth County, New Jersey",2010,2384,2528,144,6513,95,163,407,7690,21,8097,72,7339,municipality,ONJ
598,3402706610,34027,"Boonton town, Morris County, New Jersey",2000,6544,6704,160,13266,1310,642,1164,15828,76,16992,414,13386,municipality,INJ
599,3402706610,34027,"Boonton town, Morris County, New Jersey",2010,3235,3398,163,6576,838,363,920,7427,47,8347,211,5968,municipality,INJ
600,3402706640,34027,"Boonton township, Morris County, New Jersey",2000,2952,3020,68,6442,350,102,184,8390,18,8574,78,7842,municipality,INJ
601,3402706640,34027,"Boonton township, Morris County, New Jersey",2010,1575,1647,72,3208,170,63,178,4085,3,4263,51,3798,municipality,INJ
602,3402709040,34027,"Butler borough, Morris County, New Jersey",2000,5736,5846,110,11626,274,84,758,14082,30,14840,110,13584,municipality,INJ
603,3402709040,34027,"Butler borough, Morris County, New Jersey",2010,3031,3169,138,5975,228,78,860,6679,19,7539,88,6266,municipality,INJ
604,3402712100,34027,"Chatham borough, Morris County, New Jersey",2000,6318,6464,146,12136,476,22,446,16474,32,16920,106,15838,municipality,INJ
605,3402712100,34027,"Chatham borough, Morris County, New Jersey",2010,3073,3210,137,5962,433,85,457,8505,31,8962,131,7825,municipality,INJ
606,3402712130,34027,"Chatham township, Morris County, New Jersey",2000,7840,8038,198,14784,966,82,394,19778,20,20172,146,18564,municipality,INJ
607,3402712130,34027,"Chatham township, Morris County, New Jersey",2010,3915,4128,213,7431,657,69,349,10103,20,10452,160,9197,municipality,INJ
608,3402712580,34027,"Chester borough, Morris County, New Jersey",2000,1218,1254,36,2458,56,10,224,3046,6,3270,20,2954,municipality,INJ
609,3402712580,34027,"Chester borough, Morris County, New Jersey",2010,615,647,32,1196,38,13,222,1427,5,1649,27,1344,municipality,INJ
610,3402712610,34027,"Chester township, Morris County, New Jersey",2000,4646,4754,108,10128,342,144,376,14188,14,14564,130,13558,municipality,INJ
611,3402712610,34027,"Chester township, Morris County, New Jersey",2010,2592,2697,105,5490,268,77,341,7497,12,7838,106,7034,municipality,INJ
612,3402717650,34027,"Denville township, Morris County, New Jersey",2000,11980,12356,376,24094,1468,338,836,30812,68,31648,284,28654,municipality,INJ
613,3402717650,34027,"Denville township, Morris County, New Jersey",2010,6432,6734,302,12687,1081,220,883,15752,31,16635,234,14186,municipality,INJ
614,3402718070,34027,"Dover town, Morris County, New Jersey",2000,10872,11136,264,27952,892,2070,21078,15298,76,36376,386,11874,municipality,INJ
615,3402718070,34027,"Dover town, Morris County, New Jersey",2010,5562,5783,221,14240,447,845,12598,5559,51,18157,145,4071,municipality,INJ
616,3402719210,34027,"East Hanover township, Morris County, New Jersey",2000,7686,7790,104,17656,2514,128,624,22162,6,22786,178,19336,municipality,INJ
617,3402719210,34027,"East Hanover township, Morris County, New Jersey",2010,3893,3976,83,8756,1322,90,600,10557,19,11157,84,9042,municipality,INJ
618,3402723910,34027,"Florham Park borough, Morris County, New Jersey",2000,6478,6684,206,13870,686,176,380,17334,16,17714,92,16364,municipality,INJ
619,3402723910,34027,"Florham Park borough, Morris County, New Jersey",2010,4003,4201,198,9451,743,488,594,11102,38,11696,169,9664,municipality,INJ
620,3402729550,34027,"Hanover township, Morris County, New Jersey",2000,9490,9636,146,19912,2246,254,904,24892,30,25796,136,22226,municipality,INJ
621,3402729550,34027,"Hanover township, Morris County, New Jersey",2010,5308,5526,218,10672,1480,134,630,13082,26,13712,145,11297,municipality,INJ
622,3402729700,34027,"Harding township, Morris County, New Jersey",2000,2360,2486,126,4758,68,26,114,6246,14,6360,62,6076,municipality,INJ
623,3402729700,34027,"Harding township, Morris County, New Jersey",2010,1474,1610,136,2917,102,35,134,3704,8,3838,56,3503,municipality,INJ
624,3402734980,34027,"Jefferson township, Morris County, New Jersey",2000,14262,15054,792,28814,418,306,1344,38090,106,39434,372,36888,municipality,INJ
625,3402734980,34027,"Jefferson township, Morris County, New Jersey",2010,7830,8597,767,16063,977,305,1382,19932,42,21314,235,18373,municipality,INJ
626,3402737110,34027,"Kinnelon borough, Morris County, New Jersey",2000,6124,6246,122,13112,526,88,436,18294,32,18730,98,17550,municipality,INJ
627,3402737110,34027,"Kinnelon borough, Morris County, New Jersey",2010,3472,3600,128,7463,433,86,418,9830,16,10248,91,9204,municipality,INJ
628,3402740290,34027,"Lincoln Park borough, Morris County, New Jersey",2000,8052,8220,168,17432,1150,354,1266,20594,36,21860,258,18796,municipality,INJ
629,3402740290,34027,"Lincoln Park borough, Morris County, New Jersey",2010,4001,4145,144,8560,775,165,1009,9512,30,10521,143,8399,municipality,INJ
630,3402741362,34027,"Long Hill township, Morris County, New Jersey",2000,6278,6412,134,12940,840,62,606,16948,28,17554,186,15832,municipality,INJ
631,3402741362,34027,"Long Hill township, Morris County, New Jersey",2010,3105,3226,121,6472,520,48,614,8088,19,8702,116,7385,municipality,INJ
632,3402742510,34027,"Madison borough, Morris County, New Jersey",2000,11040,11282,242,26252,1232,962,1974,31086,160,33060,388,28344,municipality,INJ
633,3402742510,34027,"Madison borough, Morris County, New Jersey",2010,5485,5775,290,12088,869,441,1406,14439,28,15845,261,12840,municipality,INJ
634,3402745330,34027,"Mendham borough, Morris County, New Jersey",2000,3562,3656,94,7460,144,44,250,9944,10,10194,54,9692,municipality,INJ
635,3402745330,34027,"Mendham borough, Morris County, New Jersey",2010,1722,1798,76,3567,101,51,135,4846,12,4981,41,4641,municipality,INJ
636,3402745360,34027,"Mendham township, Morris County, New Jersey",2000,3576,3698,122,7348,218,96,164,10636,18,10800,74,10230,municipality,INJ
637,3402745360,34027,"Mendham township, Morris County, New Jersey",2010,1952,2062,110,4094,199,76,211,5658,8,5869,75,5300,municipality,INJ
638,3402746860,34027,"Mine Hill township, Morris County, New Jersey",2000,2730,2776,46,5556,178,236,638,6720,14,7358,90,6202,municipality,INJ
639,3402746860,34027,"Mine Hill township, Morris County, New Jersey",2010,1329,1380,51,2826,177,148,840,2811,12,3651,61,2413,municipality,INJ
640,3402747670,34027,"Montville township, Morris County, New Jersey",2000,14760,15082,322,31194,5224,376,1062,40616,64,41678,404,34548,municipality,INJ
641,3402747670,34027,"Montville township, Morris County, New Jersey",2010,7485,7823,338,15987,3885,252,900,20628,45,21528,312,16134,municipality,INJ
642,3402748090,34027,"Morris township, Morris County, New Jersey",2000,16232,16596,364,33692,1694,2308,1660,41932,84,43592,362,37484,municipality,INJ
643,3402748090,34027,"Morris township, Morris County, New Jersey",2010,8128,8502,374,17270,1136,1216,1683,20623,65,22306,313,17893,municipality,INJ
644,3402748210,34027,"Morris Plains borough, Morris County, New Jersey",2000,3910,3988,78,8006,450,140,282,10190,32,10472,74,9494,municipality,INJ
645,3402748210,34027,"Morris Plains borough, Morris County, New Jersey",2010,2131,2197,66,4158,275,135,314,5218,3,5532,74,4731,municipality,INJ
646,3402748300,34027,"Morristown town, Morris County, New Jersey",2000,14504,15230,726,30280,1388,6132,10068,27020,146,37088,550,18804,municipality,INJ
647,3402748300,34027,"Morristown town, Morris County, New Jersey",2010,7417,8172,755,15178,794,2479,6277,12134,56,18411,244,8561,municipality,INJ
648,3402748480,34027,"Mountain Lakes borough, Morris County, New Jersey",2000,2660,2714,54,5476,438,30,144,8368,24,8512,60,7816,municipality,INJ
649,3402748480,34027,"Mountain Lakes borough, Morris County, New Jersey",2010,1313,1363,50,2709,318,15,106,4054,5,4160,78,3638,municipality,INJ
650,3402748690,34027,"Mount Arlington borough, Morris County, New Jersey",2000,3836,4078,242,7268,346,168,424,8902,28,9326,118,8242,municipality,INJ
651,3402748690,34027,"Mount Arlington borough, Morris County, New Jersey",2010,2283,2545,262,4145,179,115,415,4635,6,5050,68,4267,municipality,INJ
652,3402749080,34027,"Mount Olive township, Morris County, New Jersey",2000,18136,18622,486,35050,2892,1790,2890,45496,172,48386,664,39978,municipality,INJ
653,3402749080,34027,"Mount Olive township, Morris County, New Jersey",2010,10690,11244,554,20727,2297,1514,3237,24880,116,28117,431,20522,municipality,INJ
654,3402750130,34027,"Netcong borough, Morris County, New Jersey",2000,2016,2086,70,3974,86,62,368,4792,8,5160,56,4580,municipality,INJ
655,3402750130,34027,"Netcong borough, Morris County, New Jersey",2010,1381,1449,68,2626,89,119,572,2660,4,3232,38,2410,municipality,INJ
656,3402756460,34027,"Parsippany-Troy Hills township, Morris County, New Jersey",2000,39248,40132,884,80068,18248,3020,7070,94228,362,101298,2032,70566,municipality,INJ
657,3402756460,34027,"Parsippany-Troy Hills township, Morris County, New Jersey",2010,20279,21274,995,42160,15443,1741,4430,48808,189,53238,1221,30214,municipality,INJ
658,3402758110,34027,"Pequannock township, Morris County, New Jersey",2000,10052,10194,142,20586,530,78,816,26960,36,27776,118,26198,municipality,INJ
659,3402758110,34027,"Pequannock township, Morris County, New Jersey",2010,6471,6794,323,12200,291,72,703,14837,26,15540,106,14342,municipality,INJ
660,3402761890,34027,"Randolph township, Morris County, New Jersey",2000,17358,17806,448,34938,4530,1110,2416,47278,158,49694,566,40914,municipality,INJ
661,3402761890,34027,"Randolph township, Morris County, New Jersey",2010,9013,9343,330,18527,2674,638,2616,23118,65,25734,365,19376,municipality,INJ
662,3402763300,34027,"Riverdale borough, Morris County, New Jersey",2000,1838,1880,42,3822,136,54,220,4776,28,4996,28,4530,municipality,INJ
663,3402763300,34027,"Riverdale borough, Morris County, New Jersey",2010,1547,1657,110,2890,187,42,256,3303,7,3559,53,3014,municipality,INJ
664,3402764050,34027,"Rockaway borough, Morris County, New Jersey",2000,4890,4982,92,9936,822,168,1216,11730,28,12946,86,10626,municipality,INJ
665,3402764050,34027,"Rockaway borough, Morris County, New Jersey",2010,2443,2521,78,5016,491,192,970,5468,15,6438,67,4703,municipality,INJ
666,3402764080,34027,"Rockaway township, Morris County, New Jersey",2000,16216,17012,796,33430,2574,1076,2880,42980,98,45860,446,38786,municipality,INJ
667,3402764080,34027,"Rockaway township, Morris County, New Jersey",2010,8983,9587,604,18417,1605,552,2705,21451,58,24156,317,18919,municipality,INJ
668,3402764980,34027,"Roxbury township, Morris County, New Jersey",2000,16728,17100,372,34876,1694,864,2308,45458,112,47766,366,42422,municipality,INJ
669,3402764980,34027,"Roxbury township, Morris County, New Jersey",2010,8292,8582,290,17579,1330,496,2083,21241,38,23324,336,19041,municipality,INJ
670,3402775890,34027,"Victory Gardens borough, Morris County, New Jersey",2000,1128,1176,48,2274,168,636,1566,1526,6,3092,56,660,municipality,INJ
671,3402775890,34027,"Victory Gardens borough, Morris County, New Jersey",2010,533,566,33,1118,35,210,957,563,8,1520,22,288,municipality,INJ
672,3402777240,34027,"Washington township, Morris County, New Jersey",2000,11510,11780,270,24562,650,286,778,34406,62,35184,188,33220,municipality,INJ
673,3402777240,34027,"Washington township, Morris County, New Jersey",2010,6237,6488,251,13218,607,239,847,17686,28,18533,222,16590,municipality,INJ
674,3402780390,34027,"Wharton borough, Morris County, New Jersey",2000,4656,4788,132,9320,396,488,2924,9672,88,12596,194,8506,municipality,INJ
675,3402780390,34027,"Wharton borough, Morris County, New Jersey",2010,2304,2426,122,4962,368,227,2630,3892,34,6522,105,3158,municipality,INJ
676,3402900000,34029,"County subdivisions not defined, Ocean County, New Jersey",2000,0,0,0,0,0,0,0,0,0,0,0,0,municipality,ONJ
677,3402900000,34029,"County subdivisions not defined, Ocean County, New Jersey",2010,0,0,0,0,0,0,0,0,0,0,0,0,municipality,ONJ
678,3402903050,34029,"Barnegat township, Ocean County, New Jersey",2000,10986,12132,1146,22274,304,640,1180,29360,30,30540,286,28100,municipality,ONJ
679,3402903050,34029,"Barnegat township, Ocean County, New Jersey",2010,8128,9085,957,16552,360,607,1420,19516,40,20936,294,18215,municipality,ONJ
680,3402903130,34029,"Barnegat Light borough, Ocean County, New Jersey",2000,742,2414,1672,1308,4,6,12,1516,4,1528,4,1498,municipality,ONJ
681,3402903130,34029,"Barnegat Light borough, Ocean County, New Jersey",2010,274,1282,1008,532,0,6,11,563,1,574,1,555,municipality,ONJ
682,3402903520,34029,"Bay Head borough, Ocean County, New Jersey",2000,1168,2106,938,2094,14,4,32,2444,2,2476,18,2406,municipality,ONJ
683,3402903520,34029,"Bay Head borough, Ocean County, New Jersey",2010,459,1023,564,818,7,5,10,958,0,968,2,944,municipality,ONJ
684,3402903940,34029,"Beach Haven borough, Ocean County, New Jersey",2000,1172,5110,3938,2118,14,2,120,2436,0,2556,12,2408,municipality,ONJ
685,3402903940,34029,"Beach Haven borough, Ocean County, New Jersey",2010,531,2667,2136,1009,9,1,116,1054,0,1170,4,1040,municipality,ONJ
686,3402904180,34029,"Beachwood borough, Ocean County, New Jersey",2000,6950,7246,296,14830,228,190,876,19874,42,20750,144,19270,municipality,ONJ
687,3402904180,34029,"Beachwood borough, Ocean County, New Jersey",2010,3682,3826,144,8233,166,185,898,10147,9,11045,108,9679,municipality,ONJ
688,3402905305,34029,"Berkeley township, Ocean County, New Jersey",2000,39656,44576,4920,70866,352,964,1864,78118,66,79982,430,76306,municipality,ONJ
689,3402905305,34029,"Berkeley township, Ocean County, New Jersey",2010,20349,23818,3469,36353,458,681,2028,39227,63,41255,302,37723,municipality,ONJ
690,3402907420,34029,"Brick township, Ocean County, New Jersey",2000,59022,65378,6356,115930,1766,1410,5860,146378,320,152238,1162,141720,municipality,ONJ
691,3402907420,34029,"Brick township, Ocean County, New Jersey",2010,29842,33677,3835,59525,1144,1374,5301,69771,153,75072,728,66372,municipality,ONJ
692,3402918670,34029,"Eagleswood township, Ocean County, New Jersey",2000,1092,1386,294,2170,6,2,32,2850,8,2882,14,2820,municipality,ONJ
693,3402918670,34029,"Eagleswood township, Ocean County, New Jersey",2010,621,760,139,1255,10,13,54,1549,1,1603,15,1510,municipality,ONJ
694,3402930390,34029,"Harvey Cedars borough, Ocean County, New Jersey",2000,334,2410,2076,614,2,4,26,692,2,718,0,684,municipality,ONJ
695,3402930390,34029,"Harvey Cedars borough, Ocean County, New Jersey",2010,169,1214,1045,298,1,2,3,334,0,337,0,331,municipality,ONJ
696,3402934530,34029,"Island Heights borough, Ocean County, New Jersey",2000,1410,1614,204,2718,22,4,48,3454,16,3502,34,3378,municipality,ONJ
697,3402934530,34029,"Island Heights borough, Ocean County, New Jersey",2010,683,831,148,1364,23,2,40,1633,1,1673,31,1576,municipality,ONJ
698,3402934680,34029,"Jackson township, Ocean County, New Jersey",2000,28352,29280,928,60228,1716,3138,4948,80684,146,85632,988,74696,municipality,ONJ
699,3402934680,34029,"Jackson township, Ocean County, New Jersey",2010,19417,20342,925,41325,1592,2460,4295,50561,119,54856,758,45632,municipality,ONJ
700,3402937380,34029,"Lacey township, Ocean County, New Jersey",2000,18672,21160,2488,37726,270,178,1090,49602,84,50692,284,48786,municipality,ONJ
701,3402937380,34029,"Lacey township, Ocean County, New Jersey",2010,10183,11573,1390,21267,221,150,1310,26334,60,27644,244,25659,municipality,ONJ
702,3402937770,34029,"Lakehurst borough, Ocean County, New Jersey",2000,1740,1922,182,3502,118,366,402,4642,36,5044,62,4060,municipality,ONJ
703,3402937770,34029,"Lakehurst borough, Ocean County, New Jersey",2010,881,943,62,1901,56,264,347,2307,14,2654,93,1880,municipality,ONJ
704,3402938550,34029,"Lakewood township, Ocean County, New Jersey",2000,39752,42428,2676,82332,1598,13756,17870,102834,318,120704,1530,85632,municipality,ONJ
705,3402938550,34029,"Lakewood township, Ocean County, New Jersey",2010,24283,26337,2054,54001,737,5346,16062,76781,119,92843,574,70005,municipality,ONJ
706,3402939390,34029,"Lavallette borough, Ocean County, New Jersey",2000,2416,6420,4004,4632,8,14,86,5244,6,5330,34,5182,municipality,ONJ
707,3402939390,34029,"Lavallette borough, Ocean County, New Jersey",2010,945,3207,2262,1669,10,2,56,1819,0,1875,7,1800,municipality,ONJ
708,3402940560,34029,"Little Egg Harbor township, Ocean County, New Jersey",2000,12358,15862,3504,24182,192,234,1040,30850,92,31890,272,30060,municipality,ONJ
709,3402940560,34029,"Little Egg Harbor township, Ocean County, New Jersey",2010,8060,10324,2264,15975,249,259,1047,19018,35,20065,203,18272,municipality,ONJ
710,3402941250,34029,"Long Beach township, Ocean County, New Jersey",2000,3328,18046,14718,5880,24,10,140,6518,2,6658,26,6456,municipality,ONJ
711,3402941250,34029,"Long Beach township, Ocean County, New Jersey",2010,1539,9216,7677,2748,15,7,126,2925,4,3051,14,2885,municipality,ONJ
712,3402943140,34029,"Manchester township, Ocean County, New Jersey",2000,41376,45362,3986,69488,656,2306,2048,75808,132,77856,572,72142,municipality,ONJ
713,3402943140,34029,"Manchester township, Ocean County, New Jersey",2010,22840,25886,3046,38627,754,1572,2062,41008,75,43070,392,38215,municipality,ONJ
714,3402943380,34029,"Mantoloking borough, Ocean County, New Jersey",2000,414,1044,630,760,4,14,6,840,0,846,0,822,municipality,ONJ
715,3402943380,34029,"Mantoloking borough, Ocean County, New Jersey",2010,162,535,373,284,1,5,7,289,3,296,1,279,municipality,ONJ
716,3402954300,34029,"Ocean township, Ocean County, New Jersey",2000,4892,5962,1070,9614,54,76,400,12500,34,12900,90,12246,municipality,ONJ
717,3402954300,34029,"Ocean township, Ocean County, New Jersey",2010,3483,4291,808,6988,89,49,230,8102,18,8332,67,7879,municipality,ONJ
718,3402954450,34029,"Ocean Gate borough, Ocean County, New Jersey",2000,1664,2304,640,3072,40,40,98,4054,14,4152,34,3926,municipality,ONJ
719,3402954450,34029,"Ocean Gate borough, Ocean County, New Jersey",2010,832,1203,371,1565,4,26,128,1883,5,2011,12,1836,municipality,ONJ
720,3402958590,34029,"Pine Beach borough, Ocean County, New Jersey",2000,1534,1744,210,3014,24,8,92,3808,2,3900,10,3764,municipality,ONJ
721,3402958590,34029,"Pine Beach borough, Ocean County, New Jersey",2010,818,903,85,1650,30,7,79,2048,2,2127,14,1995,municipality,ONJ
722,3402959790,34029,"Plumsted township, Ocean County, New Jersey",2000,5020,5256,236,10408,106,312,560,13990,24,14550,168,13380,municipality,ONJ
723,3402959790,34029,"Plumsted township, Ocean County, New Jersey",2010,2936,3067,131,6214,73,131,498,7923,29,8421,99,7591,municipality,ONJ
724,3402959880,34029,"Point Pleasant borough, Ocean County, New Jersey",2000,15120,16700,1580,29458,206,94,930,37682,68,38612,202,37112,municipality,ONJ
725,3402959880,34029,"Point Pleasant borough, Ocean County, New Jersey",2010,7273,8331,1058,14329,129,56,935,17457,28,18392,111,17133,municipality,ONJ
726,3402959910,34029,"Point Pleasant Beach borough, Ocean County, New Jersey",2000,4634,7116,2482,8584,108,54,468,10160,20,10628,58,9920,municipality,ONJ
727,3402959910,34029,"Point Pleasant Beach borough, Ocean County, New Jersey",2010,1985,3373,1388,3782,39,27,421,4244,5,4665,41,4132,municipality,ONJ
728,3402966450,34029,"Seaside Heights borough, Ocean County, New Jersey",2000,2816,5680,2864,4838,38,228,612,5698,36,6310,138,5258,municipality,ONJ
729,3402966450,34029,"Seaside Heights borough, Ocean County, New Jersey",2010,1376,3003,1627,2318,44,181,516,2371,11,2887,73,2062,municipality,ONJ
730,3402966480,34029,"Seaside Park borough, Ocean County, New Jersey",2000,2254,5622,3368,3876,26,12,104,4422,16,4526,16,4352,municipality,ONJ
731,3402966480,34029,"Seaside Park borough, Ocean County, New Jersey",2010,833,2703,1870,1390,6,15,54,1525,1,1579,11,1492,municipality,ONJ
732,3402967110,34029,"Ship Bottom borough, Ocean County, New Jersey",2000,1328,4436,3108,2358,24,8,160,2608,0,2768,12,2564,municipality,ONJ
733,3402967110,34029,"Ship Bottom borough, Ocean County, New Jersey",2010,555,2066,1511,1017,5,6,106,1050,2,1156,5,1032,municipality,ONJ
734,3402969510,34029,"South Toms River borough, Ocean County, New Jersey",2000,2146,2246,100,4934,50,1462,674,6594,24,7268,144,4914,municipality,ONJ
735,3402969510,34029,"South Toms River borough, Ocean County, New Jersey",2010,1098,1160,62,2650,23,649,718,2966,13,3684,107,2174,municipality,ONJ
736,3402970320,34029,"Stafford township, Ocean County, New Jersey",2000,17070,23044,5974,34360,434,314,1084,43980,78,45064,332,42822,municipality,ONJ
737,3402970320,34029,"Stafford township, Ocean County, New Jersey",2010,10096,13604,3508,20491,393,243,1410,25125,48,26535,213,24228,municipality,ONJ
738,3402971640,34029,"Surf City borough, Ocean County, New Jersey",2000,1412,5242,3830,2526,10,4,56,2828,16,2884,4,2794,municipality,ONJ
739,3402971640,34029,"Surf City borough, Ocean County, New Jersey",2010,622,2566,1944,1092,6,16,61,1144,2,1205,7,1113,municipality,ONJ
740,3402973125,34029,"Toms River township, Ocean County, New Jersey",2000,67020,82232,15212,137630,4396,2980,8140,171272,276,179412,1434,162186,municipality,ONJ
741,3402973125,34029,"Toms River township, Ocean County, New Jersey",2010,34760,43334,8574,71788,3237,2213,7231,84008,236,91239,1081,77241,municipality,ONJ
742,3402974210,34029,"Tuckerton borough, Ocean County, New Jersey",2000,2954,3942,988,5416,38,28,218,6816,20,7034,46,6684,municipality,ONJ
743,3402974210,34029,"Tuckerton borough, Ocean County, New Jersey",2010,1396,1902,506,2638,33,23,203,3144,7,3347,27,3054,municipality,ONJ
744,3403106340,34031,"Bloomingdale borough, Passaic County, New Jersey",2000,5694,5880,186,11828,328,54,664,14556,24,15220,130,14020,municipality,INJ
745,3403106340,34031,"Bloomingdale borough, Passaic County, New Jersey",2010,2935,3089,154,6038,188,82,714,6942,27,7656,57,6588,municipality,INJ
746,3403113690,34031,"Clifton city, Passaic County, New Jersey",2000,60488,62120,1632,123400,10056,4004,31216,126128,598,157344,5058,106412,municipality,INJ
747,3403113690,34031,"Clifton city, Passaic County, New Jersey",2010,30661,31946,1285,65630,7401,3235,26854,57282,434,84136,1342,44870,municipality,INJ
748,3403129070,34031,"Haledon borough, Passaic County, New Jersey",2000,5640,5812,172,12288,742,1048,3730,12774,38,16504,500,10446,municipality,INJ
749,3403129070,34031,"Haledon borough, Passaic County, New Jersey",2010,2778,2932,154,6128,505,806,3460,4858,31,8318,123,3393,municipality,INJ
750,3403130570,34031,"Hawthorne borough, Passaic County, New Jersey",2000,14520,14838,318,28504,678,260,2708,33728,74,36436,434,32282,municipality,INJ
751,3403130570,34031,"Hawthorne borough, Passaic County, New Jersey",2010,7454,7756,302,14769,524,355,2897,15894,54,18791,169,14792,municipality,INJ
752,3403140620,34031,"Little Falls township, Passaic County, New Jersey",2000,9374,9594,220,17776,900,142,1158,20552,36,21710,288,19186,municipality,INJ
753,3403140620,34031,"Little Falls township, Passaic County, New Jersey",2010,4740,4925,185,12449,652,549,1428,13004,48,14432,225,11530,municipality,INJ
754,3403153040,34031,"North Haledon borough, Passaic County, New Jersey",2000,5252,5350,98,12720,158,194,616,15224,8,15840,174,14690,municipality,INJ
755,3403153040,34031,"North Haledon borough, Passaic County, New Jersey",2010,3123,3213,90,6702,318,136,628,7789,16,8417,71,7248,municipality,INJ
756,3403156550,34031,"Passaic city, Passaic County, New Jersey",2000,38916,40388,1472,93924,7234,16084,84774,50948,646,135722,2174,24810,municipality,INJ
757,3403156550,34031,"Passaic city, Passaic County, New Jersey",2010,19411,20432,1021,47805,2924,5221,49557,20224,258,69781,580,11241,municipality,INJ
758,3403157000,34031,"Paterson city, Passaic County, New Jersey",2000,89420,94338,4918,209570,5456,93764,149548,148896,1588,298444,8558,39530,municipality,INJ
759,3403157000,34031,"Paterson city, Passaic County, New Jersey",2010,44329,47946,3617,105375,4663,41431,84254,61945,675,146199,1750,13426,municipality,INJ
760,3403160090,34031,"Pompton Lakes borough, Passaic County, New Jersey",2000,7898,8048,150,16122,632,254,1222,20058,54,21280,164,18954,municipality,INJ
761,3403160090,34031,"Pompton Lakes borough, Passaic County, New Jersey",2010,4190,4341,151,8639,595,127,1209,9888,34,11097,113,9019,municipality,INJ
762,3403161170,34031,"Prospect Park borough, Passaic County, New Jersey",2000,3644,3778,134,8140,360,1406,4422,7136,58,11558,526,4786,municipality,INJ
763,3403161170,34031,"Prospect Park borough, Passaic County, New Jersey",2010,1797,1931,134,4197,176,1016,3055,2810,32,5865,107,1479,municipality,INJ
764,3403163150,34031,"Ringwood borough, Passaic County, New Jersey",2000,8216,8442,226,17956,294,366,1054,23738,354,24792,212,22512,municipality,INJ
765,3403163150,34031,"Ringwood borough, Passaic County, New Jersey",2010,4182,4331,149,9203,209,148,707,11521,170,12228,194,10800,municipality,INJ
766,3403173140,34031,"Totowa borough, Passaic County, New Jersey",2000,7078,7260,182,16170,446,218,1260,18524,48,19784,168,17644,municipality,INJ
767,3403173140,34031,"Totowa borough, Passaic County, New Jersey",2010,3783,3918,135,8631,639,220,1550,9254,23,10804,123,8249,municipality,INJ
768,3403176730,34031,"Wanaque borough, Passaic County, New Jersey",2000,6888,7000,112,15530,736,294,1108,19424,94,20532,306,17994,municipality,INJ
769,3403176730,34031,"Wanaque borough, Passaic County, New Jersey",2010,4018,4184,166,8822,508,305,1075,10041,47,11116,167,9014,municipality,INJ
770,3403177840,34031,"Wayne township, Passaic County, New Jersey",2000,37510,38436,926,83086,6112,1686,5508,102630,192,108138,1108,93532,municipality,INJ
771,3403177840,34031,"Wayne township, Passaic County, New Jersey",2010,19127,19768,641,42683,4441,1124,4335,50382,146,54717,641,44030,municipality,INJ
772,3403179460,34031,"West Milford township, Passaic County, New Jersey",2000,18380,19818,1438,38444,524,628,1786,51034,300,52820,634,48948,municipality,INJ
773,3403179460,34031,"West Milford township, Passaic County, New Jersey",2010,9625,10419,794,20052,319,327,1512,24338,130,25850,330,23232,municipality,INJ
774,3403182423,34031,"Woodland Park borough, Passaic County, New Jersey",2000,8794,8994,200,17668,838,654,2210,19764,50,21974,594,17628,municipality,INJ
775,3403182423,34031,"Woodland Park borough, Passaic County, New Jersey",2010,4632,4835,203,9490,494,398,2442,9377,65,11819,187,8233,municipality,INJ
776,3403504450,34035,"Bedminster township, Somerset County, New Jersey",2000,8470,8934,464,13644,1062,286,638,15966,68,16604,114,14436,municipality,INJ
777,3403504450,34035,"Bedminster township, Somerset County, New Jersey",2010,4100,4349,249,6721,707,157,519,7646,14,8165,122,6646,municipality,INJ
778,3403505560,34035,"Bernards township, Somerset County, New Jersey",2000,18484,18970,486,35540,3856,682,1292,47858,74,49150,450,42796,municipality,INJ
779,3403505560,34035,"Bernards township, Somerset County, New Jersey",2010,9783,10103,320,18970,3670,478,1054,25598,72,26652,432,20946,municipality,INJ
780,3403505590,34035,"Bernardsville borough, Somerset County, New Jersey",2000,5446,5614,168,10860,388,36,878,13812,30,14690,138,13220,municipality,INJ
781,3403505590,34035,"Bernardsville borough, Somerset County, New Jersey",2010,2685,2871,186,5499,248,58,903,6804,11,7707,85,6402,municipality,INJ
782,3403506790,34035,"Bound Brook borough, Somerset County, New Jersey",2000,7230,7604,374,15900,564,444,7082,13228,78,20310,214,11928,municipality,INJ
783,3403506790,34035,"Bound Brook borough, Somerset County, New Jersey",2010,3586,3816,230,8049,264,522,5062,5340,47,10402,124,4383,municipality,INJ
784,3403507180,34035,"Branchburg township, Somerset County, New Jersey",2000,10544,10810,266,21166,1780,546,784,28348,64,29132,246,25712,municipality,INJ
785,3403507180,34035,"Branchburg township, Somerset County, New Jersey",2010,5271,5419,148,10692,1210,313,643,13816,47,14459,210,12036,municipality,INJ
786,3403507720,34035,"Bridgewater township, Somerset County, New Jersey",2000,31122,31758,636,63844,9018,1798,4112,81768,142,85880,820,69990,municipality,INJ
787,3403507720,34035,"Bridgewater township, Somerset County, New Jersey",2010,16111,16657,546,33110,7901,978,3004,41460,121,44464,608,31852,municipality,INJ
788,3403522890,34035,"Far Hills borough, Somerset County, New Jersey",2000,736,772,36,1402,36,14,62,1656,2,1718,14,1590,municipality,INJ
789,3403522890,34035,"Far Hills borough, Somerset County, New Jersey",2010,376,418,42,698,17,6,88,831,0,919,9,799,municipality,INJ
790,3403524900,34035,"Franklin township, Somerset County, New Jersey",2000,38710,39578,868,78722,12950,25776,8254,93552,582,101806,1792,52452,municipality,INJ
791,3403524900,34035,"Franklin township, Somerset County, New Jersey",2010,23301,24426,1125,48508,12410,15888,8050,54250,333,62300,1421,24198,municipality,INJ
792,3403527510,34035,"Green Brook township, Somerset County, New Jersey",2000,3786,3832,46,8556,904,186,462,10846,16,11308,104,9636,municipality,INJ
793,3403527510,34035,"Green Brook township, Somerset County, New Jersey",2010,2375,2448,73,5301,1453,238,494,6709,9,7203,92,4917,municipality,INJ
794,3403531890,34035,"Hillsborough township, Somerset County, New Jersey",2000,25298,25708,410,51926,5344,2650,3480,69788,206,73268,864,60724,municipality,INJ
795,3403531890,34035,"Hillsborough township, Somerset County, New Jersey",2010,13573,14030,457,28203,4723,1674,2893,35410,93,38303,551,28369,municipality,INJ
796,3403543620,34035,"Manville borough, Somerset County, New Jersey",2000,8230,8592,362,16406,270,90,1118,19568,24,20686,136,19048,municipality,INJ
797,3403543620,34035,"Manville borough, Somerset County, New Jersey",2010,4016,4277,261,8251,205,259,1963,8381,44,10344,118,7755,municipality,INJ
798,3403546590,34035,"Millstone borough, Somerset County, New Jersey",2000,338,346,8,662,8,8,26,794,0,820,4,774,municipality,INJ
799,3403546590,34035,"Millstone borough, Somerset County, New Jersey",2010,162,167,5,319,7,5,15,403,2,418,2,387,municipality,INJ
800,3403547580,34035,"Montgomery township, Somerset County, New Jersey",2000,11606,12260,654,23444,4020,700,774,34188,52,34962,402,29014,municipality,INJ
801,3403547580,34035,"Montgomery township, Somerset County, New Jersey",2010,7635,7902,267,15399,5689,586,1017,21237,56,22254,470,14436,municipality,INJ
802,3403553280,34035,"North Plainfield borough, Somerset County, New Jersey",2000,14404,14786,382,31328,2106,5160,13832,28374,160,42206,902,20046,municipality,INJ
803,3403553280,34035,"North Plainfield borough, Somerset County, New Jersey",2010,7448,7848,400,16570,1260,3848,9699,12237,110,21936,284,6735,municipality,INJ
804,3403557300,34035,"Peapack and Gladstone borough, Somerset County, New Jersey",2000,1680,1742,62,3602,60,152,184,4682,10,4866,18,4442,municipality,INJ
805,3403557300,34035,"Peapack and Gladstone borough, Somerset County, New Jersey",2010,887,949,62,1899,47,99,281,2301,9,2582,22,2124,municipality,INJ
806,3403561980,34035,"Raritan borough, Somerset County, New Jersey",2000,5112,5288,176,9844,1036,94,1066,11610,28,12676,130,10322,municipality,INJ
807,3403561980,34035,"Raritan borough, Somerset County, New Jersey",2010,2673,2847,174,5290,975,128,1128,5753,32,6881,111,4507,municipality,INJ
808,3403564320,34035,"Rocky Hill borough, Somerset County, New Jersey",2000,568,590,22,1056,6,18,52,1272,14,1324,18,1216,municipality,INJ
809,3403564320,34035,"Rocky Hill borough, Somerset County, New Jersey",2010,280,292,12,524,16,10,33,649,3,682,20,600,municipality,INJ
810,3403568460,34035,"Somerville borough, Somerset County, New Jersey",2000,9486,9764,278,19396,1818,3096,4224,20622,106,24846,538,15064,municipality,INJ
811,3403568460,34035,"Somerville borough, Somerset County, New Jersey",2010,4591,4951,360,9516,1359,1389,2873,9225,59,12098,266,6152,municipality,INJ
812,3403568730,34035,"South Bound Brook borough, Somerset County, New Jersey",2000,3264,3352,88,6874,368,690,2056,6928,32,8984,146,5692,municipality,INJ
813,3403568730,34035,"South Bound Brook borough, Somerset County, New Jersey",2010,1733,1865,132,3586,275,429,1245,3318,26,4563,114,2474,municipality,INJ
814,3403576940,34035,"Warren township, Somerset County, New Jersey",2000,9258,9436,178,20054,3040,338,910,27608,56,28518,338,23836,municipality,INJ
815,3403576940,34035,"Warren township, Somerset County, New Jersey",2010,5059,5258,199,11051,2304,225,820,14491,33,15311,225,11704,municipality,INJ
816,3403577600,34035,"Watchung borough, Somerset County, New Jersey",2000,4196,4310,114,8772,1106,378,336,10890,26,11226,150,9230,municipality,INJ
817,3403577600,34035,"Watchung borough, Somerset County, New Jersey",2010,2114,2234,120,4453,733,190,307,5494,22,5801,122,4427,municipality,INJ
818,3403701330,34037,"Andover borough, Sussex County, New Jersey",2000,522,546,24,1030,30,26,34,1282,18,1316,6,1202,municipality,ONJ
819,3403701330,34037,"Andover borough, Sussex County, New Jersey",2010,241,263,22,478,8,5,46,560,3,606,10,534,municipality,ONJ
820,3403701360,34037,"Andover township, Sussex County, New Jersey",2000,3778,3936,158,9044,274,222,272,11794,16,12066,76,11206,municipality,ONJ
821,3403701360,34037,"Andover township, Sussex County, New Jersey",2010,2070,2181,111,4924,164,202,325,5994,5,6319,76,5547,municipality,ONJ
822,3403707300,34037,"Branchville borough, Sussex County, New Jersey",2000,708,754,46,1284,6,0,22,1668,6,1690,4,1652,municipality,ONJ
823,3403707300,34037,"Branchville borough, Sussex County, New Jersey",2010,364,386,22,649,9,2,33,808,3,841,6,788,municipality,ONJ
824,3403709160,34037,"Byram township, Sussex County, New Jersey",2000,5666,6156,490,11748,232,158,486,16022,28,16508,160,15444,municipality,ONJ
825,3403709160,34037,"Byram township, Sussex County, New Jersey",2010,2926,3207,281,6202,173,113,417,7933,18,8350,76,7553,municipality,ONJ
826,3403724810,34037,"Frankford township, Sussex County, New Jersey",2000,3678,4590,912,8134,42,42,192,10648,12,10840,42,10510,municipality,ONJ
827,3403724810,34037,"Frankford township, Sussex County, New Jersey",2010,2046,2520,474,4398,46,53,176,5389,4,5565,62,5224,municipality,ONJ
828,3403724930,34037,"Franklin borough, Sussex County, New Jersey",2000,3796,3994,198,7482,152,60,456,9864,34,10320,108,9510,municipality,ONJ
829,3403724930,34037,"Franklin borough, Sussex County, New Jersey",2010,1936,2136,200,3926,88,95,395,4650,14,5045,91,4362,municipality,ONJ
830,3403725140,34037,"Fredon township, Sussex County, New Jersey",2000,1964,2038,74,4198,48,30,124,5596,10,5720,28,5480,municipality,ONJ
831,3403725140,34037,"Fredon township, Sussex County, New Jersey",2010,1207,1289,82,2554,58,17,127,3310,4,3437,28,3203,municipality,ONJ
832,3403727420,34037,"Green township, Sussex County, New Jersey",2000,2092,2138,46,4454,62,52,206,6234,4,6440,54,6062,municipality,ONJ
833,3403727420,34037,"Green township, Sussex County, New Jersey",2010,1181,1251,70,2580,60,42,173,3428,5,3601,34,3287,municipality,ONJ
834,3403729220,34037,"Hamburg borough, Sussex County, New Jersey",2000,2346,2466,120,4548,142,42,262,5948,24,6210,102,5638,municipality,ONJ
835,3403729220,34037,"Hamburg borough, Sussex County, New Jersey",2010,1364,1476,112,2540,66,57,225,3052,15,3277,59,2855,municipality,ONJ
836,3403729490,34037,"Hampton township, Sussex County, New Jersey",2000,3714,4052,338,7264,66,92,188,9698,6,9886,68,9466,municipality,ONJ
837,3403729490,34037,"Hampton township, Sussex County, New Jersey",2010,2021,2200,179,4103,62,41,200,4996,7,5196,39,4847,municipality,ONJ
838,3403729850,34037,"Hardyston township, Sussex County, New Jersey",2000,4638,5380,742,9176,190,102,398,11944,22,12342,134,11496,municipality,ONJ
839,3403729850,34037,"Hardyston township, Sussex County, New Jersey",2010,3255,3783,528,6463,243,200,457,7756,28,8213,86,7199,municipality,ONJ
840,3403732910,34037,"Hopatcong borough, Sussex County, New Jersey",2000,11312,12380,1068,23374,564,592,1904,29872,76,31776,352,28288,municipality,ONJ
841,3403732910,34037,"Hopatcong borough, Sussex County, New Jersey",2010,5653,6296,643,11758,334,401,1714,13433,30,15147,178,12490,municipality,ONJ
842,3403737440,34037,"Lafayette township, Sussex County, New Jersey",2000,1542,1598,56,3338,36,48,108,4492,6,4600,26,4376,municipality,ONJ
843,3403737440,34037,"Lafayette township, Sussex County, New Jersey",2010,875,919,44,1945,19,36,129,2409,4,2538,30,2320,municipality,ONJ
844,3403747430,34037,"Montague township, Sussex County, New Jersey",2000,2572,3176,604,4970,46,122,224,6600,22,6824,66,6344,municipality,ONJ
845,3403747430,34037,"Montague township, Sussex County, New Jersey",2010,1535,1802,267,2971,39,83,246,3601,12,3847,75,3392,municipality,ONJ
846,3403751930,34037,"Newton town, Sussex County, New Jersey",2000,6516,6850,334,12542,322,544,626,15862,44,16488,170,14782,municipality,ONJ
847,3403751930,34037,"Newton town, Sussex County, New Jersey",2010,3170,3479,309,6301,233,361,987,7010,40,7997,119,6257,municipality,ONJ
848,3403754660,34037,"Ogdensburg borough, Sussex County, New Jersey",2000,1762,1806,44,3720,38,8,220,5056,2,5276,46,4962,municipality,ONJ
849,3403754660,34037,"Ogdensburg borough, Sussex County, New Jersey",2010,864,905,41,1820,44,8,151,2259,5,2410,18,2184,municipality,ONJ
850,3403765700,34037,"Sandyston township, Sussex County, New Jersey",2000,1386,1814,428,2730,16,12,48,3602,10,3650,26,3538,municipality,ONJ
851,3403765700,34037,"Sandyston township, Sussex County, New Jersey",2010,788,988,200,1549,11,8,68,1930,5,1998,21,1885,municipality,ONJ
852,3403769690,34037,"Sparta township, Sussex County, New Jersey",2000,12450,13180,730,25088,502,100,918,35242,58,36160,312,34270,municipality,ONJ
853,3403769690,34037,"Sparta township, Sussex County, New Jersey",2010,6868,7423,555,14030,490,187,1054,18668,35,19722,241,17715,municipality,ONJ
854,3403770380,34037,"Stanhope borough, Sussex County, New Jersey",2000,2768,2838,70,5372,108,90,290,6878,30,7168,140,6510,municipality,ONJ
855,3403770380,34037,"Stanhope borough, Sussex County, New Jersey",2010,1396,1472,76,2790,83,53,307,3303,9,3610,51,3107,municipality,ONJ
856,3403770890,34037,"Stillwater township, Sussex County, New Jersey",2000,2988,4060,1072,6144,36,14,178,8356,18,8534,54,8234,municipality,ONJ
857,3403770890,34037,"Stillwater township, Sussex County, New Jersey",2010,1553,1930,377,3201,29,27,90,4009,2,4099,48,3903,municipality,ONJ
858,3403771670,34037,"Sussex borough, Sussex County, New Jersey",2000,1806,1922,116,3264,52,44,110,4180,4,4290,26,4054,municipality,ONJ
859,3403771670,34037,"Sussex borough, Sussex County, New Jersey",2010,899,1005,106,1645,49,39,169,1961,12,2130,36,1825,municipality,ONJ
860,3403775740,34037,"Vernon township, Sussex County, New Jersey",2000,16736,19988,3252,34252,342,356,1778,47594,94,49372,374,46428,municipality,ONJ
861,3403775740,34037,"Vernon township, Sussex County, New Jersey",2010,8622,10958,2336,18128,185,292,1534,22409,68,23943,240,21624,municipality,ONJ
862,3403776640,34037,"Walpack township, Sussex County, New Jersey",2000,40,68,28,66,0,0,0,82,0,82,0,82,municipality,ONJ
863,3403776640,34037,"Walpack township, Sussex County, New Jersey",2010,8,15,7,14,0,0,0,16,0,16,1,15,municipality,ONJ
864,3403776790,34037,"Wantage township, Sussex County, New Jersey",2000,6882,7326,444,14674,140,132,600,20174,14,20774,174,19714,municipality,ONJ
865,3403776790,34037,"Wantage township, Sussex County, New Jersey",2010,3910,4173,263,8523,112,126,594,10764,12,11358,146,10368,municipality,ONJ
866,3403905320,34039,"Berkeley Heights township, Union County, New Jersey",2000,8958,9124,166,19624,2110,286,988,25826,56,26814,152,23222,municipality,INJ
867,3403905320,34039,"Berkeley Heights township, Union County, New Jersey",2010,4470,4596,126,9632,1372,186,675,12508,17,13183,173,10760,municipality,INJ
868,3403913150,34039,"Clark township, Union County, New Jersey",2000,11274,11418,144,23124,804,70,1070,28124,34,29194,148,27068,municipality,INJ
869,3403913150,34039,"Clark township, Union County, New Jersey",2010,5562,5751,189,11633,527,116,1107,13649,38,14756,94,12874,municipality,INJ
870,3403915640,34039,"Cranford township, Union County, New Jersey",2000,16794,17120,326,34632,968,1158,1758,43398,68,45156,276,40928,municipality,INJ
871,3403915640,34039,"Cranford township, Union County, New Jersey",2010,8583,8816,233,17154,635,563,1474,21151,63,22625,255,19635,municipality,INJ
872,3403921000,34039,"Elizabeth city, Union County, New Jersey",2000,80964,85676,4712,177776,5490,44658,119254,121882,1318,241136,5740,64676,municipality,INJ
873,3403921000,34039,"Elizabeth city, Union County, New Jersey",2010,41596,45516,3920,92923,2521,23072,74353,50616,980,124969,1338,22705,municipality,INJ
874,3403922860,34039,"Fanwood borough, Union County, New Jersey",2000,5148,5230,82,10646,630,728,536,13812,38,14348,152,12264,municipality,INJ
875,3403922860,34039,"Fanwood borough, Union County, New Jersey",2010,2627,2686,59,5290,490,374,458,6860,17,7318,126,5853,municipality,INJ
876,3403925800,34039,"Garwood borough, Union County, New Jersey",2000,3462,3564,102,6644,110,30,414,7892,2,8306,48,7702,municipality,INJ
877,3403925800,34039,"Garwood borough, Union County, New Jersey",2010,1778,1870,92,3412,86,42,373,3853,18,4226,41,3666,municipality,INJ
878,3403931980,34039,"Hillside township, Union County, New Jersey",2000,14322,14776,454,32370,1488,19922,6306,37188,414,43494,1382,13982,municipality,INJ
879,3403931980,34039,"Hillside township, Union County, New Jersey",2010,7112,7536,424,16327,571,11091,3774,17630,245,21404,349,5374,municipality,INJ
880,3403936690,34039,"Kenilworth borough, Union County, New Jersey",2000,5708,5852,144,12158,440,366,1326,14024,12,15350,128,13078,municipality,INJ
881,3403936690,34039,"Kenilworth borough, Union County, New Jersey",2010,2841,2924,83,6187,303,213,1228,6686,34,7914,89,6047,municipality,INJ
882,3403940350,34039,"Linden city, Union County, New Jersey",2000,30104,31134,1030,61096,1828,17564,11348,67440,364,78788,2030,45654,municipality,INJ
883,3403940350,34039,"Linden city, Union County, New Jersey",2010,14909,15872,963,31665,1066,10403,10095,30404,232,40499,614,18089,municipality,INJ
884,3403948510,34039,"Mountainside borough, Union County, New Jersey",2000,4868,4956,88,10420,360,122,398,12806,22,13204,80,12222,municipality,INJ
885,3403948510,34039,"Mountainside borough, Union County, New Jersey",2010,2468,2558,90,5131,323,121,407,6278,7,6685,73,5754,municipality,INJ
886,3403951810,34039,"New Providence borough, Union County, New Jersey",2000,8808,8970,162,17542,1806,208,834,22980,32,23814,216,20718,municipality,INJ
887,3403951810,34039,"New Providence borough, Union County, New Jersey",2010,4408,4537,129,8849,1187,153,783,11388,28,12171,150,9870,municipality,INJ
888,3403959190,34039,"Plainfield city, Union County, New Jersey",2000,30274,32360,2086,69324,856,57396,24066,71592,484,95658,1840,11016,municipality,INJ
889,3403959190,34039,"Plainfield city, Union County, New Jersey",2010,15180,16621,1441,36947,439,24069,20105,29703,307,49808,749,4139,municipality,INJ
890,3403961530,34039,"Rahway city, Union County, New Jersey",2000,20056,20762,706,40340,1850,14116,7350,45650,308,53000,1178,28198,municipality,INJ
891,3403961530,34039,"Rahway city, Union County, New Jersey",2010,10533,11300,767,21383,1148,8104,6433,20913,127,27346,521,11013,municipality,INJ
892,3403964620,34039,"Roselle borough, Union County, New Jersey",2000,15040,15740,700,31682,1146,21338,7282,35266,306,42548,1128,11348,municipality,INJ
893,3403964620,34039,"Roselle borough, Union County, New Jersey",2010,7407,7939,532,16132,464,11148,5644,15441,137,21085,303,3389,municipality,INJ
894,3403964650,34039,"Roselle Park borough, Union County, New Jersey",2000,10274,10516,242,20656,2398,596,4340,22222,48,26562,386,18794,municipality,INJ
895,3403964650,34039,"Roselle Park borough, Union County, New Jersey",2010,5002,5231,229,10320,1337,697,3809,9488,32,13297,161,7261,municipality,INJ
896,3403966060,34039,"Scotch Plains township, Union County, New Jersey",2000,16698,16958,260,33934,3276,5064,1790,43674,96,45464,568,34670,municipality,INJ
897,3403966060,34039,"Scotch Plains township, Union County, New Jersey",2010,8595,8896,301,17420,1795,2519,1582,21928,85,23510,408,17121,municipality,INJ
898,3403970020,34039,"Springfield township, Union County, New Jersey",2000,12002,12408,406,22926,1350,1072,1194,27664,40,28858,220,24982,municipality,INJ
899,3403970020,34039,"Springfield township, Union County, New Jersey",2010,6511,6736,225,12486,1196,968,1502,14315,32,15817,197,11922,municipality,INJ
900,3403971430,34039,"Summit city, Union County, New Jersey",2000,15794,16292,498,30868,1870,1754,4300,37962,82,42262,404,33852,municipality,INJ
901,3403971430,34039,"Summit city, Union County, New Jersey",2010,7708,8190,482,15224,1367,933,2851,18606,53,21457,356,15897,municipality,INJ
902,3403974480,34039,"Union township, Union County, New Jersey",2000,39068,40002,934,84572,8382,21126,9722,99088,362,108810,1896,67322,municipality,INJ
903,3403974480,34039,"Union township, Union County, New Jersey",2010,19556,20250,694,44693,5959,15979,8465,48177,397,56642,869,24973,municipality,INJ
904,3403979040,34039,"Westfield town, Union County, New Jersey",2000,21244,21638,394,42470,2412,2274,1672,57616,164,59288,672,52094,municipality,INJ
905,3403979040,34039,"Westfield town, Union County, New Jersey",2010,10566,10950,384,21217,1708,940,1492,28824,79,30316,468,25629,municipality,INJ
906,3403981650,34039,"Winfield township, Union County, New Jersey",2000,1388,1394,6,2396,4,4,74,2954,10,3028,36,2900,municipality,INJ
907,3403981650,34039,"Winfield township, Union County, New Jersey",2010,706,714,8,1216,2,14,94,1377,4,1471,16,1341,municipality,INJ
908,3404100670,34041,"Allamuchy township, Warren County, New Jersey",2000,3384,3548,164,6284,144,72,208,7546,18,7754,48,7264,municipality,ONJ
909,3404100670,34041,"Allamuchy township, Warren County, New Jersey",2010,1953,2096,143,3525,118,75,194,4129,10,4323,46,3880,municipality,ONJ
910,3404101030,34041,"Alpha borough, Warren County, New Jersey",2000,1978,2068,90,3752,60,10,94,4870,16,4964,36,4748,municipality,ONJ
911,3404101030,34041,"Alpha borough, Warren County, New Jersey",2010,964,1032,68,1831,36,55,125,2244,1,2369,37,2115,municipality,ONJ
912,3404104990,34041,"Belvidere town, Warren County, New Jersey",2000,2176,2330,154,3982,28,28,128,5414,12,5542,36,5310,municipality,ONJ
913,3404104990,34041,"Belvidere town, Warren County, New Jersey",2010,1054,1140,86,2002,21,38,97,2584,2,2681,29,2494,municipality,ONJ
914,3404106160,34041,"Blairstown township, Warren County, New Jersey",2000,4080,4272,192,8556,64,30,228,11266,22,11494,50,11100,municipality,ONJ
915,3404106160,34041,"Blairstown township, Warren County, New Jersey",2010,2124,2272,148,4541,68,63,226,5741,8,5967,44,5558,municipality,ONJ
916,3404124960,34041,"Franklin township, Warren County, New Jersey",2000,1944,2038,94,3940,48,44,110,5426,4,5536,48,5282,municipality,ONJ
917,3404124960,34041,"Franklin township, Warren County, New Jersey",2010,1122,1219,97,2385,74,47,122,3054,7,3176,39,2887,municipality,ONJ
918,3404125320,34041,"Frelinghuysen township, Warren County, New Jersey",2000,1444,1510,66,3080,16,14,110,4056,10,4166,28,3988,municipality,ONJ
919,3404125320,34041,"Frelinghuysen township, Warren County, New Jersey",2010,760,826,66,1748,12,14,57,2173,3,2230,19,2125,municipality,ONJ
920,3404128260,34041,"Greenwich township, Warren County, New Jersey",2000,2842,2954,112,5794,194,212,332,8398,16,8730,64,7912,municipality,ONJ
921,3404128260,34041,"Greenwich township, Warren County, New Jersey",2010,1808,1870,62,3826,343,355,364,5348,17,5712,77,4556,municipality,ONJ
922,3404128710,34041,"Hackettstown town, Warren County, New Jersey",2000,8268,8694,426,16086,602,442,1666,19140,80,20806,388,17628,municipality,ONJ
923,3404128710,34041,"Hackettstown town, Warren County, New Jersey",2010,3575,3755,180,7747,478,210,1474,8250,46,9724,109,7407,municipality,ONJ
924,3404129820,34041,"Hardwick township, Warren County, New Jersey",2000,1004,1060,56,2150,12,16,68,2860,6,2928,14,2812,municipality,ONJ
925,3404129820,34041,"Hardwick township, Warren County, New Jersey",2010,573,619,46,1275,11,14,67,1629,0,1696,9,1595,municipality,ONJ
926,3404130090,34041,"Harmony township, Warren County, New Jersey",2000,2020,2152,132,4142,22,38,70,5388,4,5458,38,5286,municipality,ONJ
927,3404130090,34041,"Harmony township, Warren County, New Jersey",2010,1017,1109,92,2108,5,18,35,2632,5,2667,14,2590,municipality,ONJ
928,3404133060,34041,"Hope township, Warren County, New Jersey",2000,1394,1494,100,2782,16,16,56,3726,0,3782,28,3666,municipality,ONJ
929,3404133060,34041,"Hope township, Warren County, New Jersey",2010,741,809,68,1511,31,23,80,1872,1,1952,11,1806,municipality,ONJ
930,3404133930,34041,"Independence township, Warren County, New Jersey",2000,4292,4420,128,8208,188,130,422,10784,14,11206,120,10332,municipality,ONJ
931,3404133930,34041,"Independence township, Warren County, New Jersey",2010,2234,2325,91,4338,126,64,307,5355,18,5662,60,5087,municipality,ONJ
932,3404137320,34041,"Knowlton township, Warren County, New Jersey",2000,2056,2270,214,4308,38,22,110,5844,6,5954,52,5726,municipality,ONJ
933,3404137320,34041,"Knowlton township, Warren County, New Jersey",2010,1097,1212,115,2342,28,27,111,2944,14,3055,29,2846,municipality,ONJ
934,3404140110,34041,"Liberty township, Warren County, New Jersey",2000,1960,2176,216,3962,32,20,148,5382,10,5530,46,5274,municipality,ONJ
935,3404140110,34041,"Liberty township, Warren County, New Jersey",2010,1047,1151,104,2228,41,30,122,2820,8,2942,26,2715,municipality,ONJ
936,3404141490,34041,"Lopatcong township, Warren County, New Jersey",2000,4286,4858,572,8702,188,124,230,11300,18,11530,42,10928,municipality,ONJ
937,3404141490,34041,"Lopatcong township, Warren County, New Jersey",2010,3136,3420,284,6162,334,458,480,7534,19,8014,93,6630,municipality,ONJ
938,3404143320,34041,"Mansfield township, Warren County, New Jersey",2000,4668,4830,162,9714,162,562,582,12724,68,13306,184,11748,municipality,ONJ
939,3404143320,34041,"Mansfield township, Warren County, New Jersey",2010,2972,3316,344,5959,248,355,845,6880,29,7725,110,6138,municipality,ONJ
940,3404155530,34041,"Oxford township, Warren County, New Jersey",2000,1772,1876,104,3346,24,54,160,4454,4,4614,20,4352,municipality,ONJ
941,3404155530,34041,"Oxford township, Warren County, New Jersey",2010,950,1033,83,1910,38,40,95,2419,1,2514,24,2316,municipality,ONJ
942,3404158350,34041,"Phillipsburg town, Warren County, New Jersey",2000,12088,13302,1214,22256,252,1004,1632,28700,58,30332,396,26990,municipality,ONJ
943,3404158350,34041,"Phillipsburg town, Warren County, New Jersey",2010,5925,6607,682,11096,222,1037,1767,13183,39,14950,330,11555,municipality,ONJ
944,3404159820,34041,"Pohatcong township, Warren County, New Jersey",2000,2682,2822,140,5242,20,30,138,6694,4,6832,36,6604,municipality,ONJ
945,3404159820,34041,"Pohatcong township, Warren County, New Jersey",2010,1310,1420,110,2584,30,53,116,3223,3,3339,38,3099,municipality,ONJ
946,3404177270,34041,"Washington borough, Warren County, New Jersey",2000,5448,5752,304,9864,192,500,560,12864,40,13424,138,11994,municipality,ONJ
947,3404177270,34041,"Washington borough, Warren County, New Jersey",2010,2623,2897,274,4914,217,372,549,5912,14,6461,115,5194,municipality,ONJ
948,3404177300,34041,"Washington township, Warren County, New Jersey",2000,4198,4348,150,8746,118,206,270,12226,12,12496,70,11820,municipality,ONJ
949,3404177300,34041,"Washington township, Warren County, New Jersey",2010,2380,2493,113,4999,126,152,292,6359,13,6651,65,6003,municipality,ONJ
950,3404180570,34041,"White township, Warren County, New Jersey",2000,3336,3540,204,6598,50,102,180,8310,24,8490,88,8046,municipality,ONJ
951,3404180570,34041,"White township, Warren County, New Jersey",2010,2115,2304,189,4053,35,92,134,4748,8,4882,44,4569,municipality,ONJ
952,3600508510,36005,"Bronx borough, Bronx County, New York",2000,926424,981318,54894,1870556,77116,832676,1289410,1375890,24378,2665300,54418,387302,municipality,NYC
953,3600508510,36005,"Bronx borough, Bronx County, New York",2010,483449,511896,28447,1016912,47335,416695,741413,643695,12494,1385108,15962,151209,municipality,NYC
954,3602701693,36027,"Amenia town, Dutchess County, New York",2000,3250,3628,378,6180,38,234,272,7824,58,8096,118,7376,municipality,MHV
955,3602701693,36027,"Amenia town, Dutchess County, New York",2010,1741,2045,304,3529,61,172,376,4060,25,4436,82,3720,municipality,MHV
956,3602705100,36027,"Beacon city, Dutchess County, New York",2000,10182,10812,630,20130,350,5112,4668,22948,114,27616,618,16754,municipality,MHV
957,3602705100,36027,"Beacon city, Dutchess County, New York",2010,5347,5715,368,12429,250,3232,3219,12322,105,15541,402,8333,municipality,MHV
958,3602705452,36027,"Beekman town, Dutchess County, New York",2000,7502,8360,858,15824,388,528,1232,21672,66,22904,268,20422,municipality,MHV
959,3602705452,36027,"Beekman town, Dutchess County, New York",2010,4251,4797,546,11146,387,1559,1332,13289,90,14621,186,11067,municipality,MHV
960,3602716408,36027,"Clinton town, Dutchess County, New York",2000,3004,3468,464,6036,80,116,140,7880,28,8020,58,7598,municipality,MHV
961,3602716408,36027,"Clinton town, Dutchess County, New York",2010,1602,1915,313,3369,50,97,161,4151,18,4312,56,3930,municipality,MHV
962,3602720819,36027,"Dover town, Dutchess County, New York",2000,6068,6532,464,12134,168,880,968,16162,102,17130,258,14754,municipality,MHV
963,3602720819,36027,"Dover town, Dutchess County, New York",2010,3259,3637,378,6632,115,379,1199,7500,20,8699,158,6828,municipality,MHV
964,3602721996,36027,"East Fishkill town, Dutchess County, New York",2000,16466,16990,524,35954,1426,1126,2070,49108,120,51178,546,45890,municipality,MHV
965,3602721996,36027,"East Fishkill town, Dutchess County, New York",2010,9512,10039,527,21216,1162,918,2224,26805,91,29029,339,24295,municipality,MHV
966,3602725978,36027,"Fishkill town, Dutchess County, New York",2000,13712,14080,368,33108,1200,5468,4242,36274,138,40516,276,29192,municipality,MHV
967,3602725978,36027,"Fishkill town, Dutchess County, New York",2010,8642,9246,604,17751,1695,2083,2420,19687,112,22107,318,15479,municipality,MHV
968,3602737209,36027,"Hyde Park town, Dutchess County, New York",2000,14790,15408,618,31394,576,1692,1348,40354,188,41702,642,37256,municipality,MHV
969,3602737209,36027,"Hyde Park town, Dutchess County, New York",2010,7829,8416,587,17376,526,1210,1204,20367,92,21571,396,18143,municipality,MHV
970,3602740299,36027,"La Grange town, Dutchess County, New York",2000,10170,10480,310,21340,868,680,1272,28584,100,29856,336,26600,municipality,MHV
971,3602740299,36027,"La Grange town, Dutchess County, New York",2010,5440,5668,228,11710,630,545,1116,14614,56,15730,195,13188,municipality,MHV
972,3602747207,36027,"Milan town, Dutchess County, New York",2000,1764,2180,416,7826,68,2372,1430,7688,72,9118,56,5120,municipality,MHV
973,3602747207,36027,"Milan town, Dutchess County, New York",2010,964,1279,315,1848,12,35,105,2265,8,2370,21,2189,municipality,MHV
974,3602751891,36027,"North East town, Dutchess County, New York",2000,2292,2732,440,4620,34,126,196,5808,8,6004,54,5586,municipality,MHV
975,3602751891,36027,"North East town, Dutchess County, New York",2010,1259,1627,368,2407,32,74,275,2756,18,3031,38,2594,municipality,MHV
976,3602756825,36027,"Pawling town, Dutchess County, New York",2000,5646,6202,556,11234,190,202,730,14312,30,15042,136,13754,municipality,MHV
977,3602756825,36027,"Pawling town, Dutchess County, New York",2010,3093,3593,500,6379,183,211,865,7598,19,8463,83,7102,municipality,MHV
978,3602758156,36027,"Pine Plains town, Dutchess County, New York",2000,1976,2322,346,3808,34,46,70,5068,42,5138,54,4892,municipality,MHV
979,3602758156,36027,"Pine Plains town, Dutchess County, New York",2010,1007,1284,277,1950,26,29,172,2301,5,2473,33,2208,municipality,MHV
980,3602758695,36027,"Pleasant Valley town, Dutchess County, New York",2000,6934,7228,294,13400,116,332,480,17652,42,18132,174,16988,municipality,MHV
981,3602758695,36027,"Pleasant Valley town, Dutchess County, New York",2010,3765,4049,284,7426,109,264,452,9220,28,9672,182,8637,municipality,MHV
982,3602759641,36027,"Poughkeepsie city, Dutchess County, New York",2000,24028,26306,2278,44242,960,20708,6354,53388,354,59742,1954,29412,municipality,MHV
983,3602759641,36027,"Poughkeepsie city, Dutchess County, New York",2010,12400,13984,1584,25468,521,10407,6384,26352,171,32736,1001,14252,municipality,MHV
984,3602759652,36027,"Poughkeepsie town, Dutchess County, New York",2000,29210,30264,1054,66238,4354,6652,4508,81046,226,85554,1352,68462,municipality,MHV
985,3602759652,36027,"Poughkeepsie town, Dutchess County, New York",2010,15276,16116,840,34248,2614,3983,4233,39108,191,43341,1066,31254,municipality,MHV
986,3602760905,36027,"Red Hook town, Dutchess County, New York",2000,7148,7680,532,15636,430,270,552,20264,80,20816,264,19220,municipality,MHV
987,3602760905,36027,"Red Hook town, Dutchess County, New York",2010,3942,4384,442,9092,272,190,555,10764,44,11319,169,10089,municipality,MHV
988,3602761357,36027,"Rhinebeck town, Dutchess County, New York",2000,6002,6510,508,12378,212,534,612,14912,16,15524,160,13990,municipality,MHV
989,3602761357,36027,"Rhinebeck town, Dutchess County, New York",2010,3158,3653,495,6280,132,185,387,7161,25,7548,81,6738,municipality,MHV
990,3602770662,36027,"Stanford town, Dutchess County, New York",2000,2796,3424,628,5432,78,108,188,6900,30,7088,86,6598,municipality,MHV
991,3602770662,36027,"Stanford town, Dutchess County, New York",2010,1496,1913,417,2969,39,64,219,3604,21,3823,57,3423,municipality,MHV
992,3602776166,36027,"Union Vale town, Dutchess County, New York",2000,2718,2928,210,6466,108,214,312,8780,12,9092,88,8358,municipality,MHV
993,3602776166,36027,"Union Vale town, Dutchess County, New York",2010,1708,1911,203,3657,110,74,227,4650,4,4877,56,4406,municipality,MHV
994,3602778157,36027,"Wappinger town, Dutchess County, New York",2000,19586,20288,702,39212,2240,2470,4136,48412,170,52548,668,42864,municipality,MHV
995,3602778157,36027,"Wappinger town, Dutchess County, New York",2010,10318,10908,590,20964,1341,1564,3860,23188,101,27048,441,19741,municipality,MHV
996,3602778388,36027,"Washington town, Dutchess County, New York",2000,3828,4384,556,7172,62,248,340,9144,14,9484,80,8740,municipality,MHV
997,3602778388,36027,"Washington town, Dutchess County, New York",2010,1956,2459,503,3673,63,120,282,4459,26,4741,54,4196,municipality,MHV
998,3604710022,36047,"Brooklyn borough, Kings County, New York",2000,1761454,1861732,100278,3605654,368582,1697166,975756,3954896,42708,4930652,137376,1709064,municipality,NYC
999,3604710022,36047,"Brooklyn borough, Kings County, New York",2010,916856,1000293,83437,1910322,260129,799066,496285,2008415,15904,2504700,40010,893306,municipality,NYC
1000,3601011,36059,"Albertson CDP, New York",2000,1812,1853,41,4032,754,8,286,4914,5,5200,80,4067,municipality,LI
1001,3601011,36059,"Albertson CDP, New York",2010,1789,1850,61,4048,1256,12,377,4805,26,5182,126,3385,municipality,LI
1002,3602968,36059,"Atlantic Beach village, New York",2000,766,954,188,1598,16,14,59,1927,1,1986,14,1882,municipality,LI
1003,3602968,36059,"Atlantic Beach village, New York",2010,857,1091,234,1553,18,12,74,1817,1,1891,10,1776,municipality,LI
1004,3604143,36059,"Baldwin CDP, New York",2000,10621,10786,165,23403,1141,5926,3282,28320,174,31602,581,20498,municipality,LI
1005,3604143,36059,"Baldwin CDP, New York",2010,10447,10783,336,24334,1371,9941,5821,26314,290,32135,708,14004,municipality,LI
1006,3604550,36059,"Barnum Island CDP, New York",2000,836,854,18,2039,56,8,256,2231,8,2487,33,2126,municipality,LI
1007,3604550,36059,"Barnum Island CDP, New York",2010,843,889,46,1987,64,22,377,2037,18,2414,19,1914,municipality,LI
1008,3604803,36059,"Baxter Estates village, New York",2000,376,386,10,757,72,23,147,859,1,1006,16,747,municipality,LI
1009,3604803,36059,"Baxter Estates village, New York",2010,382,411,29,777,60,12,168,831,2,999,14,743,municipality,LI
1010,3604891,36059,"Bay Park CDP, New York",2000,874,892,18,1800,22,6,97,2203,1,2300,23,2151,municipality,LI
1011,3604891,36059,"Bay Park CDP, New York",2010,867,903,36,1743,37,6,141,2071,1,2212,13,2014,municipality,LI
1012,3605034,36059,"Bayville village, New York",2000,2566,2683,117,5451,117,20,344,6791,14,7135,33,6607,municipality,LI
1013,3605034,36059,"Bayville village, New York",2010,2471,2651,180,5220,112,18,433,6236,25,6669,68,6013,municipality,LI
1014,3605639,36059,"Bellerose village, New York",2000,378,384,6,875,78,5,51,1122,2,1173,10,1027,municipality,LI
1015,3605639,36059,"Bellerose village, New York",2010,375,378,3,869,52,35,113,1080,9,1193,20,964,municipality,LI
1016,3605661,36059,"Bellerose Terrace CDP, New York",2000,639,649,10,1557,337,122,429,1728,38,2157,55,1176,municipality,LI
1017,3605661,36059,"Bellerose Terrace CDP, New York",2010,633,665,32,1668,611,168,568,1630,38,2198,49,764,municipality,LI
1018,3605738,36059,"Bellmore CDP, New York",2000,5643,5724,81,12283,329,69,515,15926,28,16441,111,15389,municipality,LI
1019,3605738,36059,"Bellmore CDP, New York",2010,5669,5807,138,12324,477,158,922,15296,40,16218,143,14478,municipality,LI
1020,3606387,36059,"Bethpage CDP, New York",2000,5710,5788,78,12790,494,36,785,15758,17,16543,145,15066,municipality,LI
1021,3606387,36059,"Bethpage CDP, New York",2010,5875,6051,176,12908,895,90,1152,15277,33,16429,164,14095,municipality,LI
1022,3610132,36059,"Brookville village, New York",2000,631,648,17,1428,131,43,57,2069,5,2126,24,1866,municipality,LI
1023,3610132,36059,"Brookville village, New York",2010,612,663,51,2895,351,372,219,3246,16,3465,22,2485,municipality,LI
1024,3612419,36059,"Carle Place CDP, New York",2000,1900,1922,22,4051,286,89,408,4839,6,5247,31,4427,municipality,LI
1025,3612419,36059,"Carle Place CDP, New York",2010,1863,1932,69,3927,391,90,552,4429,18,4981,49,3881,municipality,LI
1026,3613233,36059,"Cedarhurst village, New York",2000,2289,2366,77,4617,190,70,515,5649,22,6164,73,5294,municipality,LI
1027,3613233,36059,"Cedarhurst village, New York",2010,2242,2375,133,4668,236,134,705,5887,44,6592,50,5423,municipality,LI
1028,3613618,36059,"Centre Island village, New York",2000,174,209,35,351,4,2,14,430,0,444,3,421,municipality,LI
1029,3613618,36059,"Centre Island village, New York",2010,168,232,64,328,15,0,30,380,3,410,0,362,municipality,LI
1030,3618597,36059,"Cove Neck village, New York",2000,110,140,30,221,12,0,13,287,0,300,0,275,municipality,LI
1031,3618597,36059,"Cove Neck village, New York",2010,104,148,44,214,4,1,14,272,0,286,3,264,municipality,LI
1032,3621578,36059,"East Atlantic Beach CDP, New York",2000,887,965,78,1774,20,7,80,2177,6,2257,14,2130,municipality,LI
1033,3621578,36059,"East Atlantic Beach CDP, New York",2010,849,972,123,1680,22,12,109,1940,1,2049,16,1889,municipality,LI
1034,3622260,36059,"East Hills village, New York",2000,2245,2275,30,4799,330,53,101,6741,21,6842,49,6288,municipality,LI
1035,3622260,36059,"East Hills village, New York",2010,2252,2301,49,4893,513,66,156,6799,4,6955,76,6140,municipality,LI
1036,3622480,36059,"East Massapequa CDP, New York",2000,6432,6535,103,14652,435,2328,1466,18099,62,19565,261,15013,municipality,LI
1037,3622480,36059,"East Massapequa CDP, New York",2010,6599,6796,197,14739,404,2298,1929,17140,67,19069,273,14098,municipality,LI
1038,3622502,36059,"East Meadow CDP, New York",2000,12186,12375,189,28703,2493,1513,2626,34835,75,37461,399,30355,municipality,LI
1039,3622502,36059,"East Meadow CDP, New York",2010,12410,12863,453,30262,4400,1867,4653,33479,133,38132,451,26628,municipality,LI
1040,3622623,36059,"East Norwich CDP, New York",2000,938,950,12,2051,66,16,85,2590,3,2675,15,2490,municipality,LI
1041,3622623,36059,"East Norwich CDP, New York",2010,943,966,23,2021,92,19,118,2591,2,2709,25,2453,municipality,LI
1042,3622876,36059,"East Rockaway village, New York",2000,3926,4003,77,7942,177,56,603,9811,8,10414,52,9518,municipality,LI
1043,3622876,36059,"East Rockaway village, New York",2010,3825,3997,172,7628,200,127,788,9030,22,9818,64,8617,municipality,LI
1044,3623217,36059,"East Williston village, New York",2000,833,846,13,1796,84,9,59,2444,7,2503,10,2334,municipality,LI
1045,3623217,36059,"East Williston village, New York",2010,842,864,22,1814,99,8,110,2446,0,2556,23,2316,municipality,LI
1046,3624273,36059,"Elmont CDP, New York",2000,9902,10151,249,24022,2958,10902,4672,27985,437,32657,1057,12631,municipality,LI
1047,3624273,36059,"Elmont CDP, New York",2010,9847,10279,432,25337,3609,14587,7236,25962,556,33198,716,6494,municipality,LI
1048,3625384,36059,"Farmingdale village, New York",2000,3216,3289,73,6617,311,116,1056,7343,30,8399,97,6789,municipality,LI
1049,3625384,36059,"Farmingdale village, New York",2010,3326,3482,156,6700,445,199,1122,7067,29,8189,79,6315,municipality,LI
1050,3626264,36059,"Floral Park village, New York",2000,5770,5892,122,12063,617,59,859,15108,43,15967,99,14290,municipality,LI
1051,3626264,36059,"Floral Park village, New York",2010,5680,5909,229,12198,1086,198,1391,14472,66,15863,184,12938,municipality,LI
1052,3626352,36059,"Flower Hill village, New York",2000,1477,1514,37,3332,465,46,181,4327,6,4508,84,3726,municipality,LI
1053,3626352,36059,"Flower Hill village, New York",2010,1473,1523,50,3326,591,34,271,4394,7,4665,92,3670,municipality,LI
1054,3627309,36059,"Franklin Square CDP, New York",2000,10187,10364,177,22893,1105,277,2023,27319,90,29342,290,25557,municipality,LI
1055,3627309,36059,"Franklin Square CDP, New York",2010,9941,10313,372,23111,2100,845,3885,25435,175,29320,303,22012,municipality,LI
1056,3627485,36059,"Freeport village, New York",2000,13504,13819,315,32240,579,13610,14648,29135,272,43783,839,13835,municipality,LI
1057,3627485,36059,"Freeport village, New York",2010,13279,13865,586,32852,669,13226,17858,25002,277,42860,717,10113,municipality,LI
1058,3628178,36059,"Garden City village, New York",2000,7386,7555,169,15924,706,254,600,21072,36,21672,138,19938,municipality,LI
1059,3628178,36059,"Garden City village, New York",2010,7366,7647,281,16462,792,294,1003,21368,36,22371,212,20034,municipality,LI
1060,3628189,36059,"Garden City Park CDP, New York",2000,2508,2548,40,5864,1541,308,611,6943,47,7554,140,4907,municipality,LI
1061,3628189,36059,"Garden City Park CDP, New York",2010,2533,2603,70,6135,2578,282,942,6864,71,7806,143,3790,municipality,LI
1062,3628200,36059,"Garden City South CDP, New York",2000,1399,1411,12,3089,122,12,233,3741,4,3974,12,3591,municipality,LI
1063,3628200,36059,"Garden City South CDP, New York",2010,1384,1429,45,3132,229,33,317,3707,8,4024,23,3414,municipality,LI
1064,3629113,36059,"Glen Cove city, New York",2000,9461,9734,273,20979,1082,1614,5336,21286,77,26622,369,18144,municipality,LI
1065,3629113,36059,"Glen Cove city, New York",2010,9764,10352,588,21403,1235,1728,7513,19451,123,26964,352,16013,municipality,LI
1066,3629245,36059,"Glen Head CDP, New York",2000,1681,1717,36,3521,90,22,213,4412,4,4625,32,4264,municipality,LI
1067,3629245,36059,"Glen Head CDP, New York",2010,1718,1784,66,3594,158,36,380,4317,21,4697,52,4050,municipality,LI
1068,3629421,36059,"Glenwood Landing CDP, New York",2000,1262,1284,22,2613,92,10,118,3423,5,3541,29,3287,municipality,LI
1069,3629421,36059,"Glenwood Landing CDP, New York",2010,1336,1400,64,2800,140,29,232,3547,3,3779,42,3333,municipality,LI
1070,3630169,36059,"Great Neck village, New York",2000,3346,3441,95,7023,470,255,875,8663,38,9538,255,7645,municipality,LI
1071,3630169,36059,"Great Neck village, New York",2010,3473,3645,172,7371,721,176,1015,8974,19,9989,309,7749,municipality,LI
1072,3630191,36059,"Great Neck Estates village, New York",2000,919,944,25,2014,133,23,72,2684,2,2756,31,2495,municipality,LI
1073,3630191,36059,"Great Neck Estates village, New York",2010,902,937,35,2014,281,21,80,2681,6,2761,37,2336,municipality,LI
1074,3630202,36059,"Great Neck Gardens CDP, New York",2000,376,381,5,781,81,8,25,1064,1,1089,18,956,municipality,LI
1075,3630202,36059,"Great Neck Gardens CDP, New York",2010,393,401,8,859,143,9,20,1166,6,1186,40,968,municipality,LI
1076,3630213,36059,"Great Neck Plaza village, New York",2000,3603,3925,322,5686,194,98,469,5964,15,6433,97,5560,municipality,LI
1077,3630213,36059,"Great Neck Plaza village, New York",2010,3690,4052,362,5793,769,88,526,6181,26,6707,93,5205,municipality,LI
1078,3630598,36059,"Greenvale CDP, New York",2000,362,372,10,2008,232,256,292,1939,14,2231,50,1387,municipality,LI
1079,3630598,36059,"Greenvale CDP, New York",2010,358,373,15,826,206,20,149,945,1,1094,31,687,municipality,LI
1080,3632094,36059,"Harbor Hills CDP, New York",2000,181,186,5,382,12,2,7,556,0,563,7,535,municipality,LI
1081,3632094,36059,"Harbor Hills CDP, New York",2010,180,190,10,394,30,0,11,564,0,575,4,530,municipality,LI
1082,3632105,36059,"Harbor Isle CDP, New York",2000,490,497,7,1046,15,1,45,1289,1,1334,3,1269,municipality,LI
1083,3632105,36059,"Harbor Isle CDP, New York",2010,470,495,25,1034,21,4,77,1224,3,1301,18,1178,municipality,LI
1084,3633139,36059,"Hempstead village, New York",2000,15188,15579,391,41709,736,28729,17991,38563,388,56554,1250,7460,municipality,LI
1085,3633139,36059,"Hempstead village, New York",2010,15234,16034,800,40087,704,24724,23823,30068,330,53891,762,3548,municipality,LI
1086,3634198,36059,"Herricks CDP, New York",2000,1349,1371,22,3103,989,12,170,3906,10,4076,40,2855,municipality,LI
1087,3634198,36059,"Herricks CDP, New York",2010,1343,1378,35,3228,1854,19,169,4126,26,4295,90,2137,municipality,LI
1088,3634286,36059,"Hewlett CDP, New York",2000,2634,2735,101,5359,335,58,612,6448,11,7060,53,5991,municipality,LI
1089,3634286,36059,"Hewlett CDP, New York",2010,2547,2708,161,5262,480,152,727,6092,17,6819,80,5363,municipality,LI
1090,3634297,36059,"Hewlett Bay Park village, New York",2000,157,163,6,358,19,7,23,461,1,484,5,429,municipality,LI
1091,3634297,36059,"Hewlett Bay Park village, New York",2010,131,145,14,303,23,0,22,382,2,404,1,356,municipality,LI
1092,3634308,36059,"Hewlett Harbor village, New York",2000,429,437,8,898,40,5,14,1257,5,1271,5,1202,municipality,LI
1093,3634308,36059,"Hewlett Harbor village, New York",2010,418,442,24,923,49,10,30,1233,11,1263,3,1160,municipality,LI
1094,3634319,36059,"Hewlett Neck village, New York",2000,155,163,8,337,1,4,5,499,1,504,0,493,municipality,LI
1095,3634319,36059,"Hewlett Neck village, New York",2010,145,159,14,313,9,17,9,436,0,445,3,407,municipality,LI
1096,3634374,36059,"Hicksville CDP, New York",2000,13710,13912,202,31959,3714,538,3819,37441,103,41260,441,32645,municipality,LI
1097,3634374,36059,"Hicksville CDP, New York",2010,13412,13761,349,32786,8139,836,6043,35504,198,41547,728,25603,municipality,LI
1098,3637583,36059,"Inwood CDP, New York",2000,3041,3132,91,6735,190,2356,2454,6871,80,9325,226,4019,municipality,LI
1099,3637583,36059,"Inwood CDP, New York",2010,2964,3153,189,7223,322,2258,4190,5602,114,9792,122,2786,municipality,LI
1100,3637847,36059,"Island Park village, New York",2000,1685,1740,55,3657,50,31,864,3868,19,4732,74,3694,municipality,LI
1101,3637847,36059,"Island Park village, New York",2010,1603,1715,112,3730,115,64,1234,3421,24,4655,48,3170,municipality,LI
1102,3638539,36059,"Jericho CDP, New York",2000,4545,4600,55,9747,1387,179,318,12727,13,13045,114,11034,municipality,LI
1103,3638539,36059,"Jericho CDP, New York",2010,4628,4782,154,10220,3442,247,401,13166,26,13567,154,9297,municipality,LI
1104,3639309,36059,"Kensington village, New York",2000,424,447,23,880,60,8,48,1161,0,1209,14,1079,municipality,LI
1105,3639309,36059,"Kensington village, New York",2010,411,448,37,868,101,8,26,1135,3,1161,35,988,municipality,LI
1106,3639694,36059,"Kings Point village, New York",2000,1401,1455,54,3851,180,43,99,4977,9,5076,152,4593,municipality,LI
1107,3639694,36059,"Kings Point village, New York",2010,1293,1386,93,3765,167,40,84,4921,7,5005,192,4515,municipality,LI
1108,3640937,36059,"Lake Success village, New York",2000,798,824,26,2236,424,131,33,2764,7,2797,23,2179,municipality,LI
1109,3640937,36059,"Lake Success village, New York",2010,799,826,27,2330,791,96,81,2853,14,2934,32,1920,municipality,LI
1110,3641003,36059,"Lakeview CDP, New York",2000,1525,1569,44,4022,27,4674,389,5218,54,5607,173,290,municipality,LI
1111,3641003,36059,"Lakeview CDP, New York",2010,1487,1552,65,4084,44,4399,853,4762,51,5615,140,128,municipality,LI
1112,3641432,36059,"Lattingtown village, New York",2000,627,688,61,1373,65,10,43,1817,2,1860,15,1725,municipality,LI
1113,3641432,36059,"Lattingtown village, New York",2010,614,707,93,1303,47,8,41,1698,1,1739,26,1616,municipality,LI
1114,3641487,36059,"Laurel Hollow village, New York",2000,598,621,23,1343,132,17,38,1892,0,1930,11,1732,municipality,LI
1115,3641487,36059,"Laurel Hollow village, New York",2010,602,635,33,1403,149,29,45,1907,3,1952,18,1708,municipality,LI
1116,3641553,36059,"Lawrence village, New York",2000,2113,2287,174,4393,113,64,223,6299,3,6522,37,6082,municipality,LI
1117,3641553,36059,"Lawrence village, New York",2010,2045,2280,235,4501,108,86,185,6298,6,6483,23,6075,municipality,LI
1118,3642081,36059,"Levittown CDP, New York",2000,17207,17410,203,39423,1493,247,3601,49466,96,53067,379,47251,municipality,LI
1119,3642081,36059,"Levittown CDP, New York",2010,16973,17287,314,40026,2937,403,5979,45902,179,51881,569,41814,municipality,LI
1120,3642279,36059,"Lido Beach CDP, New York",2000,1149,1325,176,2208,45,16,81,2744,4,2825,22,2657,municipality,LI
1121,3642279,36059,"Lido Beach CDP, New York",2010,1192,1403,211,2284,51,18,105,2792,4,2897,29,2690,municipality,LI
1122,3643192,36059,"Locust Valley CDP, New York",2000,1279,1324,45,2684,70,127,512,3009,5,3521,34,2773,municipality,LI
1123,3643192,36059,"Locust Valley CDP, New York",2010,1208,1281,73,2507,82,99,600,2806,5,3406,32,2588,municipality,LI
1124,3643335,36059,"Long Beach city, New York",2000,14923,16128,1205,28885,814,2071,4540,30922,259,35462,450,27328,municipality,LI
1125,3643335,36059,"Long Beach city, New York",2010,14809,16450,1641,27853,881,1958,4691,28584,226,33275,402,25117,municipality,LI
1126,3643874,36059,"Lynbrook village, New York",2000,7369,7570,201,15438,593,174,1648,18263,43,19911,168,17285,municipality,LI
1127,3643874,36059,"Lynbrook village, New York",2010,7513,7921,408,15194,867,648,2534,16893,69,19427,219,15090,municipality,LI
1128,3644787,36059,"Malverne village, New York",2000,3106,3152,46,6869,273,144,537,8397,14,8934,79,7887,municipality,LI
1129,3644787,36059,"Malverne village, New York",2010,3076,3146,70,6766,354,260,736,7778,27,8514,71,7066,municipality,LI
1130,3644792,36059,"Malverne Park Oaks CDP, New York",2000,175,175,0,363,20,17,35,435,0,470,0,398,municipality,LI
1131,3644792,36059,"Malverne Park Oaks CDP, New York",2010,183,189,6,407,19,27,44,461,2,505,9,404,municipality,LI
1132,3644897,36059,"Manhasset CDP, New York",2000,2831,2917,86,6336,574,994,599,7763,17,8362,103,6075,municipality,LI
1133,3644897,36059,"Manhasset CDP, New York",2010,2790,2893,103,5984,877,744,711,7369,31,8080,88,5629,municipality,LI
1134,3644908,36059,"Manhasset Hills CDP, New York",2000,1224,1235,11,2776,985,11,121,3540,13,3661,51,2480,municipality,LI
1135,3644908,36059,"Manhasset Hills CDP, New York",2010,1184,1241,57,2771,1412,22,210,3382,6,3592,74,1868,municipality,LI
1136,3645106,36059,"Manorhaven village, New York",2000,2401,2471,70,4771,820,73,1197,4941,21,6138,124,3903,municipality,LI
1137,3645106,36059,"Manorhaven village, New York",2010,2442,2597,155,5088,1150,90,1775,4781,10,6556,84,3447,municipality,LI
1138,3645986,36059,"Massapequa CDP, New York",2000,7417,7514,97,16863,287,35,587,22065,17,22652,120,21606,municipality,LI
1139,3645986,36059,"Massapequa CDP, New York",2010,7226,7407,181,16370,350,70,900,20785,25,21685,142,20198,municipality,LI
1140,3645997,36059,"Massapequa Park village, New York",2000,5762,5809,47,13073,243,37,525,16974,8,17499,72,16614,municipality,LI
1141,3645997,36059,"Massapequa Park village, New York",2010,5731,5844,113,12827,255,52,757,16251,6,17008,80,15858,municipality,LI
1142,3646107,36059,"Matinecock village, New York",2000,285,313,28,612,13,8,32,804,0,836,8,775,municipality,LI
1143,3646107,36059,"Matinecock village, New York",2010,272,323,51,593,16,14,50,760,0,810,3,727,municipality,LI
1144,3646668,36059,"Merrick CDP, New York",2000,7524,7602,78,16499,505,109,842,21922,42,22764,169,21097,municipality,LI
1145,3646668,36059,"Merrick CDP, New York",2010,7448,7622,174,16603,619,246,1301,20796,34,22097,205,19692,municipality,LI
1146,3647405,36059,"Mill Neck village, New York",2000,295,326,31,633,39,2,46,779,4,825,4,730,municipality,LI
1147,3647405,36059,"Mill Neck village, New York",2010,379,440,61,803,61,12,57,940,9,997,9,849,municipality,LI
1148,3647636,36059,"Mineola village, New York",2000,7473,7650,177,15350,862,179,2507,16727,78,19234,381,15227,municipality,LI
1149,3647636,36059,"Mineola village, New York",2010,7396,7701,305,15150,1579,321,3090,15709,144,18799,223,13442,municipality,LI
1150,3649231,36059,"Munsey Park village, New York",2000,817,833,16,1821,149,8,43,2589,0,2632,15,2417,municipality,LI
1151,3649231,36059,"Munsey Park village, New York",2010,819,840,21,1814,173,11,87,2606,1,2693,41,2380,municipality,LI
1152,3649330,36059,"Muttontown village, New York",2000,1022,1048,26,2391,546,60,78,3334,6,3412,60,2662,municipality,LI
1153,3649330,36059,"Muttontown village, New York",2010,1071,1125,54,2553,794,54,119,3378,14,3497,31,2485,municipality,LI
1154,3650067,36059,"New Cassel CDP, New York",2000,2972,3067,95,9461,182,6082,5467,7831,45,13298,328,1194,municipality,LI
1155,3650067,36059,"New Cassel CDP, New York",2010,2974,3174,200,10161,174,5225,7577,6482,55,14059,187,841,municipality,LI
1156,3650397,36059,"New Hyde Park village, New York",2000,3290,3353,63,7421,1268,52,756,8767,34,9523,92,7321,municipality,LI
1157,3650397,36059,"New Hyde Park village, New York",2010,3271,3371,100,7623,2521,104,1184,8528,91,9712,170,5642,municipality,LI
1158,3651517,36059,"North Bellmore CDP, New York",2000,6555,6634,79,14965,632,418,913,19166,31,20079,197,17888,municipality,LI
1159,3651517,36059,"North Bellmore CDP, New York",2010,6650,6818,168,15252,904,492,1539,18402,59,19941,243,16704,municipality,LI
1160,3653022,36059,"North Hills village, New York",2000,1808,1907,99,3677,681,32,62,4239,1,4301,62,3463,municipality,LI
1161,3653022,36059,"North Hills village, New York",2010,2259,2438,179,4357,1283,54,112,4963,7,5075,89,3530,municipality,LI
1162,3653231,36059,"North Lynbrook CDP, New York",2000,223,228,5,587,26,21,78,664,0,742,5,612,municipality,LI
1163,3653231,36059,"North Lynbrook CDP, New York",2010,231,231,0,641,41,26,119,674,6,793,15,586,municipality,LI
1164,3653253,36059,"North Massapequa CDP, New York",2000,6281,6333,52,14478,221,34,619,18533,16,19152,107,18155,municipality,LI
1165,3653253,36059,"North Massapequa CDP, New York",2010,6084,6212,128,13779,315,46,968,16918,17,17886,110,16430,municipality,LI
1166,3653264,36059,"North Merrick CDP, New York",2000,3963,4004,41,8864,375,119,436,11408,31,11844,131,10752,municipality,LI
1167,3653264,36059,"North Merrick CDP, New York",2010,4044,4125,81,9187,567,169,869,11403,10,12272,120,10537,municipality,LI
1168,3653275,36059,"North New Hyde Park CDP, New York",2000,5032,5116,84,11346,2152,43,707,13835,50,14542,115,11475,municipality,LI
1169,3653275,36059,"North New Hyde Park CDP, New York",2010,4888,5016,128,11543,4329,90,1078,13821,73,14899,270,9059,municipality,LI
1170,3653748,36059,"North Valley Stream CDP, New York",2000,4860,4951,91,11684,1414,5695,1709,14080,168,15789,525,6278,municipality,LI
1171,3653748,36059,"North Valley Stream CDP, New York",2010,5113,5548,435,12755,2132,7720,2411,14217,223,16628,377,3765,municipality,LI
1172,3653792,36059,"North Wantagh CDP, New York",2000,4332,4374,42,9292,215,45,556,11600,8,12156,84,11248,municipality,LI
1173,3653792,36059,"North Wantagh CDP, New York",2010,4230,4321,91,9232,294,77,897,11063,7,11960,88,10597,municipality,LI
1174,3654441,36059,"Oceanside CDP, New York",2000,11224,11396,172,24556,590,173,1931,30802,81,32733,174,29784,municipality,LI
1175,3654441,36059,"Oceanside CDP, New York",2010,11249,11604,355,24889,879,356,2970,29139,82,32109,226,27596,municipality,LI
1176,3654551,36059,"Old Bethpage CDP, New York",2000,1834,1843,9,4091,159,63,104,5296,10,5400,42,5022,municipality,LI
1177,3654551,36059,"Old Bethpage CDP, New York",2010,1894,1927,33,4126,342,11,189,5334,2,5523,53,4926,municipality,LI
1178,3654562,36059,"Old Brookville village, New York",2000,722,760,38,1617,158,31,44,2123,3,2167,26,1905,municipality,LI
1179,3654562,36059,"Old Brookville village, New York",2010,669,720,51,1556,238,42,122,2012,3,2134,34,1695,municipality,LI
1180,3654705,36059,"Old Westbury village, New York",2000,1063,1109,46,3270,487,571,302,3926,10,4228,87,2771,municipality,LI
1181,3654705,36059,"Old Westbury village, New York",2010,1073,1172,99,3868,574,708,316,4355,25,4671,98,2950,municipality,LI
1182,3655992,36059,"Oyster Bay CDP, New York",2000,2815,2898,83,5414,120,206,836,5990,8,6826,70,5586,municipality,LI
1183,3655992,36059,"Oyster Bay CDP, New York",2010,2758,2947,189,5329,195,199,1119,5588,13,6707,99,5082,municipality,LI
1184,3656011,36059,"Oyster Bay Cove village, New York",2000,725,742,17,1620,135,40,38,2224,7,2262,18,2024,municipality,LI
1185,3656011,36059,"Oyster Bay Cove village, New York",2010,708,758,50,1570,187,33,48,2149,3,2197,16,1910,municipality,LI
1186,3658409,36059,"Plainedge CDP, New York",2000,3028,3052,24,6921,225,48,473,8722,13,9195,75,8361,municipality,LI
1187,3658409,36059,"Plainedge CDP, New York",2010,2875,2936,61,6752,399,64,684,8133,25,8817,61,7584,municipality,LI
1188,3658442,36059,"Plainview CDP, New York",2000,8556,8638,82,19214,1219,93,658,24979,24,25637,166,23477,municipality,LI
1189,3658442,36059,"Plainview CDP, New York",2010,9070,9281,211,19888,2799,110,1046,25171,51,26217,330,21881,municipality,LI
1190,3658475,36059,"Plandome village, New York",2000,409,422,13,881,40,3,27,1245,2,1272,7,1193,municipality,LI
1191,3658475,36059,"Plandome village, New York",2010,416,431,15,906,49,11,30,1319,2,1349,5,1252,municipality,LI
1192,3658486,36059,"Plandome Heights village, New York",2000,324,328,4,693,65,3,30,941,3,971,3,867,municipality,LI
1193,3658486,36059,"Plandome Heights village, New York",2010,323,330,7,680,86,2,45,960,2,1005,15,855,municipality,LI
1194,3658497,36059,"Plandome Manor village, New York",2000,281,288,7,602,46,3,19,819,0,838,10,760,municipality,LI
1195,3658497,36059,"Plandome Manor village, New York",2010,280,295,15,619,53,1,22,850,0,872,19,777,municipality,LI
1196,3658849,36059,"Point Lookout CDP, New York",2000,616,792,176,1166,7,6,31,1441,0,1472,12,1416,municipality,LI
1197,3658849,36059,"Point Lookout CDP, New York",2010,500,666,166,989,12,5,39,1180,1,1219,3,1159,municipality,LI
1198,3659520,36059,"Port Washington CDP, New York",2000,5521,5662,141,11371,920,394,1704,13511,47,15215,170,11980,municipality,LI
1199,3659520,36059,"Port Washington CDP, New York",2010,5698,6234,536,11905,1273,346,2116,13730,54,15846,213,11844,municipality,LI
1200,3659531,36059,"Port Washington North village, New York",2000,1063,1071,8,2086,247,28,170,2530,1,2700,27,2227,municipality,LI
1201,3659531,36059,"Port Washington North village, New York",2010,1298,1395,97,2475,263,44,200,2954,7,3154,35,2605,municipality,LI
1202,3663264,36059,"Rockville Centre village, New York",2000,9201,9419,218,18228,341,878,1896,22672,47,24568,144,21262,municipality,LI
1203,3663264,36059,"Rockville Centre village, New York",2010,9258,9679,421,18094,498,1039,2169,21854,47,24023,255,20015,municipality,LI
1204,3663506,36059,"Roosevelt CDP, New York",2000,4061,4234,173,11024,75,12307,2572,13282,88,15854,351,461,municipality,LI
1205,3663506,36059,"Roosevelt CDP, New York",2010,4031,4356,325,11920,85,9873,5548,10710,144,16258,282,326,municipality,LI
1206,3663770,36059,"Roslyn village, New York",2000,1060,1124,64,2102,155,59,163,2407,1,2570,50,2142,municipality,LI
1207,3663770,36059,"Roslyn village, New York",2010,1193,1288,95,2324,243,58,311,2459,13,2770,40,2105,municipality,LI
1208,3663792,36059,"Roslyn Estates village, New York",2000,401,410,9,828,59,2,27,1183,0,1210,6,1116,municipality,LI
1209,3663792,36059,"Roslyn Estates village, New York",2010,415,428,13,865,103,4,17,1234,2,1251,10,1115,municipality,LI
1210,3663803,36059,"Roslyn Harbor village, New York",2000,356,367,11,783,50,13,34,989,0,1023,7,919,municipality,LI
1211,3663803,36059,"Roslyn Harbor village, New York",2010,361,382,21,785,124,15,56,995,1,1051,17,838,municipality,LI
1212,3663814,36059,"Roslyn Heights CDP, New York",2000,2168,2226,58,4615,627,385,406,5889,22,6295,110,4745,municipality,LI
1213,3663814,36059,"Roslyn Heights CDP, New York",2010,2157,2263,106,4773,1357,397,556,6021,33,6577,176,4058,municipality,LI
1214,3664232,36059,"Russell Gardens village, New York",2000,400,409,9,787,113,6,54,1020,1,1074,15,885,municipality,LI
1215,3664232,36059,"Russell Gardens village, New York",2010,343,359,16,738,194,2,37,908,1,945,20,691,municipality,LI
1216,3664430,36059,"Saddle Rock village, New York",2000,265,275,10,608,49,6,14,777,7,791,13,702,municipality,LI
1217,3664430,36059,"Saddle Rock village, New York",2010,267,280,13,596,54,3,14,816,2,830,23,734,municipality,LI
1218,3664441,36059,"Saddle Rock Estates CDP, New York",2000,134,139,5,293,8,7,5,419,0,424,9,395,municipality,LI
1219,3664441,36059,"Saddle Rock Estates CDP, New York",2010,140,142,2,312,11,0,2,464,3,466,8,442,municipality,LI
1220,3664842,36059,"Salisbury CDP, New York",2000,4015,4052,37,9334,1101,118,1056,11285,33,12341,111,9922,municipality,LI
1221,3664842,36059,"Salisbury CDP, New York",2010,4004,4098,94,9478,1521,211,1780,10313,54,12093,151,8376,municipality,LI
1222,3665035,36059,"Sands Point village, New York",2000,878,902,24,2025,230,42,109,2677,13,2786,14,2378,municipality,LI
1223,3665035,36059,"Sands Point village, New York",2010,872,934,62,1970,219,20,125,2550,13,2675,33,2265,municipality,LI
1224,3666047,36059,"Sea Cliff village, New York",2000,2013,2082,69,3845,62,81,241,4825,12,5066,44,4626,municipality,LI
1225,3666047,36059,"Sea Cliff village, New York",2010,1960,2049,89,3796,94,113,341,4654,13,4995,40,4394,municipality,LI
1226,3666058,36059,"Seaford CDP, New York",2000,5257,5358,101,11804,259,38,586,15205,22,15791,67,14819,municipality,LI
1227,3666058,36059,"Seaford CDP, New York",2010,5266,5395,129,11725,334,70,761,14533,27,15294,116,13986,municipality,LI
1228,3666102,36059,"Searingtown CDP, New York",2000,1582,1606,24,3686,1297,49,144,4890,7,5034,122,3415,municipality,LI
1229,3666102,36059,"Searingtown CDP, New York",2010,1563,1604,41,3779,1907,48,178,4737,8,4915,107,2667,municipality,LI
1230,3669001,36059,"South Farmingdale CDP, New York",2000,4899,4950,51,11283,478,117,888,14173,33,15061,108,13437,municipality,LI
1231,3669001,36059,"South Farmingdale CDP, New York",2010,4784,4888,104,11144,644,186,1454,13032,37,14486,140,12025,municipality,LI
1232,3669023,36059,"South Floral Park village, New York",2000,456,462,6,1157,59,913,214,1364,17,1578,118,257,municipality,LI
1233,3669023,36059,"South Floral Park village, New York",2010,530,569,39,1341,137,971,316,1448,30,1764,65,245,municipality,LI
1234,3669188,36059,"South Hempstead CDP, New York",2000,1044,1075,31,2324,80,364,303,2885,7,3188,49,2385,municipality,LI
1235,3669188,36059,"South Hempstead CDP, New York",2010,1047,1076,29,2468,78,410,601,2642,24,3243,34,2096,municipality,LI
1236,3669892,36059,"South Valley Stream CDP, New York",2000,2025,2045,20,4222,762,430,286,5352,40,5638,114,4006,municipality,LI
1237,3669892,36059,"South Valley Stream CDP, New York",2010,1969,2043,74,4538,1079,1311,584,5378,102,5962,108,2778,municipality,LI
1238,3671267,36059,"Stewart Manor village, New York",2000,718,726,8,1487,37,34,78,1857,5,1935,16,1765,municipality,LI
1239,3671267,36059,"Stewart Manor village, New York",2010,699,711,12,1453,91,45,94,1802,0,1896,20,1646,municipality,LI
1240,3672554,36059,"Syosset CDP, New York",2000,6281,6354,73,13723,2344,85,542,18002,32,18544,129,15412,municipality,LI
1241,3672554,36059,"Syosset CDP, New York",2010,6188,6339,151,13791,4162,137,775,18054,49,18829,248,13458,municipality,LI
1242,3673605,36059,"Thomaston village, New York",2000,973,1000,27,1996,350,18,207,2400,5,2607,39,1988,municipality,LI
1243,3673605,36059,"Thomaston village, New York",2010,958,1004,46,1948,731,25,137,2480,5,2617,52,1667,municipality,LI
1244,3676089,36059,"Uniondale CDP, New York",2000,6301,6496,195,17585,484,12897,5392,18598,178,23990,681,4358,municipality,LI
1245,3676089,36059,"Uniondale CDP, New York",2010,7296,7652,356,24632,774,12618,10173,20794,233,30967,496,6673,municipality,LI
1246,3676287,36059,"University Gardens CDP, New York",2000,1660,1696,36,3199,550,96,314,3824,6,4138,40,3132,municipality,LI
1247,3676287,36059,"University Gardens CDP, New York",2010,1645,1695,50,3298,1246,71,318,3908,19,4226,68,2504,municipality,LI
1248,3676331,36059,"Upper Brookville village, New York",2000,568,599,31,1285,130,94,96,1705,2,1801,42,1437,municipality,LI
1249,3676331,36059,"Upper Brookville village, New York",2010,569,611,42,1318,161,16,80,1618,5,1698,31,1405,municipality,LI
1250,3676705,36059,"Valley Stream village, New York",2000,12484,12688,204,27809,2469,2603,4463,31905,245,36368,607,25981,municipality,LI
1251,3676705,36059,"Valley Stream village, New York",2010,12189,12625,436,28854,4237,6544,8344,29167,475,37511,670,17241,municipality,LI
1252,3678146,36059,"Wantagh CDP, New York",2000,6179,6250,71,13798,357,35,619,18352,25,18971,106,17829,municipality,LI
1253,3678146,36059,"Wantagh CDP, New York",2010,6126,6250,124,13790,372,51,889,17982,36,18871,143,17380,municipality,LI
1254,3679444,36059,"Westbury village, New York",2000,4638,4714,76,11089,673,3107,2689,11574,66,14263,370,7358,municipality,LI
1255,3679444,36059,"Westbury village, New York",2010,5078,5271,193,12099,898,3127,4128,11018,94,15146,254,6645,municipality,LI
1256,3680225,36059,"West Hempstead CDP, New York",2000,6024,6110,86,13808,940,1012,1860,16853,77,18713,332,14492,municipality,LI
1257,3680225,36059,"West Hempstead CDP, New York",2010,5939,6130,191,14097,1129,1807,3098,15764,99,18862,305,12424,municipality,LI
1258,3682117,36059,"Williston Park village, New York",2000,2612,2668,56,5571,505,24,313,6948,10,7261,50,6359,municipality,LI
1259,3682117,36059,"Williston Park village, New York",2010,2668,2743,75,5656,852,55,442,6845,22,7287,99,5817,municipality,LI
1260,3682744,36059,"Woodbury CDP, New York",2000,2851,2895,44,6784,630,84,128,8882,9,9010,56,8103,municipality,LI
1261,3682744,36059,"Woodbury CDP, New York",2010,3054,3178,124,6932,912,114,199,8708,12,8907,84,7586,municipality,LI
1262,3682942,36059,"Woodmere CDP, New York",2000,5349,5462,113,11847,604,269,587,15860,33,16447,100,14854,municipality,LI
1263,3682942,36059,"Woodmere CDP, New York",2010,5336,5570,234,12210,786,687,790,16331,38,17121,82,14738,municipality,LI
1264,3682986,36059,"Woodsburgh village, New York",2000,257,268,11,556,6,2,18,813,2,831,1,802,municipality,LI
1265,3682986,36059,"Woodsburgh village, New York",2010,267,300,33,594,22,7,23,755,6,778,5,715,municipality,LI
1266,3605929113,36059,"Glen Cove city, Nassau County, New York",2000,18922,19468,546,41958,2164,3228,10672,42572,154,53244,738,36288,municipality,LI
1267,3605929113,36059,"Glen Cove city, Nassau County, New York",2010,9764,10352,588,21403,1235,1728,7513,19451,123,26964,352,16013,municipality,LI
1268,3605934000,36059,"Hempstead town, Nassau County, New York",2000,493656,504572,10916,1127146,52854,215858,173314,1338534,6328,1511848,20790,1042704,municipality,LI
1269,3605934000,36059,"Hempstead town, Nassau County, New York",2010,246456,256734,10278,580059,39084,119480,132154,627603,4338,759757,9818,454883,municipality,LI
1270,3605943335,36059,"Long Beach city, Nassau County, New York",2000,29846,32256,2410,57770,1628,4142,9080,61844,518,70924,900,54656,municipality,LI
1271,3605943335,36059,"Long Beach city, Nassau County, New York",2010,14809,16450,1641,27853,881,1958,4691,28584,226,33275,402,25117,municipality,LI
1272,3605953000,36059,"North Hempstead town, Nassau County, New York",2000,153640,157854,4214,340372,40418,27302,43744,401478,1258,445222,6976,325524,municipality,LI
1273,3605953000,36059,"North Hempstead town, Nassau County, New York",2010,78080,81961,3881,173311,33747,11971,29074,197248,898,226322,3872,146760,municipality,LI
1274,3605956000,36059,"Oyster Bay town, Nassau County, New York",2000,198710,202152,3442,443684,28424,9190,29754,558096,936,587850,4824,514722,municipality,LI
1275,3605956000,36059,"Oyster Bay town, Nassau County, New York",2010,99419,102849,3430,225326,26611,6168,21923,271291,731,293214,3245,234536,municipality,LI
1276,3606144919,36061,"Manhattan borough, New York County, New York",2000,1477288,1596288,119000,2558558,286582,469396,835632,2238758,17146,3074390,57888,1407746,municipality,NYC
1277,3606144919,36061,"Manhattan borough, New York County, New York",2010,763846,847090,83244,1351438,177624,205340,403577,1182296,7882,1585873,29957,761493,municipality,NYC
1278,3607107003,36071,"Blooming Grove town, Orange County, New York",2000,11672,13118,1446,24248,470,1198,3112,31590,210,34702,420,29292,municipality,MHV
1279,3607107003,36071,"Blooming Grove town, Orange County, New York",2010,6284,6954,670,13464,392,953,2709,15319,88,18028,309,13577,municipality,MHV
1280,3607115308,36071,"Chester town, Orange County, New York",2000,7696,7968,272,17638,638,1536,2462,21818,116,24280,190,19338,municipality,MHV
1281,3607115308,36071,"Chester town, Orange County, New York",2010,4135,4372,237,8813,490,812,1669,10312,62,11981,253,8695,municipality,MHV
1282,3607118300,36071,"Cornwall town, Orange County, New York",2000,9250,9704,454,17742,300,288,1258,23356,60,24614,256,22452,municipality,MHV
1283,3607118300,36071,"Cornwall town, Orange County, New York",2010,4742,5136,394,9411,212,221,1046,11600,44,12646,207,10916,municipality,MHV
1284,3607118916,36071,"Crawford town, Orange County, New York",2000,5414,5702,288,10976,114,178,808,14942,24,15750,146,14480,municipality,MHV
1285,3607118916,36071,"Crawford town, Orange County, New York",2010,3279,3475,196,6879,139,303,924,8392,43,9316,171,7736,municipality,MHV
1286,3607119961,36071,"Deerpark town, Orange County, New York",2000,5812,6664,852,11398,90,234,600,15116,46,15716,152,14594,municipality,MHV
1287,3607119961,36071,"Deerpark town, Orange County, New York",2010,2988,3484,496,6081,89,174,547,7354,32,7901,160,6899,municipality,MHV
1288,3607129553,36071,"Goshen town, Orange County, New York",2000,8148,8640,492,19512,438,1602,1900,23926,62,25826,148,21676,municipality,MHV
1289,3607129553,36071,"Goshen town, Orange County, New York",2010,4536,4921,385,10490,347,888,1867,11820,72,13687,196,10317,municipality,MHV
1290,3607130631,36071,"Greenville town, Orange County, New York",2000,2486,2730,244,5294,80,94,340,7260,12,7600,60,7014,municipality,MHV
1291,3607130631,36071,"Greenville town, Orange County, New York",2010,1504,1653,149,3342,66,113,425,4191,12,4616,81,3919,municipality,MHV
1292,3607131907,36071,"Hamptonburgh town, Orange County, New York",2000,2934,3064,130,6652,138,176,414,8958,28,9372,126,8490,municipality,MHV
1293,3607131907,36071,"Hamptonburgh town, Orange County, New York",2010,1739,1819,80,4086,167,202,484,5077,26,5561,87,4595,municipality,MHV
1294,3607134550,36071,"Highlands town, Orange County, New York",2000,6460,6836,376,19270,648,2128,1924,23044,184,24968,562,19522,municipality,MHV
1295,3607134550,36071,"Highlands town, Orange County, New York",2010,3026,3487,461,10123,416,934,1585,10907,104,12492,433,9020,municipality,MHV
1296,3607147042,36071,"Middletown city, Orange County, New York",2000,18932,20248,1316,36666,846,6700,12750,38026,386,50776,1248,28846,municipality,MHV
1297,3607147042,36071,"Middletown city, Orange County, New York",2010,9976,10866,890,20429,503,5075,11158,16928,179,28086,751,10420,municipality,MHV
1298,3607147713,36071,"Minisink town, Orange County, New York",2000,2364,2490,126,5032,42,74,330,6840,4,7170,38,6682,municipality,MHV
1299,3607147713,36071,"Minisink town, Orange County, New York",2010,1485,1561,76,3217,49,105,410,4080,17,4490,57,3852,municipality,MHV
1300,3607147999,36071,"Monroe town, Orange County, New York",2000,16456,17034,578,36726,850,738,3086,59728,176,62814,468,57496,municipality,MHV
1301,3607147999,36071,"Monroe town, Orange County, New York",2010,10312,11144,832,22279,980,772,3365,36547,84,39912,371,34340,municipality,MHV
1302,3607148153,36071,"Montgomery town, Orange County, New York",2000,14546,15286,740,29524,274,1388,3240,38542,140,41782,464,36276,municipality,MHV
1303,3607148153,36071,"Montgomery town, Orange County, New York",2010,8000,8523,523,16797,318,1378,3167,19439,82,22606,411,17250,municipality,MHV
1304,3607148857,36071,"Mount Hope town, Orange County, New York",2000,3164,3428,264,10544,194,1978,1940,11338,40,13278,98,9028,municipality,MHV
1305,3607148857,36071,"Mount Hope town, Orange County, New York",2010,1770,1955,185,5604,109,1025,1121,5897,49,7018,86,4628,municipality,MHV
1306,3607150034,36071,"Newburgh city, Orange County, New York",2000,18288,20952,2664,37760,404,17922,20514,36004,250,56518,1490,15938,municipality,MHV
1307,3607150034,36071,"Newburgh city, Orange County, New York",2010,9030,10505,1475,20003,257,8071,13814,15052,169,28866,675,5880,municipality,MHV
1308,3607150045,36071,"Newburgh town, Orange County, New York",2000,19530,20244,714,40708,1114,3746,5288,49848,156,55136,742,44090,municipality,MHV
1309,3607150045,36071,"Newburgh town, Orange County, New York",2010,10762,11313,551,23043,865,3289,4664,25137,141,29801,512,20330,municipality,MHV
1310,3607150848,36071,"New Windsor town, Orange County, New York",2000,16792,17518,726,33604,778,2892,5076,40656,188,45732,704,36094,municipality,MHV
1311,3607150848,36071,"New Windsor town, Orange County, New York",2010,9291,9862,571,19103,840,2599,4920,20324,88,25244,493,16304,municipality,MHV
1312,3607159388,36071,"Port Jervis city, Orange County, New York",2000,7066,7702,636,12798,114,666,1320,16400,120,17720,322,15178,municipality,MHV
1313,3607159388,36071,"Port Jervis city, Orange County, New York",2010,3570,3957,387,6596,108,565,1054,7774,70,8828,296,6735,municipality,MHV
1314,3607175781,36071,"Tuxedo town, Orange County, New York",2000,2674,2914,240,5224,206,78,284,6384,32,6668,82,5986,municipality,MHV
1315,3607175781,36071,"Tuxedo town, Orange County, New York",2010,1457,1691,234,2867,190,73,258,3366,13,3624,61,3029,municipality,MHV
1316,3607177992,36071,"Wallkill town, Orange County, New York",2000,17732,18566,834,36384,1168,4290,6608,42710,206,49318,1006,36040,municipality,MHV
1317,3607177992,36071,"Wallkill town, Orange County, New York",2010,10133,10777,644,20877,855,3939,6162,21264,201,27426,623,15646,municipality,MHV
1318,3607178366,36071,"Warwick town, Orange County, New York",2000,21736,23636,1900,44798,518,2468,3982,57546,250,61528,660,53650,municipality,MHV
1319,3607178366,36071,"Warwick town, Orange County, New York",2010,11835,12982,1147,24563,463,1425,3279,28786,144,32065,446,26308,municipality,MHV
1320,3607178839,36071,"Wawayanda town, Orange County, New York",2000,4190,4348,158,8842,202,214,738,11808,42,12546,138,11212,municipality,MHV
1321,3607178839,36071,"Wawayanda town, Orange County, New York",2010,2444,2630,186,5300,139,331,883,6383,15,7266,110,5788,municipality,MHV
1322,3607182755,36071,"Woodbury town, Orange County, New York",2000,6234,6716,482,13082,482,546,1502,17418,48,18920,196,16146,municipality,MHV
1323,3607182755,36071,"Woodbury town, Orange County, New York",2010,3627,3958,331,7917,691,648,1674,9679,50,11353,215,8075,municipality,MHV
1324,3607912529,36079,"Carmel town, Putnam County, New York",2000,21694,22566,872,48018,772,650,3910,62102,132,66012,672,59876,municipality,LHV
1325,3607912529,36079,"Carmel town, Putnam County, New York",2010,11672,12348,676,25664,588,545,3469,30836,85,34305,315,29303,municipality,LHV
1326,3607939331,36079,"Kent town, Putnam County, New York",2000,9736,10706,970,20656,332,386,1616,26402,86,28018,312,25286,municipality,LHV
1327,3607939331,36079,"Kent town, Putnam County, New York",2010,4888,5508,620,10502,245,308,1755,11752,53,13507,167,10979,municipality,LHV
1328,3607956748,36079,"Patterson town, Putnam County, New York",2000,7058,7492,434,16572,280,760,1584,21028,58,22612,318,19612,municipality,LHV
1329,3607956748,36079,"Patterson town, Putnam County, New York",2010,3905,4272,367,9264,209,480,1555,10468,58,12023,167,9554,municipality,LHV
1330,3607957584,36079,"Philipstown town, Putnam County, New York",2000,7198,7966,768,14328,196,172,714,18130,52,18844,152,17558,municipality,LHV
1331,3607957584,36079,"Philipstown town, Putnam County, New York",2010,3685,4164,479,7501,134,148,671,8991,36,9662,151,8522,municipality,LHV
1332,3607960147,36079,"Putnam Valley town, Putnam County, New York",2000,7352,8506,1154,15668,168,298,1342,20030,98,21372,240,19226,municipality,LHV
1333,3607960147,36079,"Putnam Valley town, Putnam County, New York",2010,4216,4837,621,8957,207,239,1159,10650,30,11809,177,9997,municipality,LHV
1334,3607968924,36079,"Southeast town, Putnam County, New York",2000,12368,12824,456,25500,566,608,2786,31846,62,34632,222,30388,municipality,LHV
1335,3607968924,36079,"Southeast town, Putnam County, New York",2010,6675,7095,420,14172,449,327,3052,15352,44,18404,178,14354,municipality,LHV
1336,3608160323,36081,"Queens borough, Queens County, New York",2000,1565328,1634500,69172,3440310,778606,845662,1113210,3345548,70468,4458758,185022,1465790,municipality,NYC
1337,3608160323,36081,"Queens borough, Queens County, New York",2010,780117,835127,55010,1768821,508334,395881,613750,1616972,39923,2230722,56107,616727,municipality,NYC
1338,3608570915,36085,"Staten Island borough, Richmond County, New York",2000,312682,327986,15304,660940,49572,79408,107100,780356,3150,887456,15594,632632,municipality,NYC
1339,3608570915,36085,"Staten Island borough, Richmond County, New York",2010,165516,176656,11140,359529,34697,44313,81051,387679,1860,468730,6640,300169,municipality,NYC
1340,3608715968,36087,"Clarkstown town, Rockland County, New York",2000,55394,56440,1046,123536,12884,12356,11366,152798,454,164164,2402,124702,municipality,LHV
1341,3608715968,36087,"Clarkstown town, Rockland County, New York",2010,29234,30314,1080,64483,8748,7598,9831,74356,314,84187,1327,56369,municipality,LHV
1342,3608732765,36087,"Haverstraw town, Rockland County, New York",2000,22510,23106,596,49838,2124,6292,21458,46164,298,67622,1184,36266,municipality,LHV
1343,3608732765,36087,"Haverstraw town, Rockland County, New York",2010,12170,12809,639,27769,1559,4627,15012,21622,122,36634,608,14706,municipality,LHV
1344,3608755211,36087,"Orangetown town, Rockland County, New York",2000,34660,35654,994,73914,6112,5374,5746,89676,250,95422,1512,76428,municipality,LHV
1345,3608755211,36087,"Orangetown town, Rockland County, New York",2010,17826,18611,785,38585,3386,2742,4782,44430,143,49212,669,37490,municipality,LHV
1346,3608760510,36087,"Ramapo town, Rockland County, New York",2000,63122,64844,1722,144594,9928,35930,17846,199964,1120,217810,4588,148398,municipality,LHV
1347,3608760510,36087,"Ramapo town, Rockland County, New York",2010,34731,36754,2023,81772,5013,19173,17223,109372,523,126595,1569,83094,municipality,LHV
1348,3608771674,36087,"Stony Point town, Rockland County, New York",2000,9664,9902,238,21052,366,326,1948,26540,78,28488,258,25512,municipality,LHV
1349,3608771674,36087,"Stony Point town, Rockland County, New York",2010,5281,5569,288,11498,393,483,1935,13124,37,15059,200,12011,municipality,LHV
1350,3601594,36103,"Amagansett CDP, New York",2000,493,1664,1171,863,4,18,43,1024,6,1067,8,988,municipality,LI
1351,3601594,36103,"Amagansett CDP, New York",2010,513,1790,1277,963,22,13,119,1046,2,1165,5,1004,municipality,LI
1352,3602044,36103,"Amityville village, New York",2000,3434,3577,143,7375,119,759,867,8574,26,9441,140,7530,municipality,LI
1353,3602044,36103,"Amityville village, New York",2010,3690,3997,307,7840,166,874,1249,8274,30,9523,108,7096,municipality,LI
1354,3602374,36103,"Aquebogue CDP, New York",2000,872,1013,141,1727,7,118,73,2181,2,2254,23,2031,municipality,LI
1355,3602374,36103,"Aquebogue CDP, New York",2010,932,1127,195,1973,5,102,290,2148,1,2438,13,2027,municipality,LI
1356,3602737,36103,"Asharoken village, New York",2000,254,307,53,512,17,1,12,613,1,625,0,594,municipality,LI
1357,3602737,36103,"Asharoken village, New York",2010,255,302,47,532,13,0,20,634,0,654,9,612,municipality,LI
1358,3603408,36103,"Babylon village, New York",2000,4554,4680,126,9377,183,315,644,11971,33,12615,196,11244,municipality,LI
1359,3603408,36103,"Babylon village, New York",2010,4585,4768,183,9392,263,221,817,11349,37,12166,170,10658,municipality,LI
1360,3604055,36103,"Baiting Hollow CDP, New York",2000,600,962,362,1175,8,19,58,1391,0,1449,4,1360,municipality,LI
1361,3604055,36103,"Baiting Hollow CDP, New York",2010,719,1208,489,1387,12,15,98,1544,2,1642,6,1509,municipality,LI
1362,3604913,36103,"Bayport CDP, New York",2000,3222,3325,103,6444,102,69,340,8322,10,8662,61,8080,municipality,LI
1363,3604913,36103,"Bayport CDP, New York",2010,3346,3515,169,6679,151,115,470,8426,10,8896,78,8072,municipality,LI
1364,3604935,36103,"Bay Shore CDP, New York",2000,8194,8639,445,17682,554,3857,4738,19114,134,23852,551,14018,municipality,LI
1365,3604935,36103,"Bay Shore CDP, New York",2010,9064,9663,599,19871,845,4590,8101,18236,173,26337,573,12055,municipality,LI
1366,3605039,36103,"Baywood CDP, New York",2000,2252,2317,65,5511,124,693,1759,5812,28,7571,162,4805,municipality,LI
1367,3605039,36103,"Baywood CDP, New York",2010,2162,2272,110,5573,288,976,2548,4802,50,7350,116,3372,municipality,LI
1368,3605672,36103,"Belle Terre village, New York",2000,286,297,11,626,42,9,16,816,4,832,13,748,municipality,LI
1369,3605672,36103,"Belle Terre village, New York",2010,286,308,22,596,26,10,31,761,0,792,11,714,municipality,LI
1370,3605771,36103,"Bellport village, New York",2000,993,1139,146,1921,39,30,42,2321,11,2363,25,2216,municipality,LI
1371,3605771,36103,"Bellport village, New York",2010,921,1170,249,1725,27,32,87,1997,8,2084,34,1896,municipality,LI
1372,3607069,36103,"Blue Point CDP, New York",2000,1571,1664,93,3228,47,22,192,4215,9,4407,15,4122,municipality,LI
1373,3607069,36103,"Blue Point CDP, New York",2010,1680,1747,67,3608,78,36,200,4573,22,4773,35,4402,municipality,LI
1374,3607157,36103,"Bohemia CDP, New York",2000,3326,3387,61,7578,233,78,435,9436,12,9871,72,9041,municipality,LI
1375,3607157,36103,"Bohemia CDP, New York",2010,3606,3731,125,7942,232,91,723,9457,9,10180,64,9061,municipality,LI
1376,3608026,36103,"Brentwood CDP, New York",2000,12580,13039,459,37805,1046,8654,29251,24666,358,53917,1169,13439,municipality,LI
1377,3608026,36103,"Brentwood CDP, New York",2010,13654,14202,548,44122,1101,8344,41529,19135,361,60664,775,8554,municipality,LI
1378,3608136,36103,"Bridgehampton CDP, New York",2000,627,1494,867,1137,11,239,45,1336,10,1381,14,1062,municipality,LI
1379,3608136,36103,"Bridgehampton CDP, New York",2010,748,2431,1683,1440,21,232,256,1500,8,1756,18,1221,municipality,LI
1380,3608323,36103,"Brightwaters village, New York",2000,1127,1144,17,2360,41,49,132,3116,4,3248,28,2994,municipality,LI
1381,3608323,36103,"Brightwaters village, New York",2010,1126,1156,30,2301,48,38,159,2944,6,3103,42,2810,municipality,LI
1382,3609000,36103,"Brookhaven CDP, New York",2000,1101,1167,66,2669,23,339,228,3342,11,3570,56,2913,municipality,LI
1383,3609000,36103,"Brookhaven CDP, New York",2010,1176,1268,92,2765,24,214,212,3239,11,3451,28,2962,municipality,LI
1384,3611781,36103,"Calverton CDP, New York",2000,2539,2735,196,4548,54,409,346,5358,28,5704,91,4776,municipality,LI
1385,3611781,36103,"Calverton CDP, New York",2010,2965,3224,259,5344,57,493,453,6057,16,6510,73,5418,municipality,LI
1386,3613376,36103,"Centereach CDP, New York",2000,8176,8329,153,19903,862,501,1932,25353,70,27285,262,23658,municipality,LI
1387,3613376,36103,"Centereach CDP, New York",2010,10026,10408,382,23886,1950,834,3575,28003,66,31578,404,24749,municipality,LI
1388,3613420,36103,"Center Moriches CDP, New York",2000,2319,2465,146,4983,66,339,440,6215,8,6655,81,5721,municipality,LI
1389,3613420,36103,"Center Moriches CDP, New York",2010,2597,2818,221,5679,105,248,776,6804,16,7580,122,6313,municipality,LI
1390,3613442,36103,"Centerport CDP, New York",2000,2022,2094,72,4084,64,12,117,5329,9,5446,15,5229,municipality,LI
1391,3613442,36103,"Centerport CDP, New York",2010,2032,2120,88,4055,102,26,194,5314,2,5508,57,5127,municipality,LI
1392,3613552,36103,"Central Islip CDP, New York",2000,8792,9189,397,22621,971,8244,11452,20498,297,31950,824,10162,municipality,LI
1393,3613552,36103,"Central Islip CDP, New York",2010,9365,9961,596,25283,1112,7740,17938,16512,269,34450,708,6683,municipality,LI
1394,3616958,36103,"Cold Spring Harbor CDP, New York",2000,1753,1790,37,3649,65,21,98,4877,5,4975,46,4740,municipality,LI
1395,3616958,36103,"Cold Spring Harbor CDP, New York",2010,1749,1809,60,3698,113,34,194,4876,4,5070,42,4683,municipality,LI
1396,3617530,36103,"Commack CDP, New York",2000,11697,11824,127,26786,1364,214,1055,35312,59,36367,185,33490,municipality,LI
1397,3617530,36103,"Commack CDP, New York",2010,11907,12138,231,26741,1951,297,1722,34402,84,36124,320,31750,municipality,LI
1398,3618146,36103,"Copiague CDP, New York",2000,7210,7415,205,16824,377,843,4489,17433,79,21922,285,15849,municipality,LI
1399,3618146,36103,"Copiague CDP, New York",2010,7535,7919,384,18111,464,1455,7523,15470,100,22993,284,13167,municipality,LI
1400,3618157,36103,"Coram CDP, New York",2000,12530,12880,350,26170,1148,2869,3314,31609,143,34923,552,26897,municipality,LI
1401,3618157,36103,"Coram CDP, New York",2010,14632,15437,805,30369,1952,3842,5307,33806,155,39113,784,27073,municipality,LI
1402,3619466,36103,"Cutchogue CDP, New York",2000,1120,1680,560,2237,15,69,162,2687,1,2849,22,2580,municipality,LI
1403,3619466,36103,"Cutchogue CDP, New York",2010,1347,2062,715,2695,27,47,242,3107,3,3349,17,3013,municipality,LI
1404,3619972,36103,"Deer Park CDP, New York",2000,9516,9698,182,21179,811,2500,2139,26177,98,28316,469,22299,municipality,LI
1405,3619972,36103,"Deer Park CDP, New York",2010,9383,9715,332,21319,1871,3182,3364,24381,107,27745,466,18755,municipality,LI
1406,3620379,36103,"Dering Harbor village, New York",2000,6,32,26,11,0,0,0,13,1,13,0,12,municipality,LI
1407,3620379,36103,"Dering Harbor village, New York",2010,5,35,30,11,0,0,0,11,0,11,0,11,municipality,LI
1408,3620687,36103,"Dix Hills CDP, New York",2000,7952,8057,105,18619,1913,819,995,25029,56,26024,408,21833,municipality,LI
1409,3620687,36103,"Dix Hills CDP, New York",2010,8319,8529,210,19520,2990,1385,1533,25359,83,26892,468,20433,municipality,LI
1410,3621985,36103,"East Farmingdale CDP, New York",2000,1693,1723,30,3997,219,750,687,4713,18,5400,102,3624,municipality,LI
1411,3621985,36103,"East Farmingdale CDP, New York",2010,2002,2114,112,5052,332,775,1353,5131,40,6484,109,3875,municipality,LI
1412,3622183,36103,"East Hampton village, New York",2000,635,1745,1110,1142,25,19,119,1215,7,1334,17,1147,municipality,LI
1413,3622183,36103,"East Hampton village, New York",2010,533,1836,1303,930,12,8,128,955,0,1083,4,931,municipality,LI
1414,3622200,36103,"East Hampton North CDP, New York",2000,1445,2251,806,2787,58,262,596,2991,27,3587,69,2575,municipality,LI
1415,3622200,36103,"East Hampton North CDP, New York",2010,1536,2545,1009,3252,44,244,1594,2548,23,4142,58,2179,municipality,LI
1416,3622315,36103,"East Islip CDP, New York",2000,4578,4661,83,10066,198,71,547,13531,34,14078,86,13142,municipality,LI
1417,3622315,36103,"East Islip CDP, New York",2010,4803,4942,139,10815,223,143,903,13572,24,14475,129,13053,municipality,LI
1418,3622447,36103,"East Marion CDP, New York",2000,329,744,415,616,7,7,22,734,5,756,8,707,municipality,LI
1419,3622447,36103,"East Marion CDP, New York",2010,409,953,544,790,8,7,62,864,0,926,17,832,municipality,LI
1420,3622546,36103,"East Moriches CDP, New York",2000,1510,1668,158,3348,66,71,235,4315,14,4550,36,4128,municipality,LI
1421,3622546,36103,"East Moriches CDP, New York",2010,1896,2163,267,4030,46,75,312,4937,11,5249,63,4742,municipality,LI
1422,3622612,36103,"East Northport CDP, New York",2000,6967,7086,119,15527,471,181,814,20031,38,20845,207,19134,municipality,LI
1423,3622612,36103,"East Northport CDP, New York",2010,7114,7288,174,15071,564,158,1354,18863,40,20217,213,17888,municipality,LI
1424,3622733,36103,"East Patchogue CDP, New York",2000,7493,7760,267,16008,404,625,1895,18929,69,20824,271,17560,municipality,LI
1425,3622733,36103,"East Patchogue CDP, New York",2010,8294,8685,391,17777,518,903,3951,18518,80,22469,304,16713,municipality,LI
1426,3622810,36103,"Eastport CDP, New York",2000,554,637,83,1106,16,12,136,1318,4,1454,11,1275,municipality,LI
1427,3622810,36103,"Eastport CDP, New York",2010,702,865,163,1438,11,23,160,1671,0,1831,17,1620,municipality,LI
1428,3622832,36103,"East Quogue CDP, New York",2000,1660,2465,805,3232,30,28,230,4035,6,4265,30,3941,municipality,LI
1429,3622832,36103,"East Quogue CDP, New York",2010,1832,3069,1237,3597,61,63,425,4332,17,4757,35,4156,municipality,LI
1430,3622980,36103,"East Shoreham CDP, New York",2000,1787,1827,40,4073,88,67,235,5574,6,5809,37,5376,municipality,LI
1431,3622980,36103,"East Shoreham CDP, New York",2010,2047,2104,57,4802,155,86,364,6302,12,6666,44,6005,municipality,LI
1432,3623316,36103,"Eatons Neck CDP, New York",2000,512,554,42,1053,14,3,16,1372,1,1388,3,1351,municipality,LI
1433,3623316,36103,"Eatons Neck CDP, New York",2010,519,575,56,1070,13,2,36,1370,2,1406,17,1336,municipality,LI
1434,3624405,36103,"Elwood CDP, New York",2000,3435,3493,58,8072,610,586,550,10366,49,10916,98,9023,municipality,LI
1435,3624405,36103,"Elwood CDP, New York",2010,3512,3585,73,8179,887,674,918,10259,36,11177,118,8544,municipality,LI
1436,3625417,36103,"Farmingville CDP, New York",2000,5041,5170,129,11796,282,187,1336,15122,28,16458,174,14451,municipality,LI
1437,3625417,36103,"Farmingville CDP, New York",2010,4707,4884,177,11631,571,339,1942,13539,64,15481,201,12364,municipality,LI
1438,3625839,36103,"Fire Island CDP, New York",2000,138,3157,3019,246,2,0,9,301,1,310,5,293,municipality,LI
1439,3625839,36103,"Fire Island CDP, New York",2010,131,3395,3264,239,1,12,23,269,0,292,3,253,municipality,LI
1440,3625923,36103,"Fishers Island CDP, New York",2000,138,625,487,226,3,3,4,285,0,289,6,273,municipality,LI
1441,3625923,36103,"Fishers Island CDP, New York",2010,120,660,540,196,2,2,2,234,1,236,4,225,municipality,LI
1442,3626121,36103,"Flanders CDP, New York",2000,1260,1521,261,2633,21,676,502,3144,57,3646,73,2317,municipality,LI
1443,3626121,36103,"Flanders CDP, New York",2010,1345,1684,339,3320,46,597,1677,2795,41,4472,91,2020,municipality,LI
1444,3626946,36103,"Fort Salonga CDP, New York",2000,3225,3310,85,7139,164,59,217,9417,6,9634,42,9146,municipality,LI
1445,3626946,36103,"Fort Salonga CDP, New York",2010,3370,3484,114,7365,216,84,388,9620,33,10008,73,9214,municipality,LI
1446,3628997,36103,"Gilgo-Oak Beach-Captree CDP, New York",2000,161,305,144,288,9,1,6,327,0,333,0,317,municipality,LI
1447,3628997,36103,"Gilgo-Oak Beach-Captree CDP, New York",2010,182,376,194,346,3,1,26,391,0,417,3,384,municipality,LI
1448,3629509,36103,"Gordon Heights CDP, New York",2000,856,945,89,2004,59,1846,449,2645,37,3094,104,599,municipality,LI
1449,3629509,36103,"Gordon Heights CDP, New York",2010,1070,1182,112,2867,75,1971,1012,3030,75,4042,126,783,municipality,LI
1450,3630235,36103,"Great River CDP, New York",2000,509,519,10,1098,9,0,29,1517,5,1546,10,1493,municipality,LI
1451,3630235,36103,"Great River CDP, New York",2010,503,517,14,1131,23,8,62,1427,0,1489,7,1389,municipality,LI
1452,3630543,36103,"Greenlawn CDP, New York",2000,4499,4644,145,9830,368,1967,905,12381,55,13286,199,9792,municipality,LI
1453,3630543,36103,"Greenlawn CDP, New York",2010,4560,4722,162,10220,555,1841,1724,12018,47,13742,237,9338,municipality,LI
1454,3630576,36103,"Greenport village, New York",2000,776,1075,299,1572,6,288,353,1695,5,2048,48,1348,municipality,LI
1455,3630576,36103,"Greenport village, New York",2010,820,1191,371,1791,11,219,746,1451,12,2197,32,1177,municipality,LI
1456,3630581,36103,"Greenport West CDP, New York",2000,750,1283,533,1353,6,87,100,1579,6,1679,23,1457,municipality,LI
1457,3630581,36103,"Greenport West CDP, New York",2010,960,1651,691,1814,16,100,328,1796,9,2124,25,1646,municipality,LI
1458,3631445,36103,"Halesite CDP, New York",2000,1014,1049,35,2034,24,40,80,2502,4,2582,21,2413,municipality,LI
1459,3631445,36103,"Halesite CDP, New York",2010,1008,1070,62,1994,38,17,106,2392,7,2498,18,2312,municipality,LI
1460,3631896,36103,"Hampton Bays CDP, New York",2000,4877,6875,1998,9696,82,92,1529,10707,36,12236,95,10402,municipality,LI
1461,3631896,36103,"Hampton Bays CDP, New York",2010,5079,7873,2794,10666,108,161,3895,9708,56,13603,109,9274,municipality,LI
1462,3632732,36103,"Hauppauge CDP, New York",2000,7006,7153,147,15268,710,216,887,19213,37,20100,198,18052,municipality,LI
1463,3632732,36103,"Hauppauge CDP, New York",2010,7333,7566,233,15921,1226,389,1479,19403,53,20882,187,17548,municipality,LI
1464,3632963,36103,"Head of the Harbor village, New York",2000,484,501,17,1056,45,17,20,1427,0,1447,7,1358,municipality,LI
1465,3632963,36103,"Head of the Harbor village, New York",2010,511,551,40,1097,38,10,46,1426,3,1472,12,1363,municipality,LI
1466,3635056,36103,"Holbrook CDP, New York",2000,9019,9157,138,20437,780,341,1616,25896,45,27512,219,24511,municipality,LI
1467,3635056,36103,"Holbrook CDP, New York",2010,9550,9820,270,20951,1008,401,2311,24884,60,27195,233,23182,municipality,LI
1468,3635254,36103,"Holtsville CDP, New York",2000,5316,5418,102,12205,296,174,1200,15806,33,17006,162,15141,municipality,LI
1469,3635254,36103,"Holtsville CDP, New York",2010,6725,6929,204,14873,859,326,1990,17724,54,19714,176,16309,municipality,LI
1470,3636233,36103,"Huntington CDP, New York",2000,7052,7273,221,14143,327,379,658,17745,32,18403,174,16833,municipality,LI
1471,3636233,36103,"Huntington CDP, New York",2010,7170,7482,312,14096,390,382,906,17140,35,18046,191,16142,municipality,LI
1472,3637022,36103,"Huntington Bay village, New York",2000,539,560,21,1141,14,1,19,1477,0,1496,8,1454,municipality,LI
1473,3637022,36103,"Huntington Bay village, New York",2010,534,578,44,1120,26,6,49,1376,0,1425,15,1329,municipality,LI
1474,3637044,36103,"Huntington Station CDP, New York",2000,9731,10028,297,22206,917,3296,6802,23108,123,29910,585,18187,municipality,LI
1475,3637044,36103,"Huntington Station CDP, New York",2010,10067,10523,456,24868,1154,3299,12109,20920,140,33029,605,15722,municipality,LI
1476,3637840,36103,"Islandia village, New York",2000,1007,1031,24,2303,184,353,584,2473,3,3057,63,1870,municipality,LI
1477,3637840,36103,"Islandia village, New York",2010,1026,1088,62,2672,204,429,944,2391,11,3335,57,1690,municipality,LI
1478,3637869,36103,"Islip CDP, New York",2000,6868,7026,158,14935,410,937,2195,18380,37,20575,275,16721,municipality,LI
1479,3637869,36103,"Islip CDP, New York",2010,6437,6664,227,14188,461,760,2580,16109,70,18689,248,14570,municipality,LI
1480,3638022,36103,"Islip Terrace CDP, New York",2000,1755,1784,29,3976,84,28,373,5268,4,5641,25,5127,municipality,LI
1481,3638022,36103,"Islip Terrace CDP, New York",2010,1703,1764,61,4015,124,90,478,4911,15,5389,55,4627,municipality,LI
1482,3638253,36103,"Jamesport CDP, New York",2000,605,959,354,1211,8,9,97,1429,0,1526,6,1406,municipality,LI
1483,3638253,36103,"Jamesport CDP, New York",2010,715,1169,454,1427,7,18,142,1568,0,1710,13,1530,municipality,LI
1484,3639672,36103,"Kings Park CDP, New York",2000,5480,5574,94,12071,304,131,538,15608,34,16146,139,15000,municipality,LI
1485,3639672,36103,"Kings Park CDP, New York",2010,6212,6469,257,13249,406,183,915,16367,31,17282,166,15581,municipality,LI
1486,3640530,36103,"Lake Grove village, New York",2000,3419,3509,90,7554,504,141,496,9754,28,10250,91,8990,municipality,LI
1487,3640530,36103,"Lake Grove village, New York",2010,3814,3956,142,8457,737,215,866,10297,37,11163,103,9205,municipality,LI
1488,3640838,36103,"Lake Ronkonkoma CDP, New York",2000,6700,6949,249,14842,471,237,1153,18548,46,19701,176,17618,municipality,LI
1489,3640838,36103,"Lake Ronkonkoma CDP, New York",2010,6932,7199,267,15363,904,423,2008,18147,53,20155,256,16511,municipality,LI
1490,3641465,36103,"Laurel CDP, New York",2000,452,686,234,912,0,15,28,1160,3,1188,13,1129,municipality,LI
1491,3641465,36103,"Laurel CDP, New York",2010,524,810,286,1067,6,24,124,1270,0,1394,23,1217,municipality,LI
1492,3642554,36103,"Lindenhurst village, New York",2000,9061,9277,216,20387,379,220,1813,26006,57,27819,374,24976,municipality,LI
1493,3642554,36103,"Lindenhurst village, New York",2010,9316,9665,349,21117,518,341,2656,24597,71,27253,286,23381,municipality,LI
1494,3643005,36103,"Lloyd Harbor village, New York",2000,1147,1188,41,2524,69,23,85,3590,3,3675,23,3472,municipality,LI
1495,3643005,36103,"Lloyd Harbor village, New York",2010,1162,1262,100,2577,80,34,120,3540,9,3660,39,3378,municipality,LI
1496,3645139,36103,"Manorville CDP, New York",2000,4122,4243,121,8063,71,120,461,10670,33,11131,72,10374,municipality,LI
1497,3645139,36103,"Manorville CDP, New York",2010,5000,5303,303,10364,249,222,938,13376,38,14314,124,12743,municipality,LI
1498,3646074,36103,"Mastic CDP, New York",2000,4451,4732,281,10390,162,856,1875,13561,283,15436,261,11999,municipality,LI
1499,3646074,36103,"Mastic CDP, New York",2010,4526,4847,321,11106,323,1247,3378,12103,77,15481,394,10062,municipality,LI
1500,3646085,36103,"Mastic Beach CDP, New York",2000,3755,4375,620,7873,103,544,1222,10321,56,11543,230,9388,municipality,LI
1501,3646085,36103,"Mastic Beach CDP, New York",2010,4231,4889,658,9340,186,1120,2019,10911,69,12930,285,9251,municipality,LI
1502,3646140,36103,"Mattituck CDP, New York",2000,1651,2313,662,3222,22,46,107,4091,8,4198,34,3981,municipality,LI
1503,3646140,36103,"Mattituck CDP, New York",2010,1693,2495,802,3356,37,54,288,3931,10,4219,56,3774,municipality,LI
1504,3646404,36103,"Medford CDP, New York",2000,6791,6939,148,15896,301,812,2373,19612,87,21985,268,18144,municipality,LI
1505,3646404,36103,"Medford CDP, New York",2010,7821,8171,350,18421,620,1328,4306,19836,114,24142,303,17471,municipality,LI
1506,3646514,36103,"Melville CDP, New York",2000,4930,5141,211,10823,785,294,540,13993,33,14533,170,12711,municipality,LI
1507,3646514,36103,"Melville CDP, New York",2010,6908,7194,286,14543,1372,607,955,18030,70,18985,247,15734,municipality,LI
1508,3646976,36103,"Middle Island CDP, New York",2000,3720,3900,180,7517,237,697,667,9035,46,9702,190,7865,municipality,LI
1509,3646976,36103,"Middle Island CDP, New York",2010,4217,4479,262,8380,361,786,974,9509,54,10483,174,8134,municipality,LI
1510,3647306,36103,"Miller Place CDP, New York",2000,3397,3512,115,7382,141,38,339,10241,31,10580,68,9963,municipality,LI
1511,3647306,36103,"Miller Place CDP, New York",2010,4000,4141,141,8924,359,191,621,11718,40,12339,93,11035,municipality,LI
1512,3648054,36103,"Montauk CDP, New York",2000,1593,4815,3222,3081,32,27,921,2930,9,3851,32,2830,municipality,LI
1513,3648054,36103,"Montauk CDP, New York",2010,1422,4666,3244,2764,30,74,537,2789,11,3326,30,2644,municipality,LI
1514,3648450,36103,"Moriches CDP, New York",2000,1116,1212,96,2052,42,28,92,2227,4,2319,25,2128,municipality,LI
1515,3648450,36103,"Moriches CDP, New York",2010,1322,1475,153,2396,79,72,247,2591,8,2838,32,2400,municipality,LI
1516,3649066,36103,"Mount Sinai CDP, New York",2000,2671,2740,69,6110,130,105,364,8370,14,8734,62,8059,municipality,LI
1517,3649066,36103,"Mount Sinai CDP, New York",2010,4080,4285,205,8966,486,165,706,11412,28,12118,113,10620,municipality,LI
1518,3649424,36103,"Napeague CDP, New York",2000,105,624,519,189,0,2,15,208,3,223,1,202,municipality,LI
1519,3649424,36103,"Napeague CDP, New York",2010,107,762,655,171,3,1,6,194,1,200,2,187,municipality,LI
1520,3649825,36103,"Nesconset CDP, New York",2000,3964,4227,263,8915,371,111,403,11589,27,11992,74,11006,municipality,LI
1521,3649825,36103,"Nesconset CDP, New York",2010,4564,4711,147,9941,651,159,825,12562,23,13387,89,11640,municipality,LI
1522,3650727,36103,"New Suffolk CDP, New York",2000,172,298,126,294,1,4,12,325,5,337,1,314,municipality,LI
1523,3650727,36103,"New Suffolk CDP, New York",2010,177,307,130,310,0,1,22,327,1,349,0,325,municipality,LI
1524,3651286,36103,"Nissequogue village, New York",2000,533,570,37,1148,15,1,45,1498,0,1543,18,1464,municipality,LI
1525,3651286,36103,"Nissequogue village, New York",2010,573,646,73,1275,87,11,60,1689,2,1749,19,1570,municipality,LI
1526,3651396,36103,"North Amityville CDP, New York",2000,5045,5308,263,11632,173,11071,2242,14330,220,16572,587,2279,municipality,LI
1527,3651396,36103,"North Amityville CDP, New York",2010,5333,5636,303,13036,167,10076,5093,12769,209,17862,410,1907,municipality,LI
1528,3651418,36103,"Northampton CDP, New York",2000,158,205,47,331,4,207,39,429,4,468,23,191,municipality,LI
1529,3651418,36103,"Northampton CDP, New York",2010,191,239,48,461,2,157,112,458,2,570,12,285,municipality,LI
1530,3651440,36103,"North Babylon CDP, New York",2000,6146,6271,125,13668,372,352,1313,16564,50,17877,198,15592,municipality,LI
1531,3651440,36103,"North Babylon CDP, New York",2010,6136,6378,242,13671,696,1009,2221,15288,61,17509,212,13310,municipality,LI
1532,3651495,36103,"North Bay Shore CDP, New York",2000,3794,3992,198,10534,300,2632,7608,7384,94,14992,456,3902,municipality,LI
1533,3651495,36103,"North Bay Shore CDP, New York",2010,4395,4627,232,13805,697,2894,12310,6634,136,18944,322,2585,municipality,LI
1534,3651528,36103,"North Bellport CDP, New York",2000,2349,2520,171,5985,166,2640,1841,7166,132,9007,260,3968,municipality,LI
1535,3651528,36103,"North Bellport CDP, New York",2010,3362,3652,290,8080,288,2868,3382,8163,151,11545,421,4435,municipality,LI
1536,3652078,36103,"North Great River CDP, New York",2000,1156,1167,11,2834,49,56,248,3681,6,3929,39,3531,municipality,LI
1537,3652078,36103,"North Great River CDP, New York",2010,1264,1367,103,3077,82,109,470,3531,13,4001,23,3304,municipality,LI
1538,3652188,36103,"North Haven village, New York",2000,337,578,241,614,5,3,11,732,0,743,2,722,municipality,LI
1539,3652188,36103,"North Haven village, New York",2010,332,739,407,633,12,1,24,809,0,833,4,792,municipality,LI
1540,3653198,36103,"North Lindenhurst CDP, New York",2000,3808,3883,75,8758,244,416,1372,10395,35,11767,135,9565,municipality,LI
1541,3653198,36103,"North Lindenhurst CDP, New York",2010,3787,3898,111,8888,362,564,2246,9406,49,11652,145,8286,municipality,LI
1542,3653319,36103,"North Patchogue CDP, New York",2000,2694,2781,87,5753,82,99,686,7139,8,7825,95,6855,municipality,LI
1543,3653319,36103,"North Patchogue CDP, New York",2010,2300,2432,132,5479,127,155,1491,5755,15,7246,75,5383,municipality,LI
1544,3653396,36103,"Northport village, New York",2000,2952,3052,100,5766,95,44,159,7447,8,7606,40,7260,municipality,LI
1545,3653396,36103,"Northport village, New York",2010,2921,3066,145,5658,121,40,267,7134,11,7401,46,6916,municipality,LI
1546,3653561,36103,"North Sea CDP, New York",2000,1880,3265,1385,3572,43,61,238,4255,19,4493,29,4103,municipality,LI
1547,3653561,36103,"North Sea CDP, New York",2010,1771,3477,1706,3573,69,40,748,3710,13,4458,52,3536,municipality,LI
1548,3653775,36103,"Northville CDP, New York",2000,296,401,105,622,2,30,39,762,1,801,13,716,municipality,LI
1549,3653775,36103,"Northville CDP, New York",2010,531,772,241,1102,10,14,78,1262,2,1340,14,1222,municipality,LI
1550,3653852,36103,"Northwest Harbor CDP, New York",2000,1181,3008,1827,2287,32,103,280,2779,24,3059,56,2564,municipality,LI
1551,3653852,36103,"Northwest Harbor CDP, New York",2010,1313,3394,2081,2649,56,83,605,2712,13,3317,34,2526,municipality,LI
1552,3654056,36103,"Noyack CDP, New York",2000,1158,1993,835,2121,22,25,124,2572,10,2696,15,2500,municipality,LI
1553,3654056,36103,"Noyack CDP, New York",2010,1510,2881,1371,2820,52,43,334,3234,15,3568,25,3099,municipality,LI
1554,3654144,36103,"Oakdale CDP, New York",2000,3035,3207,172,6285,53,113,243,7832,6,8075,30,7630,municipality,LI
1555,3654144,36103,"Oakdale CDP, New York",2010,3116,3280,164,6361,102,81,314,7660,7,7974,43,7427,municipality,LI
1556,3654430,36103,"Ocean Beach village, New York",2000,61,595,534,108,2,0,3,135,0,138,0,133,municipality,LI
1557,3654430,36103,"Ocean Beach village, New York",2010,39,607,568,71,0,0,1,78,0,79,0,78,municipality,LI
1558,3654617,36103,"Old Field village, New York",2000,313,346,33,663,34,7,22,925,5,947,5,874,municipality,LI
1559,3654617,36103,"Old Field village, New York",2010,325,369,44,713,58,8,26,892,16,918,11,799,municipality,LI
1560,3655321,36103,"Orient CDP, New York",2000,330,673,343,581,7,4,7,702,3,709,1,687,municipality,LI
1561,3655321,36103,"Orient CDP, New York",2010,353,772,419,633,6,8,16,727,2,743,7,704,municipality,LI
1562,3656660,36103,"Patchogue village, New York",2000,4636,4902,266,9236,163,408,2842,9077,70,11919,205,8231,municipality,LI
1563,3656660,36103,"Patchogue village, New York",2010,4694,5023,329,9345,185,620,3488,8310,47,11798,162,7296,municipality,LI
1564,3656968,36103,"Peconic CDP, New York",2000,426,682,256,833,12,10,39,1042,3,1081,9,1008,municipality,LI
1565,3656968,36103,"Peconic CDP, New York",2010,273,479,206,561,1,22,70,613,0,683,3,587,municipality,LI
1566,3659157,36103,"Poquott village, New York",2000,350,378,28,719,40,14,43,932,0,975,9,869,municipality,LI
1567,3659157,36103,"Poquott village, New York",2010,353,380,27,728,63,18,40,913,4,953,17,811,municipality,LI
1568,3659355,36103,"Port Jefferson village, New York",2000,2985,3074,89,6266,261,126,408,7429,29,7837,63,6950,municipality,LI
1569,3659355,36103,"Port Jefferson village, New York",2010,3090,3270,180,6143,470,117,500,7250,25,7750,82,6556,municipality,LI
1570,3659377,36103,"Port Jefferson Station CDP, New York",2000,2600,2656,56,5631,278,139,685,6842,18,7527,77,6330,municipality,LI
1571,3659377,36103,"Port Jefferson Station CDP, New York",2010,2812,2949,137,6123,416,183,1158,6680,17,7838,66,5998,municipality,LI
1572,3660408,36103,"Quiogue CDP, New York",2000,336,545,209,622,15,88,115,685,6,800,28,548,municipality,LI
1573,3660408,36103,"Quiogue CDP, New York",2010,307,583,276,612,17,67,155,661,14,816,22,541,municipality,LI
1574,3660422,36103,"Quogue village, New York",2000,453,1322,869,838,4,45,28,990,5,1018,14,922,municipality,LI
1575,3660422,36103,"Quogue village, New York",2010,424,1623,1199,803,10,17,58,909,2,967,21,859,municipality,LI
1576,3661142,36103,"Remsenburg-Speonk CDP, New York",2000,960,1401,441,2038,17,47,140,2535,7,2675,23,2441,municipality,LI
1577,3661142,36103,"Remsenburg-Speonk CDP, New York",2010,984,1624,640,2003,19,33,209,2433,3,2642,30,2348,municipality,LI
1578,3661665,36103,"Ridge CDP, New York",2000,5545,5922,377,10270,120,441,469,12911,54,13380,191,12105,municipality,LI
1579,3661665,36103,"Ridge CDP, New York",2010,5714,6235,521,10825,241,601,749,12587,28,13336,147,11570,municipality,LI
1580,3661973,36103,"Riverhead CDP, New York",2000,3878,4167,289,7980,119,2470,949,9564,65,10513,168,6742,municipality,LI
1581,3661973,36103,"Riverhead CDP, New York",2010,4827,5295,468,10568,220,2033,3369,9930,57,13299,295,7325,municipality,LI
1582,3662066,36103,"Riverside CDP, New York",2000,846,926,80,2457,21,989,278,2597,31,2875,38,1518,municipality,LI
1583,3662066,36103,"Riverside CDP, New York",2010,716,840,124,2521,7,706,872,2039,29,2911,61,1236,municipality,LI
1584,3663319,36103,"Rocky Point CDP, New York",2000,3557,3949,392,7103,117,60,511,9674,17,10185,116,9364,municipality,LI
1585,3663319,36103,"Rocky Point CDP, New York",2010,4820,5366,546,10201,222,187,978,13036,41,14014,155,12431,municipality,LI
1586,3663473,36103,"Ronkonkoma CDP, New York",2000,6550,6660,110,14863,476,153,1269,18760,49,20029,247,17835,municipality,LI
1587,3663473,36103,"Ronkonkoma CDP, New York",2010,6512,6724,212,14608,882,342,1944,17138,74,19082,205,15635,municipality,LI
1588,3664452,36103,"Sagaponack village, New York",2000,249,734,485,469,15,14,20,562,0,582,3,530,municipality,LI
1589,3664452,36103,"Sagaponack village, New York",2010,146,676,530,269,2,4,7,306,2,313,3,295,municipality,LI
1590,3664485,36103,"Sag Harbor village, New York",2000,1120,1942,822,1932,22,169,169,2144,24,2313,44,1885,municipality,LI
1591,3664485,36103,"Sag Harbor village, New York",2010,1000,1941,941,1796,31,157,285,1884,12,2169,30,1654,municipality,LI
1592,3664584,36103,"St. James CDP, New York",2000,4555,4674,119,9835,163,34,458,12810,13,13268,57,12543,municipality,LI
1593,3664584,36103,"St. James CDP, New York",2010,4535,4741,206,9977,261,65,750,12588,30,13338,99,12133,municipality,LI
1594,3664881,36103,"Saltaire village, New York",2000,14,401,387,27,4,0,1,42,0,43,5,33,municipality,LI
1595,3664881,36103,"Saltaire village, New York",2010,15,459,444,32,0,0,0,37,0,37,0,37,municipality,LI
1596,3665409,36103,"Sayville CDP, New York",2000,5603,5721,118,12185,336,107,505,16230,16,16735,118,15653,municipality,LI
1597,3665409,36103,"Sayville CDP, New York",2010,5983,6220,237,12814,307,161,814,16039,26,16853,130,15415,municipality,LI
1598,3666212,36103,"Selden CDP, New York",2000,6809,7083,274,15663,535,349,1799,20062,43,21861,272,18863,municipality,LI
1599,3666212,36103,"Selden CDP, New York",2010,6446,6739,293,14966,866,568,2750,17101,81,19851,243,15343,municipality,LI
1600,3666481,36103,"Setauket-East Setauket CDP, New York",2000,5521,5632,111,11649,1398,194,546,15385,63,15931,167,13563,municipality,LI
1601,3666481,36103,"Setauket-East Setauket CDP, New York",2010,5391,5589,198,11502,1137,156,807,14670,54,15477,195,13128,municipality,LI
1602,3666828,36103,"Shelter Island CDP, New York",2000,531,964,433,978,7,8,40,1194,0,1234,18,1161,municipality,LI
1603,3666828,36103,"Shelter Island CDP, New York",2010,598,1136,538,1064,6,12,75,1258,6,1333,12,1222,municipality,LI
1604,3666850,36103,"Shelter Island Heights CDP, New York",2000,459,1374,915,835,4,3,13,968,0,981,11,950,municipality,LI
1605,3666850,36103,"Shelter Island Heights CDP, New York",2010,525,1583,1058,906,4,13,41,1007,3,1048,21,966,municipality,LI
1606,3667048,36103,"Shinnecock Hills CDP, New York",2000,502,928,426,1507,17,73,182,1567,16,1749,22,1439,municipality,LI
1607,3667048,36103,"Shinnecock Hills CDP, New York",2010,744,1500,756,1736,23,40,655,1533,14,2188,20,1436,municipality,LI
1608,3667070,36103,"Shirley CDP, New York",2000,7353,7774,421,17478,304,788,2749,22646,121,25395,438,20995,municipality,LI
1609,3667070,36103,"Shirley CDP, New York",2010,8353,9022,669,20493,701,1768,4781,23073,105,27854,533,19966,municipality,LI
1610,3667191,36103,"Shoreham village, New York",2000,145,163,18,302,10,0,12,405,0,417,1,394,municipality,LI
1611,3667191,36103,"Shoreham village, New York",2010,192,229,37,405,16,7,15,516,0,531,3,490,municipality,LI
1612,3667851,36103,"Smithtown CDP, New York",2000,8815,8956,141,19892,474,143,910,25991,23,26901,153,25198,municipality,LI
1613,3667851,36103,"Smithtown CDP, New York",2010,8773,9031,258,19510,754,272,1361,25109,37,26470,221,23825,municipality,LI
1614,3668374,36103,"Sound Beach CDP, New York",2000,3358,3640,282,6995,114,60,341,9466,25,9807,89,9178,municipality,LI
1615,3668374,36103,"Sound Beach CDP, New York",2010,2729,3001,272,5649,134,89,475,7137,27,7612,106,6781,municipality,LI
1616,3668462,36103,"Southampton village, New York",2000,1651,2936,1285,3190,41,502,359,3606,21,3965,48,2994,municipality,LI
1617,3668462,36103,"Southampton village, New York",2010,1263,3314,2051,2621,51,297,503,2606,34,3109,37,2187,municipality,LI
1618,3669254,36103,"South Huntington CDP, New York",2000,3299,3379,80,7343,334,76,356,9109,10,9465,91,8598,municipality,LI
1619,3669254,36103,"South Huntington CDP, New York",2010,3378,3500,122,7364,549,212,756,8666,20,9422,144,7741,municipality,LI
1620,3669452,36103,"Southold CDP, New York",2000,2317,3710,1393,4332,11,46,148,5317,12,5465,45,5203,municipality,LI
1621,3669452,36103,"Southold CDP, New York",2010,2414,3996,1582,4616,47,43,482,5266,7,5748,46,5123,municipality,LI
1622,3670387,36103,"Springs CDP, New York",2000,1924,3878,1954,3844,72,67,804,4146,19,4950,98,3890,municipality,LI
1623,3670387,36103,"Springs CDP, New York",2010,2318,4340,2022,5154,97,94,2410,4182,16,6592,30,3945,municipality,LI
1624,3671608,36103,"Stony Brook CDP, New York",2000,4758,4970,212,10029,779,158,334,13393,19,13727,117,12320,municipality,LI
1625,3671608,36103,"Stony Brook CDP, New York",2010,4846,5042,196,10436,1029,215,603,13137,28,13740,147,11718,municipality,LI
1626,3671620,36103,"Stony Brook University CDP, New York",2010,26,26,0,9151,1883,1247,612,8604,61,9216,109,5304,municipality,LI
1627,3673352,36103,"Terryville CDP, New York",2000,3313,3437,124,7684,242,154,1007,9582,20,10589,102,9064,municipality,LI
1628,3673352,36103,"Terryville CDP, New York",2010,3827,3971,144,8779,364,266,1831,10018,60,11849,92,9236,municipality,LI
1629,3675572,36103,"Tuckahoe CDP, New York",2000,687,1092,405,1360,13,122,321,1420,24,1741,13,1248,municipality,LI
1630,3675572,36103,"Tuckahoe CDP, New York",2010,480,865,385,1041,18,128,366,1007,9,1373,36,816,municipality,LI
1631,3677519,36103,"Village of the Branch village, New York",2000,605,611,6,1446,49,3,57,1838,1,1895,6,1779,municipality,LI
1632,3677519,36103,"Village of the Branch village, New York",2010,625,645,20,1317,39,21,51,1756,2,1807,23,1671,municipality,LI
1633,3677772,36103,"Wading River CDP, New York",2000,2370,2713,343,4867,65,121,246,6422,14,6668,52,6170,municipality,LI
1634,3677772,36103,"Wading River CDP, New York",2010,2716,3090,374,5683,71,150,349,7370,17,7719,101,7031,municipality,LI
1635,3677805,36103,"Wainscott CDP, New York",2000,260,764,504,511,2,25,44,584,2,628,17,538,municipality,LI
1636,3677805,36103,"Wainscott CDP, New York",2010,264,876,612,509,3,15,93,557,9,650,10,520,municipality,LI
1637,3678575,36103,"Water Mill CDP, New York",2000,722,1461,739,1377,12,37,57,1667,1,1724,6,1611,municipality,LI
1638,3678575,36103,"Water Mill CDP, New York",2010,652,2085,1433,1271,22,15,109,1450,1,1559,16,1396,municipality,LI
1639,3679246,36103,"West Babylon CDP, New York",2000,14268,14571,303,32339,818,4333,3344,40108,121,43452,583,34253,municipality,LI
1640,3679246,36103,"West Babylon CDP, New York",2010,14537,15091,554,33507,1163,4622,5262,37951,200,43213,644,31322,municipality,LI
1641,3679301,36103,"West Bay Shore CDP, New York",2000,1721,1789,68,3664,100,42,195,4580,10,4775,37,4391,municipality,LI
1642,3679301,36103,"West Bay Shore CDP, New York",2010,1720,1818,98,3669,101,100,343,4305,7,4648,70,4027,municipality,LI
1643,3680170,36103,"Westhampton CDP, New York",2000,1070,1601,531,2107,35,124,157,2712,6,2869,42,2505,municipality,LI
1644,3680170,36103,"Westhampton CDP, New York",2010,1045,2120,1075,2418,35,109,380,2699,13,3079,38,2504,municipality,LI
1645,3680181,36103,"Westhampton Beach village, New York",2000,805,2279,1474,1513,22,88,146,1756,12,1902,16,1618,municipality,LI
1646,3680181,36103,"Westhampton Beach village, New York",2010,691,2376,1685,1371,17,46,340,1381,0,1721,19,1299,municipality,LI
1647,3680186,36103,"West Hampton Dunes village, New York",2000,7,172,165,11,1,0,0,11,0,11,0,10,municipality,LI
1648,3680186,36103,"West Hampton Dunes village, New York",2010,24,272,248,47,1,0,2,53,0,55,0,52,municipality,LI
1649,3680258,36103,"West Hills CDP, New York",2000,1978,2008,30,4279,191,48,135,5472,10,5607,39,5184,municipality,LI
1650,3680258,36103,"West Hills CDP, New York",2010,1974,2037,63,4362,300,60,304,5288,11,5592,67,4850,municipality,LI
1651,3680302,36103,"West Islip CDP, New York",2000,8883,9044,161,20682,314,108,1018,27889,37,28907,239,27191,municipality,LI
1652,3680302,36103,"West Islip CDP, New York",2010,9040,9266,226,21082,477,166,1557,26778,22,28335,244,25869,municipality,LI
1653,3680885,36103,"West Sayville CDP, New York",2000,1735,2014,279,3680,61,20,105,4898,8,5003,16,4793,municipality,LI
1654,3680885,36103,"West Sayville CDP, New York",2010,1771,2124,353,3837,55,35,183,4828,16,5011,29,4693,municipality,LI
1655,3681419,36103,"Wheatley Heights CDP, New York",2000,1455,1494,39,3496,171,2344,585,4428,41,5013,138,1734,municipality,LI
1656,3681419,36103,"Wheatley Heights CDP, New York",2010,1480,1517,37,3706,285,2701,692,4438,44,5130,171,1237,municipality,LI
1657,3683294,36103,"Wyandanch CDP, New York",2000,2525,2776,251,6793,58,7949,1724,8822,91,10546,315,409,municipality,LI
1658,3683294,36103,"Wyandanch CDP, New York",2010,2926,3157,231,8185,121,7326,3286,8361,101,11647,234,579,municipality,LI
1659,3683426,36103,"Yaphank CDP, New York",2000,1566,1650,84,3926,52,550,369,4656,12,5025,53,3989,municipality,LI
1660,3683426,36103,"Yaphank CDP, New York",2010,1872,1961,89,4788,105,389,677,5268,15,5945,52,4707,municipality,LI
1661,3610304000,36103,"Babylon town, Suffolk County, New York",2000,138096,142372,4276,313306,7950,63890,42550,381034,1748,423584,7086,300360,municipality,LI
1662,3610304000,36103,"Babylon town, Suffolk County, New York",2010,70894,74233,3339,164175,6411,33147,35793,177810,1049,213603,3242,133961,municipality,LI
1663,3610310000,36103,"Brookhaven town, Suffolk County, New York",2000,293656,310812,17156,657254,25824,36392,72082,824414,3084,896496,11370,747744,municipality,LI
1664,3610310000,36103,"Brookhaven town, Suffolk County, New York",2010,162884,175026,12142,369968,18880,24428,60270,425770,1863,486040,6817,373782,municipality,LI
1665,3610322194,36103,"East Hampton town, Suffolk County, New York",2000,16202,39280,23078,31062,472,1362,5828,33610,232,39438,650,30894,municipality,LI
1666,3610322194,36103,"East Hampton town, Suffolk County, New York",2010,8410,21038,12628,17186,278,678,5660,15797,85,21457,192,14564,municipality,LI
1667,3610337000,36103,"Huntington town, Suffolk County, New York",2000,131834,135416,3582,291140,13624,15868,25688,364890,912,390578,4432,330054,municipality,LI
1668,3610337000,36103,"Huntington town, Suffolk County, New York",2010,69311,71948,2637,152755,10009,8933,22362,180902,563,203264,2707,158690,municipality,LI
1669,3610338000,36103,"Islip town, Suffolk County, New York",2000,197872,208556,10684,468614,13744,53654,130062,515162,2434,645224,9724,435606,municipality,LI
1670,3610338000,36103,"Islip town, Suffolk County, New York",2010,103631,110665,7034,251805,9358,27898,97371,238172,1385,335543,4248,195283,municipality,LI
1671,3610359106,36103,"Poospatuck Reservation, Suffolk County, New York",2000,186,200,14,344,0,70,26,516,410,542,28,8,municipality,LI
1672,3610359106,36103,"Poospatuck Reservation, Suffolk County, New York",2010,110,124,14,245,3,53,27,297,139,324,62,40,municipality,LI
1673,3610361984,36103,"Riverhead town, Suffolk County, New York",2000,21498,24958,3460,42616,498,5724,3356,52004,188,55360,608,44986,municipality,LI
1674,3610361984,36103,"Riverhead town, Suffolk County, New York",2010,12990,15424,2434,26668,367,2501,4649,28857,88,33506,480,25421,municipality,LI
1675,3610366839,36103,"Shelter Island town, Suffolk County, New York",2000,1992,4740,2748,3648,22,22,106,4350,2,4456,58,4246,municipality,LI
1676,3610366839,36103,"Shelter Island town, Suffolk County, New York",2010,1128,2754,1626,1981,10,25,116,2276,9,2392,33,2199,municipality,LI
1677,3610367059,36103,"Shinnecock Reservation, Suffolk County, New York",2000,358,388,30,694,2,24,50,958,882,1008,10,40,municipality,LI
1678,3610367059,36103,"Shinnecock Reservation, Suffolk County, New York",2010,226,256,30,500,3,29,42,620,483,662,72,33,municipality,LI
1679,3610368000,36103,"Smithtown town, Suffolk County, New York",2000,76974,78714,1740,171248,5486,1378,7710,223720,360,231430,1422,215074,municipality,LI
1680,3610368000,36103,"Smithtown town, Suffolk County, New York",2010,40055,41381,1326,87705,4197,1122,6272,111529,238,117801,996,104976,municipality,LI
1681,3610368473,36103,"Southampton town, Suffolk County, New York",2000,43008,71672,28664,86294,908,6982,9400,100024,562,109424,1148,90424,municipality,LI
1682,3610368473,36103,"Southampton town, Suffolk County, New York",2010,21193,41759,20566,44863,618,2776,11295,45495,275,56790,670,41156,municipality,LI
1683,3610369463,36103,"Southold town, Suffolk County, New York",2000,16922,27538,10616,32356,180,1158,1964,39234,102,41198,420,37374,municipality,LI
1684,3610369463,36103,"Southold town, Suffolk County, New York",2010,9090,15377,6287,17829,161,527,2382,19586,45,21968,230,18623,municipality,LI
1685,3610506310,36105,"Bethel town, Sullivan County, New York",2000,3298,7282,3984,6820,44,378,984,7740,24,8724,74,7220,municipality,MHV
1686,3610506310,36105,"Bethel town, Sullivan County, New York",2010,1733,3954,2221,3495,36,139,485,3770,21,4255,68,3506,municipality,MHV
1687,3610511759,36105,"Callicoon town, Sullivan County, New York",2000,2444,3594,1150,4692,42,36,278,5826,20,6104,50,5678,municipality,MHV
1688,3610511759,36105,"Callicoon town, Sullivan County, New York",2010,1288,2003,715,2445,51,34,126,2931,10,3057,33,2803,municipality,MHV
1689,3610516661,36105,"Cochecton town, Sullivan County, New York",2000,1110,1910,800,2058,16,24,44,2612,12,2656,24,2536,municipality,MHV
1690,3610516661,36105,"Cochecton town, Sullivan County, New York",2010,604,1114,510,1143,10,29,57,1315,4,1372,6,1266,municipality,MHV
1691,3610520104,36105,"Delaware town, Sullivan County, New York",2000,1912,2674,762,3980,44,506,344,5094,16,5438,34,4494,municipality,MHV
1692,3610520104,36105,"Delaware town, Sullivan County, New York",2010,996,1535,539,2149,11,313,185,2485,6,2670,25,2130,municipality,MHV
1693,3610525241,36105,"Fallsburg town, Sullivan County, New York",2000,7522,13322,5800,18774,278,3560,3554,20914,162,24468,314,16600,municipality,MHV
1694,3610525241,36105,"Fallsburg town, Sullivan County, New York",2010,4225,8497,4272,9677,176,1654,2823,10047,91,12870,262,7864,municipality,MHV
1695,3610526528,36105,"Forestburgh town, Sullivan County, New York",2000,654,1000,346,1298,0,34,80,1586,0,1666,6,1546,municipality,MHV
1696,3610526528,36105,"Forestburgh town, Sullivan County, New York",2010,355,550,195,680,7,35,36,783,12,819,10,719,municipality,MHV
1697,3610527573,36105,"Fremont town, Sullivan County, New York",2000,1126,2364,1238,2070,26,44,34,2748,20,2782,38,2620,municipality,MHV
1698,3610527573,36105,"Fremont town, Sullivan County, New York",2010,607,1323,716,1116,12,31,48,1333,8,1381,26,1256,municipality,MHV
1699,3610534473,36105,"Highland town, Sullivan County, New York",2000,1902,3116,1214,3736,20,146,190,4618,26,4808,36,4390,municipality,MHV
1700,3610534473,36105,"Highland town, Sullivan County, New York",2010,1049,1766,717,2054,22,81,148,2382,1,2530,42,2236,municipality,MHV
1701,3610542235,36105,"Liberty town, Sullivan County, New York",2000,7422,10700,3278,14504,266,1650,2100,17164,104,19264,188,14956,municipality,MHV
1702,3610542235,36105,"Liberty town, Sullivan County, New York",2010,3883,5495,1612,7743,146,817,1862,8023,75,9885,170,6815,municipality,MHV
1703,3610543786,36105,"Lumberland town, Sullivan County, New York",2000,1562,2838,1276,2884,32,8,74,3804,22,3878,36,3706,municipality,MHV
1704,3610543786,36105,"Lumberland town, Sullivan County, New York",2010,967,1630,663,1922,23,34,126,2342,9,2468,36,2240,municipality,MHV
1705,3610544809,36105,"Mamakating town, Sullivan County, New York",2000,8306,11258,2952,16084,224,430,1050,20954,110,22004,280,19910,municipality,MHV
1706,3610544809,36105,"Mamakating town, Sullivan County, New York",2010,4738,6251,1513,9268,135,390,1027,11058,52,12085,220,10261,municipality,MHV
1707,3610549847,36105,"Neversink town, Sullivan County, New York",2000,2692,3920,1228,5108,16,40,156,6950,26,7106,86,6782,municipality,MHV
1708,3610549847,36105,"Neversink town, Sullivan County, New York",2010,1464,2045,581,2763,21,45,129,3428,14,3557,42,3306,municipality,MHV
1709,3610563176,36105,"Rockland town, Sullivan County, New York",2000,3120,4950,1830,5836,70,214,556,7270,10,7826,94,6882,municipality,MHV
1710,3610563176,36105,"Rockland town, Sullivan County, New York",2010,1596,2755,1159,2952,50,92,322,3453,18,3775,58,3235,municipality,MHV
1711,3610573627,36105,"Thompson town, Sullivan County, New York",2000,11086,18516,7430,20986,520,4536,4132,24246,106,28378,418,18666,municipality,MHV
1712,3610573627,36105,"Thompson town, Sullivan County, New York",2010,5982,9130,3148,11330,319,2590,3102,12206,99,15308,372,8826,municipality,MHV
1713,3610575759,36105,"Tusten town, Sullivan County, New York",2000,1166,2016,850,2198,22,188,102,2728,6,2830,48,2464,municipality,MHV
1714,3610575759,36105,"Tusten town, Sullivan County, New York",2010,652,1138,486,1234,14,65,78,1437,11,1515,30,1317,municipality,MHV
1715,3611120247,36111,"Denning town, Ulster County, New York",2000,430,1034,604,852,2,0,16,1016,10,1032,30,974,municipality,MHV
1716,3611120247,36111,"Denning town, Ulster County, New York",2010,234,531,297,454,1,6,7,544,4,551,15,518,municipality,MHV
1717,3611124691,36111,"Esopus town, Ulster County, New York",2000,6878,7448,570,13930,176,390,356,18306,52,18662,244,17444,municipality,MHV
1718,3611124691,36111,"Esopus town, Ulster County, New York",2010,3492,3969,477,7121,125,395,487,8554,38,9041,202,7794,municipality,MHV
1719,3611128255,36111,"Gardiner town, Ulster County, New York",2000,3994,4510,516,7752,78,162,480,9996,48,10476,140,9568,municipality,MHV
1720,3611128255,36111,"Gardiner town, Ulster County, New York",2010,2229,2610,381,4440,60,78,381,5332,13,5713,79,5102,municipality,MHV
1721,3611132116,36111,"Hardenburgh town, Ulster County, New York",2000,190,550,360,352,10,2,4,412,4,416,0,396,municipality,MHV
1722,3611132116,36111,"Hardenburgh town, Ulster County, New York",2010,112,344,232,194,5,0,7,231,10,238,3,213,municipality,MHV
1723,3611137143,36111,"Hurley town, Ulster County, New York",2000,5388,5892,504,10202,160,174,250,12878,28,13128,116,12400,municipality,MHV
1724,3611137143,36111,"Hurley town, Ulster County, New York",2010,2693,3069,376,5088,91,96,181,6133,26,6314,86,5834,municipality,MHV
1725,3611139727,36111,"Kingston city, Ulster County, New York",2000,19742,21274,1532,35698,712,5640,3032,43880,198,46912,1178,36152,municipality,MHV
1726,3611139727,36111,"Kingston city, Ulster County, New York",2010,10217,11147,930,18686,426,3214,3203,20690,124,23893,861,16065,municipality,MHV
1727,3611139738,36111,"Kingston town, Ulster County, New York",2000,712,796,84,1400,8,32,30,1786,4,1816,30,1712,municipality,MHV
1728,3611139738,36111,"Kingston town, Ulster County, New York",2010,380,432,52,733,11,27,28,861,4,889,6,813,municipality,MHV
1729,3611142994,36111,"Lloyd town, Ulster County, New York",2000,7252,7636,384,14774,234,968,1008,18874,74,19882,272,17326,municipality,MHV
1730,3611142994,36111,"Lloyd town, Ulster County, New York",2010,4112,4419,307,8333,309,658,793,10070,36,10863,201,8866,municipality,MHV
1731,3611145458,36111,"Marbletown town, Ulster County, New York",2000,4772,5692,920,8994,82,150,242,11466,44,11708,178,11012,municipality,MHV
1732,3611145458,36111,"Marbletown town, Ulster County, New York",2010,2400,2989,589,4606,68,81,155,5452,23,5607,84,5196,municipality,MHV
1733,3611145722,36111,"Marlborough town, Ulster County, New York",2000,6040,6352,312,12140,54,448,658,15868,32,16526,176,15158,municipality,MHV
1734,3611145722,36111,"Marlborough town, Ulster County, New York",2010,3335,3644,309,6782,77,334,769,8039,34,8808,119,7475,municipality,MHV
1735,3611150562,36111,"New Paltz town, Ulster County, New York",2000,8910,9358,448,21332,1028,1418,2108,23552,278,25660,536,20292,municipality,MHV
1736,3611150562,36111,"New Paltz town, Ulster County, New York",2010,4515,4877,362,12020,605,612,1233,12770,76,14003,277,11200,municipality,MHV
1737,3611154749,36111,"Olive town, Ulster County, New York",2000,3738,4612,874,6942,84,48,230,8928,62,9158,84,8650,municipality,MHV
1738,3611154749,36111,"Olive town, Ulster County, New York",2010,1960,2498,538,3606,57,53,139,4280,19,4419,87,4064,municipality,MHV
1739,3611158552,36111,"Plattekill town, Ulster County, New York",2000,7298,7776,478,14332,124,812,3166,16618,76,19784,312,15294,municipality,MHV
1740,3611158552,36111,"Plattekill town, Ulster County, New York",2010,3861,4242,381,7947,84,534,1934,8565,30,10499,144,7773,municipality,MHV
1741,3611163011,36111,"Rochester town, Ulster County, New York",2000,5376,7500,2124,10326,64,304,678,13358,64,14036,230,12696,municipality,MHV
1742,3611163011,36111,"Rochester town, Ulster County, New York",2010,2936,4019,1083,5682,64,151,410,6903,40,7313,144,6504,municipality,MHV
1743,3611163737,36111,"Rosendale town, Ulster County, New York",2000,5174,5714,540,9578,56,222,334,12370,64,12704,144,11884,municipality,MHV
1744,3611163737,36111,"Rosendale town, Ulster County, New York",2010,2572,2897,325,4871,46,100,304,5771,19,6075,106,5500,municipality,MHV
1745,3611165299,36111,"Saugerties town, Ulster County, New York",2000,14956,16514,1558,30320,304,1542,1832,37904,122,39736,408,35528,municipality,MHV
1746,3611165299,36111,"Saugerties town, Ulster County, New York",2010,8163,9106,943,15404,198,309,979,18503,59,19482,325,17612,municipality,MHV
1747,3611166597,36111,"Shandaken town, Ulster County, New York",2000,2926,5332,2406,5160,76,66,198,6272,52,6470,108,5970,municipality,MHV
1748,3611166597,36111,"Shandaken town, Ulster County, New York",2010,1505,2776,1271,2598,47,28,153,2932,17,3085,60,2780,municipality,MHV
1749,3611166674,36111,"Shawangunk town, Ulster County, New York",2000,6866,7508,642,18648,214,1890,1674,22370,82,24044,234,19950,municipality,MHV
1750,3611166674,36111,"Shawangunk town, Ulster County, New York",2010,3887,4333,446,11639,222,1078,1310,13022,52,14332,148,11522,municipality,MHV
1751,3611175935,36111,"Ulster town, Ulster County, New York",2000,9700,10478,778,19184,384,698,614,24474,62,25088,342,22988,municipality,MHV
1752,3611175935,36111,"Ulster town, Ulster County, New York",2010,4961,5368,407,9950,269,359,662,11665,39,12327,259,10739,municipality,MHV
1753,3611178828,36111,"Wawarsing town, Ulster County, New York",2000,8764,11642,2878,19804,294,2966,4652,21126,152,25778,510,17204,municipality,MHV
1754,3611178828,36111,"Wawarsing town, Ulster County, New York",2010,4509,6211,1702,10486,180,1784,2538,10619,110,13157,316,8229,municipality,MHV
1755,3611183052,36111,"Woodstock town, Ulster County, New York",2000,5892,7694,1802,10236,194,156,320,12162,80,12482,202,11530,municipality,MHV
1756,3611183052,36111,"Woodstock town, Ulster County, New York",2010,2976,4157,1181,5037,115,85,236,5648,14,5884,134,5300,municipality,MHV
1757,3611905320,36119,"Bedford town, Westchester County, New York",2000,11462,12040,578,26680,716,2334,2744,33522,88,36266,268,30116,municipality,LHV
1758,3611905320,36119,"Bedford town, Westchester County, New York",2010,5765,6326,561,12686,507,855,2104,15231,55,17335,197,13617,municipality,LHV
1759,3611918410,36119,"Cortlandt town, Westchester County, New York",2000,27034,28130,1096,56528,1956,3344,5532,71402,262,76934,900,64940,municipality,LHV
1760,3611918410,36119,"Cortlandt town, Westchester County, New York",2010,14987,15962,975,31331,1479,1994,5324,36268,149,41592,670,31976,municipality,LHV
1761,3611921820,36119,"Eastchester town, Westchester County, New York",2000,25252,26070,818,47700,4270,1650,2804,59832,142,62636,768,53002,municipality,LHV
1762,3611921820,36119,"Eastchester town, Westchester County, New York",2010,12946,13747,801,24270,2355,967,2335,30028,93,32363,447,26166,municipality,LHV
1763,3611930367,36119,"Greenburgh town, Westchester County, New York",2000,66086,68168,2082,132408,15174,21986,15650,157878,670,173528,3148,116900,municipality,LHV
1764,3611930367,36119,"Greenburgh town, Westchester County, New York",2010,33495,35452,1957,68042,9155,10377,12366,76034,402,88400,1561,54539,municipality,LHV
1765,3611932413,36119,"Harrison town, Westchester County, New York",2000,16788,17360,572,36476,2618,616,3236,45072,92,48308,578,41168,municipality,LHV
1766,3611932413,36119,"Harrison town, Westchester County, New York",2010,8375,8956,581,21249,2062,563,3202,24270,92,27472,420,21133,municipality,LHV
1767,3611942136,36119,"Lewisboro town, Westchester County, New York",2000,8436,8930,494,16854,514,288,612,24036,66,24648,206,22962,municipality,LHV
1768,3611942136,36119,"Lewisboro town, Westchester County, New York",2010,4453,4854,401,8998,294,153,552,11859,36,12411,189,11187,municipality,LHV
1769,3611944842,36119,"Mamaroneck town, Westchester County, New York",2000,21858,22510,652,42828,1792,1502,6328,51606,134,57934,690,47488,municipality,LHV
1770,3611944842,36119,"Mamaroneck town, Westchester County, New York",2010,10849,11562,713,21280,1131,775,4524,24632,126,29156,429,22171,municipality,LHV
1771,3611948895,36119,"Mount Kisco town, Westchester County, New York",2000,7986,8206,220,15546,842,1102,4900,15066,84,19966,264,12774,municipality,LHV
1772,3611948895,36119,"Mount Kisco town, Westchester County, New York",2010,4102,4289,187,8505,515,500,3818,7059,51,10877,131,5862,municipality,LHV
1773,3611949011,36119,"Mount Pleasant town, Westchester County, New York",2000,27474,27970,496,64004,2802,3924,12114,74328,126,86442,716,66760,municipality,LHV
1774,3611949011,36119,"Mount Pleasant town, Westchester County, New York",2010,14306,14826,520,32801,2093,2076,7859,35865,139,43724,483,31074,municipality,LHV
1775,3611949121,36119,"Mount Vernon city, Westchester County, New York",2000,51458,54096,2638,102126,2866,79778,14166,122596,1718,136762,4880,33354,municipality,LHV
1776,3611949121,36119,"Mount Vernon city, Westchester County, New York",2010,26260,28990,2730,51883,1206,41226,9592,57700,1149,67292,1670,12449,municipality,LHV
1777,3611950078,36119,"New Castle town, Westchester County, New York",2000,11464,11686,222,23834,1938,462,974,34008,46,34982,312,31250,municipality,LHV
1778,3611950078,36119,"New Castle town, Westchester County, New York",2010,5786,6037,251,11949,1282,263,710,16859,47,17569,254,15013,municipality,LHV
1779,3611950617,36119,"New Rochelle city, Westchester County, New York",2000,52378,53990,1612,109662,4608,26778,28984,115380,732,144364,2718,80544,municipality,LHV
1780,3611950617,36119,"New Rochelle city, Westchester County, New York",2010,27953,29586,1633,59554,3212,13956,21452,55610,356,77062,1138,36948,municipality,LHV
1781,3611951693,36119,"North Castle town, Westchester County, New York",2000,7166,7412,246,15250,860,364,898,20800,24,21698,188,19364,municipality,LHV
1782,3611951693,36119,"North Castle town, Westchester County, New York",2010,3913,4135,222,8321,586,179,906,10935,32,11841,144,9994,municipality,LHV
1783,3611953517,36119,"North Salem town, Westchester County, New York",2000,3528,3958,430,7640,100,74,378,9968,68,10346,134,9592,municipality,LHV
1784,3611953517,36119,"North Salem town, Westchester County, New York",2010,1811,2082,271,3880,84,60,382,4722,22,5104,45,4511,municipality,LHV
1785,3611955541,36119,"Ossining town, Westchester County, New York",2000,24710,25466,756,57164,3274,9938,14564,58504,220,73068,1008,44064,municipality,LHV
1786,3611955541,36119,"Ossining town, Westchester County, New York",2010,12706,13386,680,29560,1834,4345,11403,26271,158,37674,476,19458,municipality,LHV
1787,3611956979,36119,"Peekskill city, Westchester County, New York",2000,17392,18106,714,33940,1058,10966,9840,35042,270,44882,1196,21552,municipality,LHV
1788,3611956979,36119,"Peekskill city, Westchester County, New York",2010,9060,9709,649,18290,682,5052,8713,14870,113,23583,584,8439,municipality,LHV
1789,3611957012,36119,"Pelham town, Westchester County, New York",2000,8298,8492,194,16942,936,1038,1428,22304,102,23732,404,19824,municipality,LHV
1790,3611957012,36119,"Pelham town, Westchester County, New York",2010,4247,4483,236,8701,642,729,1243,11153,67,12396,258,9457,municipality,LHV
1791,3611959685,36119,"Pound Ridge town, Westchester County, New York",2000,3398,3736,338,6982,156,106,232,9220,10,9452,102,8846,municipality,LHV
1792,3611959685,36119,"Pound Ridge town, Westchester County, New York",2010,1844,2108,264,3695,96,64,233,4871,8,5104,88,4615,municipality,LHV
1793,3611964309,36119,"Rye city, Westchester County, New York",2000,10754,11118,364,21006,1928,362,1436,28474,72,29910,298,25814,municipality,LHV
1794,3611964309,36119,"Rye city, Westchester County, New York",2010,5520,5957,437,10592,932,207,1014,14706,35,15720,203,13329,municipality,LHV
1795,3611964320,36119,"Rye town, Westchester County, New York",2000,30778,31626,848,67142,2504,4138,28528,59232,430,87760,1352,50808,municipality,LHV
1796,3611964320,36119,"Rye town, Westchester County, New York",2010,15469,16556,1087,35078,1470,1884,19477,26451,329,45928,474,22294,municipality,LHV
1797,3611965442,36119,"Scarsdale town, Westchester County, New York",2000,11324,11590,266,23970,4482,526,934,34712,80,35646,436,29188,municipality,LHV
1798,3611965442,36119,"Scarsdale town, Westchester County, New York",2010,5418,5647,229,11389,2220,242,671,16495,88,17166,297,13648,municipality,LHV
1799,3611968308,36119,"Somers town, Westchester County, New York",2000,13604,14196,592,27646,682,586,1086,35606,40,36692,286,34012,municipality,LHV
1800,3611968308,36119,"Somers town, Westchester County, New York",2010,7623,7982,359,15365,640,304,1010,19424,46,20434,206,18228,municipality,LHV
1801,3611981677,36119,"White Plains city, Westchester County, New York",2000,41842,43152,1310,83630,4742,16276,24952,81202,606,106154,2092,57486,municipality,LHV
1802,3611981677,36119,"White Plains city, Westchester County, New York",2010,22910,24382,1472,45382,3587,7502,16839,40014,259,56853,861,27805,municipality,LHV
1803,3611984000,36119,"Yonkers city, Westchester County, New York",2000,148702,155178,6476,296744,18580,60328,101704,290468,2514,392172,10354,198692,municipality,LHV
1804,3611984000,36119,"Yonkers city, Westchester County, New York",2010,74550,80389,5839,151277,11370,31297,67927,128049,1154,195976,3065,81163,municipality,LHV
1805,3611984077,36119,"Yorktown town, Westchester County, New York",2000,25112,25704,592,52622,2484,1988,4224,68412,174,72636,714,63052,municipality,LHV
1806,3611984077,36119,"Yorktown town, Westchester County, New York",2010,12884,13418,534,27035,1689,1015,3376,32705,110,36081,404,29487,municipality,LHV
0,36005CS,36005,BX Central and South,2000,148853,158913,10060,309840,15078,119031,236419,202201,4715,438620,8984,54393,municipality,NYC
1,36005CS,36005,BX Central and South,2010,156721,165740,9019,339686,22186,122382,265843,195443,5096,461286,5467,40312,municipality,NYC
2,36005NE,36005,BX North and East,2000,94854,99908,5054,186922,4473,117431,50118,198037,1778,248155,6018,68337,municipality,NYC
3,36005NE,36005,BX North and East,2010,96791,102562,5771,194973,5609,121515,68901,184473,2733,253374,3722,50894,municipality,NYC
4,36005W,36005,BX West,2000,219505,231838,12333,438516,19007,179876,358168,287707,5696,645875,12207,70921,municipality,NYC
5,36005W,36005,BX West,2010,229937,243594,13657,482253,19540,172798,406669,263779,4665,670448,6773,60003,municipality,NYC
6,36047C,36047,BK Central,2000,201610,213139,11529,418470,11348,413337,44928,530958,4012,575886,14230,88031,municipality,NYC
7,36047C,36047,BK Central,2010,204464,218751,14287,429955,13366,394809,49672,509846,3636,559518,9762,88273,municipality,NYC
8,36047E,36047,BK East,2000,85177,92283,7106,174228,6441,155780,81201,182446,3592,263647,7084,9549,municipality,NYC
9,36047E,36047,BK East,2010,92886,100608,7722,195131,9622,164346,84875,189244,3983,274119,4128,7165,municipality,NYC
10,36047N,36047,BK North,2000,128716,140487,11771,264364,9929,124682,153255,230607,5682,383862,9002,81312,municipality,NYC
11,36047N,36047,BK North,2010,150039,165611,15572,308924,15963,112659,147533,263514,2506,411047,5461,126925,municipality,NYC
12,36047S,36047,BK Southern,2000,324145,336444,12299,664838,116417,90150,94095,787906,5164,882001,27509,548666,municipality,NYC
13,36047S,36047,BK Southern,2010,323559,357209,33650,677252,160096,79237,114375,773686,3679,888061,12205,518469,municipality,NYC
14,36047W,36047,BK West,2000,141079,148513,7434,280927,40156,64634,114399,245531,2904,359930,10863,126974,municipality,NYC
15,36047W,36047,BK West,2010,145908,158114,12206,299060,61082,48015,99830,272125,2100,371955,8454,152474,municipality,NYC
16,36061E,36061,MN East Side,2000,212494,232127,19633,323522,29113,12356,23002,337502,1430,360504,5882,288721,municipality,NYC
17,36061E,36061,MN East Side,2010,206971,234068,27097,328647,40137,12266,26956,343974,1511,370930,6833,283227,municipality,NYC
18,36061L,36061,MN Lower,2000,138123,146707,8584,252113,76240,16247,52259,239687,1843,291946,6237,139120,municipality,NYC
19,36061L,36061,MN Lower,2010,152412,166325,13913,276214,78234,15539,50634,263637,1461,314271,6926,161477,municipality,NYC
20,36061U,36061,MN Upper,2000,210107,226337,16230,424325,15198,181739,294053,276238,3425,570291,10161,65715,municipality,NYC
21,36061U,36061,MN Upper,2010,216933,233344,16411,448303,23354,155467,278755,283361,3256,562116,9135,92149,municipality,NYC
22,36061WM,36061,MN West Side and Midtown,2000,177920,192973,15053,279319,22740,24356,48502,265952,1875,314454,6664,210317,municipality,NYC
23,36061WM,36061,MN West Side and Midtown,2010,187530,213353,25823,298274,35899,22068,47232,291324,1654,338556,7063,224640,municipality,NYC
24,36081NE,36081,QN Northeast,2000,188358,194808,6450,404782,154038,30795,75682,433469,3981,509151,15909,228746,municipality,NYC
25,36081NE,36081,QN Northeast,2010,188278,199124,10846,422530,216089,28051,79640,439557,3565,519197,10471,181381,municipality,NYC
26,36081NW,36081,QN Northwest,2000,338979,350623,11644,730833,164231,49575,334561,592309,7835,926870,31554,339114,municipality,NYC
27,36081NW,36081,QN Northwest,2010,337909,362407,24498,741046,189619,39603,362648,557243,6741,919891,14905,306375,municipality,NYC
28,36081SE,36081,QN Southeast,2000,168275,180465,12190,382219,31621,311244,68892,453267,9440,522159,20406,80556,municipality,NYC
29,36081SE,36081,QN Southeast,2010,169682,183794,14112,400297,49124,295216,84386,440799,12803,525185,14917,68739,municipality,NYC
30,36081SW,36081,QN Southwest,2000,87052,91354,4302,202321,39413,31217,77470,193729,13978,271199,24642,84479,municipality,NYC
31,36081SW,36081,QN Southwest,2010,84248,89802,5554,204948,53502,33011,87076,179373,16814,266449,15814,60232,municipality,NYC
32,36085C,36085,SI Central,2000,45882,47705,1823,98148,11286,3198,12406,115771,445,128177,2077,98765,municipality,NYC
33,36085C,36085,SI Central,2010,47772,50814,3042,104928,14989,4027,17665,115456,533,133121,1853,94054,municipality,NYC
34,36085N,36085,SI North,2000,57306,60986,3680,117744,8496,35189,32192,130417,881,162609,4587,81264,municipality,NYC
35,36085N,36085,SI North,2010,60652,65422,4770,130805,13111,38620,50055,125701,986,175756,3459,69525,municipality,NYC
36,36085S,36085,SI South,2000,53153,55302,2149,114578,5004,1317,8952,143990,249,152942,1133,136287,municipality,NYC
37,36085S,36085,SI South,2010,57092,60420,3328,123796,6597,1666,13331,146522,341,159853,1328,136590,municipality,NYC
