,stco,name,yr,H_Occ,H_Tot,H_Vac,P_Asian,P_Black,P_Hisp,P_NonHisp,P_Other,P_Tot,P_White,id
1,01001,"Autauga County, Alabama",2000,16003,17662,1659,194,7428,610,43061,616,43671,34823,01001
2,01003,"Baldwin County, Alabama",2000,55336,74285,18949,531,14357,2466,137949,2193,140415,120868,01003
3,01005,"Barbour County, Alabama",2000,10409,12461,2052,83,13369,478,28560,320,29038,14788,01005
4,01007,"Bibb County, Alabama",2000,7421,8345,924,17,4584,210,20616,145,20826,15870,01007
5,01009,"Blount County, Alabama",2000,19265,21158,1893,70,598,2718,48306,639,51024,46999,01009
6,01011,"Bullock County, Alabama",2000,3986,4727,741,21,8486,322,11392,121,11714,2764,01011
7,01013,"Butler County, Alabama",2000,8398,9957,1559,34,8671,143,21256,122,21399,12429,01013
8,01015,"Calhoun County, Alabama",2000,45307,51322,6015,625,20725,1753,110496,1548,112249,87598,01015
9,01017,"Chambers County, Alabama",2000,14522,16256,1734,68,13872,280,36303,252,36583,22111,01017
10,01019,"Cherokee County, Alabama",2000,9719,14025,4306,32,1327,204,23784,261,23988,22164,01019
11,01021,"Chilton County, Alabama",2000,15287,17651,2364,65,4131,1152,38441,348,39593,33897,01021
12,01023,"Choctaw County, Alabama",2000,6363,7839,1476,6,6985,107,15815,100,15922,8724,01023
13,01025,"Clarke County, Alabama",2000,10578,12631,2053,45,11918,180,27687,205,27867,15519,01025
14,01027,"Clay County, Alabama",2000,5765,6612,847,12,2219,253,14001,154,14254,11616,01027
15,01029,"Cleburne County, Alabama",2000,5590,6189,599,19,521,198,13925,150,14123,13235,01029
16,01031,"Coffee County, Alabama",2000,17421,19837,2416,409,7950,1183,42432,1102,43615,32971,01031
17,01033,"Colbert County, Alabama",2000,22461,24980,2519,127,9096,618,54366,673,54984,44470,01033
18,01035,"Conecuh County, Alabama",2000,5792,7265,1473,16,6091,102,13987,120,14089,7760,01035
19,01037,"Coosa County, Alabama",2000,4682,6142,1460,5,4147,158,12044,150,12202,7742,01037
20,01039,"Covington County, Alabama",2000,15640,18578,2938,64,4618,292,37339,410,37631,32247,01039
21,01041,"Crenshaw County, Alabama",2000,5577,6644,1067,15,3369,87,13578,152,13665,10042,01041
22,01043,"Cullman County, Alabama",2000,30706,35233,4527,136,726,1688,75795,993,77483,73940,01043
23,01045,"Dale County, Alabama",2000,18878,21779,2901,518,9902,1642,47487,1296,49129,35771,01045
24,01047,"Dallas County, Alabama",2000,17841,20450,2609,157,29201,290,46075,300,46365,16417,01047
25,01049,"DeKalb County, Alabama",2000,25113,28051,2938,105,1064,3578,60874,1269,64452,58436,01049
26,01051,"Elmore County, Alabama",2000,22737,25733,2996,232,13505,805,65069,956,65874,50376,01051
27,01053,"Escambia County, Alabama",2000,14297,16544,2247,93,11799,379,38061,1594,38440,24575,01053
28,01055,"Etowah County, Alabama",2000,41615,45959,4344,428,15120,1763,101696,1229,103459,84919,01055
29,01057,"Fayette County, Alabama",2000,7493,8472,979,28,2199,152,18343,122,18495,15994,01057
30,01059,"Franklin County, Alabama",2000,12259,13749,1490,32,1307,2316,28907,300,31223,27268,01059
31,01061,"Geneva County, Alabama",2000,10477,12115,1638,32,2725,453,25311,373,25764,22181,01061
32,01063,"Greene County, Alabama",2000,3931,5117,1186,8,7964,58,9916,46,9974,1898,01063
33,01065,"Hale County, Alabama",2000,6415,7756,1341,25,10074,157,17028,126,17185,6803,01065
34,01067,"Henry County, Alabama",2000,6525,8037,1512,10,5247,249,16061,157,16310,10647,01067
35,01069,"Houston County, Alabama",2000,35834,39571,3737,548,21703,1122,87665,1102,88787,64312,01069
36,01071,"Jackson County, Alabama",2000,21615,24168,2553,123,2002,610,53316,1991,53926,49200,01071
37,01073,"Jefferson County, Alabama",2000,263265,288162,24897,5909,259623,10284,651763,6524,662047,379707,01073
38,01075,"Lamar County, Alabama",2000,6468,7517,1049,9,1899,207,15697,94,15904,13695,01075
39,01077,"Lauderdale County, Alabama",2000,36088,40424,4336,305,8624,894,87072,903,87966,77240,01077
40,01079,"Lawrence County, Alabama",2000,13538,15009,1471,33,4613,367,34436,2891,34803,26899,01079
41,01081,"Lee County, Alabama",2000,45702,50329,4627,1864,25954,1645,113447,1331,115092,84298,01081
42,01083,"Limestone County, Alabama",2000,24688,26897,2209,228,8703,1740,63936,863,65676,54142,01083
43,01085,"Lowndes County, Alabama",2000,4909,5801,892,15,9841,85,13388,68,13473,3464,01085
44,01087,"Macon County, Alabama",2000,8950,10627,1677,91,20298,173,23932,212,24105,3331,01087
45,01089,"Madison County, Alabama",2000,109955,120288,10333,5107,62602,5226,271474,7269,276700,196496,01089
46,01091,"Marengo County, Alabama",2000,8767,10127,1360,37,11581,219,22320,120,22539,10582,01091
47,01093,"Marion County, Alabama",2000,12697,14416,1719,45,1131,360,30854,291,31214,29387,01093
48,01095,"Marshall County, Alabama",2000,32547,36331,3784,196,1194,4656,77575,1104,82231,75081,01095
49,01097,"Mobile County, Alabama",2000,150179,165101,14922,5599,132845,4887,394956,6749,399843,249763,01097
50,01099,"Monroe County, Alabama",2000,9383,11343,1960,69,9683,190,24134,420,24324,13962,01099
51,01101,"Montgomery County, Alabama",2000,86068,95437,9369,2189,108146,2665,220845,2652,223510,107858,01101
52,01103,"Morgan County, Alabama",2000,43602,47388,3786,491,12383,3645,107419,1961,111064,92584,01103
53,01105,"Perry County, Alabama",2000,4333,5406,1073,4,8057,102,11759,56,11861,3642,01105
54,01107,"Pickens County, Alabama",2000,8086,9520,1434,22,8940,147,20802,164,20949,11676,01107
55,01109,"Pike County, Alabama",2000,11933,13981,2048,105,10766,365,29240,579,29605,17790,01109
56,01111,"Randolph County, Alabama",2000,8642,10285,1643,50,4949,272,22108,169,22380,16940,01111
57,01113,"Russell County, Alabama",2000,19741,22831,3090,173,20217,744,49012,697,49756,27925,01113
58,01115,"St. Clair County, Alabama",2000,24143,27303,3160,108,5253,686,64056,778,64742,57917,01115
59,01117,"Shelby County, Alabama",2000,54631,59302,4671,1465,10570,2910,140383,1397,143293,126951,01117
60,01119,"Sumter County, Alabama",2000,5708,6953,1245,15,10718,165,14633,87,14798,3813,01119
61,01121,"Talladega County, Alabama",2000,30674,34469,3795,159,25206,812,79509,745,80321,53399,01121
62,01123,"Tallapoosa County, Alabama",2000,16656,20510,3854,74,10488,242,41233,329,41475,30342,01123
63,01125,"Tuscaloosa County, Alabama",2000,64517,71429,6912,1506,48135,2130,162745,1737,164875,111367,01125
64,01127,"Walker County, Alabama",2000,28364,32417,4053,140,4323,607,70106,788,70713,64855,01127
65,01129,"Washington County, Alabama",2000,6705,8123,1418,10,4818,160,17937,1436,18097,11673,01129
66,01131,"Wilcox County, Alabama",2000,4776,6183,1407,8,9423,97,13086,44,13183,3611,01131
67,01133,"Winston County, Alabama",2000,10107,12502,2395,30,93,372,24471,293,24843,24055,01133
68,02013,"Aleutians East Borough, Alaska",2000,526,724,198,712,42,339,2358,1083,2697,521,02013
69,02016,"Aleutians West Census Area, Alaska",2000,1270,2234,964,1338,165,573,4892,1330,5465,2059,02016
70,02020,"Anchorage Municipality, Alaska",2000,94822,100368,5546,14208,14667,14799,245484,34627,260283,181982,02020
71,02050,"Bethel Census Area, Alaska",2000,4226,5188,962,168,59,140,15866,13681,16006,1958,02050
72,02060,"Bristol Bay Borough, Alaska",2000,490,979,489,3,7,7,1251,585,1258,656,02060
73,02068,"Denali Borough, Alaska",2000,785,1351,566,26,27,47,1846,193,1893,1600,02068
74,02070,"Dillingham Census Area, Alaska",2000,1529,2332,803,30,18,111,4811,3732,4922,1031,02070
75,02090,"Fairbanks North Star Borough, Alaska",2000,29777,33291,3514,1682,4719,3440,79400,10057,82840,62942,02090
76,02100,"Haines Borough, Alaska",2000,991,1419,428,17,3,33,2359,379,2392,1960,02100
77,02110,"Juneau City and Borough, Alaska",2000,11543,12282,739,1422,235,1040,29671,5516,30711,22498,02110
78,02122,"Kenai Peninsula Borough, Alaska",2000,18438,24871,6433,471,220,1087,48604,5650,49691,42263,02122
79,02130,"Ketchikan Gateway Borough, Alaska",2000,5399,6218,819,596,67,372,13698,2771,14070,10264,02130
80,02150,"Kodiak Island Borough, Alaska",2000,4424,5159,735,2193,129,848,13065,2742,13913,8001,02150
81,02164,"Lake and Peninsula Borough, Alaska",2000,588,1557,969,4,1,21,1802,1455,1823,342,02164
82,02170,"Matanuska-Susitna Borough, Alaska",2000,20556,27329,6773,401,398,1485,57837,5863,59322,51175,02170
83,02180,"Nome Census Area, Alaska",2000,2693,3649,956,62,35,92,9104,7255,9196,1752,02180
84,02185,"North Slope Borough, Alaska",2000,2109,2538,429,435,51,175,7210,5496,7385,1228,02185
85,02188,"Northwest Arctic Borough, Alaska",2000,1780,2540,760,64,15,57,7151,6194,7208,878,02188
86,02201,"Prince of Wales-Outer Ketchikan Census Area, Alaska",2000,2262,3055,793,22,9,107,6039,2780,6146,3228,02201
87,02220,"Sitka City and Borough, Alaska",2000,3278,3650,372,329,24,290,8545,2265,8835,5927,02220
88,02232,"Skagway-Hoonah-Angoon Census Area, Alaska",2000,1369,2108,739,12,5,97,3339,1347,3436,1975,02232
89,02240,"Southeast Fairbanks Census Area, Alaska",2000,2098,3225,1127,42,118,167,6007,1067,6174,4780,02240
90,02261,"Valdez-Cordova Census Area, Alaska",2000,3884,5148,1264,359,33,286,9909,1905,10195,7612,02261
91,02270,"Wade Hampton Census Area, Alaska",2000,1602,2063,461,7,4,23,7005,6664,7028,330,02270
92,02280,"Wrangell-Petersburg Census Area, Alaska",2000,2587,3284,697,105,15,132,6552,1586,6684,4846,02280
93,02282,"Yakutat City and Borough, Alaska",2000,265,499,234,10,1,6,802,385,808,406,02282
94,02290,"Yukon-Koyukuk Census Area, Alaska",2000,2309,3917,1608,23,6,78,6473,4870,6551,1574,02290
95,04001,"Apache County, Arizona",2000,19971,31621,11650,85,163,3119,66304,53775,69423,12281,04001
96,04003,"Cochise County, Arizona",2000,43893,51126,7233,1876,5062,36134,81621,3929,117755,70754,04003
97,04005,"Coconino County, Arizona",2000,40448,53443,12995,896,1150,12727,103593,34578,116320,66969,04005
98,04007,"Gila County, Arizona",2000,20140,28189,8049,211,174,8546,42789,7013,51335,35391,04007
99,04009,"Graham County, Arizona",2000,10116,11430,1314,182,602,9054,24435,5163,33489,18488,04009
100,04011,"Greenlee County, Arizona",2000,3117,3744,627,12,34,3681,4866,216,8547,4604,04011
101,04012,"La Paz County, Arizona",2000,8362,15133,6771,78,149,4420,15295,2495,19715,12573,04012
102,04013,"Maricopa County, Arizona",2000,1132886,1250231,117345,64562,108521,763341,2308808,101195,3072149,2034530,04013
103,04015,"Mohave County, Arizona",2000,62809,80062,17253,1118,787,17182,137850,5662,155032,130283,04015
104,04017,"Navajo County, Arizona",2000,30043,47413,17370,315,794,8011,89459,47154,97470,41196,04017
105,04019,"Pima County, Arizona",2000,332350,366737,34387,16595,24047,247578,596168,36806,843746,518720,04019
106,04021,"Pinal County, Arizona",2000,61364,81154,19790,1001,4658,53671,126056,14756,179727,105641,04021
107,04023,"Santa Cruz County, Arizona",2000,11809,13036,1227,189,75,31005,7376,277,38381,6835,04023
108,04025,"Yavapai County, Arizona",2000,70171,81730,11559,833,589,16376,151141,4682,167517,145037,04025
109,04027,"Yuma County, Arizona",2000,53848,74140,20292,1362,3136,80772,79254,3800,160026,70956,04027
110,05001,"Arkansas County, Arkansas",2000,8457,9672,1215,74,4823,157,20592,179,20749,15516,05001
111,05003,"Ashley County, Arkansas",2000,9384,10615,1231,39,6506,776,23433,186,24209,16702,05003
112,05005,"Baxter County, Arkansas",2000,17052,19891,2839,130,42,385,38001,547,38386,37282,05005
113,05007,"Benton County, Arkansas",2000,58212,64281,6069,1644,558,13469,139937,4641,153406,133094,05007
114,05009,"Boone County, Arkansas",2000,13851,15426,1575,107,39,360,33588,535,33948,32907,05009
115,05011,"Bradley County, Arkansas",2000,4834,5930,1096,7,3598,1040,11560,104,12600,7851,05011
116,05013,"Calhoun County, Arkansas",2000,2317,3012,695,2,1342,86,5658,66,5744,4248,05013
117,05015,"Carroll County, Arkansas",2000,10189,11828,1639,98,25,2471,22886,514,25357,22249,05015
118,05017,"Chicot County, Arkansas",2000,5205,5974,769,55,7541,407,13710,134,14117,5980,05017
119,05019,"Clark County, Arkansas",2000,8912,10166,1254,145,5166,566,22980,367,23546,17302,05019
120,05021,"Clay County, Arkansas",2000,7417,8498,1081,14,29,140,17469,249,17609,17177,05021
121,05023,"Cleburne County, Arkansas",2000,10190,13732,3542,35,29,282,23764,308,24046,23392,05023
122,05025,"Cleveland County, Arkansas",2000,3273,3834,561,12,1124,139,8432,97,8571,7199,05025
123,05027,"Columbia County, Arkansas",2000,9981,11566,1585,87,9205,269,25334,266,25603,15776,05027
124,05029,"Conway County, Arkansas",2000,7967,9028,1061,47,2649,359,19977,308,20336,16973,05029
125,05031,"Craighead County, Arkansas",2000,32301,35133,2832,480,6345,1739,80409,1095,82148,72489,05031
126,05033,"Crawford County, Arkansas",2000,19702,21315,1613,619,463,1743,51504,2111,53247,48311,05033
127,05035,"Crittenden County, Arkansas",2000,18471,20507,2036,236,23828,720,50146,439,50866,25643,05035
128,05037,"Cross County, Arkansas",2000,7391,8030,639,53,4608,181,19345,159,19526,14525,05037
129,05039,"Dallas County, Arkansas",2000,3519,4401,882,21,3743,177,9033,76,9210,5193,05039
130,05041,"Desha County, Arkansas",2000,5922,6663,741,45,7044,485,14856,156,15341,7611,05041
131,05043,"Drew County, Arkansas",2000,7337,8287,950,79,5071,329,18394,197,18723,13047,05043
132,05045,"Faulkner County, Arkansas",2000,31882,34546,2664,609,7261,1509,84505,1417,86014,75218,05045
133,05047,"Franklin County, Arkansas",2000,6882,7673,791,46,108,310,17461,364,17771,16943,05047
134,05049,"Fulton County, Arkansas",2000,4810,5973,1163,23,23,62,11580,208,11642,11326,05049
135,05051,"Garland County, Arkansas",2000,37813,44953,7140,431,6829,2254,85814,1710,88068,76844,05051
136,05053,"Grant County, Arkansas",2000,6241,6960,719,22,406,189,16275,184,16464,15663,05053
137,05055,"Greene County, Arkansas",2000,14750,16161,1411,61,48,434,36897,643,37331,36145,05055
138,05057,"Hempstead County, Arkansas",2000,8959,10166,1207,40,7107,1946,21641,386,23587,14108,05057
139,05059,"Hot Spring County, Arkansas",2000,12004,13384,1380,64,3107,384,29969,503,30353,26295,05059
140,05061,"Howard County, Arkansas",2000,5471,6297,826,71,3111,727,13573,171,14300,10220,05061
141,05063,"Independence County, Arkansas",2000,13467,14841,1374,216,685,523,33710,556,34233,32253,05063
142,05065,"Izard County, Arkansas",2000,5440,6591,1151,13,189,133,13116,212,13249,12702,05065
143,05067,"Jackson County, Arkansas",2000,6971,7956,985,32,3210,234,18184,217,18418,14725,05067
144,05069,"Jefferson County, Arkansas",2000,30555,34350,3795,542,41623,810,83468,828,84278,40475,05069
145,05071,"Johnson County, Arkansas",2000,8738,9926,1188,54,303,1527,21254,385,22781,20512,05071
146,05073,"Lafayette County, Arkansas",2000,3434,4560,1126,19,3106,88,8471,84,8559,5262,05073
147,05075,"Lawrence County, Arkansas",2000,7108,8085,977,9,78,121,17653,261,17774,17305,05075
148,05077,"Lee County, Arkansas",2000,4182,4768,586,32,7142,276,12304,56,12580,5074,05077
149,05079,"Lincoln County, Arkansas",2000,4265,4955,690,9,4760,263,14229,145,14492,9315,05079
150,05081,"Little River County, Arkansas",2000,5465,6435,970,25,2891,235,13393,414,13628,10063,05081
151,05083,"Logan County, Arkansas",2000,8693,9942,1249,33,235,273,22213,417,22486,21528,05083
152,05085,"Lonoke County, Arkansas",2000,19262,20749,1487,212,3393,922,51906,746,52828,47555,05085
153,05087,"Madison County, Arkansas",2000,5463,6537,1074,9,15,436,13807,321,14243,13462,05087
154,05089,"Marion County, Arkansas",2000,6776,8235,1459,32,18,122,16018,322,16140,15646,05089
155,05091,"Miller County, Arkansas",2000,15637,17727,2090,150,9250,641,39802,796,40443,29606,05091
156,05093,"Mississippi County, Arkansas",2000,19349,22310,2961,195,16909,1169,50810,669,51979,33037,05093
157,05095,"Monroe County, Arkansas",2000,4105,5067,962,12,3964,132,10122,143,10254,6003,05095
158,05097,"Montgomery County, Arkansas",2000,3785,5048,1263,34,27,234,9011,210,9245,8740,05097
159,05099,"Nevada County, Arkansas",2000,3893,4751,858,6,3088,151,9804,92,9955,6618,05099
160,05101,"Newton County, Arkansas",2000,3500,4316,816,14,12,93,8515,156,8608,8333,05101
161,05103,"Ouachita County, Arkansas",2000,11613,13450,1837,67,11084,210,28580,315,28790,17114,05103
162,05105,"Perry County, Arkansas",2000,3989,4702,713,13,177,120,10089,188,10209,9711,05105
163,05107,"Phillips County, Arkansas",2000,9711,10859,1148,80,15495,382,26063,243,26445,10245,05107
164,05109,"Pike County, Arkansas",2000,4504,5536,1032,18,391,403,10900,181,11303,10310,05109
165,05111,"Poinsett County, Arkansas",2000,10026,11051,1025,39,1815,366,25248,222,25614,23172,05111
166,05113,"Polk County, Arkansas",2000,8047,9236,1189,42,32,708,19521,611,20229,18836,05113
167,05115,"Pope County, Arkansas",2000,20701,22851,2150,343,1403,1123,53346,1065,54469,50535,05115
168,05117,"Prairie County, Arkansas",2000,3894,4790,896,16,1304,77,9462,82,9539,8060,05117
169,05119,"Pulaski County, Arkansas",2000,147942,161135,13193,4440,114732,8816,352658,6096,361474,227390,05119
170,05121,"Randolph County, Arkansas",2000,7265,8268,1003,13,174,149,18046,300,18195,17559,05121
171,05123,"St. Francis County, Arkansas",2000,10043,11242,1199,161,14273,1431,27898,240,29329,13224,05123
172,05125,"Saline County, Arkansas",2000,31778,33825,2047,469,1814,1090,82439,1188,83529,78968,05125
173,05127,"Scott County, Arkansas",2000,4323,4924,601,104,24,628,10368,287,10996,9953,05127
174,05129,"Searcy County, Arkansas",2000,3523,4292,769,11,3,86,8175,168,8261,7993,05129
175,05131,"Sebastian County, Arkansas",2000,45300,49311,4011,4016,7011,7710,107361,4324,115071,92010,05131
176,05133,"Sevier County, Arkansas",2000,5708,6434,726,21,757,3107,12650,449,15757,11423,05133
177,05135,"Sharp County, Arkansas",2000,7211,9342,2131,21,84,167,16952,344,17119,16503,05135
178,05137,"Stone County, Arkansas",2000,4768,5715,947,6,9,124,11375,268,11499,11092,05137
179,05139,"Union County, Arkansas",2000,17989,20676,2687,173,14543,520,45109,443,45629,29950,05139
180,05141,"Van Buren County, Arkansas",2000,6825,9164,2339,39,50,215,15977,338,16192,15550,05141
181,05143,"Washington County, Arkansas",2000,60151,64330,4179,2396,3408,12932,144783,5611,157715,133368,05143
182,05145,"White County, Arkansas",2000,25148,27613,2465,210,2389,1264,65901,1125,67165,62177,05145
183,05147,"Woodruff County, Arkansas",2000,3531,4089,558,6,2671,69,8672,96,8741,5899,05147
184,05149,"Yell County, Arkansas",2000,7922,9157,1235,144,296,2691,18448,358,21139,17650,05149
185,06001,"Alameda County, California",2000,523366,540183,16817,292673,211124,273910,1169831,74939,1443741,591095,06001
186,06003,"Alpine County, California",2000,483,1514,1031,4,7,94,1114,236,1208,867,06003
187,06005,"Amador County, California",2000,12759,15035,2276,326,1348,3126,31974,1380,35100,28920,06005
188,06007,"Butte County, California",2000,79566,85523,5957,6676,2699,21339,181832,9893,203171,162564,06007
189,06009,"Calaveras County, California",2000,16469,22946,6477,322,300,2765,37789,1702,40554,35465,06009
190,06011,"Colusa County, California",2000,6097,6774,677,220,88,8752,10052,726,18804,9018,06011
191,06013,"Contra Costa County, California",2000,344129,354577,10448,102681,86851,167776,781040,42099,948816,549409,06013
192,06015,"Del Norte County, California",2000,9170,10434,1264,619,1167,3829,23678,2598,27507,19294,06015
193,06017,"El Dorado County, California",2000,58939,71278,12339,3250,745,14566,141733,5013,156299,132725,06017
194,06019,"Fresno County, California",2000,252940,270767,17827,63029,40291,351636,447771,26929,799407,317522,06019
195,06021,"Glenn County, California",2000,9172,9982,810,863,117,7840,18613,1085,26453,16548,06021
196,06023,"Humboldt County, California",2000,51238,55912,4674,2022,1035,8210,118308,12021,126518,103230,06023
197,06025,"Imperial County, California",2000,39384,43891,4507,2446,5148,102817,39544,3182,142361,28768,06025
198,06027,"Inyo County, California",2000,7703,9042,1339,158,20,2257,15688,2158,17945,13352,06027
199,06029,"Kern County, California",2000,208652,231564,22912,21177,37845,254036,407609,21397,661645,327190,06029
200,06031,"Kings County, California",2000,34418,36563,2145,3884,10418,56461,73000,4881,129461,53817,06031
201,06033,"Lake County, California",2000,23974,32528,8554,468,1209,6639,51670,3060,58309,46933,06033
202,06035,"Lassen County, California",2000,9625,12000,2375,244,2976,4681,29147,2034,33828,23893,06035
203,06037,"Los Angeles County, California",2000,3133774,3270909,137135,1124569,901472,4242213,5277125,291470,9519338,2959614,06037
204,06039,"Madera County, California",2000,36155,40387,4232,1480,4710,54515,68594,5013,123109,57391,06039
205,06041,"Marin County, California",2000,100650,104990,4340,11078,6946,27351,219938,7660,247289,194254,06041
206,06043,"Mariposa County, California",2000,6613,8826,2213,120,111,1329,15801,1031,17130,14539,06043
207,06045,"Mendocino County, California",2000,33266,36937,3671,1006,471,14213,72052,5994,86265,64581,06045
208,06047,"Merced County, California",2000,63815,68373,4558,14041,7594,95466,115088,7868,210554,85585,06047
209,06049,"Modoc County, California",2000,3784,4807,1023,58,59,1088,8361,581,9449,7663,06049
210,06051,"Mono County, California",2000,5137,11757,6620,140,53,2274,10579,549,12853,9837,06051
211,06053,"Monterey County, California",2000,121236,131708,10472,23203,14085,187969,213793,14460,401762,162045,06053
212,06055,"Napa County, California",2000,45402,48554,3152,3641,1527,29416,94863,3763,124279,85932,06055
213,06057,"Nevada County, California",2000,36894,44282,7388,702,234,5201,86832,2798,92033,83098,06057
214,06059,"Orange County, California",2000,935287,969484,34197,383810,42639,875579,1970710,85283,2846289,1458978,06059
215,06061,"Placer County, California",2000,93382,107302,13920,7148,1896,24019,224380,8100,248399,207236,06061
216,06063,"Plumas County, California",2000,9000,13386,4386,107,130,1177,19647,937,20824,18473,06063
217,06065,"Riverside County, California",2000,506218,584674,78456,55199,92403,559575,985812,49379,1545387,788831,06065
218,06067,"Sacramento County, California",2000,453602,474814,21212,132601,118073,195890,1027609,70280,1223499,706655,06067
219,06069,"San Benito County, California",2000,15885,16499,614,1173,475,25516,27718,1557,53234,24513,06069
220,06071,"San Bernardino County, California",2000,528594,601369,72775,78154,150201,669387,1040047,59470,1709434,752222,06071
221,06073,"San Diego County, California",2000,994677,1040149,45472,245297,154487,750965,2062868,114251,2813833,1548833,06073
222,06075,"San Francisco County, California",2000,329700,346527,16827,238173,58791,109504,667229,31356,776733,338909,06075
223,06077,"San Joaquin County, California",2000,181629,189160,7531,62126,36139,172073,391525,26258,563598,267002,06077
224,06079,"San Luis Obispo County, California",2000,92739,102275,9536,6342,4743,40196,206485,7560,246681,187840,06079
225,06081,"San Mateo County, California",2000,254103,260576,6473,140313,23778,154708,552453,36007,707161,352355,06081
226,06083,"Santa Barbara County, California",2000,136622,142901,6279,15713,8385,136668,262679,11498,399347,227083,06083
227,06085,"Santa Clara County, California",2000,565863,579329,13466,426771,44475,403401,1279184,63656,1682585,744282,06085
228,06087,"Santa Cruz County, California",2000,91139,98873,7734,8464,2160,68486,187116,9028,255602,167464,06087
229,06089,"Shasta County, California",2000,63426,68810,5384,3014,1179,8998,154258,8968,163256,141097,06089
230,06091,"Sierra County, California",2000,1520,2202,682,5,6,213,3342,121,3555,3210,06091
231,06093,"Siskiyou County, California",2000,18556,21947,3391,523,556,3354,40947,2958,44301,36910,06093
232,06095,"Solano County, California",2000,130403,134513,4110,49399,57597,69598,324944,23666,394542,194282,06095
233,06097,"Sonoma County, California",2000,172403,183153,10750,13786,6116,79511,379103,17515,458614,341686,06097
234,06099,"Stanislaus County, California",2000,145146,150807,5661,18234,10621,141871,305126,20270,446997,256001,06099
235,06101,"Sutter County, California",2000,27033,28319,1286,8771,1418,17529,61401,3680,78930,47532,06101
236,06103,"Tehama County, California",2000,21013,23547,2534,423,279,8871,47168,2494,56039,43972,06103
237,06105,"Trinity County, California",2000,5587,7980,2393,58,54,517,12505,1122,13022,11271,06105
238,06107,"Tulare County, California",2000,110385,119639,9254,11457,5122,186846,181175,10680,368021,153916,06107
239,06109,"Tuolumne County, California",2000,21004,28336,7332,377,1135,4445,50056,2167,54501,46377,06109
240,06111,"Ventura County, California",2000,243234,251712,8478,39452,13490,251734,501463,21072,753197,427449,06111
241,06113,"Yolo County, California",2000,59375,61587,2212,16390,3133,43707,124953,7488,168660,97942,06113
242,06115,"Yuba County, California",2000,20535,22636,2101,4480,1795,10449,49770,4175,60219,39320,06115
243,08001,"Adams County, Colorado",2000,128156,132594,4438,11415,10206,102585,261272,9151,363857,230500,08001
244,08003,"Alamosa County, Colorado",2000,5467,6088,621,112,106,6197,8769,462,14966,8089,08003
245,08005,"Arapahoe County, Colorado",2000,190909,196835,5926,19021,36254,57612,430355,14336,487967,360744,08005
246,08007,"Archuleta County, Colorado",2000,3980,6212,2232,31,31,1659,8239,250,9898,7927,08007
247,08009,"Baca County, Colorado",2000,1905,2364,459,7,1,317,4200,108,4517,4084,08009
248,08011,"Bent County, Colorado",2000,2003,2366,363,31,208,1814,4184,151,5998,3794,08011
249,08013,"Boulder County, Colorado",2000,114680,119900,5220,8834,2393,30456,260832,6093,291288,243512,08013
250,08015,"Chaffee County, Colorado",2000,6584,8392,1808,65,257,1393,14849,353,16242,14174,08015
251,08017,"Cheyenne County, Colorado",2000,880,1105,225,3,9,181,2050,20,2231,2018,08017
252,08019,"Clear Creek County, Colorado",2000,4019,5128,1109,33,26,361,8961,143,9322,8759,08019
253,08021,"Conejos County, Colorado",2000,2980,3886,906,8,9,4949,3451,136,8400,3298,08021
254,08023,"Costilla County, Colorado",2000,1503,2202,699,34,21,2476,1187,99,3663,1033,08023
255,08025,"Crowley County, Colorado",2000,1358,1542,184,45,386,1244,4274,172,5518,3671,08025
256,08027,"Custer County, Colorado",2000,1480,2989,1509,10,12,88,3415,94,3503,3299,08027
257,08029,"Delta County, Colorado",2000,11058,12374,1316,83,135,3171,24663,500,27834,23945,08029
258,08031,"Denver County, Colorado",2000,239235,251435,12200,15137,59921,175704,378932,15877,554636,287997,08031
259,08033,"Dolores County, Colorado",2000,785,1193,408,7,1,71,1773,54,1844,1711,08033
260,08035,"Douglas County, Colorado",2000,60924,63333,2409,4369,1596,8886,166880,3229,175766,157686,08035
261,08037,"Eagle County, Colorado",2000,15148,22111,6963,337,104,9682,31977,644,41659,30892,08037
262,08039,"Elbert County, Colorado",2000,6770,7113,343,70,123,766,19106,402,19872,18511,08039
263,08041,"El Paso County, Colorado",2000,192409,202428,10019,12791,32393,58401,458528,19525,516929,393819,08041
264,08043,"Fremont County, Colorado",2000,15232,17145,1913,224,2439,4776,41369,1298,46145,37408,08043
265,08045,"Garfield County, Colorado",2000,16229,17336,1107,183,128,7300,36491,731,43791,35449,08045
266,08047,"Gilpin County, Colorado",2000,2043,2929,886,33,24,202,4555,121,4757,4377,08047
267,08049,"Grand County, Colorado",2000,5075,10894,5819,82,60,543,11899,180,12442,11577,08049
268,08051,"Gunnison County, Colorado",2000,5649,9135,3486,71,55,700,13256,244,13956,12886,08051
269,08053,"Hinsdale County, Colorado",2000,359,1304,945,2,0,12,778,13,790,763,08053
270,08055,"Huerfano County, Colorado",2000,3082,4599,1517,27,210,2763,5099,272,7862,4590,08055
271,08057,"Jackson County, Colorado",2000,661,1145,484,1,0,103,1474,21,1577,1452,08057
272,08059,"Jefferson County, Colorado",2000,206067,212488,6421,11855,4312,52449,474607,11024,527056,447416,08059
273,08061,"Kiowa County, Colorado",2000,665,817,152,0,8,51,1571,33,1622,1530,08061
274,08063,"Kit Carson County, Colorado",2000,2990,3430,440,26,136,1095,6916,76,8011,6678,08063
275,08065,"Lake County, Colorado",2000,2977,3913,936,22,12,2823,4989,146,7812,4809,08065
276,08067,"La Plata County, Colorado",2000,17342,20765,3423,174,120,4571,39370,2908,43941,36168,08067
277,08069,"Larimer County, Colorado",2000,97164,105392,8228,3840,1511,20811,230683,5173,251494,220159,08069
278,08071,"Las Animas County, Colorado",2000,6173,7629,1456,53,52,6304,8903,411,15207,8387,08071
279,08073,"Lincoln County, Colorado",2000,2058,2406,348,33,298,519,5568,111,6087,5126,08073
280,08075,"Logan County, Colorado",2000,7551,8424,873,77,411,2439,18065,267,20504,17310,08075
281,08077,"Mesa County, Colorado",2000,45823,48427,2604,593,460,11651,104604,2441,116255,101110,08077
282,08079,"Mineral County, Colorado",2000,377,1119,742,0,0,17,814,21,831,793,08079
283,08081,"Moffat County, Colorado",2000,4983,5635,652,42,17,1247,11937,252,13184,11626,08081
284,08083,"Montezuma County, Colorado",2000,9201,10497,1296,47,31,2263,21567,3013,23830,18476,08083
285,08085,"Montrose County, Colorado",2000,13043,14202,1159,130,78,4967,28465,703,33432,27554,08085
286,08087,"Morgan County, Colorado",2000,9539,10410,871,47,57,8473,18698,403,27171,18191,08087
287,08089,"Otero County, Colorado",2000,7920,8813,893,134,111,7642,12669,410,20311,12014,08089
288,08091,"Ouray County, Colorado",2000,1576,2146,570,13,3,152,3590,87,3742,3487,08091
289,08093,"Park County, Colorado",2000,5894,10697,4803,60,67,628,13895,337,14523,13431,08093
290,08095,"Phillips County, Colorado",2000,1781,2014,233,18,9,527,3953,61,4480,3865,08095
291,08097,"Pitkin County, Colorado",2000,6807,10096,3289,161,55,973,13899,204,14872,13479,08097
292,08099,"Prowers County, Colorado",2000,5307,5977,670,49,35,4766,9717,206,14483,9427,08099
293,08101,"Pueblo County, Colorado",2000,54579,58926,4347,847,2391,53710,87762,2900,141472,81624,08101
294,08103,"Rio Blanco County, Colorado",2000,2306,2855,549,15,11,296,5690,118,5986,5546,08103
295,08105,"Rio Grande County, Colorado",2000,4701,6003,1302,25,12,5172,7241,182,12413,7022,08105
296,08107,"Routt County, Colorado",2000,7953,11217,3264,75,23,634,19056,296,19690,18662,08107
297,08109,"Saguache County, Colorado",2000,2300,3087,787,26,1,2678,3239,159,5917,3053,08109
298,08111,"San Juan County, Colorado",2000,269,632,363,1,0,41,517,7,558,509,08111
299,08113,"San Miguel County, Colorado",2000,3015,5197,2182,49,10,439,6155,137,6594,5959,08113
300,08115,"Sedgwick County, Colorado",2000,1165,1387,222,19,9,314,2433,29,2747,2376,08115
301,08117,"Summit County, Colorado",2000,9120,24201,15081,201,157,2306,21242,473,23548,20411,08117
302,08119,"Teller County, Colorado",2000,7993,10362,2369,115,109,718,19837,511,20555,19102,08119
303,08121,"Washington County, Colorado",2000,1989,2307,318,5,2,310,4616,41,4926,4568,08121
304,08123,"Weld County, Colorado",2000,63247,66194,2947,1452,817,48935,132001,3159,180936,126573,08123
305,08125,"Yuma County, Colorado",2000,3800,4295,495,7,10,1268,8573,82,9841,8474,08125
306,09001,"Fairfield County, Connecticut",2000,324232,339466,15234,28473,84724,104835,777732,19383,882567,645152,09001
307,09003,"Hartford County, Connecticut",2000,335098,353022,17924,20535,95157,98968,758215,16726,857183,625797,09003
308,09005,"Litchfield County, Connecticut",2000,71551,79267,7716,2107,1837,3894,178299,2201,182193,172154,09005
309,09007,"Middlesex County, Connecticut",2000,61341,67285,5944,2392,6588,4649,150422,2463,155071,138979,09007
310,09009,"New Haven County, Connecticut",2000,319040,340732,21692,19061,89286,83131,740877,15989,824008,616541,09009
311,09011,"New London County, Connecticut",2000,99835,110674,10839,5026,12760,13236,245852,8524,259088,219542,09011
312,09013,"Tolland County, Connecticut",2000,49431,51570,2139,3069,3480,3873,132491,1928,136364,124014,09013
313,09015,"Windham County, Connecticut",2000,41142,43959,2817,901,1739,7737,101354,2048,109091,96666,09015
314,10001,"Kent County, Delaware",2000,47224,50481,3257,2104,25770,4069,122628,3429,126697,91325,10001
315,10003,"New Castle County, Delaware",2000,188935,199521,10586,12856,99648,26293,473972,7708,500265,353760,10003
316,10005,"Sussex County, Delaware",2000,62577,93070,30493,1150,23017,6915,149723,2668,156638,122888,10005
317,11001,"District of Columbia, District of Columbia",2000,248338,274845,26507,15039,340088,44953,527106,12801,572059,159178,11001
318,12001,"Alachua County, Florida",2000,87509,95113,7604,7630,41597,12493,205462,4418,217955,151817,12001
319,12003,"Baker County, Florida",2000,7043,7592,549,88,3083,419,21840,280,22259,18389,12003
320,12005,"Bay County, Florida",2000,59597,78435,18838,2534,15526,3591,144626,3858,148217,122708,12005
321,12007,"Bradford County, Florida",2000,8497,9605,1108,154,5367,622,25466,386,26088,19559,12007
322,12009,"Brevard County, Florida",2000,198195,222072,23877,7061,39067,21970,454260,9437,476230,398695,12009
323,12011,"Broward County, Florida",2000,654445,741043,86598,36049,325305,271652,1351366,48338,1623018,941674,12011
324,12013,"Calhoun County, Florida",2000,4468,5250,782,69,2028,492,12525,323,13017,10105,12013
325,12015,"Charlotte County, Florida",2000,63864,79758,15894,1194,5992,4667,136960,1711,141627,128063,12015
326,12017,"Citrus County, Florida",2000,52634,62204,9570,886,2712,3141,114944,1518,118085,109828,12017
327,12019,"Clay County, Florida",2000,50243,53748,3505,2754,9243,6059,134755,3171,140814,119587,12019
328,12021,"Collier County, Florida",2000,102973,144536,41563,1527,10999,49296,202081,4038,251377,185517,12021
329,12023,"Columbia County, Florida",2000,20925,23579,2654,372,9522,1546,54967,1015,56513,44058,12023
330,12027,"DeSoto County, Florida",2000,10746,13608,2862,131,4031,8019,24190,324,32209,19704,12027
331,12029,"Dixie County, Florida",2000,5205,7362,2157,34,1231,249,13578,181,13827,12132,12029
332,12031,"Duval County, Florida",2000,303747,329778,26031,20871,214473,31946,746933,16842,778879,494747,12031
333,12033,"Escambia County, Florida",2000,111049,124647,13598,6440,62548,7935,286475,8809,294410,208678,12033
334,12035,"Flagler County, Florida",2000,21294,24452,3158,576,4295,2537,47295,788,49832,41636,12035
335,12037,"Franklin County, Florida",2000,4096,7180,3084,19,1762,268,10789,186,11057,8822,12037
336,12039,"Gadsden County, Florida",2000,15867,17703,1836,105,25632,2782,42305,394,45087,16174,12039
337,12041,"Gilchrist County, Florida",2000,5021,5906,885,22,996,404,14033,203,14437,12812,12041
338,12043,"Glades County, Florida",2000,3852,5790,1938,31,1106,1594,8982,589,10576,7256,12043
339,12045,"Gulf County, Florida",2000,4931,7587,2656,53,2247,270,13062,270,13332,10492,12045
340,12047,"Hamilton County, Florida",2000,4161,4966,805,26,4967,847,12480,151,13327,7336,12047
341,12049,"Hardee County, Florida",2000,8166,9820,1654,71,2165,9611,17327,387,26938,14704,12049
342,12051,"Hendry County, Florida",2000,10850,12294,1444,148,5245,14336,21874,591,36210,15890,12051
343,12053,"Hernando County, Florida",2000,55425,62727,7302,820,5149,6587,124215,1576,130802,116670,12053
344,12055,"Highlands County, Florida",2000,37471,48846,11375,881,7925,10542,76824,1204,87366,66814,12055
345,12057,"Hillsborough County, Florida",2000,391357,425962,34605,21585,144259,179692,819256,20807,998948,632605,12057
346,12059,"Holmes County, Florida",2000,6921,7998,1077,72,1190,358,18206,443,18564,16501,12059
347,12061,"Indian River County, Florida",2000,49137,57902,8765,828,9143,7381,105566,1345,112947,94250,12061
348,12063,"Jackson County, Florida",2000,16620,19490,2870,160,12273,1361,45394,875,46755,32086,12063
349,12065,"Jefferson County, Florida",2000,4695,5251,556,37,4903,290,12612,150,12902,7522,12065
350,12067,"Lafayette County, Florida",2000,2142,2660,518,8,989,642,6380,97,7022,5286,12067
351,12069,"Lake County, Florida",2000,88413,102830,14417,1640,17231,11808,198720,2564,210528,177285,12069
352,12071,"Lee County, Florida",2000,188599,245405,56806,3345,28020,42042,398846,6042,440888,361439,12071
353,12073,"Leon County, Florida",2000,96521,103974,7453,4507,69049,8407,231045,4015,239452,153474,12073
354,12075,"Levy County, Florida",2000,13867,16570,2703,129,3734,1339,33111,594,34450,28654,12075
355,12077,"Liberty County, Florida",2000,2222,3156,934,10,1276,316,6705,186,7021,5233,12077
356,12079,"Madison County, Florida",2000,6629,7836,1207,60,7475,600,18133,220,18733,10378,12079
357,12081,"Manatee County, Florida",2000,112460,138128,25668,2330,21136,24540,239462,3332,264002,212664,12081
358,12083,"Marion County, Florida",2000,106755,122663,15908,1777,29370,15616,243300,3921,258916,208232,12083
359,12085,"Martin County, Florida",2000,55288,65471,10183,745,6482,9506,117225,1257,126731,108741,12085
360,12086,"Miami-Dade County, Florida",2000,776774,852278,75504,30537,427140,1291737,961625,38176,2253362,465772,12086
361,12087,"Monroe County, Florida",2000,35086,51617,16531,645,3567,12553,67036,1362,79589,61462,12087
362,12089,"Nassau County, Florida",2000,21980,25917,3937,251,4436,873,56790,780,57663,51323,12089
363,12091,"Okaloosa County, Florida",2000,66269,78593,12324,4144,15232,7302,163196,5761,170498,138059,12091
364,12093,"Okeechobee County, Florida",2000,12593,15504,2911,228,2796,6684,29226,503,35910,25699,12093
365,12095,"Orange County, Florida",2000,336286,361349,25063,29655,157096,168361,727983,25531,896344,515701,12095
366,12097,"Osceola County, Florida",2000,60977,72293,11316,3721,11075,50727,121766,4178,172493,102792,12097
367,12099,"Palm Beach County, Florida",2000,474175,556428,82253,16881,152433,140675,990509,22711,1131184,798484,12099
368,12101,"Pasco County, Florida",2000,147566,173717,26151,3194,6833,19603,325162,5069,344765,310066,12101
369,12103,"Pinellas County, Florida",2000,414968,481573,66605,18794,81146,42760,878722,16168,921482,762614,12103
370,12105,"Polk County, Florida",2000,187233,226376,39143,4448,64544,45933,437991,7633,483924,361366,12105
371,12107,"Putnam County, Florida",2000,27839,33870,6031,294,11898,4168,66255,976,70423,53087,12107
372,12109,"St. Johns County, Florida",2000,49614,58008,8394,1162,7688,3244,119891,1419,123135,109622,12109
373,12111,"St. Lucie County, Florida",2000,76933,91262,14329,1803,29148,15733,176962,3243,192695,142768,12111
374,12113,"Santa Rosa County, Florida",2000,43793,49119,5326,1498,4899,2968,114775,3459,117743,104919,12113
375,12115,"Sarasota County, Florida",2000,149937,182467,32530,2506,13254,14142,311815,3452,325957,292603,12115
376,12117,"Seminole County, Florida",2000,139572,147079,7507,8992,33688,40731,324465,7103,365196,274682,12117
377,12119,"Sumter County, Florida",2000,20779,25195,4416,216,7202,3356,49989,775,53345,41796,12119
378,12121,"Suwannee County, Florida",2000,13460,15679,2219,165,4177,1703,33141,537,34844,28262,12121
379,12123,"Taylor County, Florida",2000,7176,9646,2470,85,3640,295,18961,419,19256,14817,12123
380,12125,"Union County, Florida",2000,3367,3736,369,33,3038,477,12965,235,13442,9659,12125
381,12127,"Volusia County, Florida",2000,184723,211938,27215,4360,40380,29111,414232,6447,443343,363045,12127
382,12129,"Wakulla County, Florida",2000,8450,9820,1370,56,2586,443,22420,385,22863,19393,12129
383,12131,"Walton County, Florida",2000,16548,29083,12535,175,2801,880,39721,1320,40601,35425,12131
384,12133,"Washington County, Florida",2000,7931,9503,1572,71,2828,483,20490,715,20973,16876,12133
385,13001,"Appling County, Georgia",2000,6606,7854,1248,51,3398,792,16627,125,17419,13053,13001
386,13003,"Atkinson County, Georgia",2000,2717,3171,454,9,1477,1290,6319,73,7609,4760,13003
387,13005,"Bacon County, Georgia",2000,3833,4464,631,28,1562,342,9761,103,10103,8068,13005
388,13007,"Baker County, Georgia",2000,1514,1740,226,0,2038,111,3963,36,4074,1889,13007
389,13009,"Baldwin County, Georgia",2000,14758,17173,2415,442,19324,607,44093,407,44700,23920,13009
390,13011,"Banks County, Georgia",2000,5364,5808,444,87,459,493,13929,127,14422,13256,13011
391,13013,"Barrow County, Georgia",2000,16354,17304,950,1000,4456,1460,44684,685,46144,38543,13013
392,13015,"Bartow County, Georgia",2000,27176,28751,1575,381,6558,2524,73495,912,76019,65644,13015
393,13017,"Ben Hill County, Georgia",2000,6673,7623,950,49,5673,800,16684,144,17484,10818,13017
394,13019,"Berrien County, Georgia",2000,6261,7100,839,47,1843,384,15851,200,16235,13761,13019
395,13021,"Bibb County, Georgia",2000,59667,67194,7527,1632,72503,2023,151864,1467,153887,76262,13021
396,13023,"Bleckley County, Georgia",2000,4372,4866,494,102,2865,107,11559,87,11666,8505,13023
397,13025,"Brantley County, Georgia",2000,5436,6490,1054,13,579,152,14477,173,14629,13712,13025
398,13027,"Brooks County, Georgia",2000,6155,7118,963,38,6429,505,15945,175,16450,9303,13027
399,13029,"Bryan County, Georgia",2000,8089,8675,586,174,3272,465,22952,368,23417,19138,13029
400,13031,"Bulloch County, Georgia",2000,20743,22742,1999,456,16000,1052,54931,477,55983,37998,13031
401,13033,"Burke County, Georgia",2000,7934,8842,908,51,11285,316,21927,255,22243,10336,13033
402,13035,"Butts County, Georgia",2000,6455,7380,925,50,5601,277,19245,228,19522,13366,13035
403,13037,"Calhoun County, Georgia",2000,1962,2305,343,4,3726,189,6131,33,6320,2368,13037
404,13039,"Camden County, Georgia",2000,14705,16958,2253,429,8719,1585,42079,956,43664,31975,13039
405,13043,"Candler County, Georgia",2000,3375,3893,518,26,2576,882,8695,65,9577,6028,13043
406,13045,"Carroll County, Georgia",2000,31568,34067,2499,532,14177,2243,85025,1058,87268,69258,13045
407,13047,"Catoosa County, Georgia",2000,20425,21794,1369,370,661,621,52661,617,53282,51013,13047
408,13049,"Charlton County, Georgia",2000,3342,3859,517,35,2990,81,10201,162,10282,7014,13049
409,13051,"Chatham County, Georgia",2000,89865,99683,9818,3992,93463,5403,226645,3388,232048,125802,13051
410,13053,"Chattahoochee County, Georgia",2000,2932,3316,384,249,4353,1551,13331,548,14882,8181,13053
411,13055,"Chattooga County, Georgia",2000,9577,10677,1100,25,2840,537,24933,292,25470,21776,13055
412,13057,"Cherokee County, Georgia",2000,49495,51937,2442,1127,3483,7695,134208,1980,141903,127618,13057
413,13059,"Clarke County, Georgia",2000,39706,42126,2420,3162,27496,6436,95053,1500,101489,62895,13059
414,13061,"Clay County, Georgia",2000,1347,1925,578,9,2009,32,3325,25,3357,1282,13061
415,13063,"Clayton County, Georgia",2000,82243,86461,4218,10562,120816,17728,218789,4774,236517,82637,13063
416,13065,"Clinch County, Georgia",2000,2512,2837,325,8,2019,54,6824,84,6878,4713,13065
417,13067,"Cobb County, Georgia",2000,227487,237522,10035,18417,112924,46964,560787,11499,607751,417947,13067
418,13069,"Coffee County, Georgia",2000,13354,15610,2256,204,9629,2550,34863,329,37413,24701,13069
419,13071,"Colquitt County, Georgia",2000,15495,17554,2059,89,9812,4554,37499,346,42053,27252,13071
420,13073,"Columbia County, Georgia",2000,31120,33321,2201,2985,9917,2313,86975,1635,89288,72438,13073
421,13075,"Cook County, Georgia",2000,5882,6558,676,62,4565,485,15286,133,15771,10526,13075
422,13077,"Coweta County, Georgia",2000,31442,33182,1740,608,15935,2797,86418,1008,89215,68867,13077
423,13079,"Crawford County, Georgia",2000,4461,4872,411,21,2970,301,12194,166,12495,9037,13079
424,13081,"Crisp County, Georgia",2000,8337,9559,1222,148,9511,382,21614,177,21996,11778,13081
425,13083,"Dade County, Georgia",2000,5633,6224,591,56,96,137,15017,180,15154,14685,13083
426,13085,"Dawson County, Georgia",2000,6069,7163,1094,51,57,254,15745,208,15999,15429,13085
427,13087,"Decatur County, Georgia",2000,10380,11968,1588,86,11227,905,27335,222,28240,15800,13087
428,13089,"DeKalb County, Georgia",2000,249339,261231,11892,26483,358381,52542,613323,13774,665865,214685,13089
429,13091,"Dodge County, Georgia",2000,7062,8186,1124,42,5623,248,18923,116,19171,13142,13091
430,13093,"Dooly County, Georgia",2000,3909,4499,590,49,5679,537,10988,99,11525,5161,13093
431,13095,"Dougherty County, Georgia",2000,35552,39656,4104,544,57521,1292,94773,914,96065,35794,13095
432,13097,"Douglas County, Georgia",2000,32822,34825,2003,1075,16978,2640,89534,1516,92174,69965,13097
433,13099,"Early County, Georgia",2000,4695,5338,643,23,5901,152,12202,119,12354,6159,13099
434,13101,"Echols County, Georgia",2000,1264,1482,218,3,252,739,3015,72,3754,2688,13101
435,13103,"Effingham County, Georgia",2000,13151,14169,1018,168,4853,531,37004,490,37535,31493,13103
436,13105,"Elbert County, Georgia",2000,8004,9136,1132,50,6305,489,20022,162,20511,13505,13105
437,13107,"Emanuel County, Georgia",2000,8045,9419,1374,44,7253,745,21092,132,21837,13663,13107
438,13109,"Evans County, Georgia",2000,3778,4381,603,32,3439,625,9870,66,10495,6333,13109
439,13111,"Fannin County, Georgia",2000,8369,11134,2765,47,22,130,19668,287,19798,19312,13111
440,13113,"Fayette County, Georgia",2000,31524,32726,1202,2183,10383,2582,88681,1295,91263,74820,13113
441,13115,"Floyd County, Georgia",2000,34028,36615,2587,834,11984,4983,85582,1090,90565,71674,13115
442,13117,"Forsyth County, Georgia",2000,34565,36505,1940,771,426,5477,92930,913,98407,90820,13117
443,13119,"Franklin County, Georgia",2000,7888,9303,1415,50,1786,187,20098,198,20285,18064,13119
444,13121,"Fulton County, Georgia",2000,321242,348632,27390,24635,361018,48056,767950,12300,816006,369997,13121
445,13123,"Gilmer County, Georgia",2000,9071,11924,2853,35,51,1815,21641,268,23456,21287,13123
446,13125,"Glascock County, Georgia",2000,1004,1192,188,0,212,12,2544,23,2556,2309,13125
447,13127,"Glynn County, Georgia",2000,27208,32636,5428,406,17711,2019,65549,866,67568,46566,13127
448,13129,"Gordon County, Georgia",2000,16173,17145,972,225,1511,3268,40836,458,44104,38642,13129
449,13131,"Grady County, Georgia",2000,8797,9991,1194,72,7074,1222,22437,337,23659,14954,13131
450,13133,"Greene County, Georgia",2000,5477,6653,1176,36,6356,420,13986,113,14406,7481,13133
451,13135,"Gwinnett County, Georgia",2000,202317,209682,7365,42180,76837,64137,524311,11130,588448,394164,13135
452,13137,"Habersham County, Georgia",2000,13259,14634,1375,664,1551,2750,33152,451,35902,30486,13137
453,13139,"Hall County, Georgia",2000,47381,51046,3665,1820,9900,27242,112035,1373,139277,98942,13139
454,13141,"Hancock County, Georgia",2000,3237,4287,1050,9,7820,54,10022,52,10076,2141,13141
455,13143,"Haralson County, Georgia",2000,9826,10719,893,84,1387,143,25547,277,25690,23799,13143
456,13145,"Harris County, Georgia",2000,8822,10288,1466,118,4597,260,23435,276,23695,18444,13145
457,13147,"Hart County, Georgia",2000,9106,11111,2005,122,4430,196,22801,162,22997,18087,13147
458,13149,"Heard County, Georgia",2000,4043,4512,469,11,1181,116,10896,124,11012,9580,13149
459,13151,"Henry County, Georgia",2000,41373,43166,1793,2062,17435,2692,116649,1602,119341,95550,13151
460,13153,"Houston County, Georgia",2000,40911,44509,3598,1727,27181,3363,107402,2103,110765,76391,13153
461,13155,"Irwin County, Georgia",2000,3644,4149,505,32,2555,202,9729,40,9931,7102,13155
462,13157,"Jackson County, Georgia",2000,15057,16226,1169,397,3197,1249,40340,432,41589,36314,13157
463,13159,"Jasper County, Georgia",2000,4175,4806,631,18,3096,236,11190,112,11426,7964,13159
464,13161,"Jeff Davis County, Georgia",2000,4828,5581,753,56,1904,651,12033,81,12684,9992,13161
465,13163,"Jefferson County, Georgia",2000,6339,7221,882,27,9663,259,17007,102,17266,7215,13163
466,13165,"Jenkins County, Georgia",2000,3214,3907,693,18,3437,287,8288,67,8575,4766,13165
467,13167,"Johnson County, Georgia",2000,3130,3634,504,10,3131,78,8482,34,8560,5307,13167
468,13169,"Jones County, Georgia",2000,8659,9272,613,125,5490,169,23470,206,23639,17649,13169
469,13171,"Lamar County, Georgia",2000,5712,6145,433,59,4806,172,15740,192,15912,10683,13171
470,13173,"Lanier County, Georgia",2000,2593,3011,418,26,1845,126,7115,122,7241,5122,13173
471,13175,"Laurens County, Georgia",2000,17083,19687,2604,361,15417,529,44345,368,44874,28199,13175
472,13177,"Lee County, Georgia",2000,8229,8813,584,208,3823,300,24457,223,24757,20203,13177
473,13179,"Liberty County, Georgia",2000,19383,21977,2594,1053,26025,5022,56588,2266,61610,27244,13179
474,13181,"Lincoln County, Georgia",2000,3251,4514,1263,7,2857,81,8267,82,8348,5321,13181
475,13183,"Long County, Georgia",2000,3574,4232,658,58,2429,870,9434,269,10304,6678,13183
476,13185,"Lowndes County, Georgia",2000,32654,36551,3897,1081,31128,2447,89668,1467,92115,55992,13185
477,13187,"Lumpkin County, Georgia",2000,7537,8263,726,75,306,728,20288,526,21016,19381,13187
478,13189,"McDuffie County, Georgia",2000,7970,8916,946,68,7909,284,20947,175,21231,12795,13189
479,13191,"McIntosh County, Georgia",2000,4202,5735,1533,32,3971,99,10748,138,10847,6607,13191
480,13193,"Macon County, Georgia",2000,4834,5495,661,82,8337,364,13710,107,14074,5184,13193
481,13195,"Madison County, Georgia",2000,9800,10520,720,70,2165,507,25223,275,25730,22713,13195
482,13197,"Marion County, Georgia",2000,2668,3130,462,7,2410,413,6731,132,7144,4182,13197
483,13199,"Meriwether County, Georgia",2000,8248,9211,963,52,9467,191,22343,245,22534,12579,13199
484,13201,"Miller County, Georgia",2000,2487,2770,283,2,1845,44,6339,36,6383,4456,13201
485,13205,"Mitchell County, Georgia",2000,8063,8880,817,61,11423,491,23441,211,23932,11746,13205
486,13207,"Monroe County, Georgia",2000,7719,8425,706,74,6015,281,21476,237,21757,15150,13207
487,13209,"Montgomery County, Georgia",2000,2919,3492,573,16,2251,271,7999,48,8270,5684,13209
488,13211,"Morgan County, Georgia",2000,5558,6128,570,51,4385,248,15209,154,15457,10619,13211
489,13213,"Murray County, Georgia",2000,13286,14320,1034,89,191,2006,34500,330,36506,33890,13213
490,13215,"Muscogee County, Georgia",2000,69819,76182,6363,2789,80720,8372,177919,3742,186291,90668,13215
491,13217,"Newton County, Georgia",2000,21997,23033,1036,444,13690,1157,60844,703,62001,46007,13217
492,13219,"Oconee County, Georgia",2000,9051,9528,477,373,1653,833,25392,254,26225,23112,13219
493,13221,"Oglethorpe County, Georgia",2000,4849,5368,519,30,2476,174,12461,138,12635,9817,13221
494,13223,"Paulding County, Georgia",2000,28089,29274,1185,324,5634,1398,80280,1134,81678,73188,13223
495,13225,"Peach County, Georgia",2000,8436,9093,657,77,10682,998,22670,257,23668,11654,13225
496,13227,"Pickens County, Georgia",2000,8960,10687,1727,52,292,467,22516,275,22983,21897,13227
497,13229,"Pierce County, Georgia",2000,5958,6719,761,25,1691,357,15279,138,15636,13425,13229
498,13231,"Pike County, Georgia",2000,4755,5068,313,51,2019,167,13521,101,13688,11350,13231
499,13233,"Polk County, Georgia",2000,14012,15059,1047,118,5073,2921,35206,331,38127,29684,13233
500,13235,"Pulaski County, Georgia",2000,3407,3944,537,32,3249,270,9318,105,9588,5932,13235
501,13237,"Putnam County, Georgia",2000,7402,10319,2917,125,5603,407,18405,206,18812,12471,13237
502,13239,"Quitman County, Georgia",2000,1047,1773,726,1,1213,13,2585,20,2598,1351,13239
503,13241,"Rabun County, Georgia",2000,6279,10210,3931,57,118,683,14367,169,15050,14023,13241
504,13243,"Randolph County, Georgia",2000,2909,3402,493,12,4609,92,7699,62,7791,3016,13243
505,13245,"Richmond County, Georgia",2000,73920,82312,8392,2949,98584,5545,194230,4037,199775,88660,13245
506,13247,"Rockdale County, Georgia",2000,24052,25082,1030,1339,12670,4182,65929,953,70111,50967,13247
507,13249,"Schley County, Georgia",2000,1435,1612,177,3,1169,89,3677,43,3766,2462,13249
508,13251,"Screven County, Georgia",2000,5797,6853,1056,40,6923,147,15227,82,15374,8182,13251
509,13253,"Seminole County, Georgia",2000,3573,4742,1169,17,3224,347,9022,47,9369,5734,13253
510,13255,"Spalding County, Georgia",2000,21519,23001,1482,388,18076,947,57470,571,58417,38435,13255
511,13257,"Stephens County, Georgia",2000,9951,11652,1701,145,3029,250,25185,338,25435,21673,13257
512,13259,"Stewart County, Georgia",2000,2007,2354,347,9,3201,79,5173,37,5252,1926,13259
513,13261,"Sumter County, Georgia",2000,12025,13700,1675,193,16196,891,32309,248,33200,15672,13261
514,13263,"Talbot County, Georgia",2000,2538,2871,333,18,3974,82,6416,70,6498,2354,13263
515,13265,"Taliaferro County, Georgia",2000,870,1085,215,1,1251,19,2058,19,2077,787,13265
516,13267,"Tattnall County, Georgia",2000,7057,8578,1521,64,6988,1883,20422,152,22305,13218,13267
517,13269,"Taylor County, Georgia",2000,3281,3978,697,16,3736,163,8652,53,8815,4847,13269
518,13271,"Telfair County, Georgia",2000,4140,5083,943,23,4515,215,11579,48,11794,6993,13271
519,13273,"Terrell County, Georgia",2000,4002,4460,458,31,6614,136,10834,88,10970,4101,13273
520,13275,"Thomas County, Georgia",2000,16309,18285,1976,172,16497,734,42003,459,42737,24875,13275
521,13277,"Tift County, Georgia",2000,13919,15411,1492,372,10695,2944,35463,304,38407,24092,13277
522,13279,"Toombs County, Georgia",2000,9877,11371,1494,119,6237,2310,23757,175,26067,17226,13279
523,13281,"Towns County, Georgia",2000,3998,6282,2284,29,12,67,9252,52,9319,9159,13281
524,13283,"Treutlen County, Georgia",2000,2531,2865,334,18,2253,79,6775,41,6854,4463,13283
525,13285,"Troup County, Georgia",2000,21920,23824,1904,340,18650,1004,57775,524,58779,38261,13285
526,13287,"Turner County, Georgia",2000,3435,3916,481,31,3868,244,9260,46,9504,5315,13287
527,13289,"Twiggs County, Georgia",2000,3832,4291,459,11,4589,112,10478,94,10590,5784,13289
528,13291,"Union County, Georgia",2000,7159,10001,2842,40,94,153,17136,165,17289,16837,13291
529,13293,"Upson County, Georgia",2000,10722,11616,894,102,7675,327,27270,222,27597,19271,13293
530,13295,"Walker County, Georgia",2000,23605,25577,1972,165,2300,565,60488,687,61053,57336,13295
531,13297,"Walton County, Georgia",2000,21307,22500,1193,410,8703,1163,59524,680,60687,49731,13297
532,13299,"Ware County, Georgia",2000,13475,15831,2356,166,9907,688,34795,288,35483,24434,13299
533,13301,"Warren County, Georgia",2000,2435,2767,332,8,3755,51,6285,39,6336,2483,13301
534,13303,"Washington County, Georgia",2000,7435,8327,892,55,11233,134,21042,134,21176,9620,13303
535,13305,"Wayne County, Georgia",2000,9324,10827,1503,114,5333,1013,25552,267,26565,19838,13305
536,13307,"Webster County, Georgia",2000,911,1115,204,0,1123,66,2324,15,2390,1186,13307
537,13309,"Wheeler County, Georgia",2000,2011,2447,436,5,2045,219,5960,44,6179,3866,13309
538,13311,"White County, Georgia",2000,7731,9454,1723,95,432,311,19633,302,19944,18804,13311
539,13313,"Whitfield County, Georgia",2000,29385,30722,1337,736,3066,18419,65106,966,83525,60338,13313
540,13315,"Wilcox County, Georgia",2000,2785,3320,535,14,3091,139,8438,34,8577,5299,13315
541,13317,"Wilkes County, Georgia",2000,4314,5022,708,25,4591,212,10475,101,10687,5758,13317
542,13319,"Wilkinson County, Georgia",2000,3827,4449,622,7,4153,101,10119,66,10220,5893,13319
543,13321,"Worth County, Georgia",2000,8106,9086,980,47,6482,240,21727,199,21967,14999,13321
544,15001,"Hawaii County, Hawaii",2000,52985,62674,9689,38378,602,14111,134566,51363,148677,44223,15001
545,15003,"Honolulu County, Hawaii",2000,286450,315988,29538,396531,19583,58729,817427,225680,876156,175633,15003
546,15005,"Kalawao County, Hawaii",2000,115,172,57,25,0,6,141,83,147,33,15005
547,15007,"Kauai County, Hawaii",2000,20183,25331,5148,20412,163,4803,53660,16801,58463,16284,15007
548,15009,"Maui County, Hawaii",2000,43507,56377,12870,38803,481,10050,118044,37842,128094,40918,15009
549,16001,"Ada County, Idaho",2000,113408,118516,5108,5140,1829,13467,287437,7899,300904,272569,16001
550,16003,"Adams County, Idaho",2000,1421,1982,561,5,2,54,3422,97,3476,3318,16003
551,16005,"Bannock County, Idaho",2000,27192,29102,1910,732,411,3540,72025,3246,75565,67636,16005
552,16007,"Bear Lake County, Idaho",2000,2259,3268,1009,2,6,154,6257,54,6411,6195,16007
553,16009,"Benewah County, Idaho",2000,3580,4238,658,13,11,142,9029,950,9171,8055,16009
554,16011,"Bingham County, Idaho",2000,13317,14303,986,235,52,5550,36185,3074,41735,32824,16011
555,16013,"Blaine County, Idaho",2000,7780,12186,4406,118,12,2030,16961,300,18991,16531,16013
556,16015,"Boise County, Idaho",2000,2616,4349,1733,20,7,228,6442,193,6670,6222,16015
557,16017,"Bonner County, Idaho",2000,14693,19646,4953,98,38,604,36231,889,36835,35206,16017
558,16019,"Bonneville County, Idaho",2000,28753,30484,1731,664,360,5703,76819,1334,82522,74461,16019
559,16021,"Boundary County, Idaho",2000,3707,4095,388,56,9,335,9536,273,9871,9198,16021
560,16023,"Butte County, Idaho",2000,1089,1290,201,7,8,120,2779,58,2899,2706,16023
561,16025,"Camas County, Idaho",2000,396,601,205,2,1,55,936,23,991,910,16025
562,16027,"Canyon County, Idaho",2000,45018,47965,2947,1012,337,24455,106986,3209,131441,102428,16027
563,16029,"Caribou County, Idaho",2000,2560,3188,628,6,3,289,7015,77,7304,6929,16029
564,16031,"Cassia County, Idaho",2000,7060,7862,802,79,16,4013,17403,326,21416,16982,16031
565,16033,"Clark County, Idaho",2000,340,521,181,2,1,350,672,16,1022,653,16033
566,16035,"Clearwater County, Idaho",2000,3456,4144,688,31,13,165,8765,343,8930,8378,16035
567,16037,"Custer County, Idaho",2000,1770,2983,1213,1,0,183,4159,58,4342,4100,16037
568,16039,"Elmore County, Idaho",2000,9092,10527,1435,479,914,3492,25638,1027,29130,23218,16039
569,16041,"Franklin County, Idaho",2000,3476,3872,396,16,10,591,10738,93,11329,10619,16041
570,16043,"Fremont County, Idaho",2000,3885,6890,3005,43,15,1255,10564,186,11819,10320,16043
571,16045,"Gem County, Idaho",2000,5539,5888,349,54,11,1050,14131,304,15181,13762,16045
572,16047,"Gooding County, Idaho",2000,5046,5505,459,33,8,2414,11741,327,14155,11373,16047
573,16049,"Idaho County, Idaho",2000,6084,7537,1453,38,12,243,15268,727,15511,14491,16049
574,16051,"Jefferson County, Idaho",2000,5901,6287,386,43,21,1907,17248,229,19155,16955,16051
575,16053,"Jerome County, Idaho",2000,6298,6713,415,49,21,3150,15192,331,18342,14791,16053
576,16055,"Kootenai County, Idaho",2000,41308,46607,5299,527,176,2528,106157,2884,108685,102570,16055
577,16057,"Latah County, Idaho",2000,13059,13838,779,729,199,740,34195,834,34935,32433,16057
578,16059,"Lemhi County, Idaho",2000,3275,4154,879,14,8,170,7636,162,7806,7452,16059
579,16061,"Lewis County, Idaho",2000,1554,1795,241,14,13,71,3676,222,3747,3427,16061
580,16063,"Lincoln County, Idaho",2000,1447,1651,204,17,4,542,3502,106,4044,3375,16063
581,16065,"Madison County, Idaho",2000,7129,7630,501,153,56,1078,26389,324,27467,25856,16065
582,16067,"Minidoka County, Idaho",2000,6973,7498,525,83,38,5137,15037,364,20174,14552,16067
583,16069,"Nez Perce County, Idaho",2000,15286,16203,917,244,101,721,36689,2464,37410,33880,16069
584,16071,"Oneida County, Idaho",2000,1430,1755,325,6,5,95,4030,33,4125,3986,16071
585,16073,"Owyhee County, Idaho",2000,3710,4452,742,50,7,2459,8185,493,10644,7635,16073
586,16075,"Payette County, Idaho",2000,7371,7949,578,169,19,2453,18125,503,20578,17434,16075
587,16077,"Power County, Idaho",2000,2560,2844,284,24,5,1638,5900,279,7538,5592,16077
588,16079,"Shoshone County, Idaho",2000,5906,7057,1151,32,15,266,13505,411,13771,13047,16079
589,16081,"Teton County, Idaho",2000,2078,2632,554,11,6,705,5294,67,5999,5210,16081
590,16083,"Twin Falls County, Idaho",2000,23853,25595,1742,465,97,6026,58258,1306,64284,56390,16083
591,16085,"Valley County, Idaho",2000,3208,8084,4876,22,2,150,7501,149,7651,7328,16085
592,16087,"Washington County, Idaho",2000,3762,4138,376,103,10,1372,8605,198,9977,8294,16087
593,17001,"Adams County, Illinois",2000,26860,29386,2526,269,2077,567,67710,753,68277,64611,17001
594,17003,"Alexander County, Illinois",2000,3808,4591,783,35,3338,138,9452,111,9590,5968,17003
595,17005,"Bond County, Illinois",2000,6155,6690,535,44,1297,253,17380,198,17633,15841,17005
596,17007,"Boone County, Illinois",2000,14597,15414,817,203,352,5219,36567,476,41786,35536,17007
597,17009,"Brown County, Illinois",2000,2108,2456,348,8,1257,273,6677,44,6950,5368,17009
598,17011,"Bureau County, Illinois",2000,14182,15331,1149,181,110,1732,33771,284,35503,33196,17011
599,17013,"Calhoun County, Illinois",2000,2046,2681,635,9,0,32,5052,42,5084,5001,17013
600,17015,"Carroll County, Illinois",2000,6794,7945,1151,68,90,340,16334,188,16674,15988,17015
601,17017,"Cass County, Illinois",2000,5347,5784,437,38,39,1162,12533,110,13695,12346,17017
602,17019,"Champaign County, Illinois",2000,70597,75280,4683,11553,19881,5203,174466,3889,179669,139143,17019
603,17021,"Christian County, Illinois",2000,13921,14992,1071,131,754,345,35027,221,35372,33921,17021
604,17023,"Clark County, Illinois",2000,6971,7816,845,22,33,54,16954,133,17008,16766,17023
605,17025,"Clay County, Illinois",2000,5839,6394,555,76,16,88,14472,83,14560,14297,17025
606,17027,"Clinton County, Illinois",2000,12754,13805,1051,115,1389,570,34965,241,35535,33220,17027
607,17029,"Coles County, Illinois",2000,21043,22768,1725,413,1208,737,52459,540,53196,50298,17029
608,17031,"Cook County, Illinois",2000,1974181,2096121,121940,257843,1390448,1071740,4305001,98001,5376741,2558709,17031
609,17033,"Crawford County, Illinois",2000,7842,8785,943,70,920,351,20101,186,20452,18925,17033
610,17035,"Cumberland County, Illinois",2000,4368,4876,508,17,11,68,11185,71,11253,11086,17035
611,17037,"DeKalb County, Illinois",2000,31674,32988,1314,2067,4040,5830,83139,1260,88969,75772,17037
612,17039,"De Witt County, Illinois",2000,6770,7282,512,46,81,213,16585,155,16798,16303,17039
613,17041,"Douglas County, Illinois",2000,7574,8005,431,49,59,690,19232,131,19922,18993,17041
614,17043,"DuPage County, Illinois",2000,325601,335621,10020,70908,26977,81366,822795,12944,904161,711966,17043
615,17045,"Edgar County, Illinois",2000,7874,8611,737,34,362,154,19550,102,19704,19052,17045
616,17047,"Edwards County, Illinois",2000,2905,3199,294,25,10,32,6939,35,6971,6869,17047
617,17049,"Effingham County, Illinois",2000,13001,13959,958,108,55,252,34012,191,34264,33658,17049
618,17051,"Fayette County, Illinois",2000,8146,9053,907,37,1064,174,21628,141,21802,20386,17051
619,17053,"Ford County, Illinois",2000,5639,6060,421,46,35,176,14065,99,14241,13885,17053
620,17055,"Franklin County, Illinois",2000,16408,18105,1697,68,57,249,38769,321,39018,38323,17055
621,17057,"Fulton County, Illinois",2000,14877,16240,1363,92,1369,478,37772,243,38250,36068,17057
622,17059,"Gallatin County, Illinois",2000,2726,3071,345,4,16,56,6389,61,6445,6308,17059
623,17061,"Greene County, Illinois",2000,5757,6332,575,13,109,77,14684,120,14761,14442,17061
624,17063,"Grundy County, Illinois",2000,14293,15040,747,112,67,1552,35983,302,37535,35502,17063
625,17065,"Hamilton County, Illinois",2000,3462,3983,521,11,57,55,8566,64,8621,8434,17065
626,17067,"Hancock County, Illinois",2000,8069,8909,840,46,38,105,20016,152,20121,19780,17067
627,17069,"Hardin County, Illinois",2000,1987,2494,507,24,132,51,4749,39,4800,4554,17069
628,17071,"Henderson County, Illinois",2000,3365,4126,761,8,21,72,8141,71,8213,8041,17071
629,17073,"Henry County, Illinois",2000,20056,21270,1214,127,569,1467,49553,432,51020,48425,17073
630,17075,"Iroquois County, Illinois",2000,12220,13362,1142,87,222,1217,30117,228,31334,29580,17075
631,17077,"Jackson County, Illinois",2000,24215,26844,2629,1799,7694,1443,58169,1231,59612,47445,17077
632,17079,"Jasper County, Illinois",2000,3930,4294,364,19,8,48,10069,39,10117,10003,17079
633,17081,"Jefferson County, Illinois",2000,15374,16990,1616,188,3093,531,39514,524,40045,35709,17081
634,17083,"Jersey County, Illinois",2000,8096,8918,822,54,113,162,21506,191,21668,21148,17083
635,17085,"Jo Daviess County, Illinois",2000,9218,12003,2785,36,41,342,21947,137,22289,21733,17085
636,17087,"Johnson County, Illinois",2000,4183,5046,863,17,1821,368,12510,119,12878,10553,17087
637,17089,"Kane County, Illinois",2000,133901,138998,5097,7142,22477,95924,308195,5186,404119,273390,17089
638,17091,"Kankakee County, Illinois",2000,38182,40610,2428,699,15942,4959,98874,1404,103833,80829,17091
639,17093,"Kendall County, Illinois",2000,18798,19519,721,479,693,4086,50458,609,54544,48677,17093
640,17095,"Knox County, Illinois",2000,22056,23717,1661,382,3472,1896,53940,731,55836,49355,17095
641,17097,"Lake County, Illinois",2000,216297,225919,9622,24866,43580,92716,551640,10226,644356,472968,17097
642,17099,"La Salle County, Illinois",2000,43417,46438,3021,579,1687,5791,105718,1008,111509,102444,17099
643,17101,"Lawrence County, Illinois",2000,6309,7014,705,18,118,137,15315,126,15452,15053,17101
644,17103,"Lee County, Illinois",2000,13253,14310,1057,202,1753,1147,34915,317,36062,32643,17103
645,17105,"Livingston County, Illinois",2000,14374,15297,923,121,2032,1056,38622,324,39678,36145,17105
646,17107,"Logan County, Illinois",2000,11113,11872,759,165,2037,503,30680,231,31183,28247,17107
647,17109,"McDonough County, Illinois",2000,12360,13289,929,662,1126,488,32425,353,32913,30284,17109
648,17111,"McHenry County, Illinois",2000,89403,92908,3505,3734,1379,19602,240475,2336,260077,233026,17111
649,17113,"McLean County, Illinois",2000,56746,59972,3226,3072,9189,3833,146600,2115,150433,132224,17113
650,17115,"Macon County, Illinois",2000,46561,50241,3680,649,16036,1120,113586,1773,114706,95128,17115
651,17117,"Macoupin County, Illinois",2000,19253,21097,1844,88,396,305,48714,402,49019,47828,17117
652,17119,"Madison County, Illinois",2000,101953,108942,6989,1515,18825,3925,255016,3363,258941,231313,17119
653,17121,"Marion County, Illinois",2000,16619,18022,1403,235,1593,378,41313,534,41691,38951,17121
654,17123,"Marshall County, Illinois",2000,5225,5914,689,24,45,138,13042,113,13180,12860,17123
655,17125,"Mason County, Illinois",2000,6389,7033,644,32,19,80,15958,108,16038,15799,17125
656,17127,"Massac County, Illinois",2000,6261,6951,690,38,826,123,15038,212,15161,13962,17127
657,17129,"Menard County, Illinois",2000,4873,5285,412,21,48,94,12392,83,12486,12240,17129
658,17131,"Mercer County, Illinois",2000,6624,7109,485,29,48,216,16741,113,16957,16551,17131
659,17133,"Monroe County, Illinois",2000,10275,10749,474,85,11,203,27416,164,27619,27156,17133
660,17135,"Montgomery County, Illinois",2000,11507,12525,1018,67,1141,326,30326,190,30652,28928,17135
661,17137,"Morgan County, Illinois",2000,14039,15291,1252,167,1950,496,36120,414,36616,33589,17137
662,17139,"Moultrie County, Illinois",2000,5405,5743,338,14,28,68,14219,99,14287,14078,17139
663,17141,"Ogle County, Illinois",2000,19278,20420,1142,209,204,3066,47966,496,51032,47057,17141
664,17143,"Peoria County, Illinois",2000,72733,78204,5471,3010,29320,3827,179606,3344,183433,143932,17143
665,17145,"Perry County, Illinois",2000,8504,9457,953,63,1849,406,22688,213,23094,20563,17145
666,17147,"Piatt County, Illinois",2000,6475,6798,323,20,39,101,16264,115,16365,16090,17147
667,17149,"Pike County, Illinois",2000,6876,8011,1135,41,260,87,17297,128,17384,16868,17149
668,17151,"Pope County, Illinois",2000,1769,2351,582,12,158,40,4373,99,4413,4104,17151
669,17153,"Pulaski County, Illinois",2000,2893,3353,460,68,2249,107,7241,83,7348,4841,17153
670,17155,"Putnam County, Illinois",2000,2415,2888,473,16,37,171,5915,45,6086,5817,17155
671,17157,"Randolph County, Illinois",2000,12084,13328,1244,81,3132,521,33372,299,33893,29860,17157
672,17159,"Richland County, Illinois",2000,6660,7468,808,91,42,124,16025,120,16149,15772,17159
673,17161,"Rock Island County, Illinois",2000,60712,64489,3777,1499,11099,12791,136583,2280,149374,121705,17161
674,17163,"St. Clair County, Illinois",2000,96810,104446,7636,2257,73282,5604,250478,3788,256082,171151,17163
675,17165,"Saline County, Illinois",2000,10992,12360,1368,52,1079,258,26475,309,26733,25035,17165
676,17167,"Sangamon County, Illinois",2000,78722,85459,6737,2067,18134,2000,186951,2783,188951,163967,17167
677,17169,"Schuyler County, Illinois",2000,2975,3304,329,5,16,39,7150,39,7189,7090,17169
678,17171,"Scott County, Illinois",2000,2222,2464,242,7,2,10,5527,21,5537,5497,17171
679,17173,"Shelby County, Illinois",2000,9056,10060,1004,46,35,110,22783,121,22893,22581,17173
680,17175,"Stark County, Illinois",2000,2525,2725,200,12,4,54,6278,49,6332,6213,17175
681,17177,"Stephenson County, Illinois",2000,19785,21713,1928,332,3732,747,48232,764,48979,43404,17177
682,17179,"Tazewell County, Illinois",2000,50327,52973,2646,654,1115,1331,127154,1115,128485,124270,17179
683,17181,"Union County, Illinois",2000,7290,7894,604,48,149,481,17812,208,18293,17407,17181
684,17183,"Vermilion County, Illinois",2000,33406,36349,2943,494,8802,2504,81415,1081,83919,71038,17183
685,17185,"Wabash County, Illinois",2000,5192,5758,566,57,51,95,12842,132,12937,12602,17185
686,17187,"Warren County, Illinois",2000,7166,7787,621,61,296,507,18228,199,18735,17672,17187
687,17189,"Washington County, Illinois",2000,5848,6385,537,27,49,108,15040,118,15148,14846,17189
688,17191,"Wayne County, Illinois",2000,7143,7950,807,58,19,103,17048,118,17151,16853,17191
689,17193,"White County, Illinois",2000,6534,7393,859,25,40,103,15268,170,15371,15033,17193
690,17195,"Whiteside County, Illinois",2000,23684,25025,1341,247,577,5347,55306,536,60653,53946,17195
691,17197,"Will County, Illinois",2000,167542,175524,7982,11021,51980,43768,458498,6974,502266,388523,17197
692,17199,"Williamson County, Illinois",2000,25358,27703,2345,304,1498,763,60533,725,61296,58006,17199
693,17201,"Winnebago County, Illinois",2000,107980,114404,6424,4719,29038,19206,259212,4638,278418,220817,17201
694,17203,"Woodford County, Illinois",2000,12797,13487,690,108,84,241,35228,276,35469,34760,17203
695,18001,"Adams County, Indiana",2000,11818,12404,586,65,43,1118,32507,196,33625,32203,18001
696,18003,"Allen County, Indiana",2000,128745,138905,10160,4597,37149,13877,317972,6494,331849,269732,18003
697,18005,"Bartholomew County, Indiana",2000,27936,29853,1917,1344,1281,1598,69837,790,71435,66422,18005
698,18007,"Benton County, Indiana",2000,3558,3818,260,8,18,245,9176,110,9421,9040,18007
699,18009,"Blackford County, Indiana",2000,5690,6155,465,22,16,83,13965,154,14048,13773,18009
700,18011,"Boone County, Indiana",2000,17081,17929,848,210,157,534,45573,359,46107,44847,18011
701,18013,"Brown County, Indiana",2000,5897,7163,1266,29,32,131,14826,156,14957,14609,18013
702,18015,"Carroll County, Indiana",2000,7718,8675,957,12,36,591,19574,113,20165,19413,18015
703,18017,"Cass County, Indiana",2000,15715,16620,905,204,499,2905,38025,401,40930,36921,18017
704,18019,"Clark County, Indiana",2000,38751,41176,2425,565,6345,1799,94673,1569,96472,86194,18019
705,18021,"Clay County, Indiana",2000,10216,11097,881,28,86,155,26401,249,26556,26038,18021
706,18023,"Clinton County, Indiana",2000,12545,13267,722,63,67,2478,31388,206,33866,31052,18023
707,18025,"Crawford County, Indiana",2000,4181,5138,957,13,16,100,10643,95,10743,10519,18025
708,18027,"Daviess County, Indiana",2000,10894,11898,1004,71,123,620,29200,191,29820,28815,18027
709,18029,"Dearborn County, Indiana",2000,16832,17791,959,122,285,266,45843,388,46109,45048,18029
710,18031,"Decatur County, Indiana",2000,9389,9992,603,177,12,132,24423,142,24555,24092,18031
711,18033,"DeKalb County, Indiana",2000,15134,16144,1010,130,101,676,39609,369,40285,39009,18033
712,18035,"Delaware County, Indiana",2000,47131,51032,3901,778,7906,1304,117465,1713,118769,107068,18035
713,18037,"Dubois County, Indiana",2000,14813,15511,698,74,53,1103,38571,178,39674,38266,18037
714,18039,"Elkhart County, Indiana",2000,66154,69791,3637,1652,9390,16300,166491,3028,182791,152421,18039
715,18041,"Fayette County, Indiana",2000,10199,10981,782,68,428,132,25456,187,25588,24773,18041
716,18043,"Floyd County, Indiana",2000,27511,29087,1576,324,3099,772,70051,976,70823,65652,18043
717,18045,"Fountain County, Indiana",2000,7041,7692,651,32,19,190,17764,114,17954,17599,18045
718,18047,"Franklin County, Indiana",2000,7868,8596,728,41,7,104,22047,137,22151,21862,18047
719,18049,"Fulton County, Indiana",2000,8082,9123,1041,76,154,473,20038,305,20511,19503,18049
720,18051,"Gibson County, Indiana",2000,12847,14125,1278,167,621,229,32271,275,32500,31208,18051
721,18053,"Grant County, Indiana",2000,28319,30560,2241,407,5229,1787,71616,1373,73403,64607,18053
722,18055,"Greene County, Indiana",2000,13372,15053,1681,64,25,268,32889,285,33157,32515,18055
723,18057,"Hamilton County, Indiana",2000,65933,69478,3545,4423,2775,2911,179829,1957,182740,170674,18057
724,18059,"Hancock County, Indiana",2000,20718,21750,1032,203,74,526,54865,433,55391,54155,18059
725,18061,"Harrison County, Indiana",2000,12917,13699,782,70,123,331,33994,283,34325,33518,18061
726,18063,"Hendricks County, Indiana",2000,37275,39229,1954,674,1143,1162,102931,1136,104093,99978,18063
727,18065,"Henry County, Indiana",2000,19486,20592,1106,92,412,387,48121,343,48508,47274,18065
728,18067,"Howard County, Indiana",2000,34800,37604,2804,856,5523,1709,83255,1498,84964,75378,18067
729,18069,"Huntington County, Indiana",2000,14242,15269,1027,113,65,363,37712,378,38075,37156,18069
730,18071,"Jackson County, Indiana",2000,16052,17137,1085,323,217,1112,40223,360,41335,39323,18071
731,18073,"Jasper County, Indiana",2000,10686,11236,550,55,102,733,29310,212,30043,28941,18073
732,18075,"Jay County, Indiana",2000,8405,9074,669,74,54,390,21416,157,21806,21131,18075
733,18077,"Jefferson County, Indiana",2000,12148,13386,1238,186,453,332,31373,413,31705,30321,18077
734,18079,"Jennings County, Indiana",2000,10134,11469,1335,68,205,193,27361,343,27554,26745,18079
735,18081,"Johnson County, Indiana",2000,42434,45095,2661,945,900,1591,113618,934,115209,110839,18081
736,18083,"Knox County, Indiana",2000,15552,17305,1753,202,726,322,38934,339,39256,37667,18083
737,18085,"Kosciusko County, Indiana",2000,27283,32188,4905,408,428,3722,70335,683,74057,68816,18085
738,18087,"LaGrange County, Indiana",2000,11225,12938,1713,84,61,1097,33812,262,34909,33405,18087
739,18089,"Lake County, Indiana",2000,181633,194992,13359,3862,121372,59128,425436,6745,484564,293457,18089
740,18091,"LaPorte County, Indiana",2000,41050,45621,4571,483,11052,3402,106704,1839,110106,93330,18091
741,18093,"Lawrence County, Indiana",2000,18535,20560,2025,129,177,416,45506,489,45922,44711,18093
742,18095,"Madison County, Indiana",2000,53052,56939,3887,460,10437,1993,131365,1594,133358,118874,18095
743,18097,"Marion County, Indiana",2000,352164,387183,35019,12198,206716,33290,827164,15710,860454,592540,18097
744,18099,"Marshall County, Indiana",2000,16519,18099,1580,138,114,2664,42464,451,45128,41761,18099
745,18101,"Martin County, Indiana",2000,4183,4729,546,15,16,42,10327,71,10369,10225,18101
746,18103,"Miami County, Indiana",2000,13716,15299,1583,115,1066,478,35604,863,36082,33560,18103
747,18105,"Monroe County, Indiana",2000,46898,50846,3948,4048,3567,2235,118328,2399,120563,108314,18105
748,18107,"Montgomery County, Indiana",2000,14595,15678,1083,158,281,611,37018,356,37629,36223,18107
749,18109,"Morgan County, Indiana",2000,24437,25908,1471,158,50,490,66199,593,66689,65398,18109
750,18111,"Newton County, Indiana",2000,5340,5726,386,32,24,422,14144,141,14566,13947,18111
751,18113,"Noble County, Indiana",2000,16696,18233,1537,166,172,3299,42976,417,46275,42221,18113
752,18115,"Ohio County, Indiana",2000,2201,2424,223,8,27,25,5598,32,5623,5531,18115
753,18117,"Orange County, Indiana",2000,7621,8348,727,31,113,108,19198,221,19306,18833,18117
754,18119,"Owen County, Indiana",2000,8282,9853,1571,33,52,164,21622,246,21786,21291,18119
755,18121,"Parke County, Indiana",2000,6415,7539,1124,31,368,104,17137,178,17241,16560,18121
756,18123,"Perry County, Indiana",2000,7270,8223,953,22,272,133,18766,127,18899,18345,18123
757,18125,"Pike County, Indiana",2000,5119,5611,492,18,11,74,12763,68,12837,12666,18125
758,18127,"Porter County, Indiana",2000,54649,57616,2967,1327,1314,7079,139719,1744,146798,135334,18127
759,18129,"Posey County, Indiana",2000,10205,11076,871,42,231,118,26943,227,27061,26443,18129
760,18131,"Pulaski County, Indiana",2000,5170,5918,748,28,126,191,13564,116,13755,13294,18131
761,18133,"Putnam County, Indiana",2000,12374,13505,1131,185,1044,412,35607,406,36019,33972,18133
762,18135,"Randolph County, Indiana",2000,10937,11775,838,41,64,333,27068,247,27401,26716,18135
763,18137,"Ripley County, Indiana",2000,9842,10482,640,95,13,247,26276,197,26523,25971,18137
764,18139,"Rush County, Indiana",2000,6923,7337,414,84,108,92,18169,183,18261,17794,18139
765,18141,"St. Joseph County, Indiana",2000,100743,107013,6270,3512,30105,12557,253002,5495,265559,213890,18141
766,18143,"Scott County, Indiana",2000,8832,9737,905,39,10,222,22738,151,22960,22538,18143
767,18145,"Shelby County, Indiana",2000,16561,17633,1072,252,325,497,42948,365,43445,42006,18145
768,18147,"Spencer County, Indiana",2000,7569,8333,764,39,110,303,20088,146,20391,19793,18147
769,18149,"Starke County, Indiana",2000,8740,10201,1461,47,51,514,23042,259,23556,22685,18149
770,18151,"Steuben County, Indiana",2000,12738,17337,4599,132,119,683,32531,349,33214,31931,18151
771,18153,"Sullivan County, Indiana",2000,7819,8804,985,29,928,179,21572,235,21751,20380,18153
772,18155,"Switzerland County, Indiana",2000,3435,4226,791,7,21,78,8987,51,9065,8908,18155
773,18157,"Tippecanoe County, Indiana",2000,55226,58343,3117,6630,3698,7834,141121,2140,148955,128653,18157
774,18159,"Tipton County, Indiana",2000,6469,6848,379,50,22,201,16376,116,16577,16188,18159
775,18161,"Union County, Indiana",2000,2793,3077,284,14,17,22,7327,59,7349,7237,18161
776,18163,"Vanderburgh County, Indiana",2000,70623,76300,5677,1284,14008,1679,170243,2404,171922,152547,18163
777,18165,"Vermillion County, Indiana",2000,6762,7405,643,20,44,107,16681,163,16788,16454,18165
778,18167,"Vigo County, Indiana",2000,40998,45203,4205,1288,6334,1275,104573,1767,105848,95184,18167
779,18169,"Wabash County, Indiana",2000,13215,14034,819,140,139,414,34546,464,34960,33803,18169
780,18171,"Warren County, Indiana",2000,3219,3477,258,15,7,37,8382,42,8419,8318,18171
781,18173,"Warrick County, Indiana",2000,19438,20546,1108,328,516,340,52043,394,52383,50805,18173
782,18175,"Washington County, Indiana",2000,10264,11191,927,43,36,200,27023,195,27223,26749,18175
783,18177,"Wayne County, Indiana",2000,28469,30468,1999,356,3594,971,70126,1209,71097,64967,18177
784,18179,"Wells County, Indiana",2000,10402,10970,568,56,41,397,27203,222,27600,26884,18179
785,18181,"White County, Indiana",2000,9727,12083,2356,62,35,1349,23918,241,25267,23580,18181
786,18183,"Whitley County, Indiana",2000,11711,12545,834,55,57,276,30431,279,30707,30040,18183
787,19001,"Adair County, Iowa",2000,3398,3690,292,19,6,58,8185,45,8243,8115,19001
788,19003,"Adams County, Iowa",2000,1867,2109,242,8,2,26,4456,32,4482,4414,19003
789,19005,"Allamakee County, Iowa",2000,5722,7142,1420,39,21,520,14155,112,14675,13983,19005
790,19007,"Appanoose County, Iowa",2000,5779,6697,918,36,58,135,13586,110,13721,13382,19007
791,19009,"Audubon County, Iowa",2000,2773,2995,222,13,9,33,6797,32,6830,6743,19009
792,19011,"Benton County, Iowa",2000,9746,10377,631,42,50,156,25152,166,25308,24894,19011
793,19013,"Black Hawk County, Iowa",2000,49683,51759,2076,1246,10108,2359,125653,2076,128012,112223,19013
794,19015,"Boone County, Iowa",2000,10374,10968,594,57,79,218,26006,141,26224,25729,19015
795,19017,"Bremer County, Iowa",2000,8860,9337,477,115,110,130,23195,134,23325,22836,19017
796,19019,"Buchanan County, Iowa",2000,7933,8697,764,85,54,131,20962,156,21093,20667,19019
797,19021,"Buena Vista County, Iowa",2000,7499,8145,646,870,61,2560,17851,162,20411,16758,19021
798,19023,"Butler County, Iowa",2000,6175,6578,403,31,13,89,15216,86,15305,15086,19023
799,19025,"Calhoun County, Iowa",2000,4513,5219,706,20,76,100,11015,70,11115,10849,19025
800,19027,"Carroll County, Iowa",2000,8486,9019,533,72,35,115,21306,80,21421,21119,19027
801,19029,"Cass County, Iowa",2000,6120,6590,470,20,31,101,14583,75,14684,14457,19029
802,19031,"Cedar County, Iowa",2000,7147,7570,423,52,34,171,18016,126,18187,17804,19031
803,19033,"Cerro Gordo County, Iowa",2000,19374,21488,2114,317,358,1291,45156,504,46447,43977,19033
804,19035,"Cherokee County, Iowa",2000,5378,5850,472,56,41,124,12911,65,13035,12749,19035
805,19037,"Chickasaw County, Iowa",2000,5192,5593,401,34,7,82,13013,70,13095,12902,19037
806,19039,"Clarke County, Iowa",2000,3584,3934,350,32,10,369,8764,74,9133,8648,19039
807,19041,"Clay County, Iowa",2000,7259,7828,569,142,30,196,17176,102,17372,16902,19041
808,19043,"Clayton County, Iowa",2000,7375,8619,1244,20,25,142,18536,105,18678,18386,19043
809,19045,"Clinton County, Iowa",2000,20105,21585,1480,269,930,627,49522,601,50149,47722,19045
810,19047,"Crawford County, Iowa",2000,6441,6958,517,83,117,1482,15460,111,16942,15149,19047
811,19049,"Dallas County, Iowa",2000,15584,16529,945,278,281,2199,38551,334,40750,37658,19049
812,19051,"Davis County, Iowa",2000,3207,3530,323,17,13,61,8480,79,8541,8371,19051
813,19053,"Decatur County, Iowa",2000,3337,3833,496,54,79,148,8541,112,8689,8296,19053
814,19055,"Delaware County, Iowa",2000,6834,7682,848,26,12,121,18283,66,18404,18179,19055
815,19057,"Des Moines County, Iowa",2000,17270,18643,1373,245,1488,740,41611,570,42351,39308,19057
816,19059,"Dickinson County, Iowa",2000,7103,11375,4272,29,20,109,16315,102,16424,16164,19059
817,19061,"Dubuque County, Iowa",2000,33690,35505,1815,509,736,1065,88078,813,89143,86020,19061
818,19063,"Emmet County, Iowa",2000,4450,4889,439,33,26,475,10552,69,11027,10424,19063
819,19065,"Fayette County, Iowa",2000,8778,9505,727,83,111,330,21678,157,22008,21327,19065
820,19067,"Floyd County, Iowa",2000,6828,7317,489,71,37,222,16678,104,16900,16466,19067
821,19069,"Franklin County, Iowa",2000,4356,4763,407,17,9,642,10062,36,10704,10000,19069
822,19071,"Fremont County, Iowa",2000,3199,3514,315,17,3,174,7836,58,8010,7758,19071
823,19073,"Greene County, Iowa",2000,4205,4623,418,24,13,172,10194,63,10366,10094,19073
824,19075,"Grundy County, Iowa",2000,4984,5304,320,35,10,72,12297,55,12369,12197,19075
825,19077,"Guthrie County, Iowa",2000,4641,5467,826,16,14,120,11233,74,11353,11129,19077
826,19079,"Hamilton County, Iowa",2000,6692,7082,390,240,38,234,16204,134,16438,15792,19079
827,19081,"Hancock County, Iowa",2000,4795,5164,369,37,7,301,11799,59,12100,11696,19081
828,19083,"Hardin County, Iowa",2000,7628,8318,690,59,111,455,18357,106,18812,18081,19083
829,19085,"Harrison County, Iowa",2000,6115,6602,487,25,13,113,15553,131,15666,15384,19085
830,19087,"Henry County, Iowa",2000,7626,8246,620,382,295,256,20080,249,20336,19154,19087
831,19089,"Howard County, Iowa",2000,3974,4327,353,17,11,55,9877,52,9932,9797,19089
832,19091,"Humboldt County, Iowa",2000,4295,4645,350,24,7,100,10281,62,10381,10188,19091
833,19093,"Ida County, Iowa",2000,3213,3506,293,19,8,37,7800,36,7837,7737,19093
834,19095,"Iowa County, Iowa",2000,6163,6545,382,47,25,152,15519,57,15671,15390,19095
835,19097,"Jackson County, Iowa",2000,8078,8949,871,19,19,121,20175,137,20296,20000,19097
836,19099,"Jasper County, Iowa",2000,14689,15659,970,159,309,375,36838,298,37213,36072,19099
837,19101,"Jefferson County, Iowa",2000,6649,7241,592,275,102,297,15884,178,16181,15329,19101
838,19103,"Johnson County, Iowa",2000,44080,45831,1751,4557,3148,2781,108225,1901,111006,98619,19103
839,19105,"Jones County, Iowa",2000,7560,8126,566,44,356,213,20008,194,20221,19414,19105
840,19107,"Keokuk County, Iowa",2000,4586,5013,427,26,8,61,11339,45,11400,11260,19107
841,19109,"Kossuth County, Iowa",2000,6974,7605,631,59,19,139,17024,79,17163,16867,19109
842,19111,"Lee County, Iowa",2000,15161,16612,1451,150,1050,902,37150,549,38052,35401,19111
843,19113,"Linn County, Iowa",2000,76753,80551,3798,2614,4857,2722,188979,3059,191701,178449,19113
844,19115,"Louisa County, Iowa",2000,4519,5133,614,24,26,1537,10646,67,12183,10529,19115
845,19117,"Lucas County, Iowa",2000,3811,4239,428,27,12,82,9340,63,9422,9238,19117
846,19119,"Lyon County, Iowa",2000,4428,4758,330,14,11,42,11721,59,11763,11637,19119
847,19121,"Madison County, Iowa",2000,5326,5661,335,25,12,105,13914,114,14019,13763,19121
848,19123,"Mahaska County, Iowa",2000,8880,9551,671,191,140,190,22145,205,22335,21609,19123
849,19125,"Marion County, Iowa",2000,12017,12755,738,330,129,257,31795,262,32052,31074,19125
850,19127,"Marshall County, Iowa",2000,15338,16324,986,307,348,3523,35788,493,39311,34640,19127
851,19129,"Mills County, Iowa",2000,5324,5671,347,42,41,179,14368,151,14547,14134,19129
852,19131,"Mitchell County, Iowa",2000,4294,4594,300,18,19,63,10811,22,10874,10752,19131
853,19133,"Monona County, Iowa",2000,4211,4660,449,12,8,70,9950,119,10020,9811,19133
854,19135,"Monroe County, Iowa",2000,3228,3588,360,32,16,40,7976,64,8016,7864,19135
855,19137,"Montgomery County, Iowa",2000,4886,5399,513,29,9,153,11618,91,11771,11489,19137
856,19139,"Muscatine County, Iowa",2000,15847,16786,939,342,271,4973,36749,390,41722,35746,19139
857,19141,"O'Brien County, Iowa",2000,6001,6509,508,75,46,267,14835,91,15102,14623,19141
858,19143,"Osceola County, Iowa",2000,2778,3012,234,14,8,125,6878,44,7003,6812,19143
859,19145,"Page County, Iowa",2000,6708,7302,594,81,277,265,16711,200,16976,16153,19145
860,19147,"Palo Alto County, Iowa",2000,4119,4631,512,31,9,77,10070,74,10147,9956,19147
861,19149,"Plymouth County, Iowa",2000,9372,9880,508,65,67,328,24521,174,24849,24215,19149
862,19151,"Pocahontas County, Iowa",2000,3617,3988,371,15,21,77,8585,59,8662,8490,19151
863,19153,"Polk County, Iowa",2000,149112,156447,7335,9765,17874,16490,358111,6687,374601,323785,19153
864,19155,"Pottawattamie County, Iowa",2000,33844,35761,1917,421,658,2892,84812,1066,87704,82667,19155
865,19157,"Poweshiek County, Iowa",2000,7398,8556,1158,201,101,226,18589,191,18815,18096,19157
866,19159,"Ringgold County, Iowa",2000,2245,2789,544,9,6,13,5456,35,5469,5406,19159
867,19161,"Sac County, Iowa",2000,4746,5460,714,16,29,111,11418,73,11529,11300,19161
868,19163,"Scott County, Iowa",2000,62334,65649,3315,2476,9498,6445,152223,2867,158668,137382,19163
869,19165,"Shelby County, Iowa",2000,5173,5459,286,36,13,88,13085,98,13173,12938,19165
870,19167,"Sioux County, Iowa",2000,10693,11260,567,185,57,808,30781,165,31589,30374,19167
871,19169,"Story County, Iowa",2000,29383,30630,1247,4076,1441,1238,78743,1005,79981,72221,19169
872,19171,"Tama County, Iowa",2000,7018,7583,565,32,44,679,17424,1208,18103,16140,19171
873,19173,"Taylor County, Iowa",2000,2824,3199,375,21,2,265,6693,37,6958,6633,19173
874,19175,"Union County, Iowa",2000,5242,5657,415,31,28,125,12184,81,12309,12044,19175
875,19177,"Van Buren County, Iowa",2000,3181,3581,400,20,5,60,7749,65,7809,7659,19177
876,19179,"Wapello County, Iowa",2000,14784,15873,1089,233,329,799,35252,351,36051,34339,19179
877,19181,"Warren County, Iowa",2000,14708,15289,581,155,106,441,40230,334,40671,39635,19181
878,19183,"Washington County, Iowa",2000,8056,8543,487,51,58,564,20106,159,20670,19838,19183
879,19185,"Wayne County, Iowa",2000,2821,3357,536,10,4,48,6682,54,6730,6614,19185
880,19187,"Webster County, Iowa",2000,15878,16969,1091,266,1339,944,39291,520,40235,37166,19187
881,19189,"Winnebago County, Iowa",2000,4749,5065,316,81,21,237,11486,87,11723,11297,19189
882,19191,"Winneshiek County, Iowa",2000,7734,8208,474,173,108,170,21140,102,21310,20757,19191
883,19193,"Woodbury County, Iowa",2000,39151,41394,2243,2490,2013,9468,94409,3085,103877,86821,19193
884,19195,"Worth County, Iowa",2000,3278,3534,256,11,21,124,7785,60,7909,7693,19195
885,19197,"Wright County, Iowa",2000,5940,6559,619,27,19,706,13628,93,14334,13489,19197
886,20001,"Allen County, Kansas",2000,5775,6449,674,38,233,278,14107,320,14385,13516,20001
887,20003,"Anderson County, Kansas",2000,3221,3596,375,18,25,88,8022,122,8110,7857,20003
888,20005,"Atchison County, Kansas",2000,6275,6818,543,57,883,327,16447,337,16774,15170,20005
889,20007,"Barber County, Kansas",2000,2235,2740,505,5,16,107,5200,74,5307,5105,20007
890,20009,"Barton County, Kansas",2000,11393,12888,1495,60,304,2344,25861,403,28205,25094,20009
891,20011,"Bourbon County, Kansas",2000,6161,7135,974,56,466,199,15180,313,15379,14345,20011
892,20013,"Brown County, Kansas",2000,4318,4815,497,22,161,249,10475,1062,10724,9230,20013
893,20015,"Butler County, Kansas",2000,21527,23176,1649,236,810,1336,58146,1445,59482,55655,20015
894,20017,"Chase County, Kansas",2000,1246,1529,283,3,28,53,2977,36,3030,2910,20017
895,20019,"Chautauqua County, Kansas",2000,1796,2169,373,3,13,59,4300,230,4359,4054,20019
896,20021,"Cherokee County, Kansas",2000,8875,10031,1156,51,137,291,22314,1426,22605,20700,20021
897,20023,"Cheyenne County, Kansas",2000,1360,1636,276,8,1,82,3083,22,3165,3052,20023
898,20025,"Clark County, Kansas",2000,979,1111,132,2,5,96,2294,39,2390,2248,20025
899,20027,"Clay County, Kansas",2000,3617,4084,467,12,50,73,8749,110,8822,8577,20027
900,20029,"Cloud County, Kansas",2000,4163,4838,675,26,34,62,10206,88,10268,10058,20029
901,20031,"Coffey County, Kansas",2000,3489,3876,387,30,21,137,8728,142,8865,8535,20031
902,20033,"Comanche County, Kansas",2000,872,1088,216,1,1,35,1932,24,1967,1906,20033
903,20035,"Cowley County, Kansas",2000,14039,15673,1634,550,971,1304,34987,1375,36291,32091,20035
904,20037,"Crawford County, Kansas",2000,15504,17221,1717,421,671,910,37332,958,38242,35282,20037
905,20039,"Decatur County, Kansas",2000,1494,1821,327,4,17,34,3438,32,3472,3385,20039
906,20041,"Dickinson County, Kansas",2000,7903,8686,783,58,101,445,18899,334,19344,18406,20041
907,20043,"Doniphan County, Kansas",2000,3173,3489,316,21,164,96,8153,193,8249,7775,20043
908,20045,"Douglas County, Kansas",2000,38486,40250,1764,3095,4148,3268,96694,4908,99962,84543,20045
909,20047,"Edwards County, Kansas",2000,1455,1754,299,11,9,335,3114,26,3449,3068,20047
910,20049,"Elk County, Kansas",2000,1412,1860,448,6,7,71,3190,96,3261,3081,20049
911,20051,"Ellis County, Kansas",2000,11193,12078,885,223,173,652,26855,299,27507,26160,20051
912,20053,"Ellsworth County, Kansas",2000,2481,3228,747,16,227,234,6291,94,6525,5954,20053
913,20055,"Finney County, Kansas",2000,12948,13763,815,1148,397,17548,22975,610,40523,20820,20055
914,20057,"Ford County, Kansas",2000,10852,11650,798,656,469,12231,20227,495,32458,18607,20057
915,20059,"Franklin County, Kansas",2000,9452,10229,777,77,287,650,24134,577,24784,23193,20059
916,20061,"Geary County, Kansas",2000,10458,11959,1501,856,6007,2362,25585,1535,27947,17187,20061
917,20063,"Gove County, Kansas",2000,1245,1423,178,3,3,38,3030,35,3068,2989,20063
918,20065,"Graham County, Kansas",2000,1263,1553,290,8,95,23,2923,30,2946,2790,20065
919,20067,"Grant County, Kansas",2000,2742,3027,285,19,9,2742,5167,115,7909,5024,20067
920,20069,"Gray County, Kansas",2000,2045,2181,136,6,10,579,5325,78,5904,5231,20069
921,20071,"Greeley County, Kansas",2000,602,712,110,1,2,177,1357,16,1534,1338,20071
922,20073,"Greenwood County, Kansas",2000,3234,4273,1039,8,11,132,7541,170,7673,7352,20073
923,20075,"Hamilton County, Kansas",2000,1054,1211,157,15,13,550,2120,33,2670,2059,20075
924,20077,"Harper County, Kansas",2000,2773,3270,497,9,15,70,6466,120,6536,6322,20077
925,20079,"Harvey County, Kansas",2000,12581,13378,797,169,502,2620,30249,605,32869,28973,20079
926,20081,"Haskell County, Kansas",2000,1481,1639,158,27,7,1015,3292,70,4307,3188,20081
927,20083,"Hodgeman County, Kansas",2000,796,945,149,0,19,56,2029,18,2085,1992,20083
928,20085,"Jackson County, Kansas",2000,4727,5094,367,20,66,189,12468,1038,12657,11344,20085
929,20087,"Jefferson County, Kansas",2000,6830,7491,661,30,65,236,18190,412,18426,17683,20087
930,20089,"Jewell County, Kansas",2000,1695,2103,408,2,1,27,3764,38,3791,3723,20089
931,20091,"Johnson County, Kansas",2000,174570,181612,7042,12697,11568,17957,433129,7436,451086,401428,20091
932,20093,"Kearny County, Kansas",2000,1542,1657,115,14,20,1203,3328,71,4531,3223,20093
933,20095,"Kingman County, Kansas",2000,3371,3852,481,20,17,125,8548,143,8673,8368,20095
934,20097,"Kiowa County, Kansas",2000,1365,1643,278,9,7,67,3211,40,3278,3155,20097
935,20099,"Labette County, Kansas",2000,9194,10306,1112,68,1050,700,22135,974,22835,20043,20099
936,20101,"Lane County, Kansas",2000,910,1065,155,2,0,31,2124,31,2155,2091,20101
937,20103,"Leavenworth County, Kansas",2000,23071,24401,1330,723,7018,2620,66071,1975,68691,56355,20103
938,20105,"Lincoln County, Kansas",2000,1529,1853,324,4,4,37,3541,42,3578,3491,20105
939,20107,"Linn County, Kansas",2000,3807,4720,913,13,57,87,9483,139,9570,9274,20107
940,20109,"Logan County, Kansas",2000,1243,1423,180,6,18,50,2996,41,3046,2931,20109
941,20111,"Lyon County, Kansas",2000,13691,14757,1066,718,785,6010,29925,636,35935,27786,20111
942,20113,"McPherson County, Kansas",2000,11205,11830,625,95,232,573,28981,414,29554,28240,20113
943,20115,"Marion County, Kansas",2000,5114,5882,768,24,63,257,13104,184,13361,12833,20115
944,20117,"Marshall County, Kansas",2000,4458,4999,541,21,24,83,10882,121,10965,10716,20117
945,20119,"Meade County, Kansas",2000,1728,1968,240,10,16,505,4126,81,4631,4019,20119
946,20121,"Miami County, Kansas",2000,10365,10984,619,49,429,451,27900,498,28351,26924,20121
947,20123,"Mitchell County, Kansas",2000,2850,3340,490,19,35,61,6871,85,6932,6732,20123
948,20125,"Montgomery County, Kansas",2000,14903,17207,2304,162,2163,1118,35134,2194,36252,30615,20125
949,20127,"Morris County, Kansas",2000,2539,3160,621,12,21,136,5968,64,6104,5871,20127
950,20129,"Morton County, Kansas",2000,1306,1519,213,37,7,493,3003,68,3496,2891,20129
951,20131,"Nemaha County, Kansas",2000,3959,4340,381,11,51,76,10641,87,10717,10492,20131
952,20133,"Neosho County, Kansas",2000,6739,7461,722,54,140,494,16503,433,16997,15876,20133
953,20135,"Ness County, Kansas",2000,1516,1835,319,3,1,52,3402,29,3454,3369,20135
954,20137,"Norton County, Kansas",2000,2266,2673,407,25,240,141,5812,62,5953,5485,20137
955,20139,"Osage County, Kansas",2000,6490,7018,528,27,36,255,16457,285,16712,16109,20139
956,20141,"Osborne County, Kansas",2000,1940,2419,479,9,3,17,4435,45,4452,4378,20141
957,20143,"Ottawa County, Kansas",2000,2430,2755,325,8,31,80,6083,75,6163,5969,20143
958,20145,"Pawnee County, Kansas",2000,2739,3114,375,39,354,301,6932,116,7233,6423,20145
959,20147,"Phillips County, Kansas",2000,2496,3088,592,26,15,40,5961,52,6001,5868,20147
960,20149,"Pottawatomie County, Kansas",2000,6771,7311,540,57,119,411,17798,334,18209,17288,20149
961,20151,"Pratt County, Kansas",2000,3963,4633,670,44,91,298,9349,119,9647,9095,20151
962,20153,"Rawlins County, Kansas",2000,1269,1565,296,3,9,24,2942,24,2966,2906,20153
963,20155,"Reno County, Kansas",2000,25498,27625,2127,286,1812,3661,61129,1234,64790,57797,20155
964,20157,"Republic County, Kansas",2000,2557,3113,556,7,15,55,5780,40,5835,5718,20157
965,20159,"Rice County, Kansas",2000,4050,4609,559,36,122,604,10157,162,10761,9837,20159
966,20161,"Riley County, Kansas",2000,22137,23397,1260,2001,4221,2872,59971,1795,62843,51954,20161
967,20163,"Rooks County, Kansas",2000,2362,2758,396,11,64,60,5625,64,5685,5486,20163
968,20165,"Rush County, Kansas",2000,1548,1928,380,4,11,37,3514,28,3551,3471,20165
969,20167,"Russell County, Kansas",2000,3207,3871,664,24,36,67,7303,97,7370,7146,20167
970,20169,"Saline County, Kansas",2000,21436,22695,1259,903,1622,3228,50369,1199,53597,46645,20169
971,20171,"Scott County, Kansas",2000,2045,2291,246,6,4,323,4797,41,5120,4746,20171
972,20173,"Sedgwick County, Kansas",2000,176444,191133,14689,15021,40748,36397,416472,14778,452869,345925,20173
973,20175,"Seward County, Kansas",2000,7419,8027,608,638,806,9486,13024,454,22510,11126,20175
974,20177,"Shawnee County, Kansas",2000,68920,73768,4848,1575,14917,12330,157541,5297,169871,135752,20177
975,20179,"Sheridan County, Kansas",2000,1124,1263,139,2,4,41,2772,13,2813,2753,20179
976,20181,"Sherman County, Kansas",2000,2758,3184,426,13,24,571,6189,67,6760,6085,20181
977,20183,"Smith County, Kansas",2000,1953,2326,373,2,5,33,4503,33,4536,4463,20183
978,20185,"Stafford County, Kansas",2000,2010,2458,448,6,7,259,4530,62,4789,4455,20185
979,20187,"Stanton County, Kansas",2000,858,1007,149,3,15,570,1836,38,2406,1780,20187
980,20189,"Stevens County, Kansas",2000,1988,2265,277,12,43,1187,4276,99,5463,4122,20189
981,20191,"Sumner County, Kansas",2000,9888,10877,989,57,175,929,25017,718,25946,24067,20191
982,20193,"Thomas County, Kansas",2000,3226,3562,336,22,35,151,8029,90,8180,7882,20193
983,20195,"Trego County, Kansas",2000,1412,1723,311,16,6,26,3293,41,3319,3230,20195
984,20197,"Wabaunsee County, Kansas",2000,2633,3033,400,10,26,128,6757,93,6885,6628,20197
985,20199,"Wallace County, Kansas",2000,674,791,117,3,11,84,1665,28,1749,1623,20199
986,20201,"Washington County, Kansas",2000,2673,3142,469,3,7,42,6441,51,6483,6380,20201
987,20203,"Wichita County, Kansas",2000,967,1119,152,2,2,466,2065,37,2531,2024,20203
988,20205,"Wilson County, Kansas",2000,4203,4937,734,27,34,173,10159,191,10332,9907,20205
989,20207,"Woodson County, Kansas",2000,1642,2076,434,2,29,52,3736,60,3788,3645,20207
990,20209,"Wyandotte County, Kansas",2000,59700,65892,6192,2513,44328,25257,132625,4250,157882,81534,20209
991,21001,"Adair County, Kentucky",2000,6747,7792,1045,45,434,132,17112,171,17244,16462,21001
992,21003,"Allen County, Kentucky",2000,6910,8057,1147,20,190,147,17653,150,17800,17293,21003
993,21005,"Anderson County, Kentucky",2000,7320,7752,432,19,442,153,18958,146,19111,18351,21005
994,21007,"Ballard County, Kentucky",2000,3395,3837,442,14,238,52,8234,115,8286,7867,21007
995,21009,"Barren County, Kentucky",2000,15346,17095,1749,155,1553,355,37678,308,38033,35662,21009
996,21011,"Bath County, Kentucky",2000,4445,4994,549,2,200,89,10996,94,11085,10700,21011
997,21013,"Bell County, Kentucky",2000,12004,13341,1337,101,720,194,29866,305,30060,28740,21013
998,21015,"Boone County, Kentucky",2000,31258,33351,2093,1083,1276,1702,84289,1059,85991,80871,21015
999,21017,"Bourbon County, Kentucky",2000,7681,8349,668,19,1330,503,18857,223,19360,17285,21017
1000,21019,"Boyd County, Kentucky",2000,20010,21976,1966,146,1224,558,49194,498,49752,47326,21019
1001,21021,"Boyle County, Kentucky",2000,10574,11418,844,155,2669,398,27299,389,27697,24086,21021
1002,21023,"Bracken County, Kentucky",2000,3228,3715,487,5,48,39,8240,57,8279,8130,21023
1003,21025,"Breathitt County, Kentucky",2000,6170,6812,642,47,62,106,15994,88,16100,15797,21025
1004,21027,"Breckinridge County, Kentucky",2000,7324,9890,2566,14,520,134,18514,193,18648,17787,21027
1005,21029,"Bullitt County, Kentucky",2000,22171,23160,989,165,232,383,60853,658,61236,59798,21029
1006,21031,"Butler County, Kentucky",2000,5059,5815,756,22,67,135,12875,102,13010,12684,21031
1007,21033,"Caldwell County, Kentucky",2000,5431,6126,695,21,623,80,12980,105,13060,12231,21033
1008,21035,"Calloway County, Kentucky",2000,13862,16069,2207,443,1200,473,33704,373,34177,31688,21035
1009,21037,"Campbell County, Kentucky",2000,34742,36898,2156,470,1388,765,87851,848,88616,85145,21037
1010,21039,"Carlisle County, Kentucky",2000,2208,2490,282,4,51,44,5307,48,5351,5204,21039
1011,21041,"Carroll County, Kentucky",2000,3940,4439,499,17,196,330,9825,125,10155,9487,21041
1012,21043,"Carter County, Kentucky",2000,10342,11534,1192,29,34,158,26731,174,26889,26494,21043
1013,21045,"Casey County, Kentucky",2000,6260,7242,982,10,51,198,15249,131,15447,15057,21045
1014,21047,"Christian County, Kentucky",2000,24857,27182,2325,636,16896,3494,68771,1993,72265,49246,21047
1015,21049,"Clark County, Kentucky",2000,13015,13749,734,64,1568,393,32751,287,33144,30832,21049
1016,21051,"Clay County, Kentucky",2000,8556,9439,883,28,1151,333,24223,211,24556,22833,21051
1017,21053,"Clinton County, Kentucky",2000,4086,4888,802,4,10,118,9516,52,9634,9450,21053
1018,21055,"Crittenden County, Kentucky",2000,3829,4410,581,8,61,48,9336,77,9384,9190,21055
1019,21057,"Cumberland County, Kentucky",2000,2976,3567,591,3,242,43,7104,66,7147,6793,21057
1020,21059,"Daviess County, Kentucky",2000,36033,38432,2399,374,3962,845,90700,1062,91545,85302,21059
1021,21061,"Edmonson County, Kentucky",2000,4648,6104,1456,8,67,65,11579,96,11644,11408,21061
1022,21063,"Elliott County, Kentucky",2000,2638,3107,469,0,2,40,6708,51,6748,6655,21063
1023,21065,"Estill County, Kentucky",2000,6108,6824,716,5,17,81,15226,102,15307,15102,21065
1024,21067,"Fayette County, Kentucky",2000,108288,116167,7879,6360,34876,8561,251951,4541,260512,206174,21067
1025,21069,"Fleming County, Kentucky",2000,5367,6120,753,23,195,103,13689,112,13792,13359,21069
1026,21071,"Floyd County, Kentucky",2000,16881,18551,1670,99,543,260,42181,257,42441,41282,21071
1027,21073,"Franklin County, Kentucky",2000,19907,21409,1502,343,4442,531,47156,690,47687,41681,21073
1028,21075,"Fulton County, Kentucky",2000,3237,3697,460,24,1792,56,7696,82,7752,5798,21075
1029,21077,"Gallatin County, Kentucky",2000,2902,3362,460,17,125,82,7788,83,7870,7563,21077
1030,21079,"Garrard County, Kentucky",2000,5741,6414,673,6,448,195,14597,96,14792,14047,21079
1031,21081,"Grant County, Kentucky",2000,8175,9306,1131,62,53,232,22152,174,22384,21863,21081
1032,21083,"Graves County, Kentucky",2000,14841,16340,1499,73,1636,888,36140,460,37028,33971,21083
1033,21085,"Grayson County, Kentucky",2000,9596,12802,3206,34,119,186,23867,210,24053,23504,21085
1034,21087,"Green County, Kentucky",2000,4706,5420,714,14,299,109,11409,92,11518,11004,21087
1035,21089,"Greenup County, Kentucky",2000,14536,15977,1441,139,208,204,36687,313,36891,36027,21089
1036,21091,"Hancock County, Kentucky",2000,3215,3600,385,14,71,64,8328,69,8392,8174,21091
1037,21093,"Hardin County, Kentucky",2000,34497,37673,3176,1683,10969,3159,91015,2578,94174,75785,21093
1038,21095,"Harlan County, Kentucky",2000,13291,15017,1726,95,865,216,32986,460,33202,31566,21095
1039,21097,"Harrison County, Kentucky",2000,7012,7660,648,23,452,207,17776,182,17983,17119,21097
1040,21099,"Hart County, Kentucky",2000,6769,8045,1276,19,1069,150,17295,160,17445,16047,21099
1041,21101,"Henderson County, Kentucky",2000,18095,19466,1371,148,3154,433,44396,451,44829,40643,21101
1042,21103,"Henry County, Kentucky",2000,5844,6381,537,41,493,339,14721,153,15060,14034,21103
1043,21105,"Hickman County, Kentucky",2000,2188,2436,248,3,520,54,5208,71,5262,4614,21105
1044,21107,"Hopkins County, Kentucky",2000,18820,20668,1848,155,2876,423,46096,497,46519,42568,21107
1045,21109,"Jackson County, Kentucky",2000,5307,6065,758,2,7,72,13423,92,13495,13322,21109
1046,21111,"Jefferson County, Kentucky",2000,287012,305835,18823,9562,130003,12370,681234,11613,693604,530056,21111
1047,21113,"Jessamine County, Kentucky",2000,13867,14646,779,223,1217,512,38529,489,39041,36600,21113
1048,21115,"Johnson County, Kentucky",2000,9103,10236,1133,59,57,143,23302,168,23445,23018,21115
1049,21117,"Kenton County, Kentucky",2000,59444,63571,4127,874,5782,1669,149795,1824,151464,141315,21117
1050,21119,"Knott County, Kentucky",2000,6717,7579,862,27,129,112,17537,129,17649,17252,21119
1051,21121,"Knox County, Kentucky",2000,12416,13999,1583,50,262,180,31615,333,31795,30970,21121
1052,21123,"Larue County, Kentucky",2000,5275,5860,585,21,470,140,13233,178,13373,12564,21123
1053,21125,"Laurel County, Kentucky",2000,20353,22317,1964,179,324,291,52424,667,52715,51254,21125
1054,21127,"Lawrence County, Kentucky",2000,5954,7040,1086,11,14,64,15505,132,15569,15348,21127
1055,21129,"Lee County, Kentucky",2000,2985,3321,336,7,298,29,7887,72,7916,7510,21129
1056,21131,"Leslie County, Kentucky",2000,4885,5502,617,15,9,77,12324,68,12401,12232,21131
1057,21133,"Letcher County, Kentucky",2000,10085,11405,1320,70,129,110,25167,115,25277,24853,21133
1058,21135,"Lewis County, Kentucky",2000,5422,6173,751,4,29,62,14030,106,14092,13891,21135
1059,21137,"Lincoln County, Kentucky",2000,9206,10127,921,23,582,208,23153,199,23361,22349,21137
1060,21139,"Livingston County, Kentucky",2000,3996,4772,776,3,13,74,9730,106,9804,9608,21139
1061,21141,"Logan County, Kentucky",2000,10506,11875,1369,44,2014,288,26285,305,26573,23922,21141
1062,21143,"Lyon County, Kentucky",2000,2898,4189,1291,14,541,59,8021,65,8080,7401,21143
1063,21145,"McCracken County, Kentucky",2000,27736,30361,2625,336,7099,694,64820,921,65514,56464,21145
1064,21147,"McCreary County, Kentucky",2000,6520,7405,885,3,106,106,16974,194,17080,16671,21147
1065,21149,"McLean County, Kentucky",2000,3984,4392,408,4,36,83,9855,66,9938,9749,21149
1066,21151,"Madison County, Kentucky",2000,27152,29595,2443,505,3138,685,70187,1060,70872,65484,21151
1067,21153,"Magoffin County, Kentucky",2000,5024,5447,423,10,19,56,13276,56,13332,13191,21153
1068,21155,"Marion County, Kentucky",2000,6613,7277,664,78,1650,144,18068,164,18212,16176,21155
1069,21157,"Marshall County, Kentucky",2000,12412,14730,2318,44,36,229,29896,269,30125,29547,21157
1070,21159,"Martin County, Kentucky",2000,4776,5551,775,8,4,78,12500,75,12578,12413,21159
1071,21161,"Mason County, Kentucky",2000,6847,7754,907,62,1200,160,16640,177,16800,15201,21161
1072,21163,"Meade County, Kentucky",2000,9470,10293,823,136,1068,567,25782,528,26349,24050,21163
1073,21165,"Menifee County, Kentucky",2000,2537,3710,1173,2,71,73,6483,54,6556,6356,21165
1074,21167,"Mercer County, Kentucky",2000,8423,9289,866,97,757,265,20552,250,20817,19448,21167
1075,21169,"Metcalfe County, Kentucky",2000,4016,4592,576,7,165,53,9984,93,10037,9719,21169
1076,21171,"Monroe County, Kentucky",2000,4741,5288,547,1,321,170,11586,86,11756,11178,21171
1077,21173,"Montgomery County, Kentucky",2000,8902,9682,780,21,779,259,22295,219,22554,21276,21173
1078,21175,"Morgan County, Kentucky",2000,4752,5487,735,22,605,85,13863,104,13948,13132,21175
1079,21177,"Muhlenberg County, Kentucky",2000,12357,13675,1318,40,1472,232,31607,259,31839,29836,21177
1080,21179,"Nelson County, Kentucky",2000,13953,14934,981,189,2054,395,37082,260,37477,34579,21179
1081,21181,"Nicholas County, Kentucky",2000,2710,3051,341,7,57,37,6776,36,6813,6676,21181
1082,21183,"Ohio County, Kentucky",2000,8899,9909,1010,46,169,231,22685,194,22916,22276,21183
1083,21185,"Oldham County, Kentucky",2000,14856,15541,685,200,1933,602,45576,522,46178,42921,21185
1084,21187,"Owen County, Kentucky",2000,4086,5345,1259,24,118,105,10442,112,10547,10188,21187
1085,21189,"Owsley County, Kentucky",2000,1894,2247,353,2,5,35,4823,31,4858,4785,21189
1086,21191,"Pendleton County, Kentucky",2000,5170,5756,586,14,69,97,14293,96,14390,14114,21191
1087,21193,"Perry County, Kentucky",2000,11460,12741,1281,143,478,154,29236,146,29390,28469,21193
1088,21195,"Pike County, Kentucky",2000,27612,30923,3311,269,309,450,68286,441,68736,67267,21195
1089,21197,"Powell County, Kentucky",2000,5044,5526,482,6,82,88,13149,92,13237,12969,21197
1090,21199,"Pulaski County, Kentucky",2000,22719,27181,4462,201,602,454,55763,503,56217,54457,21199
1091,21201,"Robertson County, Kentucky",2000,866,1034,168,0,1,21,2245,11,2266,2233,21201
1092,21203,"Rockcastle County, Kentucky",2000,6544,7353,809,20,23,102,16480,136,16582,16301,21203
1093,21205,"Rowan County, Kentucky",2000,7927,8985,1058,197,342,235,21859,257,22094,21063,21205
1094,21207,"Russell County, Kentucky",2000,6941,9064,2123,23,92,140,16175,118,16315,15942,21207
1095,21209,"Scott County, Kentucky",2000,12110,12977,867,157,1749,531,32530,457,33061,30167,21209
1096,21211,"Shelby County, Kentucky",2000,12104,12857,753,133,2923,1505,31832,483,33337,28293,21211
1097,21213,"Simpson County, Kentucky",2000,6415,7016,601,89,1670,150,16255,182,16405,14314,21213
1098,21215,"Spencer County, Kentucky",2000,4251,4555,304,10,132,132,11634,115,11766,11377,21215
1099,21217,"Taylor County, Kentucky",2000,9233,10180,947,39,1150,189,22738,207,22927,21342,21217
1100,21219,"Todd County, Kentucky",2000,4569,5121,552,17,1046,199,11772,97,11971,10612,21219
1101,21221,"Trigg County, Kentucky",2000,5215,6698,1483,31,1233,113,12484,173,12597,11047,21221
1102,21223,"Trimble County, Kentucky",2000,3137,3437,300,6,24,111,8014,86,8125,7898,21223
1103,21225,"Union County, Kentucky",2000,5710,6234,524,22,1977,244,15393,194,15637,13200,21225
1104,21227,"Warren County, Kentucky",2000,35365,38350,2985,1251,7913,2466,90056,1516,92522,79376,21227
1105,21229,"Washington County, Kentucky",2000,4121,4542,421,31,817,175,10741,107,10916,9786,21229
1106,21231,"Wayne County, Kentucky",2000,7913,9789,1876,19,287,291,19632,170,19923,19156,21231
1107,21233,"Webster County, Kentucky",2000,5560,6250,690,8,654,268,13852,107,14120,13083,21233
1108,21235,"Whitley County, Kentucky",2000,13780,15288,1508,70,122,249,35616,362,35865,35062,21235
1109,21237,"Wolfe County, Kentucky",2000,2816,3264,448,2,17,36,7029,29,7065,6981,21237
1110,21239,"Woodford County, Kentucky",2000,8893,9374,481,67,1256,695,22513,246,23208,20944,21239
1111,22001,"Acadia Parish, Louisiana",2000,21142,23209,2067,87,10705,538,58323,381,58861,47150,22001
1112,22003,"Allen Parish, Louisiana",2000,8102,9157,1055,142,6175,1146,24294,648,25440,17329,22003
1113,22005,"Ascension Parish, Louisiana",2000,26691,29172,2481,249,15466,1883,74744,651,76627,58378,22005
1114,22007,"Assumption Parish, Louisiana",2000,8239,9635,1396,53,7303,284,23104,183,23388,15565,22007
1115,22009,"Avoyelles Parish, Louisiana",2000,14736,16576,1840,71,12173,404,41077,686,41481,28147,22009
1116,22011,"Beauregard Parish, Louisiana",2000,12104,14501,2397,189,4229,468,32518,587,32986,27513,22011
1117,22013,"Bienville Parish, Louisiana",2000,6108,7830,1722,24,6860,149,15603,112,15752,8607,22013
1118,22015,"Bossier Parish, Louisiana",2000,36628,40286,3658,1216,20347,3063,95247,1983,98310,71701,22015
1119,22017,"Caddo Parish, Louisiana",2000,97974,108296,10322,1718,111984,3750,248411,3182,252161,131527,22017
1120,22019,"Calcasieu Parish, Louisiana",2000,68613,75995,7382,1163,43769,2463,181114,2466,183577,133716,22019
1121,22021,"Caldwell Parish, Louisiana",2000,3941,5035,1094,15,1884,157,10403,108,10560,8396,22021
1122,22023,"Cameron Parish, Louisiana",2000,3592,5336,1744,44,388,215,9776,100,9991,9244,22023
1123,22025,"Catahoula Parish, Louisiana",2000,4082,5351,1269,14,2942,101,10819,78,10920,7785,22025
1124,22027,"Claiborne Parish, Louisiana",2000,6270,7815,1545,14,7925,128,16723,105,16851,8679,22027
1125,22029,"Concordia Parish, Louisiana",2000,7521,9148,1627,47,7573,300,19947,155,20247,12172,22029
1126,22031,"De Soto Parish, Louisiana",2000,9691,11204,1513,27,10691,396,25098,291,25494,14089,22031
1127,22033,"East Baton Rouge Parish, Louisiana",2000,156365,169073,12708,8534,164853,7363,405489,4657,412852,227445,22033
1128,22035,"East Carroll Parish, Louisiana",2000,2969,3303,334,31,6297,112,9309,48,9421,2933,22035
1129,22037,"East Feliciana Parish, Louisiana",2000,6699,7915,1216,48,10012,157,21203,154,21360,10989,22037
1130,22039,"Evangeline Parish, Louisiana",2000,12736,14258,1522,51,10041,368,35066,244,35434,24730,22039
1131,22041,"Franklin Parish, Louisiana",2000,7754,8623,869,39,6692,160,21103,175,21263,14197,22041
1132,22043,"Grant Parish, Louisiana",2000,7073,8531,1458,24,2212,213,18485,390,18698,15859,22043
1133,22045,"Iberia Parish, Louisiana",2000,25381,27844,2463,1401,22451,1101,72165,1191,73266,47122,22045
1134,22047,"Iberville Parish, Louisiana",2000,10674,11953,1279,84,16486,343,32977,205,33320,16202,22047
1135,22049,"Jackson Parish, Louisiana",2000,6086,7338,1252,33,4282,94,15303,101,15397,10887,22049
1136,22051,"Jefferson Parish, Louisiana",2000,176234,187907,11673,13948,103376,32418,423048,7662,455466,298062,22051
1137,22053,"Jefferson Davis Parish, Louisiana",2000,11480,12824,1344,61,5571,312,31123,353,31435,25138,22053
1138,22055,"Lafayette Parish, Louisiana",2000,72372,78122,5750,2041,45149,3320,187183,2231,190503,137762,22055
1139,22057,"Lafourche Parish, Louisiana",2000,32057,35045,2988,596,11287,1284,88690,2870,89974,73937,22057
1140,22059,"La Salle Parish, Louisiana",2000,5291,6273,982,25,1732,117,14165,183,14282,12225,22059
1141,22061,"Lincoln Parish, Louisiana",2000,15235,17000,1765,538,16846,492,42017,427,42509,24206,22061
1142,22063,"Livingston Parish, Louisiana",2000,32630,36212,3582,160,3846,1017,90797,909,91814,85882,22063
1143,22065,"Madison Parish, Louisiana",2000,4469,4979,510,21,8259,288,13440,73,13728,5087,22065
1144,22067,"Morehouse Parish, Louisiana",2000,11382,12711,1329,57,13353,230,30791,166,31021,17215,22067
1145,22069,"Natchitoches Parish, Louisiana",2000,14263,16890,2627,171,14917,566,38514,1069,39080,22357,22069
1146,22071,"Orleans Parish, Louisiana",2000,188251,215091,26840,10919,323392,14826,469848,6666,484674,128871,22071
1147,22073,"Ouachita Parish, Louisiana",2000,55216,60154,4938,932,49270,1747,145503,1288,147250,94013,22073
1148,22075,"Plaquemines Parish, Louisiana",2000,9021,10481,1460,696,6227,433,26324,989,26757,18412,22075
1149,22077,"Pointe Coupee Parish, Louisiana",2000,8397,10297,1900,56,8553,245,22518,189,22763,13720,22077
1150,22079,"Rapides Parish, Louisiana",2000,47120,52038,4918,1071,38298,1739,124598,2170,126337,83059,22079
1151,22081,"Red River Parish, Louisiana",2000,3414,3988,574,9,3899,97,9525,77,9622,5540,22081
1152,22083,"Richland Parish, Louisiana",2000,7490,8335,845,36,7927,227,20754,124,20981,12667,22083
1153,22085,"Sabine Parish, Louisiana",2000,9221,13671,4450,35,3934,642,22817,2122,23459,16726,22085
1154,22087,"St. Bernard Parish, Louisiana",2000,25123,26790,1667,872,5095,3425,63804,1114,67229,56723,22087
1155,22089,"St. Charles Parish, Louisiana",2000,16422,17430,1008,265,12043,1346,46726,517,48072,33901,22089
1156,22091,"St. Helena Parish, Louisiana",2000,3873,5034,1161,10,5480,104,10421,72,10525,4859,22091
1157,22093,"St. James Parish, Louisiana",2000,6992,7605,613,10,10444,130,21086,94,21216,10538,22093
1158,22095,"St. John the Baptist Parish, Louisiana",2000,14283,15532,1249,222,19204,1230,41814,442,43044,21946,22095
1159,22097,"St. Landry Parish, Louisiana",2000,32328,36216,3888,177,36762,794,86906,807,87700,49160,22097
1160,22099,"St. Martin Parish, Louisiana",2000,17164,20245,3081,440,15464,405,48178,461,48583,31813,22099
1161,22101,"St. Mary Parish, Louisiana",2000,19317,21650,2333,854,16945,1152,52348,1498,53500,33051,22101
1162,22103,"St. Tammany Parish, Louisiana",2000,69253,75398,6145,1413,18788,4737,186531,3269,191268,163061,22103
1163,22105,"Tangipahoa Parish, Louisiana",2000,36558,40794,4236,387,28388,1536,99052,977,100588,69300,22105
1164,22107,"Tensas Parish, Louisiana",2000,2416,3359,943,7,3642,83,6535,44,6618,2842,22107
1165,22109,"Terrebonne Parish, Louisiana",2000,35997,39928,3931,836,18517,1631,102872,6971,104503,76548,22109
1166,22111,"Union Parish, Louisiana",2000,8857,10873,2016,58,6355,461,22342,157,22803,15772,22111
1167,22113,"Vermilion Parish, Louisiana",2000,19832,22461,2629,971,7527,742,53065,541,53807,44026,22113
1168,22115,"Vernon Parish, Louisiana",2000,18260,21030,2770,786,8782,3111,49420,2369,52531,37483,22115
1169,22117,"Washington Parish, Louisiana",2000,16467,19106,2639,71,13781,334,43592,344,43926,29396,22117
1170,22119,"Webster Parish, Louisiana",2000,16501,18991,2490,80,13662,378,41453,478,41831,27233,22119
1171,22121,"West Baton Rouge Parish, Louisiana",2000,7663,8370,707,39,7649,313,21288,206,21601,13394,22121
1172,22123,"West Carroll Parish, Louisiana",2000,4458,4980,522,16,2315,166,12148,76,12314,9741,22123
1173,22125,"West Feliciana Parish, Louisiana",2000,3645,4485,840,25,7575,157,14954,91,15111,7263,22125
1174,22127,"Winn Parish, Louisiana",2000,5930,7502,1572,27,5396,147,16747,224,16894,11100,22127
1175,23001,"Androscoggin County, Maine",2000,42028,45960,3932,567,647,988,102805,1532,103793,100059,23001
1176,23003,"Aroostook County, Maine",2000,30356,38719,8363,342,269,441,73497,1577,73938,71309,23003
1177,23005,"Cumberland County, Maine",2000,107989,122600,14611,3671,2690,2526,263086,3810,265612,252915,23005
1178,23007,"Franklin County, Maine",2000,11806,19159,7353,125,70,159,29308,363,29467,28750,23007
1179,23009,"Hancock County, Maine",2000,21864,33945,12081,196,123,336,51455,820,51791,50316,23009
1180,23011,"Kennebec County, Maine",2000,47683,56364,8681,685,384,852,116262,1627,117114,113566,23011
1181,23013,"Knox County, Maine",2000,16608,21612,5004,141,78,225,39393,397,39618,38777,23013
1182,23015,"Lincoln County, Maine",2000,14158,20849,6691,123,56,155,33461,296,33616,32986,23015
1183,23017,"Oxford County, Maine",2000,22314,32295,9981,196,86,292,54463,593,54755,53588,23017
1184,23019,"Penobscot County, Maine",2000,58096,66847,8751,1003,684,882,144037,2889,144919,139461,23019
1185,23021,"Piscataquis County, Maine",2000,7278,13783,6505,46,36,89,17146,263,17235,16801,23021
1186,23023,"Sagadahoc County, Maine",2000,14117,16489,2372,218,307,391,34823,536,35214,33762,23023
1187,23025,"Somerset County, Maine",2000,20496,28222,7726,168,117,234,50654,670,50888,49699,23025
1188,23027,"Waldo County, Maine",2000,14726,18904,4178,71,62,215,36065,550,36280,35382,23027
1189,23029,"Washington County, Maine",2000,14118,21919,7801,101,79,274,33667,1847,33941,31640,23029
1190,23031,"York County, Maine",2000,74563,94234,19671,1361,752,1301,185441,2042,186742,181286,23031
1191,24001,"Allegany County, Maryland",2000,29322,32984,3662,383,3962,571,74359,674,74930,69340,24001
1192,24003,"Anne Arundel County, Maryland",2000,178670,186937,8267,11110,65755,12902,476754,9370,489656,390519,24003
1193,24005,"Baltimore County, Maryland",2000,299877,313734,13857,23845,150456,13774,740518,12327,754292,553890,24005
1194,24009,"Calvert County, Maryland",2000,25447,27576,2129,647,9728,1135,73428,1159,74563,61894,24009
1195,24011,"Caroline County, Maryland",2000,11097,12028,931,163,4368,789,28983,423,29772,24029,24011
1196,24013,"Carroll County, Maryland",2000,52503,54260,1757,1124,3400,1489,149408,1429,150897,143455,24013
1197,24015,"Cecil County, Maryland",2000,31223,34461,3238,590,3321,1306,84645,1188,85951,79546,24015
1198,24017,"Charles County, Maryland",2000,41668,43903,2235,2169,31203,2722,117824,3341,120546,81111,24017
1199,24019,"Dorchester County, Maryland",2000,12706,14681,1975,199,8658,385,30289,315,30674,21117,24019
1200,24021,"Frederick County, Maryland",2000,70060,73017,2957,3235,12253,4664,190613,3159,195277,171966,24021
1201,24023,"Garrett County, Maryland",2000,11476,16761,5285,57,127,131,29715,153,29846,29378,24023
1202,24025,"Harford County, Maryland",2000,79667,83146,3479,3294,20007,4169,214421,3572,218590,187548,24025
1203,24027,"Howard County, Maryland",2000,90043,92818,2775,18977,35353,7490,240352,6012,247842,180010,24027
1204,24029,"Kent County, Maryland",2000,7666,9410,1744,103,3317,546,18651,181,19197,15050,24029
1205,24031,"Montgomery County, Maryland",2000,324565,334632,10067,98281,129371,100604,772737,25767,873341,519318,24031
1206,24033,"Prince George's County, Maryland",2000,286610,302378,15768,30803,498301,57057,744458,20518,801515,194836,24033
1207,24035,"Queen Anne's County, Maryland",2000,15315,16674,1359,229,3537,444,40119,490,40563,35863,24035
1208,24037,"St. Mary's County, Maryland",2000,30642,34081,3439,1538,11908,1720,84491,1709,86211,69336,24037
1209,24039,"Somerset County, Maryland",2000,8361,10092,1731,116,10108,334,24413,375,24747,13814,24039
1210,24041,"Talbot County, Maryland",2000,14307,16500,2193,269,5161,615,33197,311,33812,27456,24041
1211,24043,"Washington County, Maryland",2000,49726,52972,3246,1043,10150,1570,130353,1642,131923,117518,24043
1212,24045,"Wicomico County, Maryland",2000,32218,34401,2183,1459,19583,1842,82802,1208,84644,60552,24045
1213,24047,"Worcester County, Maryland",2000,19694,47360,27666,280,7699,596,45947,533,46543,37435,24047
1214,24510,"Baltimore city, Maryland",2000,257996,300477,42481,9824,417009,11061,640093,11694,651154,201566,24510
1215,25001,"Barnstable County, Massachusetts",2000,94822,147083,52261,1363,3848,3000,219230,6501,222230,207518,25001
1216,25003,"Berkshire County, Massachusetts",2000,56006,66301,10295,1312,2570,2286,132667,1824,134953,126961,25003
1217,25005,"Bristol County, Massachusetts",2000,205411,216918,11507,6673,9788,19242,515436,21037,534678,477938,25005
1218,25007,"Dukes County, Massachusetts",2000,6421,14836,8415,66,346,155,14832,931,14987,13489,25007
1219,25009,"Essex County, Massachusetts",2000,275419,287144,11725,16737,14399,79871,643548,11072,723419,601340,25009
1220,25011,"Franklin County, Massachusetts",2000,29466,31939,2473,734,594,1425,70110,1264,71535,67518,25011
1221,25013,"Hampden County, Massachusetts",2000,175288,185876,10588,5835,34034,69197,387031,7537,456228,339625,25013
1222,25015,"Hampshire County, Massachusetts",2000,55991,58644,2653,5158,2740,5212,147039,2822,152251,136319,25015
1223,25017,"Middlesex County, Massachusetts",2000,561220,576681,15461,91368,46598,66707,1398689,35952,1465396,1224771,25017
1224,25019,"Nantucket County, Massachusetts",2000,3699,9210,5511,60,783,212,9308,190,9520,8275,25019
1225,25021,"Norfolk County, Massachusetts",2000,248827,255154,6327,35643,20106,11990,638318,10836,650308,571733,25021
1226,25023,"Plymouth County, Massachusetts",2000,168361,181524,13163,4306,20449,11537,461285,22420,472822,414110,25023
1227,25025,"Suffolk County, Massachusetts",2000,278722,292520,13798,47970,143817,107031,582776,31454,689807,359535,25025
1228,25027,"Worcester County, Massachusetts",2000,283927,298159,14232,19561,18257,50864,700099,13054,750963,649227,25027
1229,26001,"Alcona County, Michigan",2000,5132,10584,5452,19,19,81,11638,181,11719,11419,26001
1230,26003,"Alger County, Michigan",2000,3785,5964,2179,32,595,99,9763,511,9862,8625,26003
1231,26005,"Allegan County, Michigan",2000,38165,43292,5127,562,1315,6040,99625,1581,105665,96167,26005
1232,26007,"Alpena County, Michigan",2000,12818,15289,2471,102,73,181,31133,332,31314,30626,26007
1233,26009,"Antrim County, Michigan",2000,9222,15090,5868,35,42,284,22826,514,23110,22235,26009
1234,26011,"Arenac County, Michigan",2000,6710,9563,2853,50,309,238,17031,374,17269,16298,26011
1235,26013,"Baraga County, Michigan",2000,3353,4631,1278,23,432,81,8665,1361,8746,6849,26013
1236,26015,"Barry County, Michigan",2000,21035,23876,2841,151,137,831,55924,841,56755,54795,26015
1237,26017,"Bay County, Michigan",2000,43930,46423,2493,522,1343,4308,105849,1865,110157,102119,26017
1238,26019,"Benzie County, Michigan",2000,6500,10312,3812,25,43,233,15765,427,15998,15270,26019
1239,26021,"Berrien County, Michigan",2000,63569,73445,9876,1839,25729,4888,157565,3199,162453,126798,26021
1240,26023,"Branch County, Michigan",2000,16349,19822,3473,179,1187,1365,44422,922,45787,42134,26023
1241,26025,"Calhoun County, Michigan",2000,54100,58691,4591,1516,14912,4351,133634,3483,137985,113723,26025
1242,26027,"Cass County, Michigan",2000,19676,23884,4208,268,3107,1233,49871,1427,51104,45069,26027
1243,26029,"Charlevoix County, Michigan",2000,10400,15370,4970,59,42,272,25818,727,26090,24990,26029
1244,26031,"Cheboygan County, Michigan",2000,10835,16583,5748,52,62,202,26246,1185,26448,24947,26031
1245,26033,"Chippewa County, Michigan",2000,13474,19430,5956,174,2088,599,37944,6695,38543,28987,26033
1246,26035,"Clare County, Michigan",2000,12686,22229,9543,78,100,340,30912,524,31252,30210,26035
1247,26037,"Clinton County, Michigan",2000,23653,24630,977,333,401,1688,63065,915,64753,61416,26037
1248,26039,"Crawford County, Michigan",2000,5625,10042,4417,36,213,142,14131,222,14273,13660,26039
1249,26041,"Delta County, Michigan",2000,15836,19223,3387,120,35,187,38333,1387,38520,36791,26041
1250,26043,"Dickinson County, Michigan",2000,11386,13702,2316,108,32,187,27285,351,27472,26794,26043
1251,26045,"Eaton County, Michigan",2000,40167,42118,1951,1150,5397,3323,100332,1890,103655,91895,26045
1252,26047,"Emmet County, Michigan",2000,12577,18554,5977,133,142,285,31152,1394,31437,29483,26047
1253,26049,"Genesee County, Michigan",2000,169825,183630,13805,3487,88356,10152,425989,11010,436141,323136,26049
1254,26051,"Gladwin County, Michigan",2000,10561,16828,6267,69,32,249,25774,417,26023,25256,26051
1255,26053,"Gogebic County, Michigan",2000,7425,10839,3414,40,299,153,17217,581,17370,16297,26053
1256,26055,"Grand Traverse County, Michigan",2000,30396,34842,4446,382,295,1155,76499,1564,77654,74258,26055
1257,26057,"Gratiot County, Michigan",2000,14501,15516,1015,144,1554,1875,40410,688,42285,38024,26057
1258,26059,"Hillsdale County, Michigan",2000,17335,20189,2854,151,197,558,45969,579,46527,45042,26059
1259,26061,"Houghton County, Michigan",2000,13793,17748,3955,643,334,251,35765,549,36016,34239,26061
1260,26063,"Huron County, Michigan",2000,14597,20430,5833,126,69,591,35488,370,36079,34923,26063
1261,26065,"Ingham County, Michigan",2000,108593,115056,6463,10204,29712,16190,263130,8529,279320,214685,26065
1262,26067,"Ionia County, Michigan",2000,20606,22006,1400,194,2759,1711,59807,1105,61518,55749,26067
1263,26069,"Iosco County, Michigan",2000,11727,20432,8705,123,106,269,27070,514,27339,26327,26069
1264,26071,"Iron County, Michigan",2000,5748,8772,3024,26,144,84,13054,283,13138,12601,26071
1265,26073,"Isabella County, Michigan",2000,22425,24528,2103,877,1211,1419,61932,2550,63351,57294,26073
1266,26075,"Jackson County, Michigan",2000,58168,62906,4738,835,12396,3493,154929,3170,158422,138528,26075
1267,26077,"Kalamazoo County, Michigan",2000,93479,99250,5771,4343,22968,6311,232292,5801,238603,199180,26077
1268,26079,"Kalkaska County, Michigan",2000,6428,10822,4394,37,34,142,16429,295,16571,16063,26079
1269,26081,"Kent County, Michigan",2000,212890,224000,11110,10577,49994,40183,534152,12419,574335,461162,26081
1270,26083,"Keweenaw County, Michigan",2000,998,2327,1329,2,79,18,2283,25,2301,2177,26083
1271,26085,"Lake County, Michigan",2000,4704,13498,8794,17,1252,191,11142,362,11333,9511,26085
1272,26087,"Lapeer County, Michigan",2000,30729,32732,2003,331,709,2731,85173,1135,87904,82998,26087
1273,26089,"Leelanau County, Michigan",2000,8436,13297,4861,48,49,694,20425,904,21119,19424,26089
1274,26091,"Lenawee County, Michigan",2000,35930,39769,3839,439,2033,6884,92006,1346,98890,88188,26091
1275,26093,"Livingston County, Michigan",2000,55384,58919,3535,896,716,1953,154998,2216,156951,151170,26093
1276,26095,"Luce County, Michigan",2000,2481,4008,1527,24,505,123,6901,585,7024,5787,26095
1277,26097,"Mackinac County, Michigan",2000,5067,9413,4346,34,23,107,11836,2273,11943,9506,26097
1278,26099,"Macomb County, Michigan",2000,309203,320276,11073,16743,21151,12435,775714,15938,788149,721882,26099
1279,26101,"Manistee County, Michigan",2000,9860,14272,4412,77,388,639,23888,642,24527,22781,26101
1280,26103,"Marquette County, Michigan",2000,25767,32877,7110,314,846,444,64190,1825,64634,61205,26103
1281,26105,"Mason County, Michigan",2000,11406,16063,4657,78,200,852,27422,568,28274,26576,26105
1282,26107,"Mecosta County, Michigan",2000,14915,19593,4678,346,1450,520,40033,978,40553,37259,26107
1283,26109,"Menominee County, Michigan",2000,10529,13639,3110,54,25,190,25136,787,25326,24270,26109
1284,26111,"Midland County, Michigan",2000,31769,33796,2027,1225,857,1287,81587,1172,82874,78333,26111
1285,26113,"Missaukee County, Michigan",2000,5450,8621,3171,35,27,169,14309,217,14478,14030,26113
1286,26115,"Monroe County, Michigan",2000,53772,56471,2699,674,2686,3110,142835,2084,145945,137391,26115
1287,26117,"Montcalm County, Michigan",2000,22079,25900,3821,154,1308,1394,59872,1097,61266,57313,26117
1288,26119,"Montmorency County, Michigan",2000,4455,9238,4783,9,25,67,10248,120,10315,10094,26119
1289,26121,"Muskegon County, Michigan",2000,63330,68556,5226,711,23971,6001,164199,4138,170200,135379,26121
1290,26123,"Newaygo County, Michigan",2000,17599,23202,5603,138,519,1845,46029,864,47874,44508,26123
1291,26125,"Oakland County, Michigan",2000,471115,492006,20891,49212,119708,28999,1165157,24485,1194156,971752,26125
1292,26127,"Oceana County, Michigan",2000,9778,15009,5231,66,77,3119,23754,545,26873,23066,26127
1293,26129,"Ogemaw County, Michigan",2000,8842,15404,6562,81,28,252,21393,378,21645,20906,26129
1294,26131,"Ontonagon County, Michigan",2000,3456,5404,1948,14,2,58,7760,177,7818,7567,26131
1295,26133,"Osceola County, Michigan",2000,8861,12853,3992,48,79,230,22967,379,23197,22461,26133
1296,26135,"Oscoda County, Michigan",2000,3921,8690,4769,6,8,89,9329,153,9418,9162,26135
1297,26137,"Otsego County, Michigan",2000,8995,13375,4380,79,42,175,23126,402,23301,22603,26137
1298,26139,"Ottawa County, Michigan",2000,81662,86856,5194,4940,2380,16692,221622,3244,238314,211058,26139
1299,26141,"Presque Isle County, Michigan",2000,6155,9910,3755,22,37,79,14332,194,14411,14079,26141
1300,26143,"Roscommon County, Michigan",2000,11250,23109,11859,49,81,204,25265,340,25469,24795,26143
1301,26145,"Saginaw County, Michigan",2000,80430,85505,5075,1648,38675,14075,195964,3664,210039,151977,26145
1302,26147,"St. Clair County, Michigan",2000,62072,67107,5035,637,3381,3593,160642,2731,164235,153893,26147
1303,26149,"St. Joseph County, Michigan",2000,23381,26503,3122,353,1561,2488,59934,1026,62422,56994,26149
1304,26151,"Sanilac County, Michigan",2000,16871,21314,4443,113,120,1239,43308,557,44547,42518,26151
1305,26153,"Schoolcraft County, Michigan",2000,3606,5700,2094,37,140,83,8820,797,8903,7846,26153
1306,26155,"Shiawassee County, Michigan",2000,26896,29087,2191,199,135,1295,70392,1042,71687,69016,26155
1307,26157,"Tuscola County, Michigan",2000,21454,23378,1924,175,613,1342,56924,936,58266,55200,26157
1308,26159,"Van Buren County, Michigan",2000,27982,33975,5993,226,3939,5634,70629,1998,76263,64466,26159
1309,26161,"Washtenaw County, Michigan",2000,125327,131069,5742,20270,39326,8839,314056,9427,322895,245033,26161
1310,26163,"Wayne County, Michigan",2000,768440,826145,57705,34837,864627,77207,1983955,55507,2061162,1028984,26163
1311,26165,"Wexford County, Michigan",2000,11824,14872,3048,126,54,307,30177,528,30484,29469,26165
1312,27001,"Aitkin County, Minnesota",2000,6644,14168,7524,27,31,92,15209,453,15301,14698,27001
1313,27003,"Anoka County, Minnesota",2000,106428,108091,1663,5010,4683,4961,293123,6844,298084,276586,27003
1314,27005,"Becker County, Minnesota",2000,11844,16612,4768,108,54,230,29770,2909,30000,26699,27005
1315,27007,"Beltrami County, Minnesota",2000,14337,16989,2652,223,139,394,39256,8651,39650,30243,27007
1316,27009,"Benton County, Minnesota",2000,13065,13460,395,390,262,307,33919,499,34226,32768,27009
1317,27011,"Big Stone County, Minnesota",2000,2377,3171,794,24,10,20,5800,47,5820,5719,27011
1318,27013,"Blue Earth County, Minnesota",2000,21062,21971,909,988,658,988,54953,687,55941,52620,27013
1319,27015,"Brown County, Minnesota",2000,10598,11163,565,109,20,545,26366,157,26911,26080,27015
1320,27017,"Carlton County, Minnesota",2000,12064,13721,1657,112,297,266,31405,2089,31671,28907,27017
1321,27019,"Carver County, Minnesota",2000,24356,24883,527,1085,399,1791,68414,662,70205,66268,27019
1322,27021,"Cass County, Minnesota",2000,10893,21286,10393,70,31,220,26930,3452,27150,23377,27021
1323,27023,"Chippewa County, Minnesota",2000,5361,5855,494,39,21,251,12837,227,13088,12550,27023
1324,27025,"Chisago County, Minnesota",2000,14454,15533,1079,285,197,473,40628,506,41101,39640,27025
1325,27027,"Clay County, Minnesota",2000,18670,19746,1076,439,261,1872,49357,1327,51229,47330,27027
1326,27029,"Clearwater County, Minnesota",2000,3330,4114,784,21,16,65,8358,814,8423,7507,27029
1327,27031,"Cook County, Minnesota",2000,2350,4708,2358,17,15,39,5129,488,5168,4609,27031
1328,27033,"Cottonwood County, Minnesota",2000,4917,5376,459,197,39,267,11900,155,12167,11509,27033
1329,27035,"Crow Wing County, Minnesota",2000,22250,33483,11233,151,167,381,54718,820,55099,53580,27035
1330,27037,"Dakota County, Minnesota",2000,131151,133750,2599,10220,7941,10459,345445,7042,355904,320242,27037
1331,27039,"Dodge County, Minnesota",2000,6420,6642,222,72,35,530,17201,120,17731,16974,27039
1332,27041,"Douglas County, Minnesota",2000,13276,16694,3418,130,58,193,32628,224,32821,32216,27041
1333,27043,"Faribault County, Minnesota",2000,6652,7247,595,57,39,566,15615,117,16181,15402,27043
1334,27045,"Fillmore County, Minnesota",2000,8228,8908,680,31,34,113,21009,121,21122,20823,27045
1335,27047,"Freeborn County, Minnesota",2000,13356,13996,640,171,65,2049,30535,238,32584,30061,27047
1336,27049,"Goodhue County, Minnesota",2000,16983,17879,896,250,273,473,43654,726,44127,42405,27049
1337,27051,"Grant County, Minnesota",2000,2534,3098,564,11,13,33,6256,62,6289,6170,27051
1338,27053,"Hennepin County, Minnesota",2000,456129,468824,12695,53229,98698,45439,1070761,37818,1116200,881016,27053
1339,27055,"Houston County, Minnesota",2000,7633,8168,535,73,58,121,19597,128,19718,19338,27055
1340,27057,"Hubbard County, Minnesota",2000,7435,12229,4794,47,32,124,18252,548,18376,17625,27057
1341,27059,"Isanti County, Minnesota",2000,11236,12062,826,120,78,259,31028,447,31287,30383,27059
1342,27061,"Itasca County, Minnesota",2000,17789,24528,6739,120,69,263,43729,2046,43992,41494,27061
1343,27063,"Jackson County, Minnesota",2000,4556,5092,536,155,10,210,11058,54,11268,10839,27063
1344,27065,"Kanabec County, Minnesota",2000,5759,6846,1087,66,22,140,14856,278,14996,14490,27065
1345,27067,"Kandiyohi County, Minnesota",2000,15936,18415,2479,152,173,3295,37908,371,41203,37212,27067
1346,27069,"Kittson County, Minnesota",2000,2167,2719,552,13,8,67,5218,55,5285,5142,27069
1347,27071,"Koochiching County, Minnesota",2000,6040,7719,1679,24,27,81,14274,479,14355,13744,27071
1348,27073,"Lac qui Parle County, Minnesota",2000,3316,3774,458,26,13,21,8046,42,8067,7965,27073
1349,27075,"Lake County, Minnesota",2000,4646,6840,2194,18,11,63,10995,163,11058,10803,27075
1350,27077,"Lake of the Woods County, Minnesota",2000,1903,3238,1335,11,12,29,4493,97,4522,4373,27077
1351,27079,"Le Sueur County, Minnesota",2000,9630,10858,1228,76,38,997,24429,218,25426,24097,27079
1352,27081,"Lincoln County, Minnesota",2000,2653,3043,390,13,3,55,6374,29,6429,6329,27081
1353,27083,"Lyon County, Minnesota",2000,9715,10298,583,423,364,1009,24416,291,25425,23338,27083
1354,27085,"McLeod County, Minnesota",2000,13449,14087,638,189,67,1268,33630,266,34898,33108,27085
1355,27087,"Mahnomen County, Minnesota",2000,1969,2700,731,3,7,46,5144,1882,5190,3252,27087
1356,27089,"Marshall County, Minnesota",2000,4101,4791,690,17,9,298,9857,81,10155,9750,27089
1357,27091,"Martin County, Minnesota",2000,9067,9800,733,90,53,421,21381,138,21802,21100,27091
1358,27093,"Meeker County, Minnesota",2000,8590,9821,1231,84,39,487,22157,127,22644,21907,27093
1359,27095,"Mille Lacs County, Minnesota",2000,8638,10467,1829,45,59,214,22116,1252,22330,20760,27095
1360,27097,"Morrison County, Minnesota",2000,11816,13870,2054,78,65,203,31509,272,31712,31094,27097
1361,27099,"Mower County, Minnesota",2000,15582,16251,669,564,206,1646,36957,303,38603,35884,27099
1362,27101,"Murray County, Minnesota",2000,3722,4357,635,19,7,135,9030,74,9165,8930,27101
1363,27103,"Nicollet County, Minnesota",2000,10642,11240,598,335,232,535,29236,264,29771,28405,27103
1364,27105,"Nobles County, Minnesota",2000,7939,8465,526,816,212,2325,18507,247,20832,17232,27105
1365,27107,"Norman County, Minnesota",2000,3010,3455,445,23,7,227,7215,228,7442,6957,27107
1366,27109,"Olmsted County, Minnesota",2000,47807,49422,1615,5270,3293,2959,121318,2157,124277,110598,27109
1367,27111,"Otter Tail County, Minnesota",2000,22671,33862,11191,250,160,957,56202,655,57159,55137,27111
1368,27113,"Pennington County, Minnesota",2000,5525,6033,508,80,27,169,13415,213,13584,13095,27113
1369,27115,"Pine County, Minnesota",2000,9939,15353,5414,80,335,465,26065,948,26530,24702,27115
1370,27117,"Pipestone County, Minnesota",2000,4069,4434,365,45,17,69,9826,226,9895,9538,27117
1371,27119,"Polk County, Minnesota",2000,12070,14008,1938,91,86,1502,29867,696,31369,28994,27119
1372,27121,"Pope County, Minnesota",2000,4513,5827,1314,9,23,57,11179,69,11236,11078,27121
1373,27123,"Ramsey County, Minnesota",2000,201236,206448,5212,44633,37978,26979,484056,16797,511035,384648,27123
1374,27125,"Red Lake County, Minnesota",2000,1727,1883,156,3,8,13,4286,94,4299,4181,27125
1375,27127,"Redwood County, Minnesota",2000,6674,7230,556,53,22,192,16623,669,16815,15879,27127
1376,27129,"Renville County, Minnesota",2000,6779,7413,634,30,10,876,16278,153,17154,16085,27129
1377,27131,"Rice County, Minnesota",2000,18888,20061,1173,823,713,3117,53548,755,56665,51257,27131
1378,27133,"Rock County, Minnesota",2000,3843,4137,294,58,52,124,9597,91,9721,9396,27133
1379,27135,"Roseau County, Minnesota",2000,6190,7101,911,279,20,71,16267,343,16338,15625,27135
1380,27137,"St. Louis County, Minnesota",2000,82619,95800,13181,1327,1676,1597,198931,6614,200528,189314,27137
1381,27139,"Scott County, Minnesota",2000,30692,31609,917,1928,802,2381,87117,1654,89498,82733,27139
1382,27141,"Sherburne County, Minnesota",2000,21581,22827,1246,368,542,709,63708,863,64417,61935,27141
1383,27143,"Sibley County, Minnesota",2000,5772,6024,252,50,15,834,14522,120,15356,14337,27143
1384,27145,"Stearns County, Minnesota",2000,47604,50291,2687,2086,1064,1827,131339,1425,133166,126764,27145
1385,27147,"Steele County, Minnesota",2000,12846,13306,460,284,357,1266,32414,359,33680,31414,27147
1386,27149,"Stevens County, Minnesota",2000,3751,4074,323,86,92,90,9963,158,10053,9627,27149
1387,27151,"Swift County, Minnesota",2000,4353,4821,468,167,319,320,11636,422,11956,10728,27151
1388,27153,"Todd County, Minnesota",2000,9342,11900,2558,76,27,463,23963,257,24426,23603,27153
1389,27155,"Traverse County, Minnesota",2000,1717,2199,482,11,1,50,4084,126,4134,3946,27155
1390,27157,"Wabasha County, Minnesota",2000,8277,9066,789,93,53,364,21246,132,21610,20968,27157
1391,27159,"Wadena County, Minnesota",2000,5426,6334,908,25,65,128,13585,155,13713,13340,27159
1392,27161,"Waseca County, Minnesota",2000,7059,7427,368,89,435,566,18960,238,19526,18198,27161
1393,27163,"Washington County, Minnesota",2000,71462,73635,2173,4279,3612,3892,197238,3214,201130,186133,27163
1394,27165,"Watonwan County, Minnesota",2000,4627,5036,409,100,36,1804,10072,88,11876,9848,27165
1395,27167,"Wilkin County, Minnesota",2000,2752,3105,353,10,11,110,7028,95,7138,6912,27167
1396,27169,"Winona County, Minnesota",2000,18744,19551,807,931,384,686,49299,462,49985,47522,27169
1397,27171,"Wright County, Minnesota",2000,31465,34355,2890,385,232,994,88992,886,89986,87489,27171
1398,27173,"Yellow Medicine County, Minnesota",2000,4439,4873,434,18,9,195,10885,289,11080,10569,27173
1399,28001,"Adams County, Mississippi",2000,13677,15175,1498,85,18026,273,34067,255,34340,15701,28001
1400,28003,"Alcorn County, Mississippi",2000,14224,15818,1594,72,3814,443,34115,252,34558,29977,28003
1401,28005,"Amite County, Mississippi",2000,5271,6446,1175,11,5756,113,13486,83,13599,7636,28005
1402,28007,"Attala County, Mississippi",2000,7567,8639,1072,52,7826,280,19381,134,19661,11369,28007
1403,28009,"Benton County, Mississippi",2000,2999,3456,457,4,2919,84,7942,83,8026,4936,28009
1404,28011,"Bolivar County, Mississippi",2000,13776,14939,1163,199,26345,477,40156,247,40633,13365,28011
1405,28013,"Calhoun County, Mississippi",2000,6019,6902,883,9,4308,318,14751,95,15069,10339,28013
1406,28015,"Carroll County, Mississippi",2000,4071,4888,817,17,3926,79,10690,42,10769,6705,28015
1407,28017,"Chickasaw County, Mississippi",2000,7253,7981,728,34,7967,445,18995,107,19440,10887,28017
1408,28019,"Choctaw County, Mississippi",2000,3686,4249,563,13,2980,79,9679,73,9758,6613,28019
1409,28021,"Claiborne County, Mississippi",2000,3685,4252,567,16,9892,94,11737,46,11831,1783,28021
1410,28023,"Clarke County, Mississippi",2000,6978,8100,1122,19,6220,120,17835,78,17955,11518,28023
1411,28025,"Clay County, Mississippi",2000,8152,8810,658,35,12331,190,21789,91,21979,9332,28025
1412,28027,"Coahoma County, Mississippi",2000,10553,11490,937,143,21099,276,30346,206,30622,8898,28027
1413,28029,"Copiah County, Mississippi",2000,10142,11101,959,43,14577,332,28425,178,28757,13627,28029
1414,28031,"Covington County, Mississippi",2000,7126,8083,957,23,6860,155,19252,120,19407,12249,28031
1415,28033,"DeSoto County, Mississippi",2000,38792,40795,2003,648,12166,2516,104683,1053,107199,90816,28033
1416,28035,"Forrest County, Mississippi",2000,27183,29913,2730,535,24225,912,71692,707,72604,46225,28035
1417,28037,"Franklin County, Mississippi",2000,3211,4119,908,6,3048,45,8403,63,8448,5286,28037
1418,28039,"George County, Mississippi",2000,6742,7513,771,30,1681,307,18837,150,19144,16976,28039
1419,28041,"Greene County, Mississippi",2000,4148,4947,799,8,3467,106,13193,81,13299,9637,28041
1420,28043,"Grenada County, Mississippi",2000,8820,9973,1153,78,9480,145,23118,146,23263,13414,28043
1421,28045,"Hancock County, Mississippi",2000,16897,21072,4175,374,2925,775,42192,713,42967,38180,28045
1422,28047,"Harrison County, Mississippi",2000,71538,79636,8098,4874,39694,4910,184691,3982,189601,136141,28047
1423,28049,"Hinds County, Mississippi",2000,91030,100287,9257,1493,152652,1978,248822,1873,250800,92804,28049
1424,28051,"Holmes County, Mississippi",2000,7314,8439,1125,32,16850,194,21415,138,21609,4395,28051
1425,28053,"Humphreys County, Mississippi",2000,3765,4138,373,30,7955,168,11038,47,11206,3006,28053
1426,28055,"Issaquena County, Mississippi",2000,726,877,151,0,1426,10,2264,16,2274,822,28055
1427,28057,"Itawamba County, Mississippi",2000,8773,9804,1031,41,1449,226,22544,112,22770,20942,28057
1428,28059,"Jackson County, Mississippi",2000,47676,51678,4002,2033,27308,2807,128613,1811,131420,97461,28059
1429,28061,"Jasper County, Mississippi",2000,6708,7671,963,12,9561,117,18032,81,18149,8378,28061
1430,28063,"Jefferson County, Mississippi",2000,3308,3819,511,10,8373,64,9676,30,9740,1263,28063
1431,28065,"Jefferson Davis County, Mississippi",2000,5177,5891,714,18,7961,107,13855,95,13962,5781,28065
1432,28067,"Jones County, Mississippi",2000,24275,26921,2646,172,17032,1271,63687,528,64958,45955,28067
1433,28069,"Kemper County, Mississippi",2000,3909,4533,624,8,6028,76,10377,273,10453,4068,28069
1434,28071,"Lafayette County, Mississippi",2000,14373,16587,2214,642,9647,427,38317,417,38744,27611,28071
1435,28073,"Lamar County, Mississippi",2000,14396,15433,1037,245,5027,426,38644,282,39070,33090,28073
1436,28075,"Lauderdale County, Mississippi",2000,29990,33418,3428,385,29706,888,77273,595,78161,46587,28075
1437,28077,"Lawrence County, Mississippi",2000,5040,5688,648,35,4233,89,13169,66,13258,8835,28077
1438,28079,"Leake County, Mississippi",2000,7611,8585,974,30,7793,440,20500,1046,20940,11631,28079
1439,28081,"Lee County, Mississippi",2000,29200,31887,2687,393,18495,882,74873,618,75755,55367,28081
1440,28083,"Leflore County, Mississippi",2000,12956,14097,1141,244,25526,720,37227,219,37947,11238,28083
1441,28085,"Lincoln County, Mississippi",2000,12538,14052,1514,81,9807,229,32937,183,33166,22866,28085
1442,28087,"Lowndes County, Mississippi",2000,22849,25104,2255,329,25486,684,60902,598,61586,34489,28087
1443,28089,"Madison County, Mississippi",2000,27219,28781,1562,965,27897,742,73932,457,74674,44613,28089
1444,28091,"Marion County, Mississippi",2000,9336,10395,1059,53,8106,158,25437,215,25595,17063,28091
1445,28093,"Marshall County, Mississippi",2000,12163,13252,1089,38,17496,425,34568,260,34993,16774,28093
1446,28095,"Monroe County, Mississippi",2000,14603,16236,1633,66,11652,261,37753,203,38014,25832,28095
1447,28097,"Montgomery County, Mississippi",2000,4690,5402,712,27,5437,103,12086,52,12189,6570,28097
1448,28099,"Neshoba County, Mississippi",2000,10694,11980,1286,54,5515,332,28352,4153,28684,18630,28099
1449,28101,"Newton County, Mississippi",2000,8221,9259,1038,39,6617,198,21640,889,21838,14095,28101
1450,28103,"Noxubee County, Mississippi",2000,4470,5228,758,13,8634,141,12407,93,12548,3667,28103
1451,28105,"Oktibbeha County, Mississippi",2000,15945,17344,1399,1084,15994,461,42441,390,42902,24973,28105
1452,28107,"Panola County, Mississippi",2000,12232,13736,1504,53,16478,384,33890,168,34274,17191,28107
1453,28109,"Pearl River County, Mississippi",2000,18078,20610,2532,130,5888,686,47935,736,48621,41181,28109
1454,28111,"Perry County, Mississippi",2000,4420,5107,687,14,2713,122,12016,95,12138,9194,28111
1455,28113,"Pike County, Mississippi",2000,14792,16720,1928,127,18433,284,38656,255,38940,19841,28113
1456,28115,"Pontotoc County, Mississippi",2000,10097,10816,719,26,3711,481,26245,172,26726,22336,28115
1457,28117,"Prentiss County, Mississippi",2000,9821,10681,860,40,3285,176,25380,210,25556,21845,28117
1458,28119,"Quitman County, Mississippi",2000,3565,3923,358,17,6919,55,10062,61,10117,3065,28119
1459,28121,"Rankin County, Mississippi",2000,42089,45070,2981,754,19669,1520,113807,832,115327,92552,28121
1460,28123,"Scott County, Mississippi",2000,10183,11116,933,42,10944,1660,26763,231,28423,15546,28123
1461,28125,"Sharkey County, Mississippi",2000,2163,2416,253,17,4527,86,6494,39,6580,1911,28125
1462,28127,"Simpson County, Mississippi",2000,10076,11307,1231,35,9432,318,27321,168,27639,17686,28127
1463,28129,"Smith County, Mississippi",2000,6046,7005,959,15,3728,96,16086,75,16182,12268,28129
1464,28131,"Stone County, Mississippi",2000,4747,5343,596,21,2591,170,13452,116,13622,10724,28131
1465,28133,"Sunflower County, Mississippi",2000,9637,10338,701,136,23871,448,33921,115,34369,9799,28133
1466,28135,"Tallahatchie County, Mississippi",2000,5263,5711,448,52,8784,137,14766,63,14903,5867,28135
1467,28137,"Tate County, Mississippi",2000,8850,9354,504,23,7844,223,25147,187,25370,17093,28137
1468,28139,"Tippah County, Mississippi",2000,8108,8868,760,21,3306,434,20392,175,20826,16890,28139
1469,28141,"Tishomingo County, Mississippi",2000,7917,9553,1636,12,595,343,18820,146,19163,18067,28141
1470,28143,"Tunica County, Mississippi",2000,3258,3705,447,38,6414,233,8994,60,9227,2482,28143
1471,28145,"Union County, Mississippi",2000,9786,10693,907,38,3784,413,24949,158,25362,20969,28145
1472,28147,"Walthall County, Mississippi",2000,5571,6418,847,33,6593,201,14955,121,15156,8208,28147
1473,28149,"Warren County, Mississippi",2000,18756,20789,2033,303,21341,514,49130,437,49644,27049,28149
1474,28151,"Washington County, Mississippi",2000,22158,24381,2223,327,40495,531,62446,381,62977,21243,28151
1475,28153,"Wayne County, Mississippi",2000,7857,9049,1192,31,8017,134,21082,79,21216,12955,28153
1476,28155,"Webster County, Mississippi",2000,3905,4344,439,18,2134,174,10120,49,10294,7919,28155
1477,28157,"Wilkinson County, Mississippi",2000,3578,5106,1528,2,7015,45,10267,48,10312,3202,28157
1478,28159,"Winston County, Mississippi",2000,7578,8472,894,16,8687,243,19917,190,20160,11024,28159
1479,28161,"Yalobusha County, Mississippi",2000,5260,6224,964,11,5006,127,12924,80,13051,7827,28161
1480,28163,"Yazoo County, Mississippi",2000,9178,10015,837,97,15074,1233,26916,187,28149,11558,28163
1481,29001,"Adair County, Missouri",2000,9669,10826,1157,347,291,315,24662,286,24977,23738,29001
1482,29003,"Andrew County, Missouri",2000,6273,6662,389,37,67,138,16354,121,16492,16129,29003
1483,29005,"Atchison County, Missouri",2000,2722,3103,381,9,132,43,6387,35,6430,6211,29005
1484,29007,"Audrain County, Missouri",2000,9844,10881,1037,88,1849,189,25664,302,25853,23425,29007
1485,29009,"Barry County, Missouri",2000,13398,15964,2566,86,30,1713,32297,695,34010,31486,29009
1486,29011,"Barton County, Missouri",2000,4895,5409,514,30,36,119,12422,278,12541,12078,29011
1487,29013,"Bates County, Missouri",2000,6511,7247,736,22,101,179,16474,237,16653,16114,29013
1488,29015,"Benton County, Missouri",2000,7420,12691,5271,21,24,153,17027,273,17180,16709,29015
1489,29017,"Bollinger County, Missouri",2000,4576,5522,946,25,25,68,11961,197,12029,11714,29017
1490,29019,"Boone County, Missouri",2000,53094,56678,3584,4000,11479,2413,133041,3195,135454,114367,29019
1491,29021,"Buchanan County, Missouri",2000,33557,36574,3017,384,3714,2086,83912,1408,85998,78406,29021
1492,29023,"Butler County, Missouri",2000,16718,18707,1989,176,2105,412,40455,739,40867,37435,29023
1493,29025,"Caldwell County, Missouri",2000,3523,4493,970,11,12,67,8902,93,8969,8786,29025
1494,29027,"Callaway County, Missouri",2000,14416,16167,1751,207,2303,377,40389,688,40766,37191,29027
1495,29029,"Camden County, Missouri",2000,15779,33470,17691,107,94,346,36705,550,37051,35954,29029
1496,29031,"Cape Girardeau County, Missouri",2000,26980,29434,2454,511,3607,624,68069,1025,68693,62926,29031
1497,29033,"Carroll County, Missouri",2000,4169,4897,728,13,177,73,10212,103,10285,9919,29033
1498,29035,"Carter County, Missouri",2000,2378,3028,650,6,3,72,5869,175,5941,5685,29035
1499,29037,"Cass County, Missouri",2000,30168,31677,1509,387,1147,1816,80276,1458,82092,77284,29037
1500,29039,"Cedar County, Missouri",2000,5685,6813,1128,63,44,153,13580,293,13733,13180,29039
1501,29041,"Chariton County, Missouri",2000,3469,4250,781,11,264,47,8391,49,8438,8067,29041
1502,29043,"Christian County, Missouri",2000,20425,21827,1402,154,139,714,53571,869,54285,52409,29043
1503,29045,"Clark County, Missouri",2000,2966,3483,517,5,5,52,7364,60,7416,7294,29045
1504,29047,"Clay County, Missouri",2000,72558,76230,3672,2456,4794,6594,177412,3717,184006,166445,29047
1505,29049,"Clinton County, Missouri",2000,7152,7877,725,32,284,205,18774,267,18979,18191,29049
1506,29051,"Cole County, Missouri",2000,27040,28915,1875,621,7049,915,70482,1128,71397,61684,29051
1507,29053,"Cooper County, Missouri",2000,5932,6676,744,34,1482,143,16527,249,16670,14762,29053
1508,29055,"Crawford County, Missouri",2000,8858,10850,1992,30,32,176,22628,285,22804,22281,29055
1509,29057,"Dade County, Missouri",2000,3202,3758,556,11,21,67,7856,154,7923,7670,29057
1510,29059,"Dallas County, Missouri",2000,6030,6914,884,10,19,147,15514,321,15661,15164,29059
1511,29061,"Daviess County, Missouri",2000,3178,3853,675,6,4,55,7961,74,8016,7877,29061
1512,29063,"DeKalb County, Missouri",2000,3528,3839,311,20,1020,125,11472,182,11597,10250,29063
1513,29065,"Dent County, Missouri",2000,5982,6994,1012,32,55,112,14815,308,14927,14420,29065
1514,29067,"Douglas County, Missouri",2000,5201,5919,718,28,14,110,12974,325,13084,12607,29067
1515,29069,"Dunklin County, Missouri",2000,13411,14682,1271,88,2873,824,32331,407,33155,28963,29069
1516,29071,"Franklin County, Missouri",2000,34945,38295,3350,243,880,678,93129,1013,93807,90993,29071
1517,29073,"Gasconade County, Missouri",2000,6171,7813,1642,24,17,64,15278,136,15342,15101,29073
1518,29075,"Gentry County, Missouri",2000,2747,3214,467,11,8,44,6817,75,6861,6723,29075
1519,29077,"Greene County, Missouri",2000,97859,104517,6658,2681,5322,4434,235957,5507,240391,222447,29077
1520,29079,"Grundy County, Missouri",2000,4382,5102,720,16,41,165,10267,122,10432,10088,29079
1521,29081,"Harrison County, Missouri",2000,3658,4316,658,13,12,89,8761,82,8850,8654,29081
1522,29083,"Henry County, Missouri",2000,9133,10261,1128,50,212,201,21796,377,21997,21157,29083
1523,29085,"Hickory County, Missouri",2000,3911,6184,2273,10,7,68,8872,180,8940,8675,29085
1524,29087,"Holt County, Missouri",2000,2237,2931,694,4,5,21,5330,66,5351,5255,29087
1525,29089,"Howard County, Missouri",2000,3836,4346,510,12,694,88,10124,151,10212,9267,29089
1526,29091,"Howell County, Missouri",2000,14762,16340,1578,130,114,450,36788,921,37238,35623,29091
1527,29093,"Iron County, Missouri",2000,4197,4907,710,10,163,62,10635,148,10697,10314,29093
1528,29095,"Jackson County, Missouri",2000,266294,288231,21937,8307,151333,35160,619720,16653,654880,443427,29095
1529,29097,"Jasper County, Missouri",2000,41412,45571,4159,714,1520,3615,101071,3501,104686,95336,29097
1530,29099,"Jefferson County, Missouri",2000,71499,75586,4087,691,1340,2002,196097,2313,198099,191753,29099
1531,29101,"Johnson County, Missouri",2000,17410,18886,1476,687,2064,1407,46851,1297,48258,42803,29101
1532,29103,"Knox County, Missouri",2000,1791,2317,526,4,4,26,4335,50,4361,4277,29103
1533,29105,"Laclede County, Missouri",2000,12760,14320,1560,94,138,401,32112,584,32513,31296,29105
1534,29107,"Lafayette County, Missouri",2000,12569,13707,1138,80,745,386,32574,459,32960,31290,29107
1535,29109,"Lawrence County, Missouri",2000,13568,14789,1221,79,68,1195,34009,649,35204,33213,29109
1536,29111,"Lewis County, Missouri",2000,3956,4602,646,21,264,77,10417,100,10494,10032,29111
1537,29113,"Lincoln County, Missouri",2000,13851,15511,1660,67,672,444,38500,577,38944,37184,29113
1538,29115,"Linn County, Missouri",2000,5697,6554,857,19,82,104,13650,143,13754,13406,29115
1539,29117,"Livingston County, Missouri",2000,5736,6467,731,38,331,94,14464,184,14558,13911,29117
1540,29119,"McDonald County, Missouri",2000,8113,9287,1174,27,33,2030,19651,1243,21681,18348,29119
1541,29121,"Macon County, Missouri",2000,6501,7502,1001,25,347,121,15641,198,15762,15071,29121
1542,29123,"Madison County, Missouri",2000,4711,5656,945,33,15,66,11734,134,11800,11552,29123
1543,29125,"Maries County, Missouri",2000,3519,4149,630,10,29,103,8800,152,8903,8609,29125
1544,29127,"Marion County, Missouri",2000,11066,12443,1377,78,1303,252,28037,420,28289,26236,29127
1545,29129,"Mercer County, Missouri",2000,1600,2125,525,0,7,11,3746,35,3757,3704,29129
1546,29131,"Miller County, Missouri",2000,9284,11263,1979,27,63,231,23333,309,23564,22934,29131
1547,29133,"Mississippi County, Missouri",2000,5383,5840,457,15,2735,129,13298,137,13427,10411,29133
1548,29135,"Moniteau County, Missouri",2000,5259,5742,483,46,557,435,14392,233,14827,13556,29135
1549,29137,"Monroe County, Missouri",2000,3656,4565,909,11,357,52,9259,122,9311,8769,29137
1550,29139,"Montgomery County, Missouri",2000,4775,5726,951,30,245,94,12042,171,12136,11596,29139
1551,29141,"Morgan County, Missouri",2000,7850,13898,6048,21,97,161,19148,337,19309,18693,29141
1552,29143,"New Madrid County, Missouri",2000,7824,8600,776,26,3024,183,19577,182,19760,16345,29143
1553,29145,"Newton County, Missouri",2000,20140,21897,1757,166,298,1147,51489,2383,52636,48642,29145
1554,29147,"Nodaway County, Missouri",2000,8138,8909,771,189,294,155,21757,207,21912,21067,29147
1555,29149,"Oregon County, Missouri",2000,4263,4997,734,14,10,113,10231,511,10344,9696,29149
1556,29151,"Osage County, Missouri",2000,4922,5904,982,10,16,77,12985,131,13062,12828,29151
1557,29153,"Ozark County, Missouri",2000,3950,5114,1164,8,14,90,9452,181,9542,9249,29153
1558,29155,"Pemiscot County, Missouri",2000,7855,8793,938,54,5231,315,19732,203,20047,14244,29155
1559,29157,"Perry County, Missouri",2000,6904,7815,911,117,33,93,18039,150,18132,17739,29157
1560,29159,"Pettis County, Missouri",2000,15568,16963,1395,154,1181,1527,37876,731,39403,35810,29159
1561,29161,"Phelps County, Missouri",2000,15683,17501,1818,934,586,485,39340,936,39825,36884,29161
1562,29163,"Pike County, Missouri",2000,6451,7493,1042,27,1672,295,18056,247,18351,16110,29163
1563,29165,"Platte County, Missouri",2000,29278,30902,1624,1084,2542,2211,71570,1714,73781,66230,29165
1564,29167,"Polk County, Missouri",2000,9917,11183,1266,51,119,350,26642,448,26992,26024,29167
1565,29169,"Pulaski County, Missouri",2000,13433,15408,1975,920,4858,2404,38761,1783,41165,31200,29169
1566,29171,"Putnam County, Missouri",2000,2228,2914,686,7,3,32,5191,26,5223,5155,29171
1567,29173,"Ralls County, Missouri",2000,3736,4564,828,7,106,42,9584,78,9626,9393,29173
1568,29175,"Randolph County, Missouri",2000,9199,10740,1541,90,1717,282,24381,410,24663,22164,29175
1569,29177,"Ray County, Missouri",2000,8743,9371,628,43,340,253,23101,334,23354,22384,29177
1570,29179,"Reynolds County, Missouri",2000,2721,3759,1038,13,32,55,6634,223,6689,6366,29179
1571,29181,"Ripley County, Missouri",2000,5416,6392,976,30,5,132,13377,323,13509,13019,29181
1572,29183,"St. Charles County, Missouri",2000,101663,105514,3851,2397,7573,4176,279707,3579,283883,266158,29183
1573,29185,"St. Clair County, Missouri",2000,4040,5205,1165,14,20,95,9557,185,9652,9338,29185
1574,29186,"Ste. Genevieve County, Missouri",2000,6586,8018,1432,29,124,132,17710,153,17842,17404,29186
1575,29187,"St. Francois County, Missouri",2000,20793,24449,3656,174,1105,447,55194,687,55641,53228,29187
1576,29189,"St. Louis County, Missouri",2000,404312,423749,19437,22492,192544,14577,1001738,14661,1016315,772041,29189
1577,29195,"Saline County, Missouri",2000,9015,10019,1004,82,1268,1050,22706,433,23756,20923,29195
1578,29197,"Schuyler County, Missouri",2000,1725,2027,302,7,2,27,4143,48,4170,4086,29197
1579,29199,"Scotland County, Missouri",2000,1902,2292,390,4,10,42,4941,37,4983,4890,29199
1580,29201,"Scott County, Missouri",2000,15626,16951,1325,93,4217,448,39974,443,40422,35221,29201
1581,29203,"Shannon County, Missouri",2000,3319,3862,543,4,14,77,8247,365,8324,7864,29203
1582,29205,"Shelby County, Missouri",2000,2745,3245,500,7,66,43,6756,55,6799,6628,29205
1583,29207,"Stoddard County, Missouri",2000,12064,13221,1157,28,268,231,29474,406,29705,28772,29207
1584,29209,"Stone County, Missouri",2000,11822,16241,4419,52,17,298,28360,494,28658,27797,29209
1585,29211,"Sullivan County, Missouri",2000,2925,3364,439,10,9,634,6585,58,7219,6508,29211
1586,29213,"Taney County, Missouri",2000,16158,19688,3530,136,129,962,38741,825,39703,37651,29213
1587,29215,"Texas County, Missouri",2000,9378,10764,1386,78,47,221,22782,623,23003,22034,29215
1588,29217,"Vernon County, Missouri",2000,7966,8872,906,63,125,172,20282,352,20454,19742,29217
1589,29219,"Warren County, Missouri",2000,9185,11046,1861,53,474,314,24211,354,24525,23330,29219
1590,29221,"Washington County, Missouri",2000,8406,9894,1488,35,577,170,23174,403,23344,22159,29221
1591,29223,"Wayne County, Missouri",2000,5551,7496,1945,15,21,65,13194,259,13259,12899,29223
1592,29225,"Webster County, Missouri",2000,11073,12052,979,81,358,400,30645,599,31045,29607,29225
1593,29227,"Worth County, Missouri",2000,1009,1245,236,2,4,7,2375,18,2382,2351,29227
1594,29229,"Wright County, Missouri",2000,7081,7957,876,25,49,139,17816,302,17955,17440,29229
1595,29510,"St. Louis city, Missouri",2000,147076,176354,29278,6820,177446,7022,341167,7572,348189,149329,29510
1596,30001,"Beaverhead County, Montana",2000,3684,4571,887,17,12,246,8956,240,9202,8687,30001
1597,30003,"Big Horn County, Montana",2000,3924,4655,731,28,4,465,12206,7717,12671,4457,30003
1598,30005,"Blaine County, Montana",2000,2501,2947,446,6,10,70,6939,3253,7009,3670,30005
1599,30007,"Broadwater County, Montana",2000,1752,2002,250,5,12,58,4327,96,4385,4214,30007
1600,30009,"Carbon County, Montana",2000,4065,5494,1429,30,22,169,9383,143,9552,9188,30009
1601,30011,"Carter County, Montana",2000,543,811,268,2,1,8,1352,10,1360,1339,30011
1602,30013,"Cascade County, Montana",2000,32547,35225,2678,643,846,1949,78408,5039,80357,71880,30013
1603,30015,"Chouteau County, Montana",2000,2226,2776,550,12,2,40,5930,907,5970,5009,30015
1604,30017,"Custer County, Montana",2000,4768,5360,592,29,11,177,11519,251,11696,11228,30017
1605,30019,"Daniels County, Montana",2000,892,1154,262,5,0,32,1985,49,2017,1931,30019
1606,30021,"Dawson County, Montana",2000,3625,4168,543,12,23,81,8978,157,9059,8786,30021
1607,30023,"Deer Lodge County, Montana",2000,3995,4958,963,32,16,155,9262,300,9417,8914,30023
1608,30025,"Fallon County, Montana",2000,1140,1410,270,9,4,11,2826,23,2837,2790,30025
1609,30027,"Fergus County, Montana",2000,4860,5558,698,21,10,96,11797,270,11893,11496,30027
1610,30029,"Flathead County, Montana",2000,29588,34773,5185,340,108,1061,73410,1916,74471,71046,30029
1611,30031,"Gallatin County, Montana",2000,26323,29489,3166,599,148,1047,66784,1365,67831,64672,30031
1612,30033,"Garfield County, Montana",2000,532,961,429,1,1,5,1274,8,1279,1264,30033
1613,30035,"Glacier County, Montana",2000,4304,5243,939,8,11,159,13088,8394,13247,4675,30035
1614,30037,"Golden Valley County, Montana",2000,365,450,85,1,0,13,1029,8,1042,1020,30037
1615,30039,"Granite County, Montana",2000,1200,2074,874,4,0,36,2794,94,2830,2696,30039
1616,30041,"Hill County, Montana",2000,6457,7453,996,56,15,208,16465,3203,16673,13191,30041
1617,30043,"Jefferson County, Montana",2000,3747,4199,452,42,13,149,9900,281,10049,9564,30043
1618,30045,"Judith Basin County, Montana",2000,951,1325,374,1,1,13,2316,28,2329,2286,30045
1619,30047,"Lake County, Montana",2000,10192,13605,3413,69,30,668,25839,7036,26507,18704,30047
1620,30049,"Lewis and Clark County, Montana",2000,22850,25672,2822,282,104,843,54873,1916,55716,52571,30049
1621,30051,"Liberty County, Montana",2000,833,1070,237,7,0,4,2154,9,2158,2138,30051
1622,30053,"Lincoln County, Montana",2000,7764,9319,1555,59,19,271,18566,571,18837,17917,30053
1623,30055,"McCone County, Montana",2000,810,1087,277,6,6,19,1958,43,1977,1903,30055
1624,30057,"Madison County, Montana",2000,2956,4671,1715,17,3,130,6721,126,6851,6575,30057
1625,30059,"Meagher County, Montana",2000,803,1363,560,3,0,29,1903,30,1932,1870,30059
1626,30061,"Mineral County, Montana",2000,1584,1961,377,19,8,61,3823,159,3884,3637,30061
1627,30063,"Missoula County, Montana",2000,38439,41319,2880,969,255,1543,94259,3809,95802,89226,30063
1628,30065,"Musselshell County, Montana",2000,1878,2317,439,6,3,72,4425,102,4497,4314,30065
1629,30067,"Park County, Montana",2000,6828,8247,1419,46,58,288,15406,308,15694,14994,30067
1630,30069,"Petroleum County, Montana",2000,211,292,81,0,0,6,487,3,493,484,30069
1631,30071,"Phillips County, Montana",2000,1848,2502,654,14,5,53,4548,444,4601,4085,30071
1632,30073,"Pondera County, Montana",2000,2410,2834,424,9,6,54,6370,1008,6424,5347,30073
1633,30075,"Powder River County, Montana",2000,737,1007,270,2,0,11,1847,42,1858,1803,30075
1634,30077,"Powell County, Montana",2000,2422,2930,508,31,35,140,7040,406,7180,6568,30077
1635,30079,"Prairie County, Montana",2000,537,718,181,2,0,8,1191,18,1199,1171,30079
1636,30081,"Ravalli County, Montana",2000,14289,15946,1657,107,45,678,35392,791,36070,34449,30081
1637,30083,"Richland County, Montana",2000,3878,4557,679,17,9,209,9458,211,9667,9221,30083
1638,30085,"Roosevelt County, Montana",2000,3581,4044,463,45,5,131,10489,6108,10620,4331,30085
1639,30087,"Rosebud County, Montana",2000,3307,3912,605,27,21,219,9164,3157,9383,5959,30087
1640,30089,"Sanders County, Montana",2000,4273,5271,998,31,13,159,10068,725,10227,9299,30089
1641,30091,"Sheridan County, Montana",2000,1741,2167,426,12,4,44,4061,87,4105,3958,30091
1642,30093,"Silver Bow County, Montana",2000,14432,16176,1744,147,45,950,33656,1054,34606,32410,30093
1643,30095,"Stillwater County, Montana",2000,3234,3947,713,16,10,165,8030,144,8195,7860,30095
1644,30097,"Sweet Grass County, Montana",2000,1476,1860,384,12,2,54,3555,74,3609,3467,30097
1645,30099,"Teton County, Montana",2000,2538,2910,372,4,12,73,6372,192,6445,6164,30099
1646,30101,"Toole County, Montana",2000,1962,2300,338,15,8,61,5206,271,5267,4912,30101
1647,30103,"Treasure County, Montana",2000,357,422,65,3,1,13,848,21,861,823,30103
1648,30105,"Valley County, Montana",2000,3150,4847,1697,19,10,60,7615,845,7675,6741,30105
1649,30107,"Wheatland County, Montana",2000,853,1154,301,2,3,25,2234,52,2259,2177,30107
1650,30109,"Wibaux County, Montana",2000,421,587,166,2,2,4,1064,16,1068,1044,30109
1651,30111,"Yellowstone County, Montana",2000,52084,54563,2479,666,542,4788,124564,5658,129352,117698,30111
1652,31001,"Adams County, Nebraska",2000,12141,13014,873,498,184,1428,29723,306,31151,28735,31001
1653,31003,"Antelope County, Nebraska",2000,2953,3346,393,4,4,52,7400,49,7452,7343,31003
1654,31005,"Arthur County, Nebraska",2000,185,273,88,2,0,6,438,11,444,425,31005
1655,31007,"Banner County, Nebraska",2000,311,375,64,1,1,46,773,2,819,769,31007
1656,31009,"Blaine County, Nebraska",2000,238,333,95,0,0,1,582,6,583,576,31009
1657,31011,"Boone County, Nebraska",2000,2454,2733,279,2,3,56,6203,17,6259,6181,31011
1658,31013,"Box Butte County, Nebraska",2000,4780,5488,708,65,41,930,11228,459,12158,10663,31013
1659,31015,"Boyd County, Nebraska",2000,1014,1406,392,4,0,2,2436,23,2438,2409,31015
1660,31017,"Brown County, Nebraska",2000,1530,1916,386,9,1,29,3496,27,3525,3459,31017
1661,31019,"Buffalo County, Nebraska",2000,15930,16830,900,288,229,1970,40289,459,42259,39313,31019
1662,31021,"Burt County, Nebraska",2000,3155,3723,568,15,12,98,7693,128,7791,7538,31021
1663,31023,"Butler County, Nebraska",2000,3426,3901,475,11,6,145,8622,49,8767,8556,31023
1664,31025,"Cass County, Nebraska",2000,9161,10179,1018,85,43,355,23979,280,24334,23571,31025
1665,31027,"Cedar County, Nebraska",2000,3623,4200,577,4,10,41,9574,55,9615,9505,31027
1666,31029,"Chase County, Nebraska",2000,1662,1927,265,7,7,139,3929,15,4068,3900,31029
1667,31031,"Cherry County, Nebraska",2000,2508,3220,712,24,4,57,6091,294,6148,5769,31031
1668,31033,"Cheyenne County, Nebraska",2000,4071,4569,498,37,11,438,9392,109,9830,9235,31033
1669,31035,"Clay County, Nebraska",2000,2756,3066,310,21,8,245,6794,39,7039,6726,31035
1670,31037,"Colfax County, Nebraska",2000,3682,4088,406,14,5,2732,7709,73,10441,7617,31037
1671,31039,"Cuming County, Nebraska",2000,3945,4283,338,19,7,559,9644,66,10203,9552,31039
1672,31041,"Custer County, Nebraska",2000,4826,5585,759,18,8,108,11685,106,11793,11553,31041
1673,31043,"Dakota County, Nebraska",2000,7095,7528,433,619,111,4581,15672,574,20253,14368,31043
1674,31045,"Dawes County, Nebraska",2000,3512,4004,492,28,70,220,8840,370,9060,8372,31045
1675,31047,"Dawson County, Nebraska",2000,8824,9805,981,150,58,6178,18187,233,24365,17746,31047
1676,31049,"Deuel County, Nebraska",2000,908,1032,124,7,1,57,2041,19,2098,2014,31049
1677,31051,"Dixon County, Nebraska",2000,2413,2673,260,17,2,348,5991,45,6339,5927,31051
1678,31053,"Dodge County, Nebraska",2000,14433,15468,1035,178,145,1421,34739,306,36160,34110,31053
1679,31055,"Douglas County, Nebraska",2000,182194,192672,10478,7848,52821,30928,432657,9460,463585,362528,31055
1680,31057,"Dundy County, Nebraska",2000,961,1196,235,11,1,74,2218,35,2292,2171,31057
1681,31059,"Fillmore County, Nebraska",2000,2689,2990,301,4,13,110,6524,65,6634,6442,31059
1682,31061,"Franklin County, Nebraska",2000,1485,1746,261,2,0,23,3551,22,3574,3527,31061
1683,31063,"Frontier County, Nebraska",2000,1192,1543,351,7,3,30,3069,23,3099,3036,31063
1684,31065,"Furnas County, Nebraska",2000,2278,2730,452,12,2,61,5263,52,5324,5197,31065
1685,31067,"Gage County, Nebraska",2000,9316,10030,714,64,69,196,22797,310,22993,22354,31067
1686,31069,"Garden County, Nebraska",2000,1020,1298,278,6,2,33,2259,21,2292,2230,31069
1687,31071,"Garfield County, Nebraska",2000,813,1021,208,1,0,19,1883,15,1902,1867,31071
1688,31073,"Gosper County, Nebraska",2000,863,1281,418,5,0,27,2116,10,2143,2101,31073
1689,31075,"Grant County, Nebraska",2000,292,449,157,2,0,10,737,1,747,734,31075
1690,31077,"Greeley County, Nebraska",2000,1077,1199,122,2,18,23,2691,14,2714,2657,31077
1691,31079,"Hall County, Nebraska",2000,20356,21574,1218,574,159,7497,46037,486,53534,44818,31079
1692,31081,"Hamilton County, Nebraska",2000,3503,3850,347,21,17,107,9296,46,9403,9212,31081
1693,31083,"Harlan County, Nebraska",2000,1597,2327,730,3,5,29,3757,20,3786,3729,31083
1694,31085,"Hayes County, Nebraska",2000,430,526,96,3,2,27,1041,6,1068,1030,31085
1695,31087,"Hitchcock County, Nebraska",2000,1287,1675,388,3,3,44,3067,30,3111,3031,31087
1696,31089,"Holt County, Nebraska",2000,4608,5281,673,20,3,82,11469,69,11551,11377,31089
1697,31091,"Hooker County, Nebraska",2000,335,440,105,1,0,8,775,8,783,766,31091
1698,31093,"Howard County, Nebraska",2000,2546,2782,236,6,19,66,6501,38,6567,6438,31093
1699,31095,"Jefferson County, Nebraska",2000,3527,3942,415,12,4,109,8224,69,8333,8139,31095
1700,31097,"Johnson County, Nebraska",2000,1887,2116,229,120,5,129,4359,67,4488,4167,31097
1701,31099,"Kearney County, Nebraska",2000,2643,2846,203,16,9,161,6721,37,6882,6659,31099
1702,31101,"Keith County, Nebraska",2000,3707,5178,1471,14,7,375,8500,93,8875,8386,31101
1703,31103,"Keya Paha County, Nebraska",2000,409,548,139,0,0,38,945,4,983,941,31103
1704,31105,"Kimball County, Nebraska",2000,1727,1972,245,4,9,136,3953,74,4089,3866,31105
1705,31107,"Knox County, Nebraska",2000,3811,4773,962,15,8,85,9289,707,9374,8559,31107
1706,31109,"Lancaster County, Nebraska",2000,99187,104217,5030,7118,6892,8437,241854,5777,250291,222067,31109
1707,31111,"Lincoln County, Nebraska",2000,14076,15438,1362,129,179,1880,32752,372,34632,32072,31111
1708,31113,"Logan County, Nebraska",2000,316,386,70,0,1,7,767,10,774,756,31113
1709,31115,"Loup County, Nebraska",2000,289,377,88,1,0,12,700,3,712,696,31115
1710,31117,"McPherson County, Nebraska",2000,202,283,81,2,0,8,525,5,533,518,31117
1711,31119,"Madison County, Nebraska",2000,13436,14432,996,141,318,3042,32184,603,35226,31122,31119
1712,31121,"Merrick County, Nebraska",2000,3209,3649,440,11,17,168,8036,35,8204,7973,31121
1713,31123,"Morrill County, Nebraska",2000,2138,2460,322,12,2,549,4891,57,5440,4820,31123
1714,31125,"Nance County, Nebraska",2000,1577,1787,210,2,0,46,3992,36,4038,3954,31125
1715,31127,"Nemaha County, Nebraska",2000,3047,3439,392,44,27,76,7500,71,7576,7358,31127
1716,31129,"Nuckolls County, Nebraska",2000,2218,2530,312,8,1,51,5006,18,5057,4979,31129
1717,31131,"Otoe County, Nebraska",2000,6060,6567,507,38,38,377,15019,121,15396,14822,31131
1718,31133,"Pawnee County, Nebraska",2000,1339,1587,248,7,0,21,3066,17,3087,3042,31133
1719,31135,"Perkins County, Nebraska",2000,1275,1444,169,7,1,74,3126,28,3200,3090,31135
1720,31137,"Phelps County, Nebraska",2000,3844,4191,347,26,10,220,9527,73,9747,9418,31137
1721,31139,"Pierce County, Nebraska",2000,2979,3247,268,16,6,56,7801,65,7857,7714,31139
1722,31141,"Platte County, Nebraska",2000,12076,12916,840,127,93,2072,29590,244,31662,29126,31141
1723,31143,"Polk County, Nebraska",2000,2259,2717,458,5,1,61,5578,29,5639,5543,31143
1724,31145,"Red Willow County, Nebraska",2000,4710,5278,568,18,16,281,11167,113,11448,11020,31145
1725,31147,"Richardson County, Nebraska",2000,3993,4560,567,14,16,100,9431,339,9531,9062,31147
1726,31149,"Rock County, Nebraska",2000,763,935,172,2,0,9,1747,10,1756,1735,31149
1727,31151,"Saline County, Nebraska",2000,5188,5611,423,236,43,911,12932,157,13843,12496,31151
1728,31153,"Sarpy County, Nebraska",2000,43426,44981,1555,2306,5231,5358,117237,2877,122595,106823,31153
1729,31155,"Saunders County, Nebraska",2000,7498,8266,768,40,21,205,19625,154,19830,19410,31155
1730,31157,"Scotts Bluff County, Nebraska",2000,14887,16119,1232,211,87,6352,30599,844,36951,29457,31157
1731,31159,"Seward County, Nebraska",2000,6013,6428,415,48,47,179,16317,145,16496,16077,31159
1732,31161,"Sheridan County, Nebraska",2000,2549,3013,464,7,3,91,6107,667,6198,5430,31161
1733,31163,"Sherman County, Nebraska",2000,1394,1839,445,8,2,34,3284,21,3318,3253,31163
1734,31165,"Sioux County, Nebraska",2000,605,780,175,3,0,34,1441,14,1475,1424,31165
1735,31167,"Stanton County, Nebraska",2000,2297,2452,155,8,27,149,6306,73,6455,6198,31167
1736,31169,"Thayer County, Nebraska",2000,2541,2828,287,7,1,61,5994,44,6055,5942,31169
1737,31171,"Thomas County, Nebraska",2000,325,446,121,0,0,6,723,3,729,720,31171
1738,31173,"Thurston County, Nebraska",2000,2255,2467,212,1,9,174,6997,3725,7171,3262,31173
1739,31175,"Valley County, Nebraska",2000,1965,2273,308,5,2,75,4572,34,4647,4531,31175
1740,31177,"Washington County, Nebraska",2000,6940,7408,468,53,62,202,18578,150,18780,18313,31177
1741,31179,"Wayne County, Nebraska",2000,3437,3662,225,33,91,146,9705,106,9851,9475,31179
1742,31181,"Webster County, Nebraska",2000,1708,1972,264,19,6,22,4039,43,4061,3971,31181
1743,31183,"Wheeler County, Nebraska",2000,352,561,209,0,0,5,881,3,886,878,31183
1744,31185,"York County, Nebraska",2000,5722,6172,450,61,137,205,14393,142,14598,14053,31185
1745,32001,"Churchill County, Nevada",2000,8912,9732,820,621,375,2076,21906,1754,23982,19156,32001
1746,32003,"Clark County, Nevada",2000,512253,559799,47546,71226,121401,302143,1073622,52326,1375765,828669,32003
1747,32005,"Douglas County, Nevada",2000,16401,19006,2605,496,122,3057,38202,1353,41259,36231,32005
1748,32007,"Elko County, Nevada",2000,15638,18456,2818,298,257,8935,36356,3030,45291,32771,32007
1749,32009,"Esmeralda County, Nevada",2000,455,833,378,0,1,99,872,90,971,781,32009
1750,32011,"Eureka County, Nevada",2000,666,1025,359,13,6,158,1493,72,1651,1402,32011
1751,32013,"Humboldt County, Nevada",2000,5733,6954,1221,88,78,3040,13066,915,16106,11985,32013
1752,32015,"Lander County, Nevada",2000,2093,2780,687,20,10,1073,4721,306,5794,4385,32015
1753,32017,"Lincoln County, Nevada",2000,1540,2178,638,13,71,221,3944,151,4165,3709,32017
1754,32019,"Lyon County, Nevada",2000,13007,14279,1272,198,202,3784,30717,1526,34501,28791,32019
1755,32021,"Mineral County, Nevada",2000,2197,2866,669,38,235,428,4643,815,5071,3555,32021
1756,32023,"Nye County, Nevada",2000,13309,15934,2625,242,373,2713,29772,1646,32485,27511,32023
1757,32027,"Pershing County, Nevada",2000,1962,2389,427,34,356,1294,5399,346,6693,4663,32027
1758,32029,"Storey County, Nevada",2000,1462,1596,134,34,9,174,3225,124,3399,3058,32029
1759,32031,"Washoe County, Nevada",2000,132084,143908,11824,14306,6734,56301,283185,14310,339486,247835,32031
1760,32033,"White Pine County, Nevada",2000,3282,4439,1157,71,370,1008,8173,437,9181,7295,32033
1761,32510,"Carson City, Nevada",2000,20171,21283,1112,895,909,7466,44991,1983,52457,41204,32510
1762,33001,"Belknap County, New Hampshire",2000,22459,32121,9662,306,151,418,55907,765,56325,54685,33001
1763,33003,"Carroll County, New Hampshire",2000,18351,34750,16399,164,69,209,43457,483,43666,42741,33003
1764,33005,"Cheshire County, New Hampshire",2000,28299,31876,3577,349,250,529,73296,888,73825,71809,33005
1765,33007,"Coos County, New Hampshire",2000,13961,19623,5662,122,36,201,32910,415,33111,32337,33007
1766,33009,"Grafton County, New Hampshire",2000,31598,43729,12131,1399,419,914,80829,1281,81743,77730,33009
1767,33011,"Hillsborough County, New Hampshire",2000,144455,149961,5506,7554,4493,12166,368675,5291,380841,351337,33011
1768,33013,"Merrimack County, New Hampshire",2000,51843,56244,4401,1158,688,1362,134863,1674,136225,131343,33013
1769,33015,"Rockingham County, New Hampshire",2000,104529,113023,8494,3066,1497,3314,274045,3058,277359,266424,33015
1770,33017,"Strafford County, New Hampshire",2000,42581,45539,2958,1535,658,1155,111078,1521,112233,107364,33017
1771,33019,"Sullivan County, New Hampshire",2000,16530,20158,3628,150,93,221,40237,512,40458,39482,33019
1772,34001,"Atlantic County, New Jersey",2000,95024,114090,19066,12662,42691,30729,221823,4984,252552,161486,34001
1773,34003,"Bergen County, New Jersey",2000,330817,339820,9003,93979,44149,91377,792741,15660,884118,638953,34003
1774,34005,"Burlington County, New Jersey",2000,154371,161311,6940,11281,62476,17632,405762,8834,423394,323171,34005
1775,34007,"Camden County, New Jersey",2000,185744,199679,13935,18710,88017,49166,459766,8041,508932,344998,34007
1776,34009,"Cape May County, New Jersey",2000,42148,91047,48899,655,4978,3378,98948,1178,102326,92137,34009
1777,34011,"Cumberland County, New Jersey",2000,49143,52863,3720,1338,28134,27823,118615,3633,146438,85510,34011
1778,34013,"Essex County, New Jersey",2000,283736,301011,17275,29141,319883,122347,671286,23554,793633,298708,34013
1779,34015,"Gloucester County, New Jersey",2000,90717,95054,4337,3763,22562,6583,248090,3503,254673,218262,34015
1780,34017,"Hudson County, New Jersey",2000,230546,240618,10072,56370,74040,242123,366852,21226,608975,215216,34017
1781,34019,"Hunterdon County, New Jersey",2000,43678,45032,1354,2332,2638,3371,118618,1175,121989,112473,34019
1782,34021,"Mercer County, New Jersey",2000,125807,133280,7473,17250,67922,33898,316863,6407,350761,225284,34021
1783,34023,"Middlesex County, New Jersey",2000,265815,273637,7822,103788,64435,101940,648222,15462,750162,464537,34023
1784,34025,"Monmouth County, New Jersey",2000,224236,240884,16648,24257,47745,38175,577126,9222,615301,495902,34025
1785,34027,"Morris County, New Jersey",2000,169711,174379,4668,29310,12506,36626,433586,6188,470212,385582,34027
1786,34029,"Ocean County, New Jersey",2000,200402,248711,48309,6426,14431,25638,485278,5247,510916,459174,34029
1787,34031,"Passaic County, New Jersey",2000,163856,170048,6192,17747,60528,146492,342557,12595,489049,251687,34031
1788,34033,"Salem County, New Jersey",2000,24295,26158,1863,386,9257,2498,61787,973,64285,51171,34033
1789,34035,"Somerset County, New Jersey",2000,108984,112023,3039,24870,21571,25811,271679,4654,297490,220584,34035
1790,34037,"Sussex County, New Jersey",2000,50831,56528,5697,1723,1444,4822,139344,1553,144166,134624,34037
1791,34039,"Union County, New Jersey",2000,186124,192945,6821,19789,104926,103011,419530,11470,522541,283345,34039
1792,34041,"Warren County, New Jersey",2000,38660,41157,2497,1235,1838,3751,98686,1208,102437,94405,34041
1793,35001,"Bernalillo County, New Mexico",2000,220936,239074,18138,10289,13700,233565,323113,30152,556678,268972,35001
1794,35003,"Catron County, New Mexico",2000,1584,2548,964,23,9,679,2864,145,3543,2687,35003
1795,35005,"Chaves County, New Mexico",2000,22561,25647,3086,290,1088,26904,34478,1130,61382,31970,35005
1796,35006,"Cibola County, New Mexico",2000,8327,10328,2001,91,231,8555,17040,10393,25595,6325,35006
1797,35007,"Colfax County, New Mexico",2000,5821,8959,3138,45,41,6739,7450,283,14189,7081,35007
1798,35009,"Curry County, New Mexico",2000,16766,19212,2446,780,2935,13685,31359,1183,45044,26461,35009
1799,35011,"De Baca County, New Mexico",2000,922,1307,385,5,1,790,1450,37,2240,1407,35011
1800,35013,"Dona Ana County, New Mexico",2000,59556,65210,5654,1241,2261,110665,64017,3827,174682,56688,35013
1801,35015,"Eddy County, New Mexico",2000,19379,22249,2870,204,669,20023,31635,965,51658,29797,35015
1802,35017,"Grant County, New Mexico",2000,12146,14066,1920,79,113,15126,15876,636,31002,15048,35017
1803,35019,"Guadalupe County, New Mexico",2000,1655,2160,505,24,59,3801,879,72,4680,724,35019
1804,35021,"Harding County, New Mexico",2000,371,545,174,0,3,364,446,15,810,428,35021
1805,35023,"Hidalgo County, New Mexico",2000,2152,2848,696,13,15,3324,2608,48,5932,2532,35023
1806,35025,"Lea County, New Mexico",2000,19699,23405,3706,198,2340,22010,33501,986,55511,29977,35025
1807,35027,"Lincoln County, New Mexico",2000,8202,15298,7096,48,47,4975,14436,578,19411,13763,35027
1808,35028,"Los Alamos County, New Mexico",2000,7497,7937,440,690,63,2155,16188,384,18343,15051,35028
1809,35029,"Luna County, New Mexico",2000,9397,11291,1894,78,183,14435,10581,399,25016,9921,35029
1810,35031,"McKinley County, New Mexico",2000,21476,26718,5242,327,287,9276,65522,56006,74798,8902,35031
1811,35033,"Mora County, New Mexico",2000,2017,2973,956,2,5,4229,951,67,5180,877,35033
1812,35035,"Otero County, New Mexico",2000,22984,29272,6288,685,2285,20033,42265,4567,62298,34728,35035
1813,35037,"Quay County, New Mexico",2000,4201,5664,1463,81,78,3857,6298,186,10155,5953,35037
1814,35039,"Rio Arriba County, New Mexico",2000,15044,18016,2972,47,85,30025,11165,5414,41190,5619,35039
1815,35041,"Roosevelt County, New Mexico",2000,6639,7746,1107,97,276,5998,12020,348,18018,11299,35041
1816,35043,"Sandoval County, New Mexico",2000,31411,34866,3455,857,1418,26437,63471,15969,89908,45227,35043
1817,35045,"San Juan County, New Mexico",2000,37711,43221,5510,279,429,17057,96744,43114,113801,52922,35045
1818,35047,"San Miguel County, New Mexico",2000,11134,14254,3120,130,185,23487,6639,634,30126,5690,35047
1819,35049,"Santa Fe County, New Mexico",2000,52482,57701,5219,1082,667,63405,65887,5348,129292,58790,35049
1820,35051,"Sierra County, New Mexico",2000,6113,8727,2614,23,55,3488,9782,348,13270,9356,35051
1821,35053,"Socorro County, New Mexico",2000,6675,7808,1133,198,91,8810,9268,2183,18078,6796,35053
1822,35055,"Taos County, New Mexico",2000,12675,17404,4729,98,81,17370,12609,2308,29979,10122,35055
1823,35057,"Torrance County, New Mexico",2000,6024,7257,1233,51,255,6283,10628,645,16911,9677,35057
1824,35059,"Union County, New Mexico",2000,1733,2225,492,14,0,1465,2709,77,4174,2618,35059
1825,35061,"Valencia County, New Mexico",2000,22681,24643,1962,188,699,36371,29781,2807,66152,26087,35061
1826,36001,"Albany County, New York",2000,120512,129972,9460,8022,31514,9079,285486,5037,294565,240913,36001
1827,36003,"Allegany County, New York",2000,18009,24505,6496,356,349,454,49473,546,49927,48222,36003
1828,36005,"Bronx County, New York",2000,463212,490659,27447,38558,416338,644705,687945,39398,1332650,193651,36005
1829,36007,"Broome County, New York",2000,80749,88817,8068,5549,6256,3986,196550,3406,200536,181339,36007
1830,36009,"Cattaraugus County, New York",2000,32023,39839,7816,381,839,791,83164,3010,83955,78934,36009
1831,36011,"Cayuga County, New York",2000,30558,35477,4919,346,3166,1611,80352,1078,81963,75762,36011
1832,36013,"Chautauqua County, New York",2000,54515,64900,10385,493,2820,5901,133849,2055,139750,128481,36013
1833,36015,"Chemung County, New York",2000,35049,37745,2696,707,5150,1609,89461,1473,91070,82131,36015
1834,36017,"Chenango County, New York",2000,19926,23890,3964,144,403,548,50853,491,51401,49815,36017
1835,36019,"Clinton County, New York",2000,29423,33091,3668,527,2694,1964,77930,980,79894,73729,36019
1836,36021,"Columbia County, New York",2000,24796,30207,5411,493,2738,1598,61496,927,63094,57338,36021
1837,36023,"Cortland County, New York",2000,18210,20116,1906,198,399,565,48034,689,48599,46748,36023
1838,36025,"Delaware County, New York",2000,19270,28952,9682,253,529,983,47072,597,48055,45693,36025
1839,36027,"Dutchess County, New York",2000,99536,106103,6567,6990,25059,18060,262090,5128,280150,224913,36027
1840,36029,"Erie County, New York",2000,380873,415868,34995,13759,121289,31054,919211,16687,950265,767476,36029
1841,36031,"Essex County, New York",2000,15028,23115,8087,159,1025,851,38000,470,38851,36346,36031
1842,36033,"Franklin County, New York",2000,17931,23936,6005,190,3180,2053,49081,3478,51134,42233,36033
1843,36035,"Fulton County, New York",2000,21884,27787,5903,291,937,884,54189,587,55073,52374,36035
1844,36037,"Genesee County, New York",2000,22770,24190,1420,290,1217,904,59466,1160,60370,56799,36037
1845,36039,"Greene County, New York",2000,18256,26544,8288,254,2518,2075,46120,708,48195,42640,36039
1846,36041,"Hamilton County, New York",2000,2362,7965,5603,8,24,57,5322,67,5379,5223,36041
1847,36043,"Herkimer County, New York",2000,25734,32026,6292,255,305,580,63847,620,64427,62667,36043
1848,36045,"Jefferson County, New York",2000,40068,54070,14002,1007,6257,4677,107061,2408,111738,97389,36045
1849,36047,"Kings County, New York",2000,880727,930866,50139,184291,848583,487878,1977448,90042,2465326,854532,36047
1850,36049,"Lewis County, New York",2000,10040,15134,5094,63,100,172,26772,246,26944,26363,36049
1851,36051,"Livingston County, New York",2000,22150,24023,1873,489,1836,1459,62869,796,64328,59748,36051
1852,36053,"Madison County, New York",2000,25368,28646,3278,385,870,734,68707,888,69441,66564,36053
1853,36055,"Monroe County, New York",2000,286512,304388,17876,17772,98174,39065,696278,13569,735343,566763,36055
1854,36057,"Montgomery County, New York",2000,20038,22522,2484,261,457,3433,46275,473,49708,45084,36057
1855,36059,"Nassau County, New York",2000,447387,458151,10764,62744,129860,133282,1201262,21711,1334544,986947,36059
1856,36061,"New York County, New York",2000,738644,798144,59500,143291,234698,417816,1119379,37517,1537195,703873,36061
1857,36063,"Niagara County, New York",2000,87846,95715,7869,1248,13356,2913,216933,4572,219846,197757,36063
1858,36065,"Oneida County, New York",2000,90496,102803,12307,2701,12937,7545,227924,3686,235469,208600,36065
1859,36067,"Onondaga County, New York",2000,181153,196633,15480,9512,41772,11175,447161,12278,458336,383599,36067
1860,36069,"Ontario County, New York",2000,38370,42647,4277,675,1904,2149,98075,1317,100224,94179,36069
1861,36071,"Orange County, New York",2000,114788,122754,7966,5054,25567,39738,301629,6248,341367,264760,36071
1862,36073,"Orleans County, New York",2000,15363,17347,1984,137,3047,1719,42452,716,44171,38552,36073
1863,36075,"Oswego County, New York",2000,45522,52831,7309,498,674,1592,120785,1503,122377,118110,36075
1864,36077,"Otsego County, New York",2000,23291,28481,5190,386,1014,1171,60505,784,61676,58321,36077
1865,36079,"Putnam County, New York",2000,32703,35030,2327,1157,1437,5976,89769,1202,95745,85973,36079
1866,36081,"Queens County, New York",2000,782664,817250,34586,389303,422831,556605,1672774,127745,2229379,732895,36081
1867,36083,"Rensselaer County, New York",2000,59894,66120,6226,2595,6870,3225,149313,2286,152538,137562,36083
1868,36085,"Richmond County, New York",2000,156341,163993,7652,24786,39704,53550,390178,9372,443728,316316,36085
1869,36087,"Rockland County, New York",2000,92675,94973,2298,15707,30139,29182,257571,6072,286753,205653,36087
1870,36089,"St. Lawrence County, New York",2000,40506,49721,9215,793,2531,2008,109923,1822,111931,104777,36089
1871,36091,"Saratoga County, New York",2000,78165,86701,8536,2064,2628,2834,197801,2269,200635,190840,36091
1872,36093,"Schenectady County, New York",2000,59684,65032,5348,2862,9456,4639,141916,3060,146555,126538,36093
1873,36095,"Schoharie County, New York",2000,11991,15915,3924,120,377,588,30994,385,31582,30112,36095
1874,36097,"Schuyler County, New York",2000,7374,9181,1807,55,265,235,18989,252,19224,18417,36097
1875,36099,"Seneca County, New York",2000,12630,14794,2164,225,720,659,32683,400,33342,31338,36099
1876,36101,"Steuben County, New York",2000,39071,46132,7061,889,1329,796,97930,1023,98726,94689,36101
1877,36103,"Suffolk County, New York",2000,469299,522323,53024,34355,93262,149411,1269958,23936,1419369,1118405,36103
1878,36105,"Sullivan County, New York",2000,27661,44730,17069,810,5897,6839,67127,1195,73966,59225,36105
1879,36107,"Tioga County, New York",2000,19725,21410,1685,295,270,509,51275,530,51784,50180,36107
1880,36109,"Tompkins County, New York",2000,36420,38625,2205,6909,3307,2968,93533,2401,96501,80916,36109
1881,36111,"Ulster County, New York",2000,67499,77656,10157,2169,9044,10941,166808,3531,177749,152064,36111
1882,36113,"Warren County, New York",2000,25726,34852,9126,338,371,663,62640,655,63303,61276,36113
1883,36115,"Washington County, New York",2000,22458,26794,4336,168,1703,1232,59810,561,61042,57378,36115
1884,36117,"Wayne County, New York",2000,34908,38767,3859,429,2961,2263,91502,1342,93765,86770,36117
1885,36119,"Westchester County, New York",2000,337142,349445,12303,40941,125227,144124,779335,21391,923459,591776,36119
1886,36121,"Wyoming County, New York",2000,14906,16940,2034,153,2309,1278,42146,354,43424,39330,36121
1887,36123,"Yates County, New York",2000,9029,12064,3035,66,130,228,24393,214,24621,23983,36123
1888,37001,"Alamance County, North Carolina",2000,51584,55463,3879,1154,24356,8835,121965,1687,130800,94768,37001
1889,37003,"Alexander County, North Carolina",2000,13137,14098,961,347,1536,841,32762,317,33603,30562,37003
1890,37005,"Alleghany County, North Carolina",2000,4593,6412,1819,21,118,530,10147,76,10677,9932,37005
1891,37007,"Anson County, North Carolina",2000,9204,10221,1017,143,12245,211,25064,247,25275,12429,37007
1892,37009,"Ashe County, North Carolina",2000,10411,13268,2857,57,155,590,23794,142,24384,23440,37009
1893,37011,"Avery County, North Carolina",2000,6532,11911,5379,33,598,413,16754,166,17167,15957,37011
1894,37013,"Beaufort County, North Carolina",2000,18319,22139,3820,98,13021,1455,43503,333,44958,30051,37013
1895,37015,"Bertie County, North Carolina",2000,7743,9050,1307,20,12277,195,19578,157,19773,7124,37015
1896,37017,"Bladen County, North Carolina",2000,12897,15316,2419,26,12170,1198,31080,849,32278,18035,37017
1897,37019,"Brunswick County, North Carolina",2000,30438,51431,20993,192,10459,1960,71183,1178,73143,59354,37019
1898,37021,"Buncombe County, North Carolina",2000,85776,93973,8197,1354,15310,5730,200600,3215,206330,180721,37021
1899,37023,"Burke County, North Carolina",2000,34528,37427,2899,3093,5953,3180,85968,1195,89148,75727,37023
1900,37025,"Cabarrus County, North Carolina",2000,49519,52848,3329,1160,15778,6620,124443,1475,131063,106030,37025
1901,37027,"Caldwell County, North Carolina",2000,30768,33430,2662,301,4201,1927,75488,679,77415,70307,37027
1902,37029,"Camden County, North Carolina",2000,2662,2973,311,39,1185,49,6836,96,6885,5516,37029
1903,37031,"Carteret County, North Carolina",2000,25204,40947,15743,307,4121,1035,58348,879,59383,53041,37031
1904,37033,"Caswell County, North Carolina",2000,8670,9601,931,36,8557,415,23086,254,23501,14239,37033
1905,37035,"Catawba County, North Carolina",2000,55533,59919,4386,4100,11751,7886,133799,1622,141685,116326,37035
1906,37037,"Chatham County, North Carolina",2000,19741,21358,1617,286,8355,4743,44586,623,49329,35322,37037
1907,37039,"Cherokee County, North Carolina",2000,10336,13499,3163,68,382,303,23995,670,24298,22875,37039
1908,37041,"Chowan County, North Carolina",2000,5580,6443,863,50,5415,219,14307,139,14526,8703,37041
1909,37043,"Clay County, North Carolina",2000,3847,5425,1578,7,70,73,8702,89,8775,8536,37043
1910,37045,"Cleveland County, North Carolina",2000,37046,40317,3271,647,20010,1433,94854,840,96287,73357,37045
1911,37047,"Columbus County, North Carolina",2000,21308,24060,2752,118,16901,1269,53480,2081,54749,34380,37047
1912,37049,"Craven County, North Carolina",2000,34582,38150,3568,881,22729,3677,87759,1714,91436,62435,37049
1913,37051,"Cumberland County, North Carolina",2000,107358,118425,11067,5552,104068,20919,282044,13120,302963,159304,37051
1914,37053,"Currituck County, North Carolina",2000,6902,10687,3785,68,1314,261,17929,260,18190,16287,37053
1915,37055,"Dare County, North Carolina",2000,12690,26671,13981,110,793,666,29301,370,29967,28028,37055
1916,37057,"Davidson County, North Carolina",2000,58156,62432,4276,1188,13389,4765,142481,1746,147246,126158,37057
1917,37059,"Davie County, North Carolina",2000,13750,14953,1203,108,2343,1209,33626,343,34835,30832,37059
1918,37061,"Duplin County, North Carolina",2000,18267,20520,2253,73,14116,7426,41637,354,49063,27094,37061
1919,37063,"Durham County, North Carolina",2000,89015,95452,6437,7311,87516,17039,206275,4077,223314,107371,37063
1920,37065,"Edgecombe County, North Carolina",2000,20392,24002,3610,62,31790,1554,54052,362,55606,21838,37065
1921,37067,"Forsyth County, North Carolina",2000,123851,133093,9242,3133,77041,19577,286490,3978,306067,202338,37067
1922,37069,"Franklin County, North Carolina",2000,17843,20364,2521,137,14124,2100,45160,564,47260,30335,37069
1923,37071,"Gaston County, North Carolina",2000,73936,78842,4906,1802,25843,5719,184646,2079,190365,154922,37071
1924,37073,"Gates County, North Carolina",2000,3901,4389,488,22,4113,81,10435,146,10516,6154,37073
1925,37075,"Graham County, North Carolina",2000,3354,5084,1730,13,15,60,7933,602,7993,7303,37075
1926,37077,"Granville County, North Carolina",2000,16654,17896,1242,173,16854,1951,46547,743,48498,28777,37077
1927,37079,"Greene County, North Carolina",2000,6696,7368,672,17,7792,1511,17463,146,18974,9508,37079
1928,37081,"Guilford County, North Carolina",2000,168667,180391,11724,10211,122279,15985,405063,7726,421048,264847,37081
1929,37083,"Halifax County, North Carolina",2000,22122,25309,3187,310,30018,579,56791,2194,57370,24269,37083
1930,37085,"Harnett County, North Carolina",2000,33800,38605,4805,573,20371,5336,85689,2037,91025,62708,37085
1931,37087,"Haywood County, North Carolina",2000,23100,28640,5540,113,674,763,53270,613,54033,51870,37087
1932,37089,"Henderson County, North Carolina",2000,37414,42996,5582,543,2686,4880,84293,946,89173,80118,37089
1933,37091,"Hertford County, North Carolina",2000,8953,9724,771,69,13375,354,22247,429,22601,8374,37091
1934,37093,"Hoke County, North Carolina",2000,11373,12518,1145,273,12536,2415,31231,4434,33646,13988,37093
1935,37095,"Hyde County, North Carolina",2000,2185,3302,1117,16,2038,131,5695,51,5826,3590,37095
1936,37097,"Iredell County, North Carolina",2000,47360,51918,4558,1535,16620,4182,118478,1296,122660,99027,37097
1937,37099,"Jackson County, North Carolina",2000,13191,19291,6100,161,547,577,32544,3743,33121,28093,37099
1938,37101,"Johnston County, North Carolina",2000,46595,50196,3601,355,18971,9440,112525,1329,121965,91870,37101
1939,37103,"Jones County, North Carolina",2000,4061,4679,618,16,3703,282,10099,124,10381,6256,37103
1940,37105,"Lee County, North Carolina",2000,18466,19909,1443,323,9982,5715,43325,553,49040,32467,37105
1941,37107,"Lenoir County, North Carolina",2000,23862,27184,3322,199,24016,1891,57757,467,59648,33075,37107
1942,37109,"Lincoln County, North Carolina",2000,24041,25717,1676,188,4067,3656,60124,579,63780,55290,37109
1943,37111,"McDowell County, North Carolina",2000,16604,18377,1773,387,1716,1214,40937,461,42151,38373,37111
1944,37113,"Macon County, North Carolina",2000,12828,20746,7918,117,353,454,29357,259,29811,28628,37113
1945,37115,"Madison County, North Carolina",2000,8000,9722,1722,43,160,266,19369,162,19635,19004,37115
1946,37117,"Martin County, North Carolina",2000,10020,10930,910,61,11542,528,25065,198,25593,13264,37117
1947,37119,"Mecklenburg County, North Carolina",2000,273416,292780,19364,21717,192403,44871,650583,11319,695454,425144,37119
1948,37121,"Mitchell County, North Carolina",2000,6551,7919,1368,32,33,311,15376,101,15687,15210,37121
1949,37123,"Montgomery County, North Carolina",2000,9848,14145,4297,412,5805,2797,24025,294,26822,17514,37123
1950,37125,"Moore County, North Carolina",2000,30713,35151,4438,325,11527,2981,71788,1092,74769,58844,37125
1951,37127,"Nash County, North Carolina",2000,33644,37051,3407,477,29505,2939,84481,1173,87420,53326,37127
1952,37129,"New Hanover County, North Carolina",2000,68183,79616,11433,1325,27001,3276,157031,2252,160307,126453,37129
1953,37131,"Northampton County, North Carolina",2000,8691,10455,1764,20,13096,161,21925,206,22086,8603,37131
1954,37133,"Onslow County, North Carolina",2000,48122,55726,7604,2454,27162,10896,139459,5243,150355,104600,37133
1955,37135,"Orange County, North Carolina",2000,45863,49289,3426,4840,16175,5273,112954,2283,118227,89656,37135
1956,37137,"Pamlico County, North Carolina",2000,5178,6781,1603,49,3167,171,12763,163,12934,9384,37137
1957,37139,"Pasquotank County, North Carolina",2000,12907,14289,1382,298,13932,429,34468,573,34897,19665,37139
1958,37141,"Pender County, North Carolina",2000,16054,20798,4744,72,9536,1496,39586,537,41082,29441,37141
1959,37143,"Perquimans County, North Carolina",2000,4645,6043,1398,24,3167,68,11300,94,11368,8015,37143
1960,37145,"Person County, North Carolina",2000,14085,15504,1419,53,10018,746,34877,529,35623,24277,37145
1961,37147,"Pitt County, North Carolina",2000,52539,58408,5869,1429,44819,4216,129582,1721,133798,81613,37147
1962,37149,"Polk County, North Carolina",2000,7908,9192,1284,39,1061,551,17773,169,18324,16504,37149
1963,37151,"Randolph County, North Carolina",2000,50659,54422,3763,807,7259,8646,121808,1492,130454,112250,37151
1964,37153,"Richmond County, North Carolina",2000,17873,19886,2013,299,14160,1319,45245,1264,46564,29522,37153
1965,37155,"Robeson County, North Carolina",2000,43677,47779,4102,385,30827,5994,117345,48134,123339,37999,37155
1966,37157,"Rockingham County, North Carolina",2000,36989,40208,3219,246,17922,2825,89103,912,91928,70023,37157
1967,37159,"Rowan County, North Carolina",2000,49940,53980,4040,1086,20440,5369,124971,1586,130340,101859,37159
1968,37161,"Rutherford County, North Carolina",2000,25191,29535,4344,191,7028,1136,61763,587,62899,53957,37161
1969,37163,"Sampson County, North Carolina",2000,22273,25142,2869,157,17871,6477,53684,1466,60161,34190,37163
1970,37165,"Scotland County, North Carolina",2000,13399,14693,1294,182,13364,423,35575,3631,35998,18398,37165
1971,37167,"Stanly County, North Carolina",2000,22223,24582,2359,1038,6641,1237,56863,573,58100,48611,37167
1972,37169,"Stokes County, North Carolina",2000,17579,19262,1683,82,2068,836,43875,346,44711,41379,37169
1973,37171,"Surry County, North Carolina",2000,28408,31033,2625,399,2911,4620,66599,621,71219,62668,37171
1974,37173,"Swain County, North Carolina",2000,5137,7105,1968,20,214,191,12777,3999,12968,8544,37173
1975,37175,"Transylvania County, North Carolina",2000,12320,15553,3233,111,1228,298,29036,392,29334,27305,37175
1976,37177,"Tyrrell County, North Carolina",2000,1537,2032,495,31,1633,150,3999,32,4149,2303,37177
1977,37179,"Union County, North Carolina",2000,43390,45695,2305,705,15312,7637,116040,1411,123677,98612,37179
1978,37181,"Vance County, North Carolina",2000,16199,18196,1997,163,20604,1957,40997,336,42954,19894,37181
1979,37183,"Wake County, North Carolina",2000,242040,258953,16913,21183,122648,33985,593861,10870,627846,439160,37183
1980,37185,"Warren County, North Carolina",2000,7708,10548,2840,26,10816,317,19655,1117,19972,7696,37185
1981,37187,"Washington County, North Carolina",2000,5367,6174,807,43,6702,311,13412,112,13723,6555,37187
1982,37189,"Watauga County, North Carolina",2000,16540,23155,6615,251,673,622,42073,405,42695,40744,37189
1983,37191,"Wayne County, North Carolina",2000,42612,47313,4701,1063,37230,5604,107725,1676,113329,67756,37191
1984,37193,"Wilkes County, North Carolina",2000,26650,29261,2611,213,2719,2262,63370,461,65632,59977,37193
1985,37195,"Wilson County, North Carolina",2000,28613,30729,2116,286,28886,4457,69357,687,73814,39498,37195
1986,37197,"Yadkin County, North Carolina",2000,14505,15821,1316,61,1219,2357,33991,265,36348,32446,37197
1987,37199,"Yancey County, North Carolina",2000,7472,9729,2257,22,101,478,17296,140,17774,17033,37199
1988,38001,"Adams County, North Dakota",2000,1121,1416,295,4,14,7,2586,18,2593,2550,38001
1989,38003,"Barnes County, North Dakota",2000,4884,5599,715,22,53,64,11711,159,11775,11477,38003
1990,38005,"Benson County, North Dakota",2000,2328,2932,604,1,7,55,6909,3368,6964,3533,38005
1991,38007,"Billings County, North Dakota",2000,366,529,163,0,0,3,885,11,888,874,38007
1992,38009,"Bottineau County, North Dakota",2000,2962,4409,1447,13,15,35,7114,151,7149,6935,38009
1993,38011,"Bowman County, North Dakota",2000,1358,1596,238,1,1,22,3220,23,3242,3195,38011
1994,38013,"Burke County, North Dakota",2000,1013,1412,399,3,3,8,2234,8,2242,2220,38013
1995,38015,"Burleigh County, North Dakota",2000,27670,29003,1333,271,166,468,68948,2825,69416,65686,38015
1996,38017,"Cass County, North Dakota",2000,51315,53790,2475,1543,978,1518,121620,2836,123138,116263,38017
1997,38019,"Cavalier County, North Dakota",2000,2017,2725,708,4,6,31,4800,70,4831,4720,38019
1998,38021,"Dickey County, North Dakota",2000,2283,2656,373,29,6,78,5679,60,5757,5584,38021
1999,38023,"Divide County, North Dakota",2000,1005,1469,464,12,0,14,2269,6,2283,2251,38023
2000,38025,"Dunn County, North Dakota",2000,1378,1965,587,3,1,27,3573,468,3600,3101,38025
2001,38027,"Eddy County, North Dakota",2000,1164,1418,254,4,2,17,2740,85,2757,2649,38027
2002,38029,"Emmons County, North Dakota",2000,1786,2168,382,7,2,50,4281,15,4331,4257,38029
2003,38031,"Foster County, North Dakota",2000,1540,1793,253,0,5,7,3752,30,3759,3717,38031
2004,38033,"Golden Valley County, North Dakota",2000,761,973,212,2,0,20,1904,32,1924,1870,38033
2005,38035,"Grand Forks County, North Dakota",2000,25435,27373,1938,636,871,1359,64750,2442,66109,60801,38035
2006,38037,"Grant County, North Dakota",2000,1195,1722,527,10,0,17,2824,68,2841,2746,38037
2007,38039,"Griggs County, North Dakota",2000,1178,1521,343,4,0,11,2743,10,2754,2729,38039
2008,38041,"Hettinger County, North Dakota",2000,1152,1419,267,2,4,6,2709,22,2715,2681,38041
2009,38043,"Kidder County, North Dakota",2000,1158,1610,452,2,5,16,2737,7,2753,2723,38043
2010,38045,"LaMoure County, North Dakota",2000,1942,2271,329,6,0,26,4675,21,4701,4648,38045
2011,38047,"Logan County, North Dakota",2000,963,1193,230,4,2,16,2292,11,2308,2275,38047
2012,38049,"McHenry County, North Dakota",2000,2526,2983,457,2,5,24,5963,60,5987,5896,38049
2013,38051,"McIntosh County, North Dakota",2000,1467,1853,386,9,0,28,3362,24,3390,3329,38051
2014,38053,"McKenzie County, North Dakota",2000,2151,2719,568,2,4,58,5679,1254,5737,4419,38053
2015,38055,"McLean County, North Dakota",2000,3815,5264,1449,11,2,81,9230,625,9311,8592,38055
2016,38057,"Mercer County, North Dakota",2000,3346,4402,1056,22,4,32,8612,306,8644,8280,38057
2017,38059,"Morton County, North Dakota",2000,9889,10587,698,77,38,164,25139,863,25303,24161,38059
2018,38061,"Mountrail County, North Dakota",2000,2560,3438,878,14,6,87,6544,2166,6631,4358,38061
2019,38063,"Nelson County, North Dakota",2000,1628,2014,386,11,3,6,3709,34,3715,3661,38063
2020,38065,"Oliver County, North Dakota",2000,791,903,112,2,1,13,2052,44,2065,2005,38065
2021,38067,"Pembina County, North Dakota",2000,3535,4115,580,18,12,264,8321,233,8585,8058,38067
2022,38069,"Pierce County, North Dakota",2000,1964,2269,305,12,4,28,4647,47,4675,4584,38069
2023,38071,"Ramsey County, North Dakota",2000,4957,5729,772,31,22,63,12003,838,12066,11112,38071
2024,38073,"Ransom County, North Dakota",2000,2350,2604,254,14,11,48,5842,68,5890,5749,38073
2025,38075,"Renville County, North Dakota",2000,1085,1413,328,12,6,19,2591,38,2610,2535,38075
2026,38077,"Richland County, North Dakota",2000,6885,7575,690,44,62,123,17875,432,17998,17337,38077
2027,38079,"Rolette County, North Dakota",2000,4556,5027,471,10,10,110,13564,10128,13674,3416,38079
2028,38081,"Sargent County, North Dakota",2000,1786,2016,230,2,2,32,4334,52,4366,4278,38081
2029,38083,"Sheridan County, North Dakota",2000,731,924,193,0,2,6,1704,10,1710,1692,38083
2030,38085,"Sioux County, North Dakota",2000,1095,1216,121,1,1,65,3979,3400,4044,577,38085
2031,38087,"Slope County, North Dakota",2000,313,451,138,0,0,1,766,2,767,764,38087
2032,38089,"Stark County, North Dakota",2000,8932,9722,790,50,47,236,22400,381,22636,21922,38089
2033,38091,"Steele County, North Dakota",2000,923,1231,308,1,1,4,2254,32,2258,2220,38091
2034,38093,"Stutsman County, North Dakota",2000,8954,9817,863,79,55,204,21704,329,21908,21241,38093
2035,38095,"Towner County, North Dakota",2000,1218,1558,340,2,2,5,2871,70,2876,2797,38095
2036,38097,"Traill County, North Dakota",2000,3341,3708,367,13,9,185,8292,100,8477,8170,38097
2037,38099,"Walsh County, North Dakota",2000,5029,5757,728,22,24,700,11689,207,12389,11436,38099
2038,38101,"Ward County, North Dakota",2000,23041,25097,2056,474,1262,1125,57670,2148,58795,53786,38101
2039,38103,"Wells County, North Dakota",2000,2215,2643,428,12,7,15,5087,24,5102,5044,38103
2040,38105,"Williams County, North Dakota",2000,8095,9680,1585,36,18,185,19576,1277,19761,18245,38105
2041,39001,"Adams County, Ohio",2000,10501,11822,1321,34,47,175,27155,470,27330,26604,39001
2042,39003,"Allen County, Ohio",2000,40646,44245,3599,594,13130,1545,106928,1848,108473,91356,39003
2043,39005,"Ashland County, Ohio",2000,19524,20832,1308,286,419,339,52184,458,52523,51021,39005
2044,39007,"Ashtabula County, Ohio",2000,39397,43792,4395,332,3165,2292,100436,1455,102728,95484,39007
2045,39009,"Athens County, Ohio",2000,22501,24901,2400,1180,1467,639,61584,1169,62223,57768,39009
2046,39011,"Auglaize County, Ohio",2000,17376,18470,1094,188,109,310,46301,451,46611,45553,39011
2047,39013,"Belmont County, Ohio",2000,28309,31236,2927,209,2547,274,69952,684,70226,66512,39013
2048,39015,"Brown County, Ohio",2000,15555,17193,1638,53,381,185,42100,324,42285,41342,39015
2049,39017,"Butler County, Ohio",2000,123082,129793,6711,5120,17398,4771,328036,4440,332807,301078,39017
2050,39019,"Carroll County, Ohio",2000,11126,13016,1890,33,153,158,28678,299,28836,28193,39019
2051,39021,"Champaign County, Ohio",2000,14952,15890,938,99,891,269,38621,552,38890,37079,39021
2052,39023,"Clark County, Ohio",2000,56648,61056,4408,751,12867,1699,143043,2677,144742,126748,39023
2053,39025,"Clermont County, Ohio",2000,66013,69226,3213,1120,1602,1547,176430,1850,177977,171858,39025
2054,39027,"Clinton County, Ohio",2000,15416,16577,1161,153,881,266,40277,494,40543,38749,39027
2055,39029,"Columbiana County, Ohio",2000,42973,46083,3110,248,2423,1309,110766,1050,112075,107045,39029
2056,39031,"Coshocton County, Ohio",2000,14356,16107,1751,118,395,216,36439,369,36655,35557,39031
2057,39033,"Crawford County, Ohio",2000,18957,20178,1221,145,275,361,46605,398,46966,45787,39033
2058,39035,"Cuyahoga County, Ohio",2000,571457,616903,45446,25019,379397,47078,1346900,23907,1393978,918577,39035
2059,39037,"Darke County, Ohio",2000,20419,21583,1164,132,204,457,52852,470,53309,52046,39037
2060,39039,"Defiance County, Ohio",2000,15138,16040,902,138,657,2857,36643,377,39500,35471,39039
2061,39041,"Delaware County, Ohio",2000,39674,42374,2700,1684,2743,1109,108880,1510,109989,102943,39041
2062,39043,"Erie County, Ohio",2000,31727,35909,4182,297,6820,1664,77887,1260,79551,69510,39043
2063,39045,"Fairfield County, Ohio",2000,45425,47922,2497,878,3245,993,121766,1442,122759,116201,39045
2064,39047,"Fayette County, Ohio",2000,11054,11904,850,130,568,352,28081,361,28433,27022,39047
2065,39049,"Franklin County, Ohio",2000,438778,471016,32238,32652,189652,24279,1044699,26735,1068978,795660,39049
2066,39051,"Fulton County, Ohio",2000,15480,16232,752,172,93,2422,39662,386,42084,39011,39051
2067,39053,"Gallia County, Ohio",2000,12060,13498,1438,110,834,191,30878,476,31069,29458,39053
2068,39055,"Geauga County, Ohio",2000,31630,32805,1175,382,1104,538,90357,710,90895,88161,39055
2069,39057,"Greene County, Ohio",2000,55312,58224,2912,2985,9332,1813,146073,2899,147886,130857,39057
2070,39059,"Guernsey County, Ohio",2000,16094,18771,2677,121,622,254,40538,687,40792,39108,39059
2071,39061,"Hamilton County, Ohio",2000,346790,373393,26603,13530,197192,9514,835789,13300,845303,611767,39061
2072,39063,"Hancock County, Ohio",2000,27898,29785,1887,865,756,2187,69108,754,71295,66733,39063
2073,39065,"Hardin County, Ohio",2000,11963,12907,944,138,220,248,31697,330,31945,31009,39065
2074,39067,"Harrison County, Ohio",2000,6398,7680,1282,16,346,59,15797,171,15856,15264,39067
2075,39069,"Henry County, Ohio",2000,10935,11622,687,124,166,1576,27634,193,29210,27151,39069
2076,39071,"Highland County, Ohio",2000,15587,17583,1996,128,603,216,40659,456,40875,39472,39071
2077,39073,"Hocking County, Ohio",2000,10843,12141,1298,22,257,124,28117,399,28241,27439,39073
2078,39075,"Holmes County, Ohio",2000,11337,12280,943,20,122,292,38651,179,38943,38330,39075
2079,39077,"Huron County, Ohio",2000,22307,23594,1287,149,557,2117,57370,607,59487,56057,39077
2080,39079,"Jackson County, Ohio",2000,12619,13909,1290,56,192,197,32444,364,32641,31832,39079
2081,39081,"Jefferson County, Ohio",2000,30417,33291,2874,245,4192,459,73435,949,73894,68049,39081
2082,39083,"Knox County, Ohio",2000,19975,21793,1818,186,361,371,54129,593,54500,52989,39083
2083,39085,"Lake County, Ohio",2000,89700,93487,3787,2034,4447,3879,223632,2270,227511,214881,39085
2084,39087,"Lawrence County, Ohio",2000,24732,27189,2457,117,1297,355,61964,635,62319,59915,39087
2085,39089,"Licking County, Ohio",2000,55609,58760,3151,841,2966,1107,144384,2079,145491,138498,39089
2086,39091,"Logan County, Ohio",2000,17956,21571,3615,181,778,332,45673,667,46005,44047,39091
2087,39093,"Lorain County, Ohio",2000,105836,111368,5532,1665,23365,19676,264988,5361,284664,234597,39093
2088,39095,"Lucas County, Ohio",2000,182847,196259,13412,5470,76495,20670,434384,9273,455054,343146,39095
2089,39097,"Madison County, Ohio",2000,13672,14399,727,175,2505,294,39919,495,40213,36744,39097
2090,39099,"Mahoning County, Ohio",2000,102587,111762,9175,1203,40270,7640,249915,3473,257555,204969,39099
2091,39101,"Marion County, Ohio",2000,24578,26298,1720,340,3779,723,65494,795,66217,60580,39101
2092,39103,"Medina County, Ohio",2000,54542,56793,2251,962,1304,1399,149696,1470,151095,145960,39103
2093,39105,"Meigs County, Ohio",2000,9234,10782,1548,24,159,138,22934,290,23072,22461,39105
2094,39107,"Mercer County, Ohio",2000,14756,15875,1119,113,39,470,40454,288,40924,40014,39107
2095,39109,"Miami County, Ohio",2000,38437,40554,2117,770,1923,721,98147,1192,98868,94262,39109
2096,39111,"Monroe County, Ohio",2000,6021,7212,1191,10,38,62,15118,126,15180,14944,39111
2097,39113,"Montgomery County, Ohio",2000,229229,248443,19214,7267,110454,7096,551966,10062,559062,424183,39113
2098,39115,"Morgan County, Ohio",2000,5890,7771,1881,12,504,61,14836,412,14897,13908,39115
2099,39117,"Morrow County, Ohio",2000,11499,12132,633,46,84,183,31445,331,31628,30984,39117
2100,39119,"Muskingum County, Ohio",2000,32518,35163,2645,230,3364,436,84149,1433,84585,79122,39119
2101,39121,"Noble County, Ohio",2000,4546,5480,934,13,938,60,13998,88,14058,12959,39121
2102,39123,"Ottawa County, Ohio",2000,16474,25532,9058,93,260,1535,39450,330,40985,38767,39123
2103,39125,"Paulding County, Ohio",2000,7773,8478,705,31,188,612,19681,235,20293,19227,39125
2104,39127,"Perry County, Ohio",2000,12500,13655,1155,33,73,152,33926,347,34078,33473,39127
2105,39129,"Pickaway County, Ohio",2000,17599,18596,997,116,3383,333,52394,645,52727,48250,39129
2106,39131,"Pike County, Ohio",2000,10444,11602,1158,51,240,155,27540,583,27695,26666,39131
2107,39133,"Portage County, Ohio",2000,56449,60096,3647,1238,4812,1093,150968,2093,152061,142825,39133
2108,39135,"Preble County, Ohio",2000,16001,17186,1185,109,135,181,42156,335,42337,41577,39135
2109,39137,"Putnam County, Ohio",2000,12200,12753,553,61,45,1521,33205,183,34726,32916,39137
2110,39139,"Richland County, Ohio",2000,49534,53062,3528,651,12082,1200,127652,2009,128852,112910,39139
2111,39141,"Ross County, Ohio",2000,27136,29461,2325,258,4534,429,72916,1133,73345,66991,39141
2112,39143,"Sandusky County, Ohio",2000,23717,25253,1536,170,1620,4298,57494,689,61792,55015,39143
2113,39145,"Scioto County, Ohio",2000,30871,34054,3183,189,2147,477,78718,1523,79195,74859,39145
2114,39147,"Seneca County, Ohio",2000,22292,23692,1400,218,1016,1972,56711,656,58683,54821,39147
2115,39149,"Shelby County, Ohio",2000,17636,18682,1046,459,710,383,47527,589,47910,45769,39149
2116,39151,"Stark County, Ohio",2000,148316,157024,8708,2040,27039,3492,374606,6517,378098,339010,39151
2117,39153,"Summit County, Ohio",2000,217788,230880,13092,7604,71218,4781,538118,8676,542899,450620,39153
2118,39155,"Trumbull County, Ohio",2000,89020,95117,6097,987,17628,1794,223322,2754,225116,201953,39155
2119,39157,"Tuscarawas County, Ohio",2000,35653,38113,2460,220,655,650,90264,813,90914,88576,39157
2120,39159,"Union County, Ohio",2000,14346,15217,871,220,1139,309,40600,446,40909,38795,39159
2121,39161,"Van Wert County, Ohio",2000,11587,12363,776,57,222,462,29197,231,29659,28687,39161
2122,39163,"Vinton County, Ohio",2000,4892,5653,761,11,45,60,12746,172,12806,12518,39163
2123,39165,"Warren County, Ohio",2000,55966,58692,2726,1978,4272,1633,156750,1650,158383,148850,39165
2124,39167,"Washington County, Ohio",2000,25137,27760,2623,274,580,324,62927,753,63251,61320,39167
2125,39169,"Wayne County, Ohio",2000,40445,42324,1879,732,1723,837,110727,1121,111564,107151,39169
2126,39171,"Williams County, Ohio",2000,15105,16140,1035,199,278,1049,38139,324,39188,37338,39171
2127,39173,"Wood County, Ohio",2000,45172,47468,2296,1241,1492,4033,117032,1386,121065,112913,39173
2128,39175,"Wyandot County, Ohio",2000,8882,9324,442,115,32,334,22574,138,22908,22289,39175
2129,40001,"Adair County, Oklahoma",2000,7471,8348,877,18,33,657,20381,10295,21038,10035,40001
2130,40003,"Alfalfa County, Oklahoma",2000,2199,2832,633,7,250,177,5928,277,6105,5394,40003
2131,40005,"Atoka County, Oklahoma",2000,4964,5673,709,31,814,196,13683,2374,13879,10464,40005
2132,40007,"Beaver County, Oklahoma",2000,2245,2719,474,4,15,630,5227,136,5857,5072,40007
2133,40009,"Beckham County, Oklahoma",2000,7356,8796,1440,81,1058,1079,18720,821,19799,16760,40009
2134,40011,"Blaine County, Oklahoma",2000,4159,5208,1049,75,782,793,11183,1504,11976,8822,40011
2135,40013,"Bryan County, Oklahoma",2000,14422,16715,2293,156,519,967,35567,6072,36534,28820,40013
2136,40015,"Caddo County, Oklahoma",2000,10957,13096,2139,51,872,1894,28256,8019,30150,19314,40015
2137,40017,"Canadian County, Oklahoma",2000,31484,33969,2485,2110,1833,3386,84311,5800,87697,74568,40017
2138,40019,"Carter County, Oklahoma",2000,17992,20577,2585,275,3435,1269,44352,5587,45621,35055,40019
2139,40021,"Cherokee County, Oklahoma",2000,16175,19499,3324,115,504,1760,40761,16659,42521,23483,40021
2140,40023,"Choctaw County, Oklahoma",2000,6220,7539,1319,22,1671,246,15096,2994,15342,10409,40023
2141,40025,"Cimarron County, Oklahoma",2000,1257,1583,326,5,17,485,2663,90,3148,2551,40025
2142,40027,"Cleveland County, Oklahoma",2000,79186,84844,5658,5880,7299,8396,199620,16908,208016,169533,40027
2143,40029,"Coal County, Oklahoma",2000,2373,2744,371,19,22,129,5902,1370,6031,4491,40029
2144,40031,"Comanche County, Oklahoma",2000,39808,45416,5608,2322,21381,9675,105321,10314,114996,71304,40031
2145,40033,"Cotton County, Oklahoma",2000,2614,3085,471,8,188,321,6293,622,6614,5475,40033
2146,40035,"Craig County, Oklahoma",2000,5620,6459,839,26,459,179,14771,4111,14950,10175,40035
2147,40037,"Creek County, Oklahoma",2000,25289,27986,2697,175,1702,1283,66084,9364,67367,54843,40037
2148,40039,"Custer County, Oklahoma",2000,10136,11675,1539,221,739,2361,23781,2078,26142,20743,40039
2149,40041,"Delaware County, Oklahoma",2000,14838,22290,7452,63,46,649,36428,10574,37077,25745,40041
2150,40043,"Dewey County, Oklahoma",2000,1962,2425,463,3,6,127,4616,308,4743,4299,40043
2151,40045,"Ellis County, Oklahoma",2000,1769,2146,377,4,2,106,3969,99,4075,3864,40045
2152,40047,"Garfield County, Oklahoma",2000,23175,26047,2872,487,1860,2387,55426,2812,57813,50267,40047
2153,40049,"Garvin County, Oklahoma",2000,10865,12641,1776,58,692,924,26286,2831,27210,22705,40049
2154,40051,"Grady County, Oklahoma",2000,17341,19444,2103,153,1379,1316,44200,3500,45516,39168,40051
2155,40053,"Grant County, Oklahoma",2000,2089,2622,533,7,4,95,5049,187,5144,4851,40053
2156,40055,"Greer County, Oklahoma",2000,2237,2788,551,16,528,451,5610,297,6061,4769,40055
2157,40057,"Harmon County, Oklahoma",2000,1266,1647,381,6,303,748,2535,65,3283,2161,40057
2158,40059,"Harper County, Oklahoma",2000,1509,1863,354,2,1,201,3361,48,3562,3310,40059
2159,40061,"Haskell County, Oklahoma",2000,4624,5573,949,32,72,177,11615,2377,11792,9134,40061
2160,40063,"Hughes County, Oklahoma",2000,5319,6237,918,30,632,353,13801,2975,14154,10164,40063
2161,40065,"Jackson County, Oklahoma",2000,10590,12377,1787,323,2245,4446,23993,1096,28439,20329,40065
2162,40067,"Jefferson County, Oklahoma",2000,2716,3373,657,77,38,478,6340,516,6818,5709,40067
2163,40069,"Johnston County, Oklahoma",2000,4057,4782,725,28,174,260,10253,2124,10513,7927,40069
2164,40071,"Kay County, Oklahoma",2000,19157,21804,2647,246,850,2045,46035,5252,48080,39687,40071
2165,40073,"Kingfisher County, Oklahoma",2000,5247,5879,632,29,213,961,12965,731,13926,11992,40073
2166,40075,"Kiowa County, Oklahoma",2000,4208,5304,1096,30,466,689,9538,808,10227,8234,40075
2167,40077,"Latimer County, Oklahoma",2000,3951,4709,758,18,99,164,10528,2664,10692,7747,40077
2168,40079,"Le Flore County, Oklahoma",2000,17861,20142,2281,97,1059,1849,46260,7397,48109,37707,40079
2169,40081,"Lincoln County, Oklahoma",2000,12178,13712,1534,77,780,483,31597,3242,32080,27498,40081
2170,40083,"Logan County, Oklahoma",2000,12389,13906,1517,112,3700,987,32937,1900,33924,27225,40083
2171,40085,"Love County, Oklahoma",2000,3442,4066,624,23,191,619,8212,819,8831,7179,40085
2172,40087,"McClain County, Oklahoma",2000,10331,11189,858,58,175,1349,26391,2489,27740,23669,40087
2173,40089,"McCurtain County, Oklahoma",2000,13216,15427,2211,73,3173,1064,33338,6170,34402,23922,40089
2174,40091,"McIntosh County, Oklahoma",2000,8085,12640,4555,27,772,248,19208,4396,19456,14013,40091
2175,40093,"Major County, Oklahoma",2000,3046,3540,494,7,14,303,7242,145,7545,7076,40093
2176,40095,"Marshall County, Oklahoma",2000,5371,8517,3146,24,235,1134,12050,1704,13184,10087,40095
2177,40097,"Mayes County, Oklahoma",2000,14823,17423,2600,108,111,718,37651,10059,38369,27373,40097
2178,40099,"Murray County, Oklahoma",2000,5003,6479,1476,38,236,397,12226,1954,12623,9998,40099
2179,40101,"Muskogee County, Oklahoma",2000,26458,29575,3117,394,9076,1857,67594,14518,69451,43606,40101
2180,40103,"Noble County, Oklahoma",2000,4504,5082,578,38,179,205,11206,1203,11411,9786,40103
2181,40105,"Nowata County, Oklahoma",2000,4147,4705,558,13,260,130,10439,2570,10569,7596,40105
2182,40107,"Okfuskee County, Oklahoma",2000,4270,5114,844,9,1224,194,11620,2723,11814,7664,40107
2183,40109,"Oklahoma County, Oklahoma",2000,266834,295020,28186,18389,98217,57336,603112,43346,660448,443160,40109
2184,40111,"Okmulgee County, Oklahoma",2000,15300,17316,2016,74,4030,772,38913,7414,39685,27395,40111
2185,40113,"Osage County, Oklahoma",2000,16617,18826,2209,99,4773,940,43497,9245,44437,29380,40113
2186,40115,"Ottawa County, Oklahoma",2000,12984,14842,1858,97,192,1061,32133,7651,33194,24193,40115
2187,40117,"Pawnee County, Oklahoma",2000,6383,7464,1081,33,113,192,16420,2702,16612,13572,40117
2188,40119,"Payne County, Oklahoma",2000,26680,29326,2646,2034,2455,1463,66727,5445,68190,56793,40119
2189,40121,"Pittsburg County, Oklahoma",2000,17157,21520,4363,113,1753,939,43014,7620,43953,33528,40121
2190,40123,"Pontotoc County, Oklahoma",2000,13978,15575,1597,156,717,808,34335,7170,35143,26292,40123
2191,40125,"Pottawatomie County, Oklahoma",2000,24540,27302,2762,389,1881,1544,63977,10082,65521,51625,40125
2192,40127,"Pushmataha County, Oklahoma",2000,4739,5795,1056,11,87,191,11476,2381,11667,8997,40127
2193,40129,"Roger Mills County, Oklahoma",2000,1428,1749,321,2,10,91,3345,233,3436,3100,40129
2194,40131,"Rogers County, Oklahoma",2000,25724,27476,1752,219,504,1294,69347,12850,70641,55774,40131
2195,40133,"Seminole County, Oklahoma",2000,9575,11146,1571,53,1375,552,24342,5513,24894,17401,40133
2196,40135,"Sequoyah County, Oklahoma",2000,14761,16940,2179,80,715,793,38179,11100,38972,26284,40135
2197,40137,"Stephens County, Oklahoma",2000,17463,19854,2391,128,936,1709,41473,3181,43182,37228,40137
2198,40139,"Texas County, Oklahoma",2000,7153,8014,861,107,114,6003,14104,463,20107,13420,40139
2199,40141,"Tillman County, Oklahoma",2000,3594,4342,748,26,828,1641,7646,428,9287,6364,40141
2200,40143,"Tulsa County, Oklahoma",2000,226892,243953,17061,9037,61089,33616,529683,51408,563299,408149,40143
2201,40145,"Wagoner County, Oklahoma",2000,21010,23174,2164,292,2135,1437,56054,8275,57491,45352,40145
2202,40147,"Washington County, Oklahoma",2000,20179,22250,2071,357,1205,1293,47703,7004,48996,39137,40147
2203,40149,"Washita County, Oklahoma",2000,4506,5452,946,28,50,516,10992,508,11508,10406,40149
2204,40151,"Woods County, Oklahoma",2000,3684,4492,808,48,212,220,8869,255,9089,8354,40151
2205,40153,"Woodward County, Oklahoma",2000,7141,8341,1200,89,202,896,17590,607,18486,16692,40153
2206,41001,"Baker County, Oregon",2000,6883,8402,1519,62,37,392,16349,412,16741,15838,41001
2207,41003,"Benton County, Oregon",2000,30145,31980,1835,3493,637,3645,74508,2562,78153,67816,41003
2208,41005,"Clackamas County, Oregon",2000,128201,136954,8753,8216,2056,16744,321647,9827,338391,301548,41005
2209,41007,"Clatsop County, Oregon",2000,14703,19685,4982,423,156,1597,34033,1090,35630,32364,41007
2210,41009,"Columbia County, Oregon",2000,16375,17572,1197,246,97,1093,42467,1548,43560,40576,41009
2211,41011,"Coos County, Oregon",2000,26213,29247,3034,553,169,2133,60646,3308,62779,56616,41011
2212,41013,"Crook County, Oregon",2000,7354,8264,910,82,6,1082,18100,480,19182,17532,41013
2213,41015,"Curry County, Oregon",2000,9543,11406,1863,144,31,761,20376,995,21137,19206,41015
2214,41017,"Deschutes County, Oregon",2000,45595,54583,8988,831,207,4304,111063,2848,115367,107177,41017
2215,41019,"Douglas County, Oregon",2000,39821,43284,3463,601,165,3283,97116,4048,100399,92302,41019
2216,41021,"Gilliam County, Oregon",2000,819,1043,224,3,3,35,1880,35,1915,1839,41021
2217,41023,"Grant County, Oregon",2000,3246,4004,758,15,8,163,7772,243,7935,7506,41023
2218,41025,"Harney County, Oregon",2000,3036,3533,497,39,9,316,7293,422,7609,6823,41025
2219,41027,"Hood River County, Oregon",2000,7248,7818,570,294,66,5107,15304,518,20411,14426,41027
2220,41029,"Jackson County, Oregon",2000,71532,75737,4205,1583,674,12126,169143,6091,181269,160795,41029
2221,41031,"Jefferson County, Oregon",2000,6727,8319,1592,54,43,3372,15637,3205,19009,12335,41031
2222,41033,"Josephine County, Oregon",2000,31000,33239,2239,460,192,3229,72497,2612,75726,69233,41033
2223,41035,"Klamath County, Oregon",2000,25205,28883,3678,482,362,4961,58814,4311,63775,53659,41035
2224,41037,"Lake County, Oregon",2000,3084,3999,915,53,8,404,7018,340,7422,6617,41037
2225,41039,"Lane County, Oregon",2000,130453,138946,8493,6390,2391,14874,308085,13229,322959,286075,41039
2226,41041,"Lincoln County, Oregon",2000,19296,26889,7593,412,113,2119,42360,2575,44479,39260,41041
2227,41043,"Linn County, Oregon",2000,39541,42521,2980,789,285,4514,98555,3469,103069,94012,41043
2228,41045,"Malheur County, Oregon",2000,10221,11233,1012,608,369,8099,23516,787,31615,21752,41045
2229,41047,"Marion County, Oregon",2000,101641,108174,6533,4905,2274,48714,236120,11061,284834,217880,41047
2230,41049,"Morrow County, Oregon",2000,3776,4276,500,45,14,2686,8309,339,10995,7911,41049
2231,41051,"Multnomah County, Oregon",2000,272098,288561,16463,37344,36592,49607,610879,31451,660486,505492,41051
2232,41053,"Polk County, Oregon",2000,23058,24461,1403,671,229,5480,56900,2606,62380,53394,41053
2233,41055,"Sherman County, Oregon",2000,797,935,138,8,0,94,1840,50,1934,1782,41055
2234,41057,"Tillamook County, Oregon",2000,10200,15906,5706,154,42,1244,23018,736,24262,22086,41057
2235,41059,"Umatilla County, Oregon",2000,25195,27676,2481,518,535,11366,59182,3459,70548,54670,41059
2236,41061,"Union County, Oregon",2000,9740,10603,863,204,117,600,23930,766,24530,22843,41061
2237,41063,"Wallowa County, Oregon",2000,3029,3900,871,17,2,125,7101,164,7226,6918,41063
2238,41065,"Wasco County, Oregon",2000,9401,10651,1250,189,65,2214,21577,1356,23791,19967,41065
2239,41067,"Washington County, Oregon",2000,169162,178913,9751,29552,4778,49735,395607,15026,445342,346251,41067
2240,41069,"Wheeler County, Oregon",2000,653,842,189,4,1,79,1468,32,1547,1431,41069
2241,41071,"Yamhill County, Oregon",2000,28732,30270,1538,889,592,9017,75975,2810,84992,71684,41071
2242,42001,"Adams County, Pennsylvania",2000,33652,35831,2179,446,1046,3323,87969,919,91292,85558,42001
2243,42003,"Allegheny County, Pennsylvania",2000,537150,583646,46496,21635,158049,11166,1270500,16687,1281666,1074129,42003
2244,42005,"Armstrong County, Pennsylvania",2000,29005,32387,3382,82,578,308,72084,448,72392,70976,42005
2245,42007,"Beaver County, Pennsylvania",2000,72576,77765,5189,450,10728,1315,180097,1901,181412,167018,42007
2246,42009,"Bedford County, Pennsylvania",2000,19768,23529,3761,142,167,263,49721,323,49984,49089,42009
2247,42011,"Berks County, Pennsylvania",2000,141570,150222,8652,3713,12478,36357,337281,4065,373638,317025,42011
2248,42013,"Blair County, Pennsylvania",2000,51518,55061,3543,461,1495,662,128482,885,129144,125641,42013
2249,42015,"Bradford County, Pennsylvania",2000,24453,28664,4211,283,249,398,62363,612,62761,61219,42015
2250,42017,"Bucks County, Pennsylvania",2000,218725,225498,6773,13545,18970,14005,583630,6382,597635,544733,42017
2251,42019,"Butler County, Pennsylvania",2000,65862,69868,4006,973,1343,1016,173067,1117,174083,169634,42019
2252,42021,"Cambria County, Pennsylvania",2000,60531,65796,5265,569,4224,1352,151246,1123,152598,145330,42021
2253,42023,"Cameron County, Pennsylvania",2000,2465,4592,2127,7,21,34,5940,30,5974,5882,42023
2254,42025,"Carbon County, Pennsylvania",2000,23701,30492,6791,183,333,858,57944,476,58802,56952,42025
2255,42027,"Centre County, Pennsylvania",2000,49323,53161,3838,5354,3469,2243,133515,1637,135758,123055,42027
2256,42029,"Chester County, Pennsylvania",2000,157905,163773,5868,8400,26395,16126,417375,4655,433501,377925,42029
2257,42031,"Clarion County, Pennsylvania",2000,16052,19426,3374,141,325,172,41593,260,41765,40867,42031
2258,42033,"Clearfield County, Pennsylvania",2000,32785,37855,5070,220,1236,471,82911,450,83382,81005,42033
2259,42035,"Clinton County, Pennsylvania",2000,14773,18166,3393,150,189,205,37709,245,37914,37125,42035
2260,42037,"Columbia County, Pennsylvania",2000,24915,27733,2818,332,481,609,63542,460,64151,62269,42037
2261,42039,"Crawford County, Pennsylvania",2000,34678,42416,7738,254,1428,537,89829,884,90366,87263,42039
2262,42041,"Cumberland County, Pennsylvania",2000,83015,86951,3936,3556,4959,2883,210791,2351,213674,199925,42041
2263,42043,"Dauphin County, Pennsylvania",2000,102670,111133,8463,4906,41709,10404,241394,4432,251798,190347,42043
2264,42045,"Delaware County, Pennsylvania",2000,206320,216978,10658,18022,79070,8368,542496,6988,550864,438416,42045
2265,42047,"Elk County, Pennsylvania",2000,14124,18115,3991,120,47,142,34970,160,35112,34643,42047
2266,42049,"Erie County, Pennsylvania",2000,106507,114322,7815,1902,16876,6126,274717,3681,280843,252258,42049
2267,42051,"Fayette County, Pennsylvania",2000,59969,66490,6521,316,5191,564,148080,1308,148644,141265,42051
2268,42053,"Forest County, Pennsylvania",2000,2000,8701,6701,6,110,60,4886,51,4946,4719,42053
2269,42055,"Franklin County, Pennsylvania",2000,50633,53803,3170,702,2891,2268,127045,1260,129313,122192,42055
2270,42057,"Fulton County, Pennsylvania",2000,5660,6790,1130,15,87,52,14209,129,14261,13978,42057
2271,42059,"Greene County, Pennsylvania",2000,15060,16678,1618,86,1579,357,40315,285,40672,38365,42059
2272,42061,"Huntingdon County, Pennsylvania",2000,16759,21058,4299,94,2334,524,45062,329,45586,42305,42061
2273,42063,"Indiana County, Pennsylvania",2000,34123,37250,3127,662,1391,457,89148,602,89605,86493,42063
2274,42065,"Jefferson County, Pennsylvania",2000,18375,22104,3729,94,49,188,45744,281,45932,45320,42065
2275,42067,"Juniata County, Pennsylvania",2000,8584,10031,1447,57,68,369,22452,122,22821,22205,42067
2276,42069,"Lackawanna County, Pennsylvania",2000,86218,95362,9144,1582,2662,2958,210337,1533,213295,204560,42069
2277,42071,"Lancaster County, Pennsylvania",2000,172560,179990,7430,6723,11837,26742,443916,4990,470658,420366,42071
2278,42073,"Lawrence County, Pennsylvania",2000,37091,39635,2544,254,3393,529,94114,894,94643,89573,42073
2279,42075,"Lebanon County, Pennsylvania",2000,46551,49320,2769,1055,1298,5969,114358,971,120327,111034,42075
2280,42077,"Lehigh County, Pennsylvania",2000,121906,128910,7004,6488,9798,31881,280209,4112,312090,259811,42077
2281,42079,"Luzerne County, Pennsylvania",2000,130687,144686,13999,1856,5202,3713,315537,1951,319250,306528,42079
2282,42081,"Lycoming County, Pennsylvania",2000,47003,52464,5461,503,5141,799,119245,1295,120044,112306,42081
2283,42083,"McKean County, Pennsylvania",2000,18024,21644,3620,138,829,485,45451,406,45936,44078,42083
2284,42085,"Mercer County, Pennsylvania",2000,46712,49859,3147,477,6279,803,119490,1227,120293,111507,42085
2285,42087,"Mifflin County, Pennsylvania",2000,18413,20745,2332,135,216,263,46223,228,46486,45644,42087
2286,42089,"Monroe County, Pennsylvania",2000,49454,67581,18127,1518,7902,9195,129492,2480,138687,117592,42089
2287,42091,"Montgomery County, Pennsylvania",2000,286098,297434,11336,30126,55303,15300,734797,9349,750097,640019,42091
2288,42093,"Montour County, Pennsylvania",2000,7085,7627,542,232,182,167,18069,103,18236,17552,42093
2289,42095,"Northampton County, Pennsylvania",2000,101541,106710,5169,3610,6886,17868,249198,3036,267066,235666,42095
2290,42097,"Northumberland County, Pennsylvania",2000,38835,43164,4329,206,1397,1041,93515,598,94556,91314,42097
2291,42099,"Perry County, Pennsylvania",2000,16695,18941,2246,65,182,301,43301,282,43602,42772,42099
2292,42101,"Philadelphia County, Pennsylvania",2000,590071,661958,71887,67119,646123,128928,1388622,30985,1517550,644395,42101
2293,42103,"Pike County, Pennsylvania",2000,17433,34681,17248,283,1430,2315,43987,705,46302,41569,42103
2294,42105,"Potter County, Pennsylvania",2000,7005,12159,5154,90,52,103,17977,175,18080,17660,42105
2295,42107,"Schuylkill County, Pennsylvania",2000,60530,67806,7276,622,3049,1671,148665,704,150336,144290,42107
2296,42109,"Snyder County, Pennsylvania",2000,13654,14890,1236,153,288,368,37178,178,37546,36559,42109
2297,42111,"Somerset County, Pennsylvania",2000,31222,37163,5941,172,1268,532,79491,315,80023,77736,42111
2298,42113,"Sullivan County, Pennsylvania",2000,2660,6017,3357,9,140,72,6484,96,6556,6239,42113
2299,42115,"Susquehanna County, Pennsylvania",2000,16529,21829,5300,91,117,285,41953,316,42238,41429,42115
2300,42117,"Tioga County, Pennsylvania",2000,15925,19893,3968,124,243,214,41159,340,41373,40452,42117
2301,42119,"Union County, Pennsylvania",2000,13178,14684,1506,427,2640,1622,40002,480,41624,36455,42119
2302,42121,"Venango County, Pennsylvania",2000,22747,26904,4157,131,614,298,57267,506,57565,56016,42121
2303,42123,"Warren County, Pennsylvania",2000,17696,23058,5362,116,89,151,43712,331,43863,43176,42123
2304,42125,"Washington County, Pennsylvania",2000,81130,87267,6137,711,6554,1170,201727,1951,202897,192511,42125
2305,42127,"Wayne County, Pennsylvania",2000,18350,30593,12243,178,731,811,46911,355,47722,45647,42127
2306,42129,"Westmoreland County, Pennsylvania",2000,149813,161058,11245,1897,7375,1869,368124,2908,369993,355944,42129
2307,42131,"Wyoming County, Pennsylvania",2000,10762,12713,1951,77,137,187,27893,206,28080,27473,42131
2308,42133,"York County, Pennsylvania",2000,148219,156720,8501,3250,13515,11296,370455,4234,381751,349456,42133
2309,44001,"Bristol County, Rhode Island",2000,19033,19881,848,500,331,572,50076,594,50648,48651,44001
2310,44003,"Kent County, Rhode Island",2000,67320,70365,3045,2220,1451,2827,164263,2506,167090,158086,44003
2311,44005,"Newport County, Rhode Island",2000,35228,39561,4333,1033,2988,2409,83024,2063,85433,76940,44005
2312,44007,"Providence County, Rhode Island",2000,239936,253214,13278,17813,36078,83232,538370,25857,621602,458622,44007
2313,44009,"Washington County, Rhode Island",2000,46907,56816,9909,1850,1074,1780,121766,2708,123546,116134,44009
2314,45001,"Abbeville County, South Carolina",2000,10131,11656,1525,59,7879,217,25950,215,26167,17797,45001
2315,45003,"Aiken County, South Carolina",2000,55587,61987,6400,896,36254,3025,139527,2048,142552,100329,45003
2316,45005,"Allendale County, South Carolina",2000,3915,4568,653,13,7927,181,11030,60,11211,3030,45005
2317,45007,"Anderson County, South Carolina",2000,65649,73213,7564,698,27399,1832,163908,1660,165740,134151,45007
2318,45009,"Bamberg County, South Carolina",2000,6123,7130,1007,32,10352,118,16540,116,16658,6040,45009
2319,45011,"Barnwell County, South Carolina",2000,9021,10191,1170,89,9957,327,23151,248,23478,12857,45011
2320,45013,"Beaufort County, South Carolina",2000,45532,60509,14977,938,28654,8208,112729,1660,120937,81477,45013
2321,45015,"Berkeley County, South Carolina",2000,49922,54717,4795,2636,37739,3935,138716,3027,142651,95314,45015
2322,45017,"Calhoun County, South Carolina",2000,5917,6864,947,21,7326,212,14973,105,15185,7521,45017
2323,45019,"Charleston County, South Carolina",2000,123326,141031,17705,3410,106337,7434,302535,4246,309969,188542,45019
2324,45021,"Cherokee County, South Carolina",2000,20495,22400,1905,162,10751,1092,51445,519,52537,40013,45021
2325,45023,"Chester County, South Carolina",2000,12880,14374,1494,96,13109,255,33813,304,34068,20304,45023
2326,45025,"Chesterfield County, South Carolina",2000,16557,18818,2261,125,14044,971,41797,456,42768,27172,45025
2327,45027,"Clarendon County, South Carolina",2000,11812,15303,3491,82,17193,560,31942,218,32502,14449,45027
2328,45029,"Colleton County, South Carolina",2000,14470,18129,3659,94,16021,551,37713,517,38264,21081,45029
2329,45031,"Darlington County, South Carolina",2000,25793,28942,3149,142,27970,658,66736,463,67394,38161,45031
2330,45033,"Dillon County, South Carolina",2000,11199,12679,1480,100,13879,539,30183,895,30722,15309,45033
2331,45035,"Dorchester County, South Carolina",2000,34709,37237,2528,1077,24067,1722,94691,1969,96413,67578,45035
2332,45037,"Edgefield County, South Carolina",2000,8270,9223,953,58,10165,503,24092,224,24595,13645,45037
2333,45039,"Fairfield County, South Carolina",2000,8774,10383,1609,41,13810,250,23204,158,23454,9195,45039
2334,45041,"Florence County, South Carolina",2000,47147,51836,4689,870,49224,1383,124378,1068,125761,73216,45041
2335,45043,"Georgetown County, South Carolina",2000,21659,28282,6623,120,21393,919,54878,354,55797,33011,45043
2336,45045,"Greenville County, South Carolina",2000,149556,162803,13247,5178,69042,14283,365333,4450,379616,286663,45045
2337,45047,"Greenwood County, South Carolina",2000,25729,28243,2514,460,20893,1902,64369,527,66271,42489,45047
2338,45049,"Hampton County, South Carolina",2000,7444,8582,1138,36,11832,547,20839,140,21386,8831,45049
2339,45051,"Horry County, South Carolina",2000,81800,122085,40285,1481,30206,5057,191572,2845,196629,157040,45051
2340,45053,"Jasper County, South Carolina",2000,7042,7928,886,89,10852,1190,19488,173,20678,8374,45053
2341,45055,"Kershaw County, South Carolina",2000,20188,22683,2495,162,13780,886,51761,593,52647,37226,45055
2342,45057,"Lancaster County, South Carolina",2000,23178,24962,1784,156,16397,978,60373,575,61351,43245,45057
2343,45059,"Laurens County, South Carolina",2000,26290,30239,3949,97,18172,1352,68215,588,69567,49358,45059
2344,45061,"Lee County, South Carolina",2000,6886,7670,784,36,12736,264,19855,122,20119,6961,45061
2345,45063,"Lexington County, South Carolina",2000,83240,90978,7738,2248,27132,4146,211868,2757,216014,179731,45063
2346,45065,"McCormick County, South Carolina",2000,3558,4459,901,29,5349,86,9872,68,9958,4426,45065
2347,45067,"Marion County, South Carolina",2000,13301,15143,1842,98,19860,634,34832,285,35466,14589,45067
2348,45069,"Marlboro County, South Carolina",2000,10478,11894,1416,67,14559,205,28613,1220,28818,12767,45069
2349,45071,"Newberry County, South Carolina",2000,14026,16805,2779,92,11893,1533,34575,320,36108,22270,45071
2350,45073,"Oconee County, South Carolina",2000,27283,32383,5100,232,5533,1562,64653,629,66215,58259,45073
2351,45075,"Orangeburg County, South Carolina",2000,34118,39304,5186,393,55507,875,90707,1086,91582,33721,45075
2352,45077,"Pickens County, South Carolina",2000,41306,46000,4694,1301,7517,1879,108878,1099,110757,98961,45077
2353,45079,"Richland County, South Carolina",2000,120101,129793,9692,5441,143773,8713,311964,4907,320677,157843,45079
2354,45081,"Saluda County, South Carolina",2000,7127,8543,1416,7,5707,1401,17780,130,19181,11936,45081
2355,45083,"Spartanburg County, South Carolina",2000,97735,106986,9251,3694,52506,7081,246710,2758,253791,187752,45083
2356,45085,"Sumter County, South Carolina",2000,37728,41751,4023,938,48617,1918,102728,1509,104646,51664,45085
2357,45087,"Union County, South Carolina",2000,12087,13351,1264,53,9247,199,29682,227,29881,20155,45087
2358,45089,"Williamsburg County, South Carolina",2000,13714,15552,1838,73,24546,273,36944,224,37217,12101,45089
2359,45091,"York County, South Carolina",2000,61051,66061,5010,1448,31380,3220,161394,2829,164614,125737,45091
2360,46003,"Aurora County, South Dakota",2000,1165,1298,133,3,9,64,2994,74,3058,2908,46003
2361,46005,"Beadle County, South Dakota",2000,7210,8206,996,52,118,155,16868,280,17023,16418,46005
2362,46007,"Bennett County, South Dakota",2000,1123,1278,155,2,10,72,3502,2041,3574,1449,46007
2363,46009,"Bon Homme County, South Dakota",2000,2635,3007,372,6,44,42,7218,248,7260,6920,46009
2364,46011,"Brookings County, South Dakota",2000,10665,11576,911,375,85,247,27973,451,28220,27062,46011
2365,46013,"Brown County, South Dakota",2000,14638,15861,1223,142,97,237,35223,1269,35460,33715,46013
2366,46015,"Brule County, South Dakota",2000,1998,2272,274,26,14,26,5338,491,5364,4807,46015
2367,46017,"Buffalo County, South Dakota",2000,526,602,76,0,2,18,2014,1680,2032,332,46017
2368,46019,"Butte County, South Dakota",2000,3516,4059,543,14,7,266,8828,250,9094,8557,46019
2369,46021,"Campbell County, South Dakota",2000,725,962,237,1,0,4,1778,11,1782,1766,46021
2370,46023,"Charles Mix County, South Dakota",2000,3343,3853,510,9,12,177,9173,2679,9350,6473,46023
2371,46025,"Clark County, South Dakota",2000,1598,1880,282,3,3,20,4123,36,4143,4081,46025
2372,46027,"Clay County, South Dakota",2000,4878,5438,560,262,128,120,13417,529,13537,12498,46027
2373,46029,"Codington County, South Dakota",2000,10357,11324,967,72,32,274,25623,571,25897,24948,46029
2374,46031,"Corson County, South Dakota",2000,1271,1536,265,2,4,89,4092,2535,4181,1551,46031
2375,46033,"Custer County, South Dakota",2000,2970,3624,654,13,17,110,7165,341,7275,6794,46033
2376,46035,"Davison County, South Dakota",2000,7585,8093,508,80,48,130,18611,495,18741,17988,46035
2377,46037,"Day County, South Dakota",2000,2586,3618,1032,4,8,24,6243,517,6267,5714,46037
2378,46039,"Deuel County, South Dakota",2000,1843,2172,329,8,4,34,4464,47,4498,4405,46039
2379,46041,"Dewey County, South Dakota",2000,1863,2133,270,7,2,51,5921,4474,5972,1438,46041
2380,46043,"Douglas County, South Dakota",2000,1321,1453,132,4,2,13,3445,55,3458,3384,46043
2381,46045,"Edmunds County, South Dakota",2000,1681,2022,341,3,3,21,4346,23,4367,4317,46045
2382,46047,"Fall River County, South Dakota",2000,3127,3812,685,17,24,130,7323,626,7453,6656,46047
2383,46049,"Faulk County, South Dakota",2000,1014,1235,221,1,2,6,2634,11,2640,2620,46049
2384,46051,"Grant County, South Dakota",2000,3116,3456,340,18,1,43,7804,56,7847,7729,46051
2385,46053,"Gregory County, South Dakota",2000,2022,2405,383,11,2,41,4751,306,4792,4432,46053
2386,46055,"Haakon County, South Dakota",2000,870,1002,132,2,0,13,2183,76,2196,2105,46055
2387,46057,"Hamlin County, South Dakota",2000,2048,2626,578,9,7,35,5505,61,5540,5428,46057
2388,46059,"Hand County, South Dakota",2000,1543,1840,297,3,1,11,3730,17,3741,3709,46059
2389,46061,"Hanson County, South Dakota",2000,1115,1218,103,4,0,3,3136,10,3139,3122,46061
2390,46063,"Harding County, South Dakota",2000,525,804,279,1,4,22,1331,19,1353,1307,46063
2391,46065,"Hughes County, South Dakota",2000,6512,7055,543,64,30,201,16280,1622,16481,14564,46065
2392,46067,"Hutchinson County, South Dakota",2000,3190,3517,327,8,5,42,8033,72,8075,7948,46067
2393,46069,"Hyde County, South Dakota",2000,679,769,90,0,2,8,1663,142,1671,1519,46069
2394,46071,"Jackson County, South Dakota",2000,945,1173,228,1,1,12,2918,1451,2930,1465,46071
2395,46073,"Jerauld County, South Dakota",2000,987,1167,180,3,0,7,2288,20,2295,2265,46073
2396,46075,"Jones County, South Dakota",2000,509,614,105,0,0,4,1189,48,1193,1141,46075
2397,46077,"Kingsbury County, South Dakota",2000,2406,2724,318,17,3,40,5775,52,5815,5703,46077
2398,46079,"Lake County, South Dakota",2000,4372,5282,910,61,23,89,11187,122,11276,10981,46079
2399,46081,"Lawrence County, South Dakota",2000,8881,10427,1546,70,45,396,21406,660,21802,20631,46081
2400,46083,"Lincoln County, South Dakota",2000,8782,9131,349,112,78,169,23962,302,24131,23470,46083
2401,46085,"Lyman County, South Dakota",2000,1400,1636,236,9,3,18,3877,1353,3895,2512,46085
2402,46087,"McCook County, South Dakota",2000,2204,2383,179,12,3,45,5787,41,5832,5731,46087
2403,46089,"McPherson County, South Dakota",2000,1227,1465,238,4,0,6,2898,14,2904,2880,46089
2404,46091,"Marshall County, South Dakota",2000,1844,2562,718,3,4,35,4541,313,4576,4221,46091
2405,46093,"Meade County, South Dakota",2000,8805,10149,1344,152,346,509,23744,1034,24253,22212,46093
2406,46095,"Mellette County, South Dakota",2000,694,824,130,2,0,35,2048,1120,2083,926,46095
2407,46097,"Miner County, South Dakota",2000,1212,1408,196,3,15,18,2866,15,2884,2833,46097
2408,46099,"Minnehaha County, South Dakota",2000,57996,60237,2241,1480,2217,3187,145094,4765,148281,136632,46099
2409,46101,"Moody County, South Dakota",2000,2526,2745,219,37,19,50,6545,913,6595,5576,46101
2410,46103,"Pennington County, South Dakota",2000,34641,37249,2608,763,722,2341,86224,8942,88565,75797,46103
2411,46105,"Perkins County, South Dakota",2000,1429,1854,425,7,3,25,3338,83,3363,3245,46105
2412,46107,"Potter County, South Dakota",2000,1145,1760,615,5,0,5,2688,43,2693,2640,46107
2413,46109,"Roberts County, South Dakota",2000,3683,4734,1051,21,10,63,9953,3101,10016,6821,46109
2414,46111,"Sanborn County, South Dakota",2000,1043,1220,177,10,1,27,2648,16,2675,2621,46111
2415,46113,"Shannon County, South Dakota",2000,2785,3123,338,3,10,177,12289,11722,12466,554,46113
2416,46115,"Spink County, South Dakota",2000,2847,3352,505,7,16,29,7425,148,7454,7254,46115
2417,46117,"Stanley County, South Dakota",2000,1111,1277,166,8,5,12,2760,172,2772,2575,46117
2418,46119,"Sully County, South Dakota",2000,630,844,214,2,0,12,1544,26,1556,1516,46119
2419,46121,"Todd County, South Dakota",2000,2462,2766,304,13,8,138,8912,7764,9050,1127,46121
2420,46123,"Tripp County, South Dakota",2000,2550,3036,486,4,2,55,6375,764,6430,5605,46123
2421,46125,"Turner County, South Dakota",2000,3510,3852,342,14,12,36,8813,63,8849,8724,46125
2422,46127,"Union County, South Dakota",2000,4927,5345,418,167,40,158,12426,138,12584,12081,46127
2423,46129,"Walworth County, South Dakota",2000,2506,3144,638,9,2,36,5938,774,5974,5153,46129
2424,46135,"Yankton County, South Dakota",2000,8187,8840,653,89,248,395,21257,555,21652,20365,46135
2425,46137,"Ziebach County, South Dakota",2000,741,879,138,2,0,25,2494,1828,2519,664,46137
2426,47001,"Anderson County, Tennessee",2000,29780,32451,2671,577,2749,787,70543,1093,71330,66124,47001
2427,47003,"Bedford County, Tennessee",2000,13905,14990,1085,160,3152,2811,34775,403,37586,31060,47003
2428,47005,"Benton County, Tennessee",2000,6863,8595,1732,40,348,157,16380,158,16537,15834,47005
2429,47007,"Bledsoe County, Tennessee",2000,4430,5142,712,14,454,138,12229,178,12367,11583,47007
2430,47009,"Blount County, Tennessee",2000,42667,47059,4392,759,3052,1120,104703,1296,105823,99596,47009
2431,47011,"Bradley County, Tennessee",2000,34281,36820,2539,489,3481,1822,86143,1256,87965,80917,47011
2432,47013,"Campbell County, Tennessee",2000,16125,18527,2402,59,119,269,39585,494,39854,38913,47013
2433,47015,"Cannon County, Tennessee",2000,4998,5420,422,13,179,157,12669,146,12826,12331,47015
2434,47017,"Carroll County, Tennessee",2000,11779,13057,1278,47,3030,386,29089,369,29475,25643,47017
2435,47019,"Carter County, Tennessee",2000,23486,25920,2434,145,558,504,56238,539,56742,54996,47019
2436,47021,"Cheatham County, Tennessee",2000,12878,13508,630,63,519,437,35475,387,35912,34506,47021
2437,47023,"Chester County, Tennessee",2000,5660,6178,518,36,1557,150,15390,185,15540,13612,47023
2438,47025,"Claiborne County, Tennessee",2000,11799,13262,1463,76,224,192,29670,296,29862,29074,47025
2439,47027,"Clay County, Tennessee",2000,3379,3959,580,11,105,108,7868,88,7976,7664,47027
2440,47029,"Cocke County, Tennessee",2000,13762,15844,2082,52,668,354,33211,435,33565,32056,47029
2441,47031,"Coffee County, Tennessee",2000,18885,20746,1861,346,1689,1051,46963,604,48014,44324,47031
2442,47033,"Crockett County, Tennessee",2000,5632,6138,506,8,2077,793,13739,105,14532,11549,47033
2443,47035,"Cumberland County, Tennessee",2000,19508,22442,2934,110,58,578,46224,453,46802,45603,47035
2444,47037,"Davidson County, Tennessee",2000,237405,252977,15572,13186,146939,26091,543800,12525,569891,371150,47037
2445,47039,"Decatur County, Tennessee",2000,4908,6448,1540,20,406,229,11502,122,11731,10954,47039
2446,47041,"DeKalb County, Tennessee",2000,6984,8409,1425,24,249,633,16790,179,17423,16338,47041
2447,47043,"Dickson County, Tennessee",2000,16473,17614,1141,115,1958,484,42672,579,43156,40020,47043
2448,47045,"Dyer County, Tennessee",2000,14751,16123,1372,120,4784,434,36845,339,37279,31602,47045
2449,47047,"Fayette County, Tennessee",2000,10467,11214,747,61,10312,298,28508,277,28806,17858,47047
2450,47049,"Fentress County, Tennessee",2000,6693,7598,905,15,18,90,16535,83,16625,16419,47049
2451,47051,"Franklin County, Tennessee",2000,15003,16813,1810,155,2145,620,38650,473,39270,35877,47051
2452,47053,"Gibson County, Tennessee",2000,19518,21059,1541,66,9447,540,47612,438,48152,37661,47053
2453,47055,"Giles County, Tennessee",2000,11713,13113,1400,102,3450,266,29181,348,29447,25281,47055
2454,47057,"Grainger County, Tennessee",2000,8270,9732,1462,18,67,226,20433,159,20659,20189,47057
2455,47059,"Greene County, Tennessee",2000,25756,28116,2360,167,1320,641,62268,472,62909,60309,47059
2456,47061,"Grundy County, Tennessee",2000,5562,6282,720,24,19,141,14191,138,14332,14010,47061
2457,47063,"Hamblen County, Tennessee",2000,23211,24693,1482,326,2364,3299,54829,678,58128,51461,47063
2458,47065,"Hamilton County, Tennessee",2000,124444,134692,10248,3905,61750,5481,302415,4285,307896,232475,47065
2459,47067,"Hancock County, Tennessee",2000,2769,3280,511,5,33,25,6761,98,6786,6625,47067
2460,47069,"Hardeman County, Tennessee",2000,9412,10694,1282,78,11474,273,27832,286,28105,15994,47069
2461,47071,"Hardin County, Tennessee",2000,10426,12807,2381,42,941,260,25318,236,25578,24099,47071
2462,47073,"Hawkins County, Tennessee",2000,21936,24416,2480,118,822,417,53146,407,53563,51799,47073
2463,47075,"Haywood County, Tennessee",2000,7558,8086,528,18,10066,524,19273,101,19797,9088,47075
2464,47077,"Henderson County, Tennessee",2000,10306,11446,1140,35,2034,247,25275,274,25522,22932,47077
2465,47079,"Henry County, Tennessee",2000,13019,15783,2764,84,2777,311,30804,347,31115,27596,47079
2466,47081,"Hickman County, Tennessee",2000,8081,8904,823,16,1007,222,22073,289,22295,20761,47081
2467,47083,"Houston County, Tennessee",2000,3216,3901,685,10,266,101,7987,100,8088,7611,47083
2468,47085,"Humphreys County, Tennessee",2000,7238,8482,1244,46,522,148,17781,183,17929,17030,47085
2469,47087,"Jackson County, Tennessee",2000,4466,5163,697,7,16,89,10895,109,10984,10763,47087
2470,47089,"Jefferson County, Tennessee",2000,17155,19319,2164,118,1016,588,43706,470,44294,42102,47089
2471,47091,"Johnson County, Tennessee",2000,6827,7879,1052,21,420,150,17349,147,17499,16761,47091
2472,47093,"Knox County, Tennessee",2000,157872,171439,13567,4909,32788,4803,377229,5539,382032,333993,47093
2473,47095,"Lake County, Tennessee",2000,2410,2716,306,11,2464,109,7845,102,7954,5268,47095
2474,47097,"Lauderdale County, Tennessee",2000,9567,10563,996,42,9192,314,26787,366,27101,17187,47097
2475,47099,"Lawrence County, Tennessee",2000,15480,16821,1341,95,586,399,39527,415,39926,38431,47099
2476,47101,"Lewis County, Tennessee",2000,4381,4821,440,21,164,136,11231,106,11367,10940,47101
2477,47103,"Lincoln County, Tennessee",2000,12503,13999,1496,98,2293,321,31019,539,31340,28089,47103
2478,47105,"Loudon County, Tennessee",2000,15944,17277,1333,83,440,894,38192,459,39086,37210,47105
2479,47107,"McMinn County, Tennessee",2000,19721,21626,1905,340,2172,884,48131,589,49015,45030,47107
2480,47109,"McNairy County, Tennessee",2000,9980,11219,1239,32,1532,229,24424,284,24653,22576,47109
2481,47111,"Macon County, Tennessee",2000,7916,8894,978,45,36,349,20037,172,20386,19784,47111
2482,47113,"Madison County, Tennessee",2000,35552,38205,2653,559,29657,1572,90265,896,91837,59153,47113
2483,47115,"Marion County, Tennessee",2000,11037,12140,1103,57,1144,202,27574,284,27776,26089,47115
2484,47117,"Marshall County, Tennessee",2000,10307,11181,874,82,2076,767,26000,247,26767,23595,47117
2485,47119,"Maury County, Tennessee",2000,26444,28674,2230,230,9821,2264,67234,856,69498,56327,47119
2486,47121,"Meigs County, Tennessee",2000,4304,5188,884,20,137,63,11023,78,11086,10788,47121
2487,47123,"Monroe County, Tennessee",2000,15329,17287,1958,130,873,684,38277,597,38961,36677,47123
2488,47125,"Montgomery County, Tennessee",2000,48330,52167,3837,2410,25496,6960,127808,4387,134768,95515,47125
2489,47127,"Moore County, Tennessee",2000,2211,2515,304,8,155,45,5695,44,5740,5488,47127
2490,47129,"Morgan County, Tennessee",2000,6990,7714,724,23,440,120,19637,158,19757,19016,47129
2491,47131,"Obion County, Tennessee",2000,13182,14489,1307,58,3174,616,31834,267,32450,28335,47131
2492,47133,"Overton County, Tennessee",2000,8110,9168,1058,17,54,138,19980,157,20118,19752,47133
2493,47135,"Perry County, Tennessee",2000,3023,4115,1092,7,130,61,7570,100,7631,7333,47135
2494,47137,"Pickett County, Tennessee",2000,2091,2956,865,2,5,41,4904,27,4945,4870,47137
2495,47139,"Polk County, Tennessee",2000,6448,7369,921,19,22,117,15933,203,16050,15689,47139
2496,47141,"Putnam County, Tennessee",2000,24865,26916,2051,574,1039,1891,60424,723,62315,58088,47141
2497,47143,"Rhea County, Tennessee",2000,11184,12565,1381,83,564,474,27926,399,28400,26880,47143
2498,47145,"Roane County, Tennessee",2000,21200,23369,2169,207,1405,359,51551,740,51910,49199,47145
2499,47147,"Robertson County, Tennessee",2000,19906,20995,1089,169,4631,1447,52986,542,54433,47644,47147
2500,47149,"Rutherford County, Tennessee",2000,66443,70616,4173,3443,17197,5065,176958,2556,182023,153762,47149
2501,47151,"Scott County, Tennessee",2000,8203,8909,706,25,19,120,21007,242,21127,20721,47151
2502,47153,"Sequatchie County, Tennessee",2000,4463,4916,453,15,19,93,11277,100,11370,11143,47153
2503,47155,"Sevier County, Tennessee",2000,28467,37252,8785,383,391,884,70286,813,71170,68699,47155
2504,47157,"Shelby County, Tennessee",2000,338366,362954,24588,14552,434201,23364,874108,10467,897472,414888,47157
2505,47159,"Smith County, Tennessee",2000,6878,7665,787,30,447,200,17512,226,17712,16809,47159
2506,47161,"Stewart County, Tennessee",2000,4930,5977,1047,180,155,124,12246,210,12370,11701,47161
2507,47163,"Sullivan County, Tennessee",2000,63556,69052,5496,644,2868,1090,151958,1410,153048,147036,47163
2508,47165,"Sumner County, Tennessee",2000,48941,51657,2716,849,7488,2291,128158,1600,130449,118221,47165
2509,47167,"Tipton County, Tennessee",2000,18106,19064,958,189,10158,622,50649,699,51271,39603,47167
2510,47169,"Trousdale County, Tennessee",2000,2780,3095,315,8,824,110,7149,68,7259,6249,47169
2511,47171,"Unicoi County, Tennessee",2000,7516,8214,698,14,10,342,17325,140,17667,17161,47171
2512,47173,"Union County, Tennessee",2000,6742,7916,1174,25,18,140,17668,199,17808,17426,47173
2513,47175,"Van Buren County, Tennessee",2000,2180,2453,273,4,7,18,5490,42,5508,5437,47175
2514,47177,"Warren County, Tennessee",2000,15181,16689,1508,159,1196,1885,36391,348,38276,34688,47177
2515,47179,"Washington County, Tennessee",2000,44195,47779,3584,774,4058,1482,105716,1306,107198,99578,47179
2516,47181,"Wayne County, Tennessee",2000,5936,6701,765,42,1143,142,16700,132,16842,15383,47181
2517,47183,"Weakley County, Tennessee",2000,13599,14928,1329,461,2409,402,34493,305,34895,31318,47183
2518,47185,"White County, Tennessee",2000,9229,10191,962,52,377,239,22863,238,23102,22196,47185
2519,47187,"Williamson County, Tennessee",2000,44725,47005,2280,1571,6543,3197,123441,1150,126638,114177,47187
2520,47189,"Wilson County, Tennessee",2000,32798,34921,2123,419,5545,1127,87682,1080,88809,80638,47189
2521,48001,"Anderson County, Texas",2000,15678,18436,2758,243,12897,6705,48404,502,55109,34762,48001
2522,48003,"Andrews County, Texas",2000,4601,5400,799,88,195,5202,7802,197,13004,7322,48003
2523,48005,"Angelina County, Texas",2000,28685,32435,3750,524,11656,11496,68634,839,80130,55615,48005
2524,48007,"Aransas County, Texas",2000,9132,12848,3716,614,303,4571,17926,413,22497,16596,48007
2525,48009,"Archer County, Texas",2000,3345,3871,526,11,7,431,8423,142,8854,8263,48009
2526,48011,"Armstrong County, Texas",2000,802,920,118,0,4,116,2032,20,2148,2008,48011
2527,48013,"Atascosa County, Texas",2000,12816,14883,2067,103,179,22620,16008,442,38628,15284,48013
2528,48015,"Austin County, Texas",2000,8747,10205,1458,68,2475,3805,19785,278,23590,16964,48015
2529,48017,"Bailey County, Texas",2000,2348,2738,390,8,76,3119,3475,74,6594,3317,48017
2530,48019,"Bandera County, Texas",2000,7010,9503,2493,47,50,2384,15261,331,17645,14833,48019
2531,48021,"Bastrop County, Texas",2000,20097,22254,2157,255,4938,13845,43888,931,57733,37764,48021
2532,48023,"Baylor County, Texas",2000,1791,2820,1029,15,135,382,3711,50,4093,3511,48023
2533,48025,"Bee County, Texas",2000,9061,10939,1878,148,3145,17450,14909,264,32359,11352,48025
2534,48027,"Bell County, Texas",2000,85507,92782,7275,5935,47344,39701,198273,8753,237974,136241,48027
2535,48029,"Bexar County, Texas",2000,488942,521359,32417,21369,95984,757033,635898,22300,1392931,496245,48029
2536,48031,"Blanco County, Texas",2000,3303,4031,728,15,60,1290,7128,141,8418,6912,48031
2537,48033,"Borden County, Texas",2000,292,435,143,0,1,87,642,17,729,624,48033
2538,48035,"Bosque County, Texas",2000,6726,8644,1918,19,320,2104,15100,254,17204,14507,48035
2539,48037,"Bowie County, Texas",2000,33058,36463,3405,372,20787,3992,85314,1443,89306,62712,48037
2540,48039,"Brazoria County, Texas",2000,81954,90628,8674,4776,20183,55063,186704,3693,241767,158052,48039
2541,48041,"Brazos County, Texas",2000,55202,59023,3821,6066,16146,27253,125162,2303,152415,100647,48041
2542,48043,"Brewster County, Texas",2000,3669,4614,945,27,87,3867,4999,175,8866,4710,48043
2543,48045,"Briscoe County, Texas",2000,724,1006,282,1,40,407,1383,23,1790,1319,48045
2544,48047,"Brooks County, Texas",2000,2711,3203,492,7,5,7304,672,27,7976,633,48047
2545,48049,"Brown County, Texas",2000,14306,17889,3583,129,1473,5793,31881,507,37674,29772,48049
2546,48051,"Burleson County, Texas",2000,6363,8197,1834,25,2443,2411,14059,230,16470,11361,48051
2547,48053,"Burnet County, Texas",2000,13133,15933,2800,89,500,5044,29103,497,34147,28017,48053
2548,48055,"Caldwell County, Texas",2000,10816,11901,1085,102,2674,13018,19176,471,32194,15929,48055
2549,48057,"Calhoun County, Texas",2000,7442,10238,2796,665,521,8448,12199,239,20647,10774,48057
2550,48059,"Callahan County, Texas",2000,5061,5925,864,34,27,812,12093,210,12905,11822,48059
2551,48061,"Cameron County, Texas",2000,97267,119654,22387,1522,909,282736,52491,1381,335227,48679,48061
2552,48063,"Camp County, Texas",2000,4336,5228,892,19,2201,1707,9842,115,11549,7507,48063
2553,48065,"Carson County, Texas",2000,2470,2815,345,8,38,458,6058,108,6516,5904,48065
2554,48067,"Cass County, Texas",2000,12190,13890,1700,44,5915,526,29912,411,30438,23542,48067
2555,48069,"Castro County, Texas",2000,2761,3198,437,1,182,4279,4006,58,8285,3765,48069
2556,48071,"Chambers County, Texas",2000,9139,10336,1197,172,2525,2810,23221,314,26031,20210,48071
2557,48073,"Cherokee County, Texas",2000,16651,19173,2522,177,7409,6178,40481,548,46659,32347,48073
2558,48075,"Childress County, Texas",2000,2474,3059,585,23,1074,1574,6114,94,7688,4923,48075
2559,48077,"Clay County, Texas",2000,4323,4992,669,11,43,404,10602,231,11006,10317,48077
2560,48079,"Cochran County, Texas",2000,1309,1587,278,8,168,1646,2084,44,3730,1864,48079
2561,48081,"Coke County, Texas",2000,1544,2843,1299,3,74,653,3211,55,3864,3079,48081
2562,48083,"Coleman County, Texas",2000,3889,5248,1359,20,199,1289,7946,128,9235,7599,48083
2563,48085,"Collin County, Texas",2000,181970,194892,12922,33902,23212,50510,441165,9935,491675,374116,48085
2564,48087,"Collingsworth County, Texas",2000,1294,1723,429,6,169,655,2551,87,3206,2289,48087
2565,48089,"Colorado County, Texas",2000,7641,9431,1790,42,2962,4024,16366,197,20390,13165,48089
2566,48091,"Comal County, Texas",2000,29066,32718,3652,343,693,17609,60412,1031,78021,58345,48091
2567,48093,"Comanche County, Texas",2000,5522,7105,1583,17,62,2928,11098,173,14026,10846,48093
2568,48095,"Concho County, Texas",2000,1058,1488,430,3,38,1639,2327,21,3966,2265,48095
2569,48097,"Cooke County, Texas",2000,13643,15061,1418,121,1087,3627,32736,702,36363,30826,48097
2570,48099,"Coryell County, Texas",2000,19950,21776,1826,1253,15976,9424,65554,2944,74978,45381,48099
2571,48101,"Cottle County, Texas",2000,820,1088,268,0,176,360,1544,20,1904,1348,48101
2572,48103,"Crane County, Texas",2000,1360,1596,236,14,116,1753,2243,30,3996,2083,48103
2573,48105,"Crockett County, Texas",2000,1524,2049,525,10,18,2242,1857,37,4099,1792,48105
2574,48107,"Crosby County, Texas",2000,2512,3202,690,2,262,3460,3612,47,7072,3301,48107
2575,48109,"Culberson County, Texas",2000,1052,1321,269,17,19,2149,826,57,2975,733,48109
2576,48111,"Dallam County, Texas",2000,2317,2697,380,13,100,1766,4456,86,6222,4257,48111
2577,48113,"Dallas County, Texas",2000,807621,854119,46498,87495,445716,662729,1556170,39642,2218899,983317,48113
2578,48115,"Dawson County, Texas",2000,4726,5500,774,32,1285,7222,7763,97,14985,6349,48115
2579,48117,"Deaf Smith County, Texas",2000,6180,6914,734,37,247,10654,7907,132,18561,7491,48117
2580,48119,"Delta County, Texas",2000,2094,2410,316,6,440,165,5162,100,5327,4616,48119
2581,48121,"Denton County, Texas",2000,158903,168069,9166,17327,24980,52619,380357,9201,432976,328849,48121
2582,48123,"DeWitt County, Texas",2000,7207,8756,1549,34,2158,5452,14561,201,20013,12168,48123
2583,48125,"Dickens County, Texas",2000,980,1368,388,3,223,660,2102,19,2762,1857,48125
2584,48127,"Dimmit County, Texas",2000,3308,4112,804,68,67,8708,1540,55,10248,1350,48127
2585,48129,"Donley County, Texas",2000,1578,2378,800,4,151,243,3585,58,3828,3372,48129
2586,48131,"Duval County, Texas",2000,4350,5543,1193,12,57,11544,1576,55,13120,1452,48131
2587,48133,"Eastland County, Texas",2000,7321,9547,2226,36,397,1976,16321,202,18297,15686,48133
2588,48135,"Ector County, Texas",2000,43846,49500,5654,744,5370,51306,69817,1535,121123,62168,48135
2589,48137,"Edwards County, Texas",2000,801,1217,416,1,3,974,1188,23,2162,1161,48137
2590,48139,"Ellis County, Texas",2000,37020,39071,2051,368,9514,20508,90852,1569,111360,79401,48139
2591,48141,"El Paso County, Texas",2000,210022,224447,14425,6148,18671,531654,147968,7614,679622,115535,48141
2592,48143,"Erath County, Texas",2000,12568,14422,1854,117,257,4959,28042,399,33001,27269,48143
2593,48145,"Falls County, Texas",2000,6496,7658,1162,20,5064,2941,15635,187,18576,10364,48145
2594,48147,"Fannin County, Texas",2000,11105,12887,1782,81,2482,1753,29489,628,31242,26298,48147
2595,48149,"Fayette County, Texas",2000,8722,11113,2391,49,1508,2786,19018,190,21804,17271,48149
2596,48151,"Fisher County, Texas",2000,1785,2277,492,6,110,928,3416,50,4344,3250,48151
2597,48153,"Floyd County, Texas",2000,2730,3221,491,12,252,3569,4202,63,7771,3875,48153
2598,48155,"Foard County, Texas",2000,664,850,186,3,52,265,1357,25,1622,1277,48155
2599,48157,"Fort Bend County, Texas",2000,110915,115991,5076,39545,69579,74871,279581,6669,354452,163788,48157
2600,48159,"Franklin County, Texas",2000,3754,5132,1378,18,364,842,8616,105,9458,8129,48159
2601,48161,"Freestone County, Texas",2000,6588,8138,1550,44,3359,1465,16402,176,17867,12823,48161
2602,48163,"Frio County, Texas",2000,4743,5660,917,58,777,11987,4265,86,16252,3344,48163
2603,48165,"Gaines County, Texas",2000,4681,5410,729,22,304,5175,9292,163,14467,8803,48165
2604,48167,"Galveston County, Texas",2000,94782,111733,16951,5152,38179,44939,205219,4037,250158,157851,48167
2605,48169,"Garza County, Texas",2000,1663,1928,265,4,221,1810,3062,77,4872,2760,48169
2606,48171,"Gillespie County, Texas",2000,8521,9902,1381,35,30,3309,17505,208,20814,17232,48171
2607,48173,"Glasscock County, Texas",2000,483,660,177,0,6,420,986,25,1406,955,48173
2608,48175,"Goliad County, Texas",2000,2644,3426,782,14,317,2439,4489,43,6928,4115,48175
2609,48177,"Gonzales County, Texas",2000,6782,8194,1412,49,1493,7381,11247,166,18628,9539,48177
2610,48179,"Gray County, Texas",2000,8793,10567,1774,88,1309,2959,19785,588,22744,17800,48179
2611,48181,"Grayson County, Texas",2000,42849,48315,5466,613,6385,7519,103076,3221,110595,92857,48181
2612,48183,"Gregg County, Texas",2000,42687,46349,3662,745,21989,10183,101196,1611,111379,76851,48183
2613,48185,"Grimes County, Texas",2000,7753,9490,1737,61,4667,3787,19765,265,23552,14772,48185
2614,48187,"Guadalupe County, Texas",2000,30900,33585,2685,733,4310,29561,59462,1561,89023,52858,48187
2615,48189,"Hale County, Texas",2000,11975,13526,1551,107,2044,17532,19070,393,36602,16526,48189
2616,48191,"Hall County, Texas",2000,1548,1988,440,5,297,1040,2742,43,3782,2397,48191
2617,48193,"Hamilton County, Texas",2000,3374,4455,1081,12,11,610,7619,98,8229,7498,48193
2618,48195,"Hansford County, Texas",2000,2005,2329,324,12,1,1690,3679,62,5369,3604,48195
2619,48197,"Hardeman County, Texas",2000,1943,2358,415,12,227,685,4039,69,4724,3731,48197
2620,48199,"Hardin County, Texas",2000,17805,19836,2031,108,3310,1223,46850,491,48073,42941,48199
2621,48201,"Harris County, Texas",2000,1205516,1298130,92614,173026,619694,1119751,2280827,55843,3400578,1432264,48201
2622,48203,"Harrison County, Texas",2000,23087,26271,3184,186,14861,3316,58794,703,62110,43044,48203
2623,48205,"Hartley County, Texas",2000,1604,1760,156,14,445,758,4779,50,5537,4270,48205
2624,48207,"Haskell County, Texas",2000,2569,3555,986,9,160,1249,4844,75,6093,4600,48207
2625,48209,"Hays County, Texas",2000,33410,35643,2233,740,3448,28859,68730,1597,97589,62945,48209
2626,48211,"Hemphill County, Texas",2000,1280,1548,268,9,52,522,2829,46,3351,2722,48211
2627,48213,"Henderson County, Texas",2000,28804,35935,7131,220,4811,5071,68206,1051,73277,62124,48213
2628,48215,"Hidalgo County, Texas",2000,156824,192658,35834,3207,1934,503100,66363,1799,569463,59423,48215
2629,48217,"Hill County, Texas",2000,12204,14624,2420,78,2359,4360,27961,445,32321,25079,48217
2630,48219,"Hockley County, Texas",2000,7994,9148,1154,29,822,8459,14257,251,22716,13155,48219
2631,48221,"Hood County, Texas",2000,16176,19105,2929,123,112,2975,38125,697,41100,37193,48221
2632,48223,"Hopkins County, Texas",2000,12286,14020,1734,79,2525,2967,28993,443,31960,25946,48223
2633,48225,"Houston County, Texas",2000,8259,10730,2471,53,6442,1739,21446,176,23185,14775,48225
2634,48227,"Howard County, Texas",2000,11389,13589,2200,196,1292,12597,21030,446,33627,19096,48227
2635,48229,"Hudspeth County, Texas",2000,1092,1471,379,4,7,2509,835,54,3344,770,48229
2636,48231,"Hunt County, Texas",2000,28742,32490,3748,413,7183,6366,70230,1464,76596,61170,48231
2637,48233,"Hutchinson County, Texas",2000,9283,10871,1588,83,563,3506,20351,601,23857,19104,48233
2638,48235,"Irion County, Texas",2000,694,914,220,0,4,436,1335,10,1771,1321,48235
2639,48237,"Jack County, Texas",2000,3047,3668,621,24,481,691,8072,99,8763,7468,48237
2640,48239,"Jackson County, Texas",2000,5336,6545,1209,55,1081,3551,10840,158,14391,9546,48239
2641,48241,"Jasper County, Texas",2000,13450,16576,3126,111,6302,1384,34220,487,35604,27320,48241
2642,48243,"Jeff Davis County, Texas",2000,896,1420,524,2,16,783,1424,30,2207,1376,48243
2643,48245,"Jefferson County, Texas",2000,92880,102080,9200,7236,84482,26536,225515,3193,252051,130604,48245
2644,48247,"Jim Hogg County, Texas",2000,1815,2308,493,5,22,4752,529,28,5281,474,48247
2645,48249,"Jim Wells County, Texas",2000,12961,14819,1858,167,166,29772,9554,220,39326,9001,48249
2646,48251,"Johnson County, Texas",2000,43636,46269,2633,654,3058,15375,111436,2264,126811,105460,48251
2647,48253,"Jones County, Texas",2000,6140,7236,1096,91,2368,4346,16439,228,20785,13752,48253
2648,48255,"Karnes County, Texas",2000,4454,5479,1025,62,1603,7324,8122,148,15446,6309,48255
2649,48257,"Kaufman County, Texas",2000,24367,26133,1766,330,7472,7925,63388,1162,71313,54424,48257
2650,48259,"Kendall County, Texas",2000,8613,9609,996,52,63,4248,19495,276,23743,19104,48259
2651,48261,"Kenedy County, Texas",2000,138,281,143,2,0,327,87,1,414,84,48261
2652,48263,"Kent County, Texas",2000,353,551,198,0,2,78,781,2,859,777,48263
2653,48265,"Kerr County, Texas",2000,17813,20228,2415,212,738,8353,35300,548,43653,33802,48265
2654,48267,"Kimble County, Texas",2000,1866,2996,1130,20,3,926,3542,38,4468,3481,48267
2655,48269,"King County, Texas",2000,108,174,66,0,0,34,322,7,356,315,48269
2656,48271,"Kinney County, Texas",2000,1314,1907,593,4,44,1707,1672,37,3379,1587,48271
2657,48273,"Kleberg County, Texas",2000,10896,12743,1847,444,1091,20635,10914,382,31549,8997,48273
2658,48275,"Knox County, Texas",2000,1690,2129,439,10,292,1067,3186,55,4253,2829,48275
2659,48277,"Lamar County, Texas",2000,19077,21113,2036,191,6493,1614,46885,1085,48499,39116,48277
2660,48279,"Lamb County, Texas",2000,5360,6294,934,9,615,6393,8316,139,14709,7553,48279
2661,48281,"Lampasas County, Texas",2000,6554,7601,1047,126,511,2677,15085,327,17762,14121,48281
2662,48283,"La Salle County, Texas",2000,1819,2436,617,18,192,4524,1342,18,5866,1114,48283
2663,48285,"Lavaca County, Texas",2000,7669,9657,1988,26,1287,2183,17027,135,19210,15579,48285
2664,48287,"Lee County, Texas",2000,5663,6851,1188,32,1872,2848,12809,181,15657,10724,48287
2665,48289,"Leon County, Texas",2000,6189,8299,2110,23,1583,1213,14122,150,15335,12366,48289
2666,48291,"Liberty County, Texas",2000,23242,26359,3117,218,8952,7660,62494,1035,70154,52289,48291
2667,48293,"Limestone County, Texas",2000,7906,9725,1819,19,4186,2859,19192,276,22051,14711,48293
2668,48295,"Lipscomb County, Texas",2000,1205,1541,336,2,13,633,2424,65,3057,2344,48295
2669,48297,"Live Oak County, Texas",2000,4230,6196,1966,23,281,4683,7626,123,12309,7199,48297
2670,48299,"Llano County, Texas",2000,7879,11829,3950,59,51,875,16169,190,17044,15869,48299
2671,48301,"Loving County, Texas",2000,31,70,39,0,0,7,60,0,67,60,48301
2672,48303,"Lubbock County, Texas",2000,92516,100595,8079,3081,18184,66609,176019,3049,242628,151705,48303
2673,48305,"Lynn County, Texas",2000,2354,2671,317,6,166,2923,3627,78,6550,3377,48305
2674,48307,"McCulloch County, Texas",2000,3277,4184,907,14,123,2219,5986,57,8205,5792,48307
2675,48309,"McLennan County, Texas",2000,78859,84795,5936,2236,32065,38233,175284,2975,213517,138008,48309
2676,48311,"McMullen County, Texas",2000,355,587,232,0,10,282,569,3,851,556,48311
2677,48313,"Madison County, Texas",2000,3914,4797,883,50,2915,2042,10898,132,12940,7801,48313
2678,48315,"Marion County, Texas",2000,4610,6384,1774,23,2599,263,10678,238,10941,7818,48315
2679,48317,"Martin County, Texas",2000,1624,1898,274,8,74,1925,2821,43,4746,2696,48317
2680,48319,"Mason County, Texas",2000,1607,2372,765,2,5,783,2955,36,3738,2912,48319
2681,48321,"Matagorda County, Texas",2000,13901,18611,4710,891,4778,11898,26059,490,37957,19900,48321
2682,48323,"Maverick County, Texas",2000,13089,14889,1800,164,53,44938,2359,532,47297,1610,48323
2683,48325,"Medina County, Texas",2000,12880,14826,1946,117,801,17873,21431,594,39304,19919,48325
2684,48327,"Menard County, Texas",2000,990,1607,617,8,10,748,1612,27,2360,1567,48327
2685,48329,"Midland County, Texas",2000,42745,48060,5315,1040,7940,33676,82333,1338,116009,72015,48329
2686,48331,"Milam County, Texas",2000,9199,10866,1667,49,2627,4516,19722,283,24238,16763,48331
2687,48333,"Mills County, Texas",2000,2001,2691,690,4,61,671,4480,48,5151,4367,48333
2688,48335,"Mitchell County, Texas",2000,2837,4168,1331,34,1229,3009,6689,85,9698,5341,48335
2689,48337,"Montague County, Texas",2000,7770,9862,2092,49,28,1035,18082,288,19117,17717,48337
2690,48339,"Montgomery County, Texas",2000,103296,112770,9474,3167,10076,37150,256618,4225,293768,239150,48339
2691,48341,"Moore County, Texas",2000,6774,7478,704,166,89,9558,10563,270,20121,10038,48341
2692,48343,"Morris County, Texas",2000,5215,6017,802,23,3137,477,12571,194,13048,9217,48343
2693,48345,"Motley County, Texas",2000,606,839,233,2,50,173,1253,29,1426,1172,48345
2694,48347,"Nacogdoches County, Texas",2000,22006,25051,3045,398,9815,6660,52543,710,59203,41620,48347
2695,48349,"Navarro County, Texas",2000,16491,18449,1958,191,7521,7113,38011,703,45124,29596,48349
2696,48351,"Newton County, Texas",2000,5583,7331,1748,39,3100,571,14501,205,15072,11157,48351
2697,48353,"Nolan County, Texas",2000,6170,7112,942,33,713,4431,11371,145,15802,10480,48353
2698,48355,"Nueces County, Texas",2000,110365,123041,12676,3458,12718,174951,138694,4340,313645,118178,48355
2699,48357,"Ochiltree County, Texas",2000,3261,3769,508,32,8,2863,6143,131,9006,5972,48357
2700,48359,"Oldham County, Texas",2000,735,815,80,8,41,241,1944,43,2185,1852,48359
2701,48361,"Orange County, Texas",2000,31642,34781,3139,652,7080,3073,81893,1206,84966,72955,48361
2702,48363,"Palo Pinto County, Texas",2000,10594,14102,3508,137,617,3667,23359,442,27026,22163,48363
2703,48365,"Panola County, Texas",2000,8821,10524,1703,53,4013,798,21958,263,22756,17629,48365
2704,48367,"Parker County, Texas",2000,31131,34084,2953,298,1559,6211,82284,1447,88495,78980,48367
2705,48369,"Parmer County, Texas",2000,3322,3732,410,28,93,4927,5089,92,10016,4876,48369
2706,48371,"Pecos County, Texas",2000,5153,6338,1185,73,700,10262,6547,167,16809,5607,48371
2707,48373,"Polk County, Texas",2000,15119,21177,6058,156,5357,3861,37272,1036,41133,30723,48373
2708,48375,"Potter County, Texas",2000,40760,44598,3838,2768,11047,31921,81625,2340,113546,65470,48375
2709,48377,"Presidio County, Texas",2000,2530,3299,769,6,10,6162,1142,47,7304,1079,48377
2710,48379,"Rains County, Texas",2000,3617,4523,906,30,263,505,8634,158,9139,8183,48379
2711,48381,"Randall County, Texas",2000,41240,43261,2021,1048,1513,10718,93594,1607,104312,89426,48381
2712,48383,"Reagan County, Texas",2000,1107,1452,345,9,94,1646,1680,32,3326,1545,48383
2713,48385,"Real County, Texas",2000,1245,2007,762,6,5,688,2359,42,3047,2306,48385
2714,48387,"Red River County, Texas",2000,5827,6916,1089,17,2538,669,13645,222,14314,10868,48387
2715,48389,"Reeves County, Texas",2000,4091,5043,952,46,238,9640,3497,82,13137,3131,48389
2716,48391,"Refugio County, Texas",2000,2985,3669,684,20,521,3490,4338,94,7828,3703,48391
2717,48393,"Roberts County, Texas",2000,362,449,87,1,3,28,859,5,887,850,48393
2718,48395,"Robertson County, Texas",2000,6179,7874,1695,26,3830,2359,13641,205,16000,9580,48395
2719,48397,"Rockwall County, Texas",2000,14530,15351,821,555,1374,4771,38309,563,43080,35817,48397
2720,48399,"Runnels County, Texas",2000,4428,5400,972,37,154,3372,8123,139,11495,7793,48399
2721,48401,"Rusk County, Texas",2000,17364,19867,2503,112,9037,3998,43374,488,47372,33737,48401
2722,48403,"Sabine County, Texas",2000,4485,7659,3174,9,1039,189,10280,117,10469,9115,48403
2723,48405,"San Augustine County, Texas",2000,3575,5356,1781,18,2484,320,8626,58,8946,6066,48405
2724,48407,"San Jacinto County, Texas",2000,8651,11520,2869,63,2796,1084,21162,331,22246,17972,48407
2725,48409,"San Patricio County, Texas",2000,22093,24864,2771,389,1767,33181,33957,1052,67138,30749,48409
2726,48411,"San Saba County, Texas",2000,2289,2951,662,5,160,1333,4853,66,6186,4622,48411
2727,48413,"Schleicher County, Texas",2000,1115,1371,256,5,32,1278,1657,25,2935,1595,48413
2728,48415,"Scurry County, Texas",2000,5756,7112,1356,36,984,4544,11817,125,16361,10672,48415
2729,48417,"Shackelford County, Texas",2000,1300,1613,313,0,9,251,3051,28,3302,3014,48417
2730,48419,"Shelby County, Texas",2000,9595,11955,2360,57,4881,2489,22735,233,25224,17564,48419
2731,48421,"Sherman County, Texas",2000,1124,1275,151,1,15,874,2312,33,3186,2263,48421
2732,48423,"Smith County, Texas",2000,65692,71701,6009,1201,33129,19521,155185,2257,174706,118598,48423
2733,48425,"Somervell County, Texas",2000,2438,2750,312,17,13,915,5894,101,6809,5763,48425
2734,48427,"Starr County, Texas",2000,14410,17589,3179,141,6,52278,1319,90,53597,1082,48427
2735,48429,"Stephens County, Texas",2000,3661,4893,1232,27,277,1418,8256,91,9674,7861,48429
2736,48431,"Sterling County, Texas",2000,513,633,120,0,1,432,961,5,1393,955,48431
2737,48433,"Stonewall County, Texas",2000,713,936,223,6,48,199,1494,28,1693,1412,48433
2738,48435,"Sutton County, Texas",2000,1515,1998,483,7,7,2106,1971,23,4077,1934,48435
2739,48437,"Swisher County, Texas",2000,2925,3315,390,5,487,2951,5427,86,8378,4849,48437
2740,48439,"Tarrant County, Texas",2000,533864,565830,31966,52057,182713,285290,1160929,30906,1446219,895253,48439
2741,48441,"Taylor County, Texas",2000,47274,52056,4782,1523,8243,22328,104227,2462,126555,91999,48441
2742,48443,"Terrell County, Texas",2000,443,991,548,7,0,525,556,20,1081,529,48443
2743,48445,"Terry County, Texas",2000,4278,5087,809,18,617,5626,7135,149,12761,6351,48445
2744,48447,"Throckmorton County, Texas",2000,765,1066,301,1,1,173,1677,20,1850,1655,48447
2745,48449,"Titus County, Texas",2000,9552,10675,1123,120,2970,7960,20158,286,28118,16782,48449
2746,48451,"Tom Green County, Texas",2000,39503,43916,4413,855,4122,31946,72064,1579,104010,65508,48451
2747,48453,"Travis County, Texas",2000,320766,335881,15115,35842,73242,229048,583232,16331,812280,457817,48453
2748,48455,"Trinity County, Texas",2000,5723,8141,2418,31,1635,668,13111,156,13779,11289,48455
2749,48457,"Tyler County, Texas",2000,7775,10419,2644,41,2491,742,20129,307,20871,17290,48457
2750,48459,"Upshur County, Texas",2000,13290,14930,1640,65,3557,1394,33897,547,35291,29728,48459
2751,48461,"Upton County, Texas",2000,1256,1609,353,0,52,1449,1955,49,3404,1854,48461
2752,48463,"Uvalde County, Texas",2000,8559,10166,1607,87,66,17089,8837,213,25926,8471,48463
2753,48465,"Val Verde County, Texas",2000,14151,16288,2137,235,609,33849,11007,429,44856,9734,48465
2754,48467,"Van Zandt County, Texas",2000,18195,20896,2701,84,1390,3201,44939,846,48140,42619,48467
2755,48469,"Victoria County, Texas",2000,30071,32945,2874,635,5137,32959,51129,867,84088,44490,48469
2756,48471,"Walker County, Texas",2000,18303,21099,2796,464,14672,8712,53046,820,61758,37090,48471
2757,48473,"Waller County, Texas",2000,10557,11955,1398,121,9496,6344,26319,413,32663,16289,48473
2758,48475,"Ward County, Texas",2000,3964,4832,868,31,476,4580,6329,127,10909,5695,48475
2759,48477,"Washington County, Texas",2000,11322,13241,1919,363,5604,2647,27726,244,30373,21515,48477
2760,48479,"Webb County, Texas",2000,50740,55206,4466,783,294,182070,11047,462,193117,9508,48479
2761,48481,"Wharton County, Texas",2000,14799,16606,1807,113,6060,12888,28300,295,41188,21832,48481
2762,48483,"Wheeler County, Texas",2000,2152,2687,535,29,137,664,4620,68,5284,4386,48483
2763,48485,"Wichita County, Texas",2000,48441,53304,4863,2386,13243,16097,115567,3448,131664,96490,48485
2764,48487,"Wilbarger County, Texas",2000,5537,6371,834,91,1278,3015,11661,209,14676,10083,48487
2765,48489,"Willacy County, Texas",2000,5584,6727,1143,21,401,17209,2873,101,20082,2350,48489
2766,48491,"Williamson County, Texas",2000,86766,90325,3559,6483,12444,42990,206977,4203,249967,183847,48491
2767,48493,"Wilson County, Texas",2000,11038,12110,1072,93,361,11834,20574,392,32408,19728,48493
2768,48495,"Winkler County, Texas",2000,2584,3214,630,10,127,3156,4017,55,7173,3825,48495
2769,48497,"Wise County, Texas",2000,17178,19242,2064,107,584,5248,43545,863,48793,41991,48497
2770,48499,"Wood County, Texas",2000,14583,17939,3356,69,2243,2102,34650,490,36752,31848,48499
2771,48501,"Yoakum County, Texas",2000,2469,2974,505,9,92,3363,3959,65,7322,3793,48501
2772,48503,"Young County, Texas",2000,7167,8504,1337,46,217,1906,16037,255,17943,15519,48503
2773,48505,"Zapata County, Texas",2000,3921,6167,2246,17,22,10328,1854,44,12182,1771,48505
2774,48507,"Zavala County, Texas",2000,3428,4075,647,8,43,10582,1018,43,11600,924,48507
2775,49001,"Beaver County, Utah",2000,1982,2660,678,35,16,333,5672,130,6005,5491,49001
2776,49003,"Box Elder County, Utah",2000,13144,14209,1065,400,66,2791,39954,771,42745,38717,49003
2777,49005,"Cache County, Utah",2000,27543,29035,1492,1803,319,5786,85605,1494,91391,81989,49005
2778,49007,"Carbon County, Utah",2000,7413,8741,1328,70,52,2097,18325,532,20422,17671,49007
2779,49009,"Daggett County, Utah",2000,340,1084,744,1,4,47,874,16,921,853,49009
2780,49011,"Davis County, Utah",2000,71201,74114,2913,3568,2521,12955,226039,5314,238994,214636,49011
2781,49013,"Duchesne County, Utah",2000,4559,6988,2429,27,18,508,13863,1054,14371,12764,49013
2782,49015,"Emery County, Utah",2000,3468,4093,625,34,19,568,10292,189,10860,10050,49015
2783,49017,"Garfield County, Utah",2000,1576,2767,1191,18,8,136,4599,133,4735,4440,49017
2784,49019,"Grand County, Utah",2000,3434,4062,628,17,18,471,8014,411,8485,7568,49019
2785,49021,"Iron County, Utah",2000,10627,13618,2991,249,108,1383,32396,1210,33779,30829,49021
2786,49023,"Juab County, Utah",2000,2456,2810,354,27,9,217,8021,141,8238,7844,49023
2787,49025,"Kane County, Utah",2000,2237,3767,1530,13,2,140,5906,167,6046,5724,49025
2788,49027,"Millard County, Utah",2000,3840,4522,682,59,13,891,11514,274,12405,11168,49027
2789,49029,"Morgan County, Utah",2000,2046,2158,112,10,2,103,7026,77,7129,6937,49029
2790,49031,"Piute County, Utah",2000,509,745,236,3,2,64,1371,27,1435,1339,49031
2791,49033,"Rich County, Utah",2000,645,2408,1763,8,0,36,1925,9,1961,1908,49033
2792,49035,"Salt Lake County, Utah",2000,295141,310988,15847,22716,8501,106787,791600,33186,898387,727197,49035
2793,49037,"San Juan County, Utah",2000,4089,5449,1360,25,18,540,13873,8120,14413,5710,49037
2794,49039,"Sanpete County, Utah",2000,6547,7879,1332,109,61,1510,21253,493,22763,20590,49039
2795,49041,"Sevier County, Utah",2000,6081,7016,935,48,49,481,18361,512,18842,17752,49041
2796,49043,"Summit County, Utah",2000,10332,17489,7157,283,54,2406,27330,385,29736,26608,49043
2797,49045,"Tooele County, Utah",2000,12677,13812,1135,234,480,4214,36521,1310,40735,34497,49045
2798,49047,"Uintah County, Utah",2000,8187,9040,853,56,26,894,24330,2586,25224,21662,49047
2799,49049,"Utah County, Utah",2000,99937,104315,4378,3855,1002,25791,342745,9091,368536,328797,49049
2800,49051,"Wasatch County, Utah",2000,4743,6564,1821,44,32,775,14440,176,15215,14188,49051
2801,49053,"Washington County, Utah",2000,29939,36478,6539,389,174,4727,85627,2771,90354,82293,49053
2802,49055,"Wayne County, Utah",2000,890,1329,439,2,4,50,2459,44,2509,2409,49055
2803,49057,"Weber County, Utah",2000,65698,70454,4756,2380,2559,24858,171675,4102,196533,162634,49057
2804,50001,"Addison County, Vermont",2000,13068,15312,2244,254,184,397,35577,527,35974,34612,50001
2805,50003,"Bennington County, Vermont",2000,14846,19403,4557,226,149,344,36650,359,36994,35916,50003
2806,50005,"Caledonia County, Vermont",2000,11663,14504,2841,110,82,201,29501,497,29702,28812,50005
2807,50007,"Chittenden County, Vermont",2000,56452,58864,2412,2901,1283,1561,145010,2404,146571,138422,50007
2808,50009,"Essex County, Vermont",2000,2602,4762,2160,17,11,32,6427,181,6459,6218,50009
2809,50011,"Franklin County, Vermont",2000,16765,19191,2426,118,134,270,45147,1461,45417,43434,50011
2810,50013,"Grand Isle County, Vermont",2000,2761,4663,1902,15,9,29,6872,150,6901,6698,50013
2811,50015,"Lamoille County, Vermont",2000,9221,11009,1788,86,72,180,23053,414,23233,22481,50015
2812,50017,"Orange County, Vermont",2000,10936,13386,2450,94,64,165,28061,370,28226,27533,50017
2813,50019,"Orleans County, Vermont",2000,10446,14673,4227,75,88,190,26087,526,26277,25398,50019
2814,50021,"Rutland County, Vermont",2000,25678,32311,6633,241,194,442,62958,610,63400,61913,50021
2815,50023,"Washington County, Vermont",2000,23659,27644,3985,327,261,732,57307,941,58039,55778,50023
2816,50025,"Windham County, Vermont",2000,18375,27039,8664,342,210,493,43723,719,44216,42452,50025
2817,50027,"Windsor County, Vermont",2000,24162,31621,7459,354,180,468,56950,652,57418,55764,50027
2818,51001,"Accomack County, Virginia",2000,15299,19550,4251,86,12039,2062,36243,421,38305,23697,51001
2819,51003,"Albemarle County, Virginia",2000,31876,33720,1844,2267,7586,2029,77207,1136,79236,66218,51003
2820,51005,"Alleghany County, Virginia",2000,5149,5812,663,30,314,47,12879,107,12926,12428,51005
2821,51007,"Amelia County, Virginia",2000,4240,4609,369,19,3183,91,11309,100,11400,8007,51007
2822,51009,"Amherst County, Virginia",2000,11941,12958,1017,108,6267,306,31588,568,31894,24645,51009
2823,51011,"Appomattox County, Virginia",2000,5322,5828,506,23,3132,65,13640,108,13705,10377,51011
2824,51013,"Arlington County, Virginia",2000,86352,90426,4074,16232,17244,35268,154185,6220,189453,114489,51013
2825,51015,"Augusta County, Virginia",2000,24818,26738,1920,184,2354,620,64995,487,65615,61970,51015
2826,51017,"Bath County, Virginia",2000,2053,2896,843,19,317,18,5030,49,5048,4645,51017
2827,51019,"Bedford County, Virginia",2000,23838,26841,3003,258,3752,449,59922,554,60371,55358,51019
2828,51021,"Bland County, Virginia",2000,2568,3161,593,8,285,32,6839,51,6871,6495,51021
2829,51023,"Botetourt County, Virginia",2000,11700,12571,871,144,1067,181,30315,271,30496,28833,51023
2830,51025,"Brunswick County, Virginia",2000,6277,7541,1264,40,10416,231,18188,103,18419,7629,51025
2831,51027,"Buchanan County, Virginia",2000,10464,11887,1423,37,706,128,26850,100,26978,26007,51027
2832,51029,"Buckingham County, Virginia",2000,5324,6290,966,27,6073,126,15497,213,15623,9184,51029
2833,51031,"Campbell County, Virginia",2000,20639,22088,1449,313,7465,423,50655,579,51078,42298,51031
2834,51033,"Caroline County, Virginia",2000,8021,8889,868,79,7562,295,21826,475,22121,13710,51033
2835,51035,"Carroll County, Virginia",2000,12186,14680,2494,28,129,479,28766,173,29245,28436,51035
2836,51036,"Charles City County, Virginia",2000,2670,2895,225,7,3795,45,6881,625,6926,2454,51036
2837,51037,"Charlotte County, Virginia",2000,4951,5734,783,20,4087,206,12266,106,12472,8053,51037
2838,51041,"Chesterfield County, Virginia",2000,93772,97707,3935,6123,45797,7617,252286,4290,259903,196076,51041
2839,51043,"Clarke County, Virginia",2000,4942,5388,446,61,848,185,12467,136,12652,11422,51043
2840,51045,"Craig County, Virginia",2000,2060,2554,494,8,9,17,5074,34,5091,5023,51045
2841,51047,"Culpeper County, Virginia",2000,12141,12871,730,225,6188,858,33404,578,34262,26413,51047
2842,51049,"Cumberland County, Virginia",2000,3528,4085,557,31,3349,150,8867,101,9017,5386,51049
2843,51051,"Dickenson County, Virginia",2000,6732,7684,952,12,58,70,16325,92,16395,16163,51051
2844,51053,"Dinwiddie County, Virginia",2000,9107,9707,600,74,8221,237,24296,266,24533,15735,51053
2845,51057,"Essex County, Virginia",2000,3995,4926,931,81,3879,72,9917,195,9989,5762,51057
2846,51059,"Fairfax County, Virginia",2000,350714,359411,8697,125585,81287,106958,862791,31623,969749,624296,51059
2847,51061,"Fauquier County, Virginia",2000,19842,21046,1204,318,4801,1114,54025,842,55139,48064,51061
2848,51063,"Floyd County, Virginia",2000,5791,6763,972,11,274,187,13687,118,13874,13284,51063
2849,51065,"Fluvanna County, Virginia",2000,7387,8018,631,75,3664,235,19812,279,20047,15794,51065
2850,51067,"Franklin County, Virginia",2000,18963,22717,3754,165,4393,573,46713,406,47286,41749,51067
2851,51069,"Frederick County, Virginia",2000,22097,23319,1222,385,1538,1004,58205,629,59209,55653,51069
2852,51071,"Giles County, Virginia",2000,6994,7732,738,31,263,105,16552,117,16657,16141,51071
2853,51073,"Gloucester County, Virginia",2000,13127,14494,1367,232,3562,560,34220,621,34780,29805,51073
2854,51075,"Goochland County, Virginia",2000,6158,6555,397,68,4298,144,16719,159,16863,12194,51075
2855,51077,"Grayson County, Virginia",2000,7259,9123,1864,12,1214,277,17640,131,17917,16283,51077
2856,51079,"Greene County, Virginia",2000,5574,5986,412,65,982,201,15043,227,15244,13769,51079
2857,51081,"Greensville County, Virginia",2000,3375,3765,390,46,6881,108,11452,64,11560,4461,51081
2858,51083,"Halifax County, Virginia",2000,15018,16953,1935,91,14164,458,36897,329,37355,22313,51083
2859,51085,"Hanover County, Virginia",2000,31121,32196,1075,669,8026,847,85473,1025,86320,75753,51085
2860,51087,"Henrico County, Virginia",2000,108121,112570,4449,9415,64342,5946,256354,4597,262300,178000,51087
2861,51089,"Henry County, Virginia",2000,23910,25921,2011,218,13080,2002,55928,543,57930,42087,51089
2862,51091,"Highland County, Virginia",2000,1131,1822,691,3,1,13,2523,12,2536,2507,51091
2863,51093,"Isle of Wight County, Virginia",2000,11319,12066,747,101,8045,254,29474,336,29728,20992,51093
2864,51095,"James City County, Virginia",2000,19003,20772,1769,682,6858,816,47286,792,48102,38954,51095
2865,51097,"King and Queen County, Virginia",2000,2673,3010,337,17,2351,58,6572,168,6630,4036,51097
2866,51099,"King George County, Virginia",2000,6091,6820,729,167,3136,301,16502,343,16803,12856,51099
2867,51101,"King William County, Virginia",2000,4846,5189,343,48,2974,120,13026,350,13146,9654,51101
2868,51103,"Lancaster County, Virginia",2000,5004,6498,1494,37,3324,71,11496,80,11567,8055,51103
2869,51105,"Lee County, Virginia",2000,9706,11086,1380,38,103,120,23469,196,23589,23132,51105
2870,51107,"Loudoun County, Virginia",2000,59900,62160,2260,9025,11517,10089,159510,3996,169599,134972,51107
2871,51109,"Louisa County, Virginia",2000,9945,11855,1910,63,5507,182,25445,358,25627,19517,51109
2872,51111,"Lunenburg County, Virginia",2000,4998,5736,738,27,5044,235,12911,145,13146,7695,51111
2873,51113,"Madison County, Virginia",2000,4739,5239,500,63,1423,96,12424,138,12520,10800,51113
2874,51115,"Mathews County, Virginia",2000,3932,5333,1401,17,1036,73,9134,86,9207,7995,51115
2875,51117,"Mecklenburg County, Virginia",2000,12951,17403,4452,95,12589,393,31987,286,32380,19017,51117
2876,51119,"Middlesex County, Virginia",2000,4253,6362,2109,12,1998,55,9877,95,9932,7772,51119
2877,51121,"Montgomery County, Virginia",2000,30997,32527,1530,3296,2996,1321,82308,1497,83629,74519,51121
2878,51125,"Nelson County, Virginia",2000,5887,8554,2667,32,2136,305,14140,207,14445,11765,51125
2879,51127,"New Kent County, Virginia",2000,4925,5203,278,71,2165,176,13286,323,13462,10727,51127
2880,51131,"Northampton County, Virginia",2000,5321,6547,1226,25,5602,454,12639,134,13093,6878,51131
2881,51133,"Northumberland County, Virginia",2000,5470,8057,2587,24,3234,114,12145,83,12259,8804,51133
2882,51135,"Nottoway County, Virginia",2000,5664,6373,709,61,6356,248,15477,137,15725,8923,51135
2883,51137,"Orange County, Virginia",2000,10150,11354,1204,81,3556,330,25551,285,25881,21629,51137
2884,51139,"Page County, Virginia",2000,9305,10557,1252,53,501,251,22926,189,23177,22183,51139
2885,51141,"Patrick County, Virginia",2000,8141,9823,1682,32,1178,363,19044,167,19407,17667,51141
2886,51143,"Pittsylvania County, Virginia",2000,24684,28011,3327,111,14525,759,60986,429,61745,45921,51143
2887,51145,"Powhatan County, Virginia",2000,7258,7509,251,46,3781,184,22193,249,22377,18117,51145
2888,51147,"Prince Edward County, Virginia",2000,6561,7527,966,104,7014,186,19534,236,19720,12180,51147
2889,51149,"Prince George County, Virginia",2000,10159,10726,567,556,10593,1625,31422,741,33047,19532,51149
2890,51153,"Prince William County, Virginia",2000,94570,98052,3482,10606,51743,27338,253475,9370,280813,181756,51153
2891,51155,"Pulaski County, Virginia",2000,14643,16325,1682,114,1947,336,34791,379,35127,32351,51155
2892,51157,"Rappahannock County, Virginia",2000,2788,3303,515,15,374,91,6892,92,6983,6411,51157
2893,51159,"Richmond County, Virginia",2000,2937,3512,575,28,2913,185,8624,67,8809,5616,51159
2894,51161,"Roanoke County, Virginia",2000,34686,36121,1435,1365,2855,888,84890,861,85778,79809,51161
2895,51163,"Rockbridge County, Virginia",2000,8486,9550,1064,92,610,120,20688,211,20808,19775,51163
2896,51165,"Rockingham County, Virginia",2000,25355,27328,1973,189,868,2221,65504,509,67725,63938,51165
2897,51167,"Russell County, Virginia",2000,11789,13191,1402,15,923,237,30071,152,30308,28981,51167
2898,51169,"Scott County, Virginia",2000,9795,11355,1560,16,137,99,23304,159,23403,22992,51169
2899,51171,"Shenandoah County, Virginia",2000,14296,16709,2413,121,399,1194,33881,315,35075,33046,51171
2900,51173,"Smyth County, Virginia",2000,13493,15111,1618,61,607,283,32798,250,33081,31880,51173
2901,51175,"Southampton County, Virginia",2000,6279,7058,779,32,7462,115,17367,119,17482,9754,51175
2902,51177,"Spotsylvania County, Virginia",2000,31308,33329,2021,1231,11127,2536,87859,1955,90395,73546,51177
2903,51179,"Stafford County, Virginia",2000,30187,31405,1218,1496,11013,3342,89104,2568,92446,74027,51179
2904,51181,"Surry County, Virginia",2000,2619,3294,675,9,3513,51,6778,86,6829,3170,51181
2905,51183,"Sussex County, Virginia",2000,4126,4653,527,15,7750,102,12402,100,12504,4537,51183
2906,51185,"Tazewell County, Virginia",2000,18277,20390,2113,271,1005,228,44370,358,44598,42736,51185
2907,51187,"Warren County, Virginia",2000,12087,13299,1212,135,1514,494,31090,494,31584,28947,51187
2908,51191,"Washington County, Virginia",2000,21056,22985,1929,136,674,322,50781,377,51103,49594,51191
2909,51193,"Westmoreland County, Virginia",2000,6846,9286,2440,61,5139,579,16139,219,16718,10720,51193
2910,51195,"Wise County, Virginia",2000,16013,17792,1779,118,708,292,39831,324,40123,38681,51195
2911,51197,"Wythe County, Virginia",2000,11511,12744,1233,104,777,157,27442,229,27599,26332,51197
2912,51199,"York County, Virginia",2000,20000,20701,701,1810,7445,1509,54788,1315,56297,44218,51199
2913,51510,"Alexandria city, Virginia",2000,61889,64251,2362,7199,28463,18882,109401,4850,128283,68889,51510
2914,51515,"Bedford city, Virginia",2000,2519,2702,183,36,1407,56,6243,97,6299,4703,51515
2915,51520,"Bristol city, Virginia",2000,7678,8469,791,64,952,169,17198,218,17367,15964,51520
2916,51530,"Buena Vista city, Virginia",2000,2547,2716,169,27,302,64,6285,67,6349,5889,51530
2917,51540,"Charlottesville city, Virginia",2000,16851,17591,740,2215,9916,1102,43947,991,45049,30825,51540
2918,51550,"Chesapeake city, Virginia",2000,69900,72672,2772,3638,56442,4076,195108,3828,199184,131200,51550
2919,51560,"Clifton Forge city, Virginia",2000,1841,2069,228,2,627,38,4251,79,4289,3543,51560
2920,51570,"Colonial Heights city, Virginia",2000,7027,7340,313,453,1043,274,16623,207,16897,14920,51570
2921,51580,"Covington city, Virginia",2000,2835,3195,360,41,828,40,6263,123,6303,5271,51580
2922,51590,"Danville city, Virginia",2000,20607,23108,2501,290,21267,612,47799,429,48411,25813,51590
2923,51595,"Emporia city, Virginia",2000,2226,2412,186,30,3174,84,5581,35,5665,2342,51595
2924,51600,"Fairfax city, Virginia",2000,8035,8204,169,2609,1035,2932,18566,589,21498,14333,51600
2925,51610,"Falls Church city, Virginia",2000,4471,4725,254,674,321,876,9501,251,10377,8255,51610
2926,51620,"Franklin city, Virginia",2000,3384,3767,383,65,4351,46,8300,84,8346,3800,51620
2927,51630,"Fredericksburg city, Virginia",2000,8102,8888,786,277,3884,945,18334,414,19279,13759,51630
2928,51640,"Galax city, Virginia",2000,2950,3217,267,47,412,757,6080,72,6837,5549,51640
2929,51650,"Hampton city, Virginia",2000,53887,57311,3424,2650,64795,4153,142284,3876,146437,70963,51650
2930,51660,"Harrisonburg city, Virginia",2000,13133,13689,556,1247,2266,3580,36888,959,40468,32416,51660
2931,51670,"Hopewell city, Virginia",2000,9055,9749,694,178,7414,651,21703,456,22354,13655,51670
2932,51678,"Lexington city, Virginia",2000,2232,2376,144,130,713,109,6758,78,6867,5837,51678
2933,51680,"Lynchburg city, Virginia",2000,25477,27640,2163,830,19288,878,64391,1165,65269,43108,51680
2934,51683,"Manassas city, Virginia",2000,11757,12114,357,1191,4430,5316,29819,894,35135,23304,51683
2935,51685,"Manassas Park city, Virginia",2000,3254,3365,111,413,1115,1544,8746,299,10290,6919,51685
2936,51690,"Martinsville city, Virginia",2000,6498,7249,751,72,6501,358,15058,149,15416,8336,51690
2937,51700,"Newport News city, Virginia",2000,69686,74117,4431,4112,69538,7595,172555,5281,180150,93624,51700
2938,51710,"Norfolk city, Virginia",2000,86210,94416,8206,6477,102268,8915,225488,6522,234403,110221,51710
2939,51720,"Norton city, Virginia",2000,1730,1946,216,39,235,34,3870,48,3904,3548,51720
2940,51730,"Petersburg city, Virginia",2000,13799,15955,2156,234,26511,463,33277,401,33740,6131,51730
2941,51735,"Poquoson city, Virginia",2000,4166,4300,134,182,78,122,11444,136,11566,11048,51735
2942,51740,"Portsmouth city, Virginia",2000,38170,41605,3435,762,50569,1748,98817,2083,100565,45403,51740
2943,51750,"Radford city, Virginia",2000,5809,6137,328,223,1274,184,15675,278,15859,13900,51750
2944,51760,"Richmond city, Virginia",2000,84549,92282,7733,2437,112455,5074,192716,3318,197790,74506,51760
2945,51770,"Roanoke city, Virginia",2000,42003,45257,3254,1088,25220,1405,93506,1942,94911,65256,51770
2946,51775,"Salem city, Virginia",2000,9954,10403,449,241,1444,205,24542,263,24747,22594,51775
2947,51790,"Staunton city, Virginia",2000,9676,10427,751,110,3305,265,23588,445,23853,19728,51790
2948,51800,"Suffolk city, Virginia",2000,23283,24704,1421,487,27524,809,62868,917,63677,33940,51800
2949,51810,"Virginia Beach city, Virginia",2000,154455,162277,7822,20618,79092,17770,407487,12375,425257,295402,51810
2950,51820,"Waynesboro city, Virginia",2000,8332,8863,531,112,1935,643,18877,338,19520,16492,51820
2951,51830,"Williamsburg city, Virginia",2000,3619,3880,261,546,1593,302,11696,205,11998,9352,51830
2952,51840,"Winchester city, Virginia",2000,10001,10587,586,374,2454,1527,22058,506,23585,18724,51840
2953,53001,"Adams County, Washington",2000,5229,5773,544,75,20,7732,8696,235,16428,8366,53001
2954,53003,"Asotin County, Washington",2000,8364,9111,747,103,34,401,20150,587,20551,19426,53003
2955,53005,"Benton County, Washington",2000,52866,55963,3097,3104,1227,17806,124669,3881,142475,116457,53005
2956,53007,"Chelan County, Washington",2000,25021,30407,5386,441,111,12831,53785,1643,66616,51590,53007
2957,53009,"Clallam County, Washington",2000,27164,30683,3519,728,517,2203,62322,4664,64525,56413,53009
2958,53011,"Clark County, Washington",2000,127208,134030,6822,10993,5628,16248,328990,13235,345238,299134,53011
2959,53013,"Columbia County, Washington",2000,1687,2018,331,16,9,258,3806,96,4064,3685,53013
2960,53015,"Cowlitz County, Washington",2000,35850,38624,2774,1195,448,4231,88717,3503,92948,83571,53015
2961,53017,"Douglas County, Washington",2000,11726,12944,1218,168,62,6433,26170,761,32603,25179,53017
2962,53019,"Ferry County, Washington",2000,2823,3775,952,18,15,205,7055,1583,7260,5439,53019
2963,53021,"Franklin County, Washington",2000,14840,16084,1244,767,1120,23032,26315,958,49347,23470,53021
2964,53023,"Garfield County, Washington",2000,987,1288,301,15,0,47,2350,31,2397,2304,53023
2965,53025,"Grant County, Washington",2000,25204,29081,3877,632,653,22476,52222,2054,74698,48883,53025
2966,53027,"Grays Harbor County, Washington",2000,26808,32489,5681,790,205,3258,63936,4829,67194,58112,53027
2967,53029,"Island County, Washington",2000,27784,32378,4594,2941,1634,2843,68715,3211,71558,60929,53029
2968,53031,"Jefferson County, Washington",2000,11645,14144,2499,300,103,535,25418,1387,25953,23628,53031
2969,53033,"King County, Washington",2000,710916,742237,31321,186615,91798,95242,1641792,88252,1737034,1275127,53033
2970,53035,"Kitsap County, Washington",2000,86416,92644,6228,10034,6495,9609,222360,15080,231969,190751,53035
2971,53037,"Kittitas County, Washington",2000,13382,16475,3093,714,227,1668,31694,928,33362,29825,53037
2972,53039,"Klickitat County, Washington",2000,7473,8633,1160,136,26,1496,17665,1174,19161,16329,53039
2973,53041,"Lewis County, Washington",2000,26306,29585,3279,466,239,3684,64916,2037,68600,62174,53041
2974,53043,"Lincoln County, Washington",2000,4151,5298,1147,24,22,191,9993,315,10184,9632,53043
2975,53045,"Mason County, Washington",2000,18912,25515,6603,512,562,2361,47044,3334,49405,42636,53045
2976,53047,"Okanogan County, Washington",2000,15027,19085,4058,172,79,5688,33876,5263,39564,28362,53047
2977,53049,"Pacific County, Washington",2000,9096,13991,4895,435,36,1052,19932,999,20984,18462,53049
2978,53051,"Pend Oreille County, Washington",2000,4639,6608,1969,72,17,241,11491,581,11732,10821,53051
2979,53053,"Pierce County, Washington",2000,260800,277060,16260,35091,47399,38621,662199,46775,700820,532934,53053
2980,53055,"San Juan County, Washington",2000,6466,9752,3286,125,34,338,13739,393,14077,13187,53055
2981,53057,"Skagit County, Washington",2000,38852,42681,3829,1513,422,11536,91443,4012,102979,85496,53057
2982,53059,"Skamania County, Washington",2000,3755,4576,821,53,30,398,9474,469,9872,8922,53059
2983,53061,"Snohomish County, Washington",2000,224852,236205,11353,34748,9803,28590,577434,27685,606024,505198,53061
2984,53063,"Spokane County, Washington",2000,163611,175005,11394,7758,6437,11561,406378,16756,417939,375427,53063
2985,53065,"Stevens County, Washington",2000,15017,17599,2582,193,107,739,39327,3309,40066,35718,53065
2986,53067,"Thurston County, Washington",2000,81625,86652,5027,9034,4714,9392,197963,11252,207355,172963,53067
2987,53069,"Wahkiakum County, Washington",2000,1553,1792,239,18,9,98,3726,153,3824,3546,53069
2988,53071,"Walla Walla County, Washington",2000,19647,21147,1500,600,869,8654,46526,1555,55180,43502,53071
2989,53073,"Whatcom County, Washington",2000,64446,73893,9447,4598,1065,8687,158127,8622,166814,143842,53073
2990,53075,"Whitman County, Washington",2000,15257,16676,1419,2247,613,1219,39521,1344,40740,35317,53075
2991,53077,"Yakima County, Washington",2000,73993,79174,5181,1957,1842,79905,142676,13144,222581,125733,53077
2992,54001,"Barbour County, West Virginia",2000,6123,7348,1225,40,77,73,15484,272,15557,15095,54001
2993,54003,"Berkeley County, West Virginia",2000,29569,32913,3344,341,3523,1156,74749,1152,75905,69733,54003
2994,54005,"Boone County, West Virginia",2000,10291,11575,1284,18,164,117,25418,172,25535,25064,54005
2995,54007,"Braxton County, West Virginia",2000,5771,7374,1603,15,101,65,14637,168,14702,14353,54007
2996,54009,"Brooke County, West Virginia",2000,10396,11150,754,87,215,99,25348,205,25447,24841,54009
2997,54011,"Cabell County, West Virginia",2000,41180,45615,4435,743,4118,654,96130,1325,96784,89944,54011
2998,54013,"Calhoun County, West Virginia",2000,3071,3848,777,8,6,42,7540,53,7582,7473,54013
2999,54015,"Clay County, West Virginia",2000,4020,4836,816,2,7,42,10288,171,10330,10108,54015
3000,54017,"Doddridge County, West Virginia",2000,2845,3661,816,11,18,42,7361,80,7403,7252,54017
3001,54019,"Fayette County, West Virginia",2000,18945,21616,2671,144,2647,325,47254,589,47579,43874,54019
3002,54021,"Gilmer County, West Virginia",2000,2768,3621,853,40,64,50,7110,70,7160,6936,54021
3003,54023,"Grant County, West Virginia",2000,4591,6105,1514,16,76,62,11237,87,11299,11058,54023
3004,54025,"Greenbrier County, West Virginia",2000,14571,17644,3073,64,1041,236,34217,480,34453,32632,54025
3005,54027,"Hampshire County, West Virginia",2000,7955,11185,3230,33,164,112,20091,161,20203,19733,54027
3006,54029,"Hancock County, West Virginia",2000,13678,14728,1050,111,747,243,32424,259,32667,31307,54029
3007,54031,"Hardy County, West Virginia",2000,5204,7115,1911,17,230,84,12585,113,12669,12225,54031
3008,54033,"Harrison County, West Virginia",2000,27867,31112,3245,407,1102,660,67992,727,68652,65756,54033
3009,54035,"Jackson County, West Virginia",2000,11061,12245,1184,64,23,81,27919,237,28000,27595,54035
3010,54037,"Jefferson County, West Virginia",2000,16165,17623,1458,250,2539,734,41456,709,42190,37958,54037
3011,54039,"Kanawha County, West Virginia",2000,86226,93788,7562,1687,13870,1172,198901,3086,200073,180258,54039
3012,54041,"Lewis County, West Virginia",2000,6946,7944,998,48,22,85,16834,160,16919,16604,54041
3013,54043,"Lincoln County, West Virginia",2000,8664,9846,1182,12,13,121,21987,175,22108,21787,54043
3014,54045,"Logan County, West Virginia",2000,14880,16807,1927,113,970,202,37508,268,37710,36157,54045
3015,54047,"McDowell County, West Virginia",2000,11169,13582,2413,16,3234,132,27197,252,27329,23695,54047
3016,54049,"Marion County, West Virginia",2000,23652,26660,3008,228,1816,394,56204,652,56598,53508,54049
3017,54051,"Marshall County, West Virginia",2000,14207,15814,1607,89,152,228,35291,288,35519,34762,54051
3018,54053,"Mason County, West Virginia",2000,10587,12056,1469,71,129,121,25836,195,25957,25441,54053
3019,54055,"Mercer County, West Virginia",2000,26509,30143,3634,288,3657,285,62695,677,62980,58073,54055
3020,54057,"Mineral County, West Virginia",2000,10784,12094,1310,51,689,158,26920,256,27078,25924,54057
3021,54059,"Mingo County, West Virginia",2000,11303,12898,1595,52,654,135,28118,278,28253,27134,54059
3022,54061,"Monongalia County, West Virginia",2000,33446,36695,3249,1998,2740,826,81040,1337,81866,74965,54061
3023,54063,"Monroe County, West Virginia",2000,5447,7267,1820,23,868,72,14511,172,14583,13448,54063
3024,54065,"Morgan County, West Virginia",2000,6145,8076,1931,18,89,124,14819,116,14943,14596,54065
3025,54067,"Nicholas County, West Virginia",2000,10722,12406,1684,50,10,127,26435,205,26562,26170,54067
3026,54069,"Ohio County, West Virginia",2000,19733,22166,2433,365,1679,238,47189,512,47427,44633,54069
3027,54071,"Pendleton County, West Virginia",2000,3350,5102,1752,14,167,73,8123,88,8196,7854,54071
3028,54073,"Pleasants County, West Virginia",2000,2887,3214,327,15,36,28,7486,72,7514,7363,54073
3029,54075,"Pocahontas County, West Virginia",2000,3835,7594,3759,13,71,39,9092,60,9131,8948,54075
3030,54077,"Preston County, West Virginia",2000,11544,13444,1900,43,82,168,29166,196,29334,28845,54077
3031,54079,"Putnam County, West Virginia",2000,20028,21621,1593,296,287,262,51327,383,51589,50361,54079
3032,54081,"Raleigh County, West Virginia",2000,31793,35678,3885,563,6719,727,78493,790,79220,70421,54081
3033,54083,"Randolph County, West Virginia",2000,11072,13478,2406,106,296,191,28071,190,28262,27479,54083
3034,54085,"Ritchie County, West Virginia",2000,4184,5513,1329,13,14,49,10294,99,10343,10168,54085
3035,54087,"Roane County, West Virginia",2000,6161,7360,1199,35,34,104,15342,129,15446,15144,54087
3036,54089,"Summers County, West Virginia",2000,5530,7331,1801,12,280,71,12928,142,12999,12494,54089
3037,54091,"Taylor County, West Virginia",2000,6320,7125,805,24,131,95,15994,127,16089,15712,54091
3038,54093,"Tucker County, West Virginia",2000,3052,4634,1582,1,4,18,7303,74,7321,7224,54093
3039,54095,"Tyler County, West Virginia",2000,3836,4780,944,8,2,41,9551,49,9592,9492,54095
3040,54097,"Upshur County, West Virginia",2000,8972,10751,1779,71,143,137,23267,177,23404,22876,54097
3041,54099,"Wayne County, West Virginia",2000,17239,19107,1868,86,53,202,42701,352,42903,42210,54099
3042,54101,"Webster County, West Virginia",2000,4010,5273,1263,6,1,36,9683,71,9719,9605,54101
3043,54103,"Wetzel County, West Virginia",2000,7164,8313,1149,57,15,74,17619,108,17693,17439,54103
3044,54105,"Wirt County, West Virginia",2000,2284,3266,982,5,17,18,5855,62,5873,5771,54105
3045,54107,"Wood County, West Virginia",2000,36275,39785,3510,448,858,514,87472,919,87986,85247,54107
3046,54109,"Wyoming County, West Virginia",2000,10454,11698,1244,20,161,135,25573,171,25708,25221,54109
3047,55001,"Adams County, Wisconsin",2000,7900,14123,6223,62,50,268,18375,242,18643,18021,55001
3048,55003,"Ashland County, Wisconsin",2000,6718,8883,2165,53,35,188,16678,1968,16866,14622,55003
3049,55005,"Barron County, Wisconsin",2000,17851,20969,3118,141,55,430,44533,670,44963,43667,55005
3050,55007,"Bayfield County, Wisconsin",2000,6207,11640,5433,41,20,91,14922,1614,15013,13247,55007
3051,55009,"Brown County, Wisconsin",2000,87295,90199,2904,4910,2562,8698,218080,7365,226778,203243,55009
3052,55011,"Buffalo County, Wisconsin",2000,5511,6098,587,44,15,85,13719,105,13804,13555,55011
3053,55013,"Burnett County, Wisconsin",2000,6613,12582,5969,37,54,120,15554,900,15674,14563,55013
3054,55015,"Calumet County, Wisconsin",2000,14910,15758,848,627,109,435,40196,398,40631,39062,55015
3055,55017,"Chippewa County, Wisconsin",2000,21356,22821,1465,491,85,289,54906,499,55195,53831,55017
3056,55019,"Clark County, Wisconsin",2000,12047,13531,1484,101,39,404,33153,297,33557,32716,55019
3057,55021,"Columbia County, Wisconsin",2000,20439,22685,2246,173,432,827,51641,560,52468,50476,55021
3058,55023,"Crawford County, Wisconsin",2000,6677,8480,1803,45,230,129,17114,146,17243,16693,55023
3059,55025,"Dane County, Wisconsin",2000,173484,180398,6914,14651,16829,14387,412139,8062,426526,372597,55025
3060,55027,"Dodge County, Wisconsin",2000,31417,33672,2255,293,2095,2188,83709,758,85897,80563,55027
3061,55029,"Door County, Wisconsin",2000,11828,19587,7759,80,49,267,27694,337,27961,27228,55029
3062,55031,"Douglas County, Wisconsin",2000,17808,20356,2548,271,245,315,42972,1375,43287,41081,55031
3063,55033,"Dunn County, Wisconsin",2000,14337,15277,940,847,135,335,39523,419,39858,38122,55033
3064,55035,"Eau Claire County, Wisconsin",2000,35822,37474,1652,2332,471,879,92263,1524,93142,87936,55035
3065,55037,"Florence County, Wisconsin",2000,2133,4239,2106,13,8,23,5065,63,5088,4981,55037
3066,55039,"Fond du Lac County, Wisconsin",2000,36931,39271,2340,839,857,1987,95309,1085,97296,92528,55039
3067,55041,"Forest County, Wisconsin",2000,4043,8322,4279,17,118,108,9916,1211,10024,8570,55041
3068,55043,"Grant County, Wisconsin",2000,18465,19940,1475,229,257,280,49317,289,49597,48542,55043
3069,55045,"Green County, Wisconsin",2000,13212,13878,666,97,83,327,33320,282,33647,32858,55045
3070,55047,"Green Lake County, Wisconsin",2000,7703,9831,2128,56,29,393,18712,153,19105,18474,55047
3071,55049,"Iowa County, Wisconsin",2000,8764,9579,815,78,36,75,22705,163,22780,22428,55049
3072,55051,"Iron County, Wisconsin",2000,3083,5706,2623,7,4,45,6816,91,6861,6714,55051
3073,55053,"Jackson County, Wisconsin",2000,7070,8029,959,26,428,357,18743,1299,19100,16990,55053
3074,55055,"Jefferson County, Wisconsin",2000,28205,30092,1887,323,184,3031,70990,718,74021,69765,55055
3075,55057,"Juneau County, Wisconsin",2000,9696,12370,2674,100,76,347,23969,475,24316,23318,55057
3076,55059,"Kenosha County, Wisconsin",2000,56057,59989,3932,1350,7446,10757,138820,2737,149577,127287,55059
3077,55061,"Kewaunee County, Wisconsin",2000,7623,8221,598,25,27,153,20034,160,20187,19822,55061
3078,55063,"La Crosse County, Wisconsin",2000,41599,43479,1880,3349,975,990,106130,1474,107120,100332,55063
3079,55065,"Lafayette County, Wisconsin",2000,6211,6674,463,36,17,92,16045,71,16137,15921,55065
3080,55067,"Langlade County, Wisconsin",2000,8452,11187,2735,57,28,171,20569,291,20740,20193,55067
3081,55069,"Lincoln County, Wisconsin",2000,11721,14681,2960,115,119,243,29398,307,29641,28857,55069
3082,55071,"Manitowoc County, Wisconsin",2000,32721,34651,1930,1637,227,1343,81544,924,82887,78756,55071
3083,55073,"Marathon County, Wisconsin",2000,47702,50360,2658,5703,337,979,124855,1298,125834,117517,55073
3084,55075,"Marinette County, Wisconsin",2000,17585,26260,8675,118,87,325,43059,500,43384,42354,55075
3085,55077,"Marquette County, Wisconsin",2000,5986,8664,2678,42,507,421,15411,302,15832,14560,55077
3086,55078,"Menominee County, Wisconsin",2000,1345,2098,753,0,3,122,4440,3911,4562,526,55078
3087,55079,"Milwaukee County, Wisconsin",2000,377729,400093,22364,23879,228471,82406,857758,21927,940164,583481,55079
3088,55081,"Monroe County, Wisconsin",2000,15399,16672,1273,195,181,740,40159,648,40899,39135,55081
3089,55083,"Oconto County, Wisconsin",2000,13979,19812,5833,68,48,240,35394,571,35634,34707,55083
3090,55085,"Oneida County, Wisconsin",2000,15333,26627,11294,109,114,244,36532,515,36776,35794,55085
3091,55087,"Outagamie County, Wisconsin",2000,60530,62614,2084,3564,846,3207,157764,3710,160971,149644,55087
3092,55089,"Ozaukee County, Wisconsin",2000,30857,32034,1177,880,759,1073,81244,711,82317,78894,55089
3093,55091,"Pepin County, Wisconsin",2000,2759,3036,277,15,6,25,7188,45,7213,7122,55091
3094,55093,"Pierce County, Wisconsin",2000,13015,13493,478,158,91,301,36503,358,36804,35896,55093
3095,55095,"Polk County, Wisconsin",2000,16254,21129,4875,105,56,329,40990,698,41319,40131,55095
3096,55097,"Portage County, Wisconsin",2000,25040,26589,1549,1509,203,967,66215,751,67182,63752,55097
3097,55099,"Price County, Wisconsin",2000,6564,9574,3010,47,16,116,15706,181,15822,15462,55099
3098,55101,"Racine County, Wisconsin",2000,70819,74718,3899,1331,19441,14990,173841,2831,188831,150238,55101
3099,55103,"Richland County, Wisconsin",2000,7118,8164,1046,38,26,167,17757,147,17924,17546,55103
3100,55105,"Rock County, Wisconsin",2000,58617,62187,3570,1180,6943,5953,146354,2347,152307,135884,55105
3101,55107,"Rusk County, Wisconsin",2000,6095,7609,1514,38,78,116,15231,174,15347,14941,55107
3102,55109,"St. Croix County, Wisconsin",2000,23410,24265,855,386,176,483,62672,585,63155,61525,55109
3103,55111,"Sauk County, Wisconsin",2000,21644,24297,2653,143,138,938,54287,765,55225,53241,55111
3104,55113,"Sawyer County, Wisconsin",2000,6640,13722,7082,41,50,145,16051,2778,16196,13182,55113
3105,55115,"Shawano County, Wisconsin",2000,15815,18317,2502,134,90,407,40257,2931,40664,37102,55115
3106,55117,"Sheboygan County, Wisconsin",2000,43545,45947,2402,3669,1189,3789,108857,1371,112646,102628,55117
3107,55119,"Taylor County, Wisconsin",2000,7529,8595,1066,46,17,127,19553,148,19680,19342,55119
3108,55121,"Trempealeau County, Wisconsin",2000,10747,11482,735,36,33,240,26770,155,27010,26546,55121
3109,55123,"Vernon County, Wisconsin",2000,10825,12416,1591,60,18,186,27870,175,28056,27617,55123
3110,55125,"Vilas County, Wisconsin",2000,9066,22397,13331,37,42,181,20852,2008,21033,18765,55125
3111,55127,"Walworth County, Wisconsin",2000,34522,43783,9261,592,747,6136,87623,856,93759,85428,55127
3112,55129,"Washburn County, Wisconsin",2000,6604,10814,4210,28,25,143,15893,336,16036,15504,55129
3113,55131,"Washington County, Wisconsin",2000,43842,45808,1966,666,447,1529,115964,981,117493,113870,55131
3114,55133,"Waukesha County, Wisconsin",2000,135229,140309,5080,5340,2570,9503,351264,3449,360767,339905,55133
3115,55135,"Waupaca County, Wisconsin",2000,19863,22508,2645,137,82,714,51017,503,51731,50295,55135
3116,55137,"Waushara County, Wisconsin",2000,9336,13667,4331,79,53,848,22306,235,23154,21939,55137
3117,55139,"Winnebago County, Wisconsin",2000,61157,64721,3564,2849,1725,3065,153698,1964,156763,147160,55139
3118,55141,"Wood County, Wisconsin",2000,30135,31691,1556,1220,201,709,74846,987,75555,72438,55141
3119,56001,"Albany County, Wyoming",2000,13269,15215,1946,539,322,2397,29617,753,32014,28003,56001
3120,56003,"Big Horn County, Wyoming",2000,4312,5105,793,24,9,707,10754,194,11461,10527,56003
3121,56005,"Campbell County, Wyoming",2000,12207,13288,1081,100,47,1191,32507,659,33698,31701,56005
3122,56007,"Carbon County, Wyoming",2000,6129,8307,2178,103,103,2163,13476,378,15639,12892,56007
3123,56009,"Converse County, Wyoming",2000,4694,5669,975,31,18,660,11392,271,12052,11072,56009
3124,56011,"Crook County, Wyoming",2000,2308,2935,627,4,3,54,5833,97,5887,5729,56011
3125,56013,"Fremont County, Wyoming",2000,13545,15541,1996,100,43,1566,34238,7402,35804,26693,56013
3126,56015,"Goshen County, Wyoming",2000,5061,5881,820,25,25,1107,11431,209,12538,11172,56015
3127,56017,"Hot Springs County, Wyoming",2000,2108,2536,428,10,17,116,4766,125,4882,4614,56017
3128,56019,"Johnson County, Wyoming",2000,2959,3503,544,4,5,148,6927,147,7075,6771,56019
3129,56021,"Laramie County, Wyoming",2000,31927,34213,2286,743,2015,8897,72710,2051,81607,67901,56021
3130,56023,"Lincoln County, Wyoming",2000,5266,6831,1565,32,14,315,14258,210,14573,14002,56023
3131,56025,"Natrona County, Wyoming",2000,26819,29882,3063,269,473,3257,63276,1511,66533,61023,56025
3132,56027,"Niobrara County, Wyoming",2000,1011,1338,327,2,3,36,2371,29,2407,2337,56027
3133,56029,"Park County, Wyoming",2000,10312,11869,1557,111,19,959,24827,341,25786,24356,56029
3134,56031,"Platte County, Wyoming",2000,3625,4528,903,9,3,465,8342,149,8807,8181,56031
3135,56033,"Sheridan County, Wyoming",2000,11167,12577,1410,101,44,646,25914,647,26560,25122,56033
3136,56035,"Sublette County, Wyoming",2000,2371,3552,1181,11,12,112,5808,76,5920,5709,56035
3137,56037,"Sweetwater County, Wyoming",2000,14105,15921,1816,235,270,3545,34068,888,37613,32675,56037
3138,56039,"Teton County, Wyoming",2000,7688,10267,2579,97,25,1185,17066,276,18251,16668,56039
3139,56041,"Uinta County, Wyoming",2000,6823,8011,1188,50,18,1055,18687,409,19742,18210,56041
3140,56043,"Washakie County, Wyoming",2000,3278,3654,376,57,8,951,7338,130,8289,7143,56043
3141,56045,"Weston County, Wyoming",2000,2624,3231,607,13,8,137,6507,188,6644,6298,56045
3142,72001,"Adjuntas Municipio, Puerto Rico",2000,5895,6715,820,1,3,19077,66,1,19143,61,72001
3143,72003,"Aguada Municipio, Puerto Rico",2000,13520,15590,2070,10,15,41747,295,26,42042,244,72003
3144,72005,"Aguadilla Municipio, Puerto Rico",2000,22087,24882,2795,79,108,63469,1216,59,64685,970,72005
3145,72007,"Aguas Buenas Municipio, Puerto Rico",2000,9240,10412,1172,11,15,28831,201,15,29032,160,72007
3146,72009,"Aibonito Municipio, Puerto Rico",2000,8408,9163,755,10,1,26352,141,7,26493,123,72009
3147,72011,"Añasco Municipio, Puerto Rico",2000,9398,10723,1325,8,15,28147,201,6,28348,172,72011
3148,72013,"Arecibo Municipio, Puerto Rico",2000,34245,38974,4729,49,33,99293,838,110,100131,646,72013
3149,72015,"Arroyo Municipio, Puerto Rico",2000,6166,7287,1121,11,36,18939,178,23,19117,108,72015
3150,72017,"Barceloneta Municipio, Puerto Rico",2000,7508,8375,867,3,7,22193,129,19,22322,100,72017
3151,72019,"Barranquitas Municipio, Puerto Rico",2000,8663,9740,1077,6,4,28754,155,10,28909,135,72019
3152,72021,"Bayamón Municipio, Puerto Rico",2000,73693,79476,5783,235,298,221144,2900,236,224044,2131,72021
3153,72023,"Cabo Rojo Municipio, Puerto Rico",2000,17114,23182,6068,15,16,46465,446,42,46911,373,72023
3154,72025,"Caguas Municipio, Puerto Rico",2000,46937,50568,3631,94,101,139359,1143,101,140502,847,72025
3155,72027,"Camuy Municipio, Puerto Rico",2000,11457,12520,1063,7,11,34967,277,19,35244,240,72027
3156,72029,"Canóvanas Municipio, Puerto Rico",2000,13446,15071,1625,10,68,43016,319,33,43335,208,72029
3157,72031,"Carolina Municipio, Puerto Rico",2000,63546,71347,7801,238,347,183125,2951,231,186076,2135,72031
3158,72033,"Cataño Municipio, Puerto Rico",2000,9638,10366,728,25,35,29653,418,73,30071,285,72033
3159,72035,"Cayey Municipio, Puerto Rico",2000,15634,17782,2148,16,15,47042,328,43,47370,254,72035
3160,72037,"Ceiba Municipio, Puerto Rico",2000,5750,6742,992,184,762,14636,3368,186,18004,2236,72037
3161,72039,"Ciales Municipio, Puerto Rico",2000,6047,6886,839,12,1,19697,114,8,19811,93,72039
3162,72041,"Cidra Municipio, Puerto Rico",2000,13204,14267,1063,17,21,42486,267,26,42753,203,72041
3163,72043,"Coamo Municipio, Puerto Rico",2000,11749,13249,1500,6,14,37371,226,13,37597,193,72043
3164,72045,"Comerío Municipio, Puerto Rico",2000,6311,7311,1000,6,0,19927,75,9,20002,60,72045
3165,72047,"Corozal Municipio, Puerto Rico",2000,11264,12386,1122,11,7,36708,159,9,36867,132,72047
3166,72049,"Culebra Municipio, Puerto Rico",2000,699,1024,325,6,8,1696,172,5,1868,153,72049
3167,72051,"Dorado Municipio, Puerto Rico",2000,10887,13067,2180,19,31,33407,610,41,34017,519,72051
3168,72053,"Fajardo Municipio, Puerto Rico",2000,14176,17136,2960,70,168,39585,1127,75,40712,814,72053
3169,72054,"Florida Municipio, Puerto Rico",2000,3962,4387,425,4,2,12287,80,4,12367,70,72054
3170,72055,"Guánica Municipio, Puerto Rico",2000,7291,8849,1558,8,6,21758,130,19,21888,97,72055
3171,72057,"Guayama Municipio, Puerto Rico",2000,14225,16368,2143,26,26,43940,361,60,44301,249,72057
3172,72059,"Guayanilla Municipio, Puerto Rico",2000,7209,8147,938,7,4,22950,122,13,23072,98,72059
3173,72061,"Guaynabo Municipio, Puerto Rico",2000,34068,36826,2758,134,314,97639,2414,126,100053,1840,72061
3174,72063,"Gurabo Municipio, Puerto Rico",2000,11741,12854,1113,10,44,36383,360,30,36743,276,72063
3175,72065,"Hatillo Municipio, Puerto Rico",2000,12685,13929,1244,15,12,38607,318,20,38925,271,72065
3176,72067,"Hormigueros Municipio, Puerto Rico",2000,5820,6423,603,17,7,16444,170,6,16614,140,72067
3177,72069,"Humacao Municipio, Puerto Rico",2000,19293,22559,3266,73,70,58288,747,67,59035,537,72069
3178,72071,"Isabela Municipio, Puerto Rico",2000,14970,17166,2196,24,32,44009,435,24,44444,355,72071
3179,72073,"Jayuya Municipio, Puerto Rico",2000,5083,5591,508,1,0,17220,98,18,17318,79,72073
3180,72075,"Juana Díaz Municipio, Puerto Rico",2000,14954,16490,1536,20,33,50266,265,17,50531,195,72075
3181,72077,"Juncos Municipio, Puerto Rico",2000,11933,13064,1131,12,20,36253,199,8,36452,159,72077
3182,72079,"Lajas Municipio, Puerto Rico",2000,9007,10947,1940,13,22,26053,208,11,26261,162,72079
3183,72081,"Lares Municipio, Puerto Rico",2000,10974,12060,1086,10,3,34228,187,7,34415,167,72081
3184,72083,"Las Marías Municipio, Puerto Rico",2000,3564,4124,560,6,2,10987,74,3,11061,63,72083
3185,72085,"Las Piedras Municipio, Puerto Rico",2000,11145,12421,1276,10,11,34246,239,23,34485,195,72085
3186,72087,"Loíza Municipio, Puerto Rico",2000,9597,10927,1330,12,73,32343,194,33,32537,76,72087
3187,72089,"Luquillo Municipio, Puerto Rico",2000,6573,9327,2754,22,44,19327,490,38,19817,386,72089
3188,72091,"Manatí Municipio, Puerto Rico",2000,15266,17113,1847,15,30,45166,243,8,45409,190,72091
3189,72093,"Maricao Municipio, Puerto Rico",2000,2013,2272,259,1,1,6393,56,2,6449,52,72093
3190,72095,"Maunabo Municipio, Puerto Rico",2000,3994,4482,488,3,24,12670,71,7,12741,37,72095
3191,72097,"Mayagüez Municipio, Puerto Rico",2000,34742,39364,4622,125,69,97467,967,81,98434,692,72097
3192,72099,"Moca Municipio, Puerto Rico",2000,12712,14253,1541,11,4,39380,317,35,39697,267,72099
3193,72101,"Morovis Municipio, Puerto Rico",2000,8801,9462,661,1,13,29770,195,14,29965,167,72101
3194,72103,"Naguabo Municipio, Puerto Rico",2000,7872,8875,1003,14,24,23510,243,42,23753,163,72103
3195,72105,"Naranjito Municipio, Puerto Rico",2000,8932,9758,826,8,3,29565,144,6,29709,127,72105
3196,72107,"Orocovis Municipio, Puerto Rico",2000,7083,7946,863,1,2,23647,197,15,23844,179,72107
3197,72109,"Patillas Municipio, Puerto Rico",2000,6576,7677,1101,0,4,20011,141,7,20152,130,72109
3198,72111,"Peñuelas Municipio, Puerto Rico",2000,7698,8735,1037,4,8,26544,175,11,26719,152,72111
3199,72113,"Ponce Municipio, Puerto Rico",2000,59607,66471,6864,125,85,184602,1873,281,186475,1382,72113
3200,72115,"Quebradillas Municipio, Puerto Rico",2000,8280,9095,815,12,5,25280,170,9,25450,144,72115
3201,72117,"Rincón Municipio, Puerto Rico",2000,5147,6827,1680,2,6,14418,349,28,14767,313,72117
3202,72119,"Río Grande Municipio, Puerto Rico",2000,16430,19928,3498,27,94,51721,641,52,52362,468,72119
3203,72121,"Sabana Grande Municipio, Puerto Rico",2000,8865,9982,1117,8,2,25787,148,20,25935,118,72121
3204,72123,"Salinas Municipio, Puerto Rico",2000,10184,11876,1692,7,13,30895,218,22,31113,176,72123
3205,72125,"San Germán Municipio, Puerto Rico",2000,12809,14335,1526,31,75,36722,383,19,37105,258,72125
3206,72127,"San Juan Municipio, Puerto Rico",2000,163462,182101,18639,635,1221,425652,8722,891,434374,5975,72127
3207,72129,"San Lorenzo Municipio, Puerto Rico",2000,13138,14594,1456,11,24,40757,240,23,40997,182,72129
3208,72131,"San Sebastián Municipio, Puerto Rico",2000,14970,16682,1712,15,12,43981,223,10,44204,186,72131
3209,72133,"Santa Isabel Municipio, Puerto Rico",2000,6781,7569,788,15,14,21512,153,16,21665,108,72133
3210,72135,"Toa Alta Municipio, Puerto Rico",2000,19420,21075,1655,26,78,63418,511,32,63929,375,72135
3211,72137,"Toa Baja Municipio, Puerto Rico",2000,30453,33473,3020,85,200,92762,1323,90,94085,948,72137
3212,72139,"Trujillo Alto Municipio, Puerto Rico",2000,24160,26241,2081,41,61,74901,827,61,75728,664,72139
3213,72141,"Utuado Municipio, Puerto Rico",2000,11207,12471,1264,14,9,35090,246,25,35336,198,72141
3214,72143,"Vega Alta Municipio, Puerto Rico",2000,11894,13526,1632,6,20,37669,241,27,37910,188,72143
3215,72145,"Vega Baja Municipio, Puerto Rico",2000,19758,21990,2232,17,29,61413,516,84,61929,386,72145
3216,72147,"Vieques Municipio, Puerto Rico",2000,3319,4388,1069,8,28,8870,236,18,9106,182,72147
3217,72149,"Villalba Municipio, Puerto Rico",2000,7722,8465,743,2,1,27787,126,9,27913,114,72149
3218,72151,"Yabucoa Municipio, Puerto Rico",2000,12242,13688,1446,9,22,38975,271,33,39246,207,72151
3219,72153,"Yauco Municipio, Puerto Rico",2000,15012,17062,2050,13,18,46097,287,28,46384,228,72153
1,05131,"Sebastian County, Arkansas",2010,49599,54651,5052,5039,7848,15445,110299,5827,125744,91585,05131
2,05133,"Sevier County, Arkansas",2010,5975,6887,912,62,717,5220,11838,643,17058,10416,05133
3,05135,"Sharp County, Arkansas",2010,7360,9822,2462,49,91,290,16974,435,17264,16399,05135
4,05137,"Stone County, Arkansas",2010,5325,6712,1387,45,11,157,12237,269,12394,11912,05137
5,05139,"Union County, Arkansas",2010,16951,19653,2702,196,13674,1460,40179,587,41639,25722,05139
6,05141,"Van Buren County, Arkansas",2010,7433,10345,2912,56,65,475,16820,417,17295,16282,05141
7,05143,"Washington County, Arkansas",2010,76389,87808,11419,4372,5828,31458,171607,10861,203065,150546,05143
8,05145,"White County, Arkansas",2010,29342,32488,3146,411,3033,2879,74197,1727,77076,69026,05145
9,05149,"Yell County, Arkansas",2010,8219,9752,1533,278,288,4230,17955,369,22185,17020,05149
10,06011,"Colusa County, California",2010,7056,7883,827,267,168,11804,9615,656,21419,8524,06011
11,06007,"Butte County, California",2010,87618,95835,8217,8921,3133,31116,188884,11414,220000,165416,06007
12,06001,"Alameda County, California",2010,545138,582549,37411,390524,184126,339889,1170382,81173,1510271,514559,06001
13,06003,"Alpine County, California",2010,497,1760,1263,7,0,84,1091,232,1175,852,06003
14,06005,"Amador County, California",2010,14569,18032,3463,396,938,4756,33335,1676,38091,30325,06005
15,06009,"Calaveras County, California",2010,18886,27925,9039,529,355,4703,40875,1917,45578,38074,06009
16,06013,"Contra Costa County, California",2010,375364,400263,24899,148881,93604,255560,793465,50057,1049025,500923,06013
17,06015,"Del Norte County, California",2010,9907,11186,1279,938,967,5093,23517,3099,28610,18513,06015
18,06031,"Kings County, California",2010,41233,43867,2634,5339,10314,77866,75116,5584,152982,53879,06031
19,06021,"Glenn County, California",2010,9800,10778,978,674,192,10539,17583,1000,28122,15717,06021
20,06023,"Humboldt County, California",2010,56031,61559,5528,2854,1393,13211,121412,13207,134623,103958,06023
21,06025,"Imperial County, California",2010,49126,56067,6941,2201,5114,140271,34257,3015,174528,23927,06025
22,06017,"El Dorado County, California",2010,70223,88159,17936,6143,1296,21875,159183,7055,181058,144689,06017
23,06019,"Fresno County, California",2010,289391,315531,26140,86856,45005,468070,462380,25997,930450,304522,06019
24,06027,"Inyo County, California",2010,8049,9478,1429,229,102,3597,14949,2322,18546,12296,06027
25,06029,"Kern County, California",2010,254610,284367,29757,33100,45377,413033,426598,24327,839631,323794,06029
26,06043,"Mariposa County, California",2010,7693,10188,2495,201,129,1676,16575,1053,18251,15192,06043
27,06033,"Lake County, California",2010,26548,35492,8944,695,1186,11088,53577,3758,64665,47938,06033
28,06035,"Lassen County, California",2010,10058,12710,2652,337,2790,6117,28778,2381,34895,23270,06035
29,06037,"Los Angeles County, California",2010,3241204,3445076,203872,1325671,815086,4687889,5130716,261638,9818605,2728321,06037
30,06039,"Madera County, California",2010,43317,49140,5823,2533,5009,80992,69873,4951,150865,57380,06039
31,06041,"Marin County, California",2010,103210,111214,8004,13577,6621,39069,213340,9312,252409,183830,06041
32,06059,"Orange County, California",2010,992781,1048907,56126,532477,44000,1012973,1997259,92283,3010232,1328499,06059
33,06045,"Mendocino County, California",2010,34945,40323,5378,1402,544,19505,68336,6141,87841,60249,06045
34,06047,"Merced County, California",2010,75642,83698,8056,18183,8785,140485,115308,6741,255793,81599,06047
35,06049,"Modoc County, California",2010,4064,5192,1128,70,77,1342,8344,548,9686,7649,06049
36,06051,"Mono County, California",2010,5768,13912,8144,191,42,3762,10440,520,14202,9687,06051
37,06053,"Monterey County, California",2010,125946,139048,13102,23777,11300,230003,185054,13542,415057,136435,06053
38,06055,"Napa County, California",2010,48876,54759,5883,8986,2440,44010,92474,4081,136484,76967,06055
39,06057,"Nevada County, California",2010,41527,52590,11063,1124,341,8439,90325,3383,98764,85477,06057
40,06071,"San Bernardino County, California",2010,611618,699637,88019,123978,170700,1001145,1034065,61789,2035210,677598,06071
41,06067,"Sacramento County, California",2010,513945,555932,41987,198944,139949,306196,1112592,86533,1418788,687166,06067
42,06069,"San Benito County, California",2010,16805,17870,1065,1298,355,31186,24083,1276,55269,21154,06069
43,06061,"Placer County, California",2010,132627,152648,20021,19963,4427,44710,303722,14038,348432,265294,06061
44,06063,"Plumas County, California",2010,8977,15566,6589,127,181,1605,18402,1079,20007,17015,06063
45,06065,"Riverside County, California",2010,686260,800707,114447,125921,130823,995257,1194384,68572,2189641,869068,06065
46,01001,"Autauga County, Alabama",2010,20221,22135,1914,467,9595,1310,53261,1045,54571,42154,01001
47,01007,"Bibb County, Alabama",2010,7953,8981,1028,22,5024,406,22509,272,22915,17191,01007
48,01017,"Chambers County, Alabama",2010,13933,17004,3071,166,13206,536,33679,414,34215,19893,01017
49,01019,"Cherokee County, Alabama",2010,10626,16267,5641,49,1206,320,25669,485,25989,23929,01019
50,01025,"Clarke County, Alabama",2010,10337,12638,2301,74,11280,271,25562,265,25833,13943,01025
51,01013,"Butler County, Alabama",2010,8491,9964,1473,174,9047,191,20756,211,20947,11324,01013
52,01009,"Blount County, Alabama",2010,21578,23887,2309,115,724,4626,52696,905,57322,50952,01009
53,01011,"Bullock County, Alabama",2010,3745,4493,748,20,7637,777,10137,88,10914,2392,01011
54,01021,"Chilton County, Alabama",2010,16558,19278,2720,125,4171,3420,40223,532,43643,35395,01021
55,01023,"Choctaw County, Alabama",2010,5866,7269,1403,12,5990,73,13786,84,13859,7700,01023
56,01037,"Coosa County, Alabama",2010,4794,6478,1684,14,3556,230,11309,135,11539,7604,01037
57,01027,"Clay County, Alabama",2010,5670,6776,1106,23,2048,399,13533,276,13932,11186,01027
58,01029,"Cleburne County, Alabama",2010,5891,6718,827,23,494,307,14665,192,14972,13956,01029
59,01031,"Coffee County, Alabama",2010,19849,22330,2481,629,8257,3180,46768,1748,49948,36134,01031
60,01035,"Conecuh County, Alabama",2010,5625,7093,1468,17,6122,161,13067,164,13228,6764,01035
61,01033,"Colbert County, Alabama",2010,22773,25758,2985,224,8702,1093,53335,1075,54428,43334,01033
62,01053,"Escambia County, Alabama",2010,14157,16486,2329,86,12162,718,37601,1845,38319,23508,01053
63,01039,"Covington County, Alabama",2010,15531,18829,3298,148,4685,483,37282,698,37765,31751,01039
64,01041,"Crenshaw County, Alabama",2010,5652,6735,1083,189,3241,204,13702,252,13906,10020,01041
65,01043,"Cullman County, Alabama",2010,31864,37054,5190,339,821,3454,76952,1224,80406,74568,01043
66,01045,"Dale County, Alabama",2010,20065,22677,2612,527,9546,2821,47430,1652,50251,35705,01045
67,01047,"Dallas County, Alabama",2010,17064,20208,3144,144,30314,309,43511,377,43820,12676,01047
68,01049,"DeKalb County, Alabama",2010,26842,31109,4267,166,1029,9690,61419,2227,71109,57997,01049
69,01051,"Elmore County, Alabama",2010,28301,32657,4356,514,15814,2129,77174,1397,79303,59449,01051
70,01065,"Hale County, Alabama",2010,6273,7655,1382,35,9265,140,15620,107,15760,6213,01065
71,01055,"Etowah County, Alabama",2010,42036,47454,5418,657,15716,3447,100983,1821,104430,82789,01055
72,01057,"Fayette County, Alabama",2010,7100,8437,1337,37,1958,204,17037,210,17241,14832,01057
73,01059,"Franklin County, Alabama",2010,12286,14022,1736,51,1211,4710,26994,483,31704,25249,01059
74,01061,"Geneva County, Alabama",2010,10920,12687,1767,64,2523,920,25870,591,26790,22692,01061
75,01063,"Greene County, Alabama",2010,3764,5007,1243,15,7349,69,8976,50,9045,1562,01063
76,01081,"Lee County, Alabama",2010,55682,62391,6709,3615,31674,4571,135676,2487,140247,97900,01081
77,01067,"Henry County, Alabama",2010,6994,8891,1897,45,4915,389,16913,222,17302,11731,01067
78,01069,"Houston County, Alabama",2010,40969,45319,4350,806,26038,2995,98552,1977,101547,69731,01069
79,01071,"Jackson County, Alabama",2010,21513,24786,3273,165,1771,1339,51888,2015,53227,47937,01071
80,01073,"Jefferson County, Alabama",2010,263568,300552,36984,9085,275511,25488,632978,8169,658466,340213,01073
81,01075,"Lamar County, Alabama",2010,6103,7354,1251,4,1635,180,14384,203,14564,12542,01075
82,01077,"Lauderdale County, Alabama",2010,38680,43791,5111,675,9190,2082,90627,1534,92709,79228,01077
83,01079,"Lawrence County, Alabama",2010,13654,15229,1575,41,3917,574,33765,3387,34339,26420,01079
84,01099,"Monroe County, Alabama",2010,9214,11333,2119,67,9581,220,22848,579,23068,12621,01099
85,01083,"Limestone County, Alabama",2010,31446,34977,3531,911,10350,4591,78191,1818,82782,65112,01083
86,01085,"Lowndes County, Alabama",2010,4352,5140,788,14,8283,87,11212,74,11299,2841,01085
87,01087,"Macon County, Alabama",2010,8499,10259,1760,76,17631,232,21220,246,21452,3267,01087
88,01089,"Madison County, Alabama",2010,134700,146447,11747,8167,79517,15404,319407,10278,334811,221445,01089
89,01091,"Marengo County, Alabama",2010,8535,10237,1702,53,10838,352,20675,177,21027,9607,01091
90,01093,"Marion County, Alabama",2010,12651,14737,2086,53,1178,632,30144,404,30776,28509,01093
91,01097,"Mobile County, Alabama",2010,158435,178196,19761,7507,142272,9936,403056,9373,412992,243904,01097
92,01095,"Marshall County, Alabama",2010,35810,40342,4532,475,1389,11238,81781,1857,93019,78060,01095
93,01115,"St. Clair County, Alabama",2010,31624,35541,3917,512,7098,1716,81877,1320,83593,72947,01115
94,01101,"Montgomery County, Alabama",2010,89981,101641,11660,4792,124928,8314,221049,3230,229363,88099,01101
95,01103,"Morgan County, Alabama",2010,47030,51193,4163,665,14059,9156,110334,3025,119490,92585,01103
96,01105,"Perry County, Alabama",2010,3947,4737,790,30,7244,114,10477,61,10591,3142,01105
97,01107,"Pickens County, Alabama",2010,8012,9483,1471,32,8169,313,19433,205,19746,11027,01107
98,01109,"Pike County, Alabama",2010,13210,15267,2057,645,11990,730,32169,647,32899,18887,01109
99,01111,"Randolph County, Alabama",2010,9164,11982,2818,54,4604,649,22264,326,22913,17280,01111
100,01113,"Russell County, Alabama",2010,21229,24595,3366,223,21926,1946,51001,1261,52947,27591,01113
101,01127,"Walker County, Alabama",2010,26571,30816,4245,190,3885,1307,65716,1054,67023,60587,01127
102,01117,"Shelby County, Alabama",2010,74072,80970,6898,3699,20606,11567,183518,2842,195085,156371,01117
103,01119,"Sumter County, Alabama",2010,5629,6786,1157,33,10283,86,13677,57,13763,3304,01119
104,01121,"Talladega County, Alabama",2010,31890,37088,5198,329,25953,1671,80620,1259,82291,53079,01121
105,01123,"Tallapoosa County, Alabama",2010,16985,22111,5126,197,11050,1042,40574,489,41616,28838,01123
106,01125,"Tuscaloosa County, Alabama",2010,76141,84872,8731,2293,57401,5949,188707,2402,194656,126611,01125
107,02090,"Fairbanks North Star Borough, Alaska",2010,36441,41783,5342,2512,4154,5651,91930,13005,97581,72259,02090
108,01129,"Washington County, Alabama",2010,6758,8407,1649,18,4360,151,17430,1597,17581,11455,01129
109,01131,"Wilcox County, Alabama",2010,4484,5649,1165,4,8420,72,11598,64,11670,3110,01131
110,01133,"Winston County, Alabama",2010,10163,13469,3306,59,115,639,23845,434,24484,23237,01133
111,02013,"Aleutians East Borough, Alaska",2010,553,747,194,1113,212,385,2756,1006,3141,425,02013
112,02016,"Aleutians West Census Area, Alaska",2010,1212,1929,717,1575,318,726,4835,1197,5561,1745,02016
113,02068,"Denali Borough, Alaska",2010,806,1771,965,19,10,42,1784,141,1826,1614,02068
114,02070,"Dillingham Census Area, Alaska",2010,1563,2427,864,32,11,101,4746,3848,4847,855,02070
115,02060,"Bristol Bay Borough, Alaska",2010,423,969,546,8,0,24,973,489,997,476,02060
116,08023,"Costilla County, Colorado",2010,1550,2613,1063,34,6,2327,1197,71,3524,1086,08023
117,08025,"Crowley County, Colorado",2010,1306,1559,253,59,555,1686,4137,154,5823,3369,08025
118,08027,"Custer County, Colorado",2010,1925,3956,2031,16,41,200,4055,84,4255,3914,08027
119,08029,"Delta County, Colorado",2010,12703,14572,1869,146,137,4345,26607,639,30952,25685,08029
120,08031,"Denver County, Colorado",2010,263107,285797,22690,19925,58388,190965,409193,17868,600158,313012,08031
121,08035,"Douglas County, Colorado",2010,102018,106859,4841,10563,3245,21392,264073,6968,285465,243297,08035
122,08033,"Dolores County, Colorado",2010,899,1468,569,2,3,82,1982,100,2064,1877,08033
123,08049,"Grand County, Colorado",2010,6469,16061,9592,121,51,1116,13727,242,14843,13313,08049
124,08039,"Elbert County, Colorado",2010,8380,8939,559,165,159,1234,21852,523,23086,21005,08039
125,08041,"El Paso County, Colorado",2010,235959,252852,16893,16492,35792,93665,528598,28367,622263,447947,08041
126,08043,"Fremont County, Colorado",2010,16582,19242,2660,274,1805,5770,41054,1328,46824,37647,08043
127,08045,"Garfield County, Colorado",2010,20359,23309,2950,342,236,15978,40411,1049,56389,38784,08045
128,08047,"Gilpin County, Colorado",2010,2460,3560,1100,75,28,267,5174,124,5441,4947,08047
129,08069,"Larimer County, Colorado",2010,120295,132722,12427,5675,2259,31628,268002,7021,299630,253047,08069
130,08051,"Gunnison County, Colorado",2010,6516,11412,4896,94,45,1255,14069,272,15324,13658,08051
131,08053,"Hinsdale County, Colorado",2010,362,1388,1026,3,3,24,819,27,843,786,08053
132,08055,"Huerfano County, Colorado",2010,3137,5075,1938,19,22,2368,4343,151,6711,4151,08055
133,08057,"Jackson County, Colorado",2010,649,1286,637,1,0,150,1244,24,1394,1219,08057
134,08059,"Jefferson County, Colorado",2010,218160,229967,11807,13682,5001,76445,458098,12255,534543,427160,08059
135,08061,"Kiowa County, Colorado",2010,619,805,186,0,3,78,1320,13,1398,1304,08061
136,08063,"Kit Carson County, Colorado",2010,3038,3527,489,34,217,1574,6696,125,8270,6320,08063
137,08065,"Lake County, Colorado",2010,2953,4271,1318,28,22,2858,4452,150,7310,4252,08065
138,08071,"Las Animas County, Colorado",2010,6384,8217,1833,98,195,6446,9061,369,15507,8399,08071
139,08067,"La Plata County, Colorado",2010,21100,25860,4760,266,176,6056,45278,3591,51334,41245,08067
140,08087,"Morgan County, Colorado",2010,10294,11490,1196,135,755,9506,18653,393,28159,17370,08087
141,08073,"Lincoln County, Colorado",2010,1948,2420,472,39,280,683,4784,120,5467,4345,08073
142,08075,"Logan County, Colorado",2010,8047,8981,934,117,881,3551,19158,406,22709,17754,08075
143,08077,"Mesa County, Colorado",2010,58095,62644,4549,1059,776,19552,127171,3392,146723,121944,08077
144,08079,"Mineral County, Colorado",2010,355,1201,846,1,2,21,691,10,712,678,08079
145,08081,"Moffat County, Colorado",2010,5465,6196,731,76,32,1985,11810,290,13795,11412,08081
146,08083,"Montezuma County, Colorado",2010,10541,12094,1553,118,47,2818,22717,3384,25535,19168,08083
147,08085,"Montrose County, Colorado",2010,16484,18250,1766,236,118,8127,33149,806,41276,31989,08085
148,08099,"Prowers County, Colorado",2010,4935,5942,1007,38,54,4417,8134,169,12551,7873,08099
149,08089,"Otero County, Colorado",2010,7729,8969,1240,135,93,7596,11235,368,18831,10639,08089
150,08091,"Ouray County, Colorado",2010,2022,3083,1061,25,6,196,4240,66,4436,4143,08091
151,08093,"Park County, Colorado",2010,7174,13947,6773,99,69,783,15423,413,16206,14842,08093
152,08095,"Phillips County, Colorado",2010,1819,2087,268,26,14,830,3612,46,4442,3526,08095
153,08097,"Pitkin County, Colorado",2010,8152,12953,4801,204,82,1561,15587,234,17148,15067,08097
154,08111,"San Juan County, Colorado",2010,344,756,412,7,0,84,615,13,699,595,08111
155,08107,"Routt County, Colorado",2010,9892,16303,6411,145,91,1600,21909,363,23509,21310,08107
156,08109,"Saguache County, Colorado",2010,2640,3843,1203,47,11,2452,3656,152,6108,3446,08109
157,08101,"Pueblo County, Colorado",2010,62972,69526,6554,1123,2646,65811,93252,3429,159063,86054,08101
158,08103,"Rio Blanco County, Colorado",2010,2647,3309,662,22,49,665,6001,174,6666,5756,08103
159,08105,"Rio Grande County, Colorado",2010,4779,6630,1851,40,25,5086,6896,231,11982,6600,08105
160,09001,"Fairfield County, Connecticut",2010,335545,361221,25676,41801,92705,155025,761804,20582,916829,606716,09001
161,08113,"San Miguel County, Colorado",2010,3454,6638,3184,52,19,630,6729,144,7359,6514,08113
162,08115,"Sedgwick County, Colorado",2010,1093,1415,322,17,7,289,2090,30,2379,2036,08115
163,08117,"Summit County, Colorado",2010,11754,29842,18088,269,208,3989,24005,370,27994,23158,08117
164,08119,"Teller County, Colorado",2010,9805,12643,2838,155,104,1294,22056,649,23350,21148,08119
165,08121,"Washington County, Colorado",2010,1980,2434,454,11,30,407,4407,60,4814,4306,08121
166,08123,"Weld County, Colorado",2010,89349,96281,6932,2873,2054,71680,181145,5391,252825,170827,08123
167,08125,"Yuma County, Colorado",2010,3952,4466,514,20,16,2088,7955,95,10043,7824,08125
168,09005,"Litchfield County, Connecticut",2010,76640,87550,10910,2877,2206,8535,181392,2906,189927,173403,09005
169,09003,"Hartford County, Connecticut",2010,350854,374249,23395,37581,110005,136783,757231,18362,894014,591283,09003
170,09007,"Middlesex County, Connecticut",2010,67202,74837,7635,4207,7256,7834,157842,3235,165676,143144,09007
171,09015,"Windham County, Connecticut",2010,44810,49073,4263,1360,1995,11351,107077,2584,118428,101138,09015
172,10001,"Kent County, Delaware",2010,60278,65338,5060,3266,37812,9346,152964,5995,162310,105891,10001
173,09009,"New Haven County, Connecticut",2010,334502,362004,27502,29933,101763,129743,732734,18654,862477,582384,09009
174,09011,"New London County, Connecticut",2010,107057,120994,13937,11248,14488,23214,250841,10500,274055,214605,09011
175,09013,"Tolland County, Connecticut",2010,54477,57963,3486,5084,4701,6602,146089,2715,152691,133589,09013
176,10005,"Sussex County, Delaware",2010,79368,123036,43668,1910,24544,16954,180191,4712,197145,149025,10005
177,11001,"District of Columbia, District of Columbia",2010,266707,296719,30012,20818,301053,54749,546974,15639,601723,209464,11001
178,10003,"New Castle County, Delaware",2010,202651,217511,14860,23132,124426,46921,491558,12164,538479,331836,10003
179,12009,"Brevard County, Florida",2010,229692,269864,40172,11098,52677,43943,499433,14192,543376,421466,12009
180,12015,"Charlotte County, Florida",2010,73370,100632,27262,1884,8622,9213,150765,2631,159978,137628,12015
181,12001,"Alachua County, Florida",2010,100516,112766,12250,13098,49420,20752,226584,6600,247336,157466,12001
182,12005,"Bay County, Florida",2010,68438,99650,31212,3298,17844,8107,160745,5813,168852,133790,12005
183,12007,"Bradford County, Florida",2010,9479,11011,1532,149,5777,1020,27500,508,28520,21066,12007
184,12011,"Broward County, Florida",2010,686047,810388,124341,55692,449677,438247,1309819,43633,1748066,760817,12011
185,12027,"DeSoto County, Florida",2010,11445,14590,3145,169,4338,10425,24437,381,34862,19549,12027
186,12003,"Baker County, Florida",2010,8772,9687,915,129,3651,520,26595,462,27115,22353,12003
187,12013,"Calhoun County, Florida",2010,5061,5999,938,71,1991,755,13870,451,14625,11357,12013
188,12017,"Citrus County, Florida",2010,63304,78026,14722,1979,3767,6584,134652,2357,141236,126549,12017
189,12019,"Clay County, Florida",2010,68792,75478,6686,5429,18085,14609,176256,5485,190865,147257,12019
190,12021,"Collier County, Florida",2010,133179,197298,64119,3390,19898,83177,238343,3899,321520,211156,12021
191,12029,"Dixie County, Florida",2010,6316,9319,3003,48,1364,512,15910,278,16422,14220,12029
192,12023,"Columbia County, Florida",2010,24941,28636,3695,611,11663,3276,64255,1506,67531,50475,12023
193,12041,"Gilchrist County, Florida",2010,6121,7307,1186,59,884,845,16094,269,16939,14882,12041
194,12031,"Duval County, Florida",2010,342450,388486,46036,35381,250063,65398,798865,24595,864263,488826,12031
195,12033,"Escambia County, Florida",2010,116238,136703,20465,8015,67443,14061,283558,11199,297619,196901,12033
196,12035,"Flagler County, Florida",2010,39186,48595,9409,2020,10470,8251,87445,2095,95696,72860,12035
197,12037,"Franklin County, Florida",2010,4254,8652,4398,26,1574,529,11020,232,11549,9188,12037
198,12039,"Gadsden County, Florida",2010,16952,19506,2554,221,25881,4419,41970,533,46389,15335,12039
199,12057,"Hillsborough County, Florida",2010,474030,536092,62062,41328,191260,306635,922591,29438,1229226,660565,12057
200,12043,"Glades County, Florida",2010,4533,6979,2446,46,1538,2720,10164,633,12884,7947,12043
201,12045,"Gulf County, Florida",2010,5335,9110,3775,41,2937,678,15185,326,15863,11881,12045
202,12047,"Hamilton County, Florida",2010,4617,5778,1161,73,5038,1306,13493,258,14799,8124,12047
203,12049,"Hardee County, Florida",2010,8245,9722,1477,294,1877,11895,15836,350,27731,13315,12049
204,12051,"Hendry County, Florida",2010,12025,14564,2539,275,5057,19243,19897,915,39140,13650,12051
205,12053,"Hernando County, Florida",2010,71745,84504,12759,1815,8165,17796,154982,3155,172778,141847,12053
206,12055,"Highlands County, Florida",2010,42604,55386,12782,1402,8750,17157,81629,1673,98786,69804,12055
207,12069,"Lake County, Florida",2010,121289,144996,23707,5055,27796,36009,261043,6827,297052,221365,12069
208,12065,"Jefferson County, Florida",2010,5646,6632,986,49,5293,546,14215,205,14761,8668,12065
209,12067,"Lafayette County, Florida",2010,2580,3328,748,13,1396,1076,7794,119,8870,6266,12067
210,12059,"Holmes County, Florida",2010,7354,8641,1287,83,1140,444,19483,538,19927,17722,12059
211,12061,"Indian River County, Florida",2010,60176,76346,16170,1646,12074,15465,122563,2063,138028,106780,12061
212,12063,"Jackson County, Florida",2010,17417,21003,3586,227,13106,2143,47603,1159,49746,33111,12063
213,12085,"Martin County, Florida",2010,63899,78131,14232,1510,7493,17881,128437,1902,146318,117532,12085
214,12071,"Lee County, Florida",2010,259818,371099,111281,8252,47751,113308,505446,10395,618754,439048,12071
215,12073,"Leon County, Florida",2010,110945,124136,13191,7950,82386,15361,260126,6307,275487,163483,12073
216,12075,"Levy County, Florida",2010,16404,20123,3719,228,3756,3047,37754,812,40801,32958,12075
217,12077,"Liberty County, Florida",2010,2525,3357,832,16,1472,518,7847,200,8365,6159,12077
218,12079,"Madison County, Florida",2010,6985,8481,1496,43,7423,899,18325,277,19224,10582,12079
219,12081,"Manatee County, Florida",2010,135729,172690,36961,5203,27228,47955,274878,5497,322833,236950,12081
220,12083,"Marion County, Florida",2010,137726,164050,26324,4337,39337,36137,295161,6351,331298,245136,12083
221,12101,"Pasco County, Florida",2010,189612,228928,39316,9609,19010,54536,410161,9303,464697,372239,12101
222,12086,"Miami-Dade County, Florida",2010,867352,989435,122083,35841,425650,1623859,872576,27534,2496435,383551,12086
223,12087,"Monroe County, Florida",2010,32629,52764,20135,782,3851,15071,58019,1297,73090,52089,12087
224,12089,"Nassau County, Florida",2010,28794,35009,6215,619,4581,2380,70934,1324,73314,64410,12089
225,12097,"Osceola County, Florida",2010,90603,128170,37567,7120,24503,122146,146539,6624,268685,108292,12097
226,12099,"Palm Beach County, Florida",2010,544227,664594,120367,30549,221209,250823,1069311,23982,1320134,793571,12099
227,12091,"Okaloosa County, Florida",2010,72379,92407,20028,5189,16333,12296,168526,7504,180822,139500,12091
228,12093,"Okeechobee County, Florida",2010,14013,18509,4496,345,3117,9561,30435,715,39996,26258,12093
229,12095,"Orange County, Florida",2010,421847,487839,65992,55541,223200,308244,837712,32217,1145956,526754,12095
230,12117,"Seminole County, Florida",2010,164706,181307,16601,15451,44196,72457,350261,10162,422718,280452,12117
231,12103,"Pinellas County, Florida",2010,415876,503634,87758,26749,91922,73241,843301,19844,916542,704786,12103
232,12105,"Polk County, Florida",2010,227485,281214,53729,9567,85336,106532,495563,11891,602095,388769,12105
233,12107,"Putnam County, Florida",2010,29409,37337,7928,444,11842,6706,67658,1391,74364,53981,12107
234,12109,"St. Johns County, Florida",2010,75338,89830,14492,3854,10388,9972,180067,3631,190039,162194,12109
235,12111,"St. Lucie County, Florida",2010,108523,137029,28506,4226,51373,45995,231794,6163,277789,170032,12111
236,12113,"Santa Rosa County, Florida",2010,56910,64760,7850,2690,7940,6507,144865,5509,151372,128726,12113
237,12115,"Sarasota County, Florida",2010,175746,228413,52667,4818,17036,30033,349415,5583,379448,321978,12115
238,12129,"Wakulla County, Florida",2010,10490,12804,2314,166,4406,1016,29760,716,30776,24472,12129
239,12119,"Sumter County, Florida",2010,41361,53026,11665,609,8736,5582,87838,1155,93420,77338,12119
240,12121,"Suwannee County, Florida",2010,15953,19164,3211,223,4696,3596,37955,736,41551,32300,12121
241,02020,"Anchorage Municipality, Alaska",2010,107332,113032,5700,23208,15308,22061,269765,48435,291826,182814,02020
242,02050,"Bethel Census Area, Alaska",2010,4651,5919,1268,158,65,181,16832,14755,17013,1854,02050
243,02150,"Kodiak Island Borough, Alaska",2010,4630,5303,673,2620,85,996,12596,2754,13592,7137,02150
244,02100,"Haines Borough, Alaska",2010,1149,1631,482,13,9,47,2461,377,2508,2062,02100
245,02105,"Hoonah-Angoon Census Area, Alaska",2010,913,1771,858,12,8,77,2073,1060,2150,993,02105
246,02110,"Juneau City and Borough, Alaska",2010,12187,13055,868,1879,259,1588,29687,6484,31275,21065,02110
247,02122,"Kenai Peninsula Borough, Alaska",2010,22161,30578,8417,614,248,1641,53759,7018,55400,45879,02122
248,02130,"Ketchikan Gateway Borough, Alaska",2010,5305,6166,861,936,76,538,12939,3009,13477,8918,02130
249,02220,"Sitka City and Borough, Alaska",2010,3545,4102,557,509,43,437,8444,2251,8881,5641,02220
250,02164,"Lake and Peninsula Borough, Alaska",2010,553,1502,949,6,9,43,1588,1211,1631,362,02164
251,02170,"Matanuska-Susitna Borough, Alaska",2010,31824,41329,9505,1075,817,3301,85694,10126,88995,73676,02170
252,02180,"Nome Census Area, Alaska",2010,2815,4008,1193,88,27,115,9377,7751,9492,1511,02180
253,02185,"North Slope Borough, Alaska",2010,2029,2500,471,414,91,249,9181,5617,9430,3059,02185
254,02188,"Northwest Arctic Borough, Alaska",2010,1919,2707,788,42,35,58,7465,6558,7523,830,02188
255,02195,"Petersburg Census Area, Alaska",2010,1599,1994,395,96,15,130,3685,925,3815,2649,02195
256,02198,"Prince of Wales-Hyder Census Area, Alaska",2010,2194,2992,798,21,17,127,5432,2638,5559,2756,02198
257,02275,"Wrangell City and Borough, Alaska",2010,1053,1428,375,32,4,37,2332,597,2369,1699,02275
258,02230,"Skagway Municipality, Alaska",2010,436,636,200,5,0,21,947,70,968,872,02230
259,02240,"Southeast Fairbanks Census Area, Alaska",2010,2567,3915,1348,64,71,234,6795,1125,7029,5535,02240
260,02261,"Valdez-Cordova Census Area, Alaska",2010,3966,6102,2136,350,45,349,9287,1943,9636,6949,02261
261,02282,"Yakutat City and Borough, Alaska",2010,270,450,180,27,2,17,645,348,662,268,02282
262,02270,"Wade Hampton Census Area, Alaska",2010,1745,2183,438,17,1,7,7452,7235,7459,199,02270
263,04009,"Graham County, Arizona",2010,11120,12980,1860,193,633,11320,25900,5591,37220,19483,04009
264,02290,"Yukon-Koyukuk Census Area, Alaska",2010,2217,4038,1821,14,9,66,5522,4281,5588,1218,02290
265,04001,"Apache County, Arizona",2010,22771,32514,9743,185,157,4113,67405,52495,71518,14568,04001
266,04003,"Cochise County, Arizona",2010,50865,59041,8176,2410,4936,42543,88803,4652,131346,76805,04003
267,04007,"Gila County, Arizona",2010,22000,32698,10698,256,195,9588,44009,8260,53597,35298,04007
268,04005,"Coconino County, Arizona",2010,46711,63321,16610,1787,1495,18166,116255,38742,134421,74231,04005
269,04023,"Santa Cruz County, Arizona",2010,15437,18010,2573,235,89,39273,8147,259,47420,7564,04023
270,04011,"Greenlee County, Arizona",2010,3188,4372,1184,44,79,4040,4397,220,8437,4054,04011
271,04012,"La Paz County, Arizona",2010,9198,16049,6851,90,115,4806,15683,2624,20489,12854,04012
272,04013,"Maricopa County, Arizona",2010,1411583,1639279,227696,128301,177490,1128741,2688376,142530,3817117,2240055,04013
273,04015,"Mohave County, Arizona",2010,82539,110911,28372,2016,1715,29569,170617,7508,200186,159378,04015
274,04017,"Navajo County, Arizona",2010,35658,56938,21280,542,842,11571,95878,47313,107449,47181,04017
275,04019,"Pima County, Arizona",2010,388660,440909,52249,24592,31075,338802,641461,44094,980263,541700,04019
276,04021,"Pinal County, Arizona",2010,125590,159222,33632,6114,16007,106977,268793,26186,375770,220486,04021
277,05015,"Carroll County, Arkansas",2010,11393,13559,2166,160,74,3489,23957,661,27446,23062,05015
278,04025,"Yavapai County, Arizona",2010,90903,110432,19529,1703,1104,28728,182305,6530,211033,172968,04025
279,04027,"Yuma County, Arizona",2010,64767,87850,23083,2041,3169,116912,78839,4607,195751,69022,04027
280,05001,"Arkansas County, Arkansas",2010,8005,9436,1431,92,4634,513,18506,269,19019,13511,05001
281,05011,"Bradley County, Arkansas",2010,4673,5860,1187,25,3167,1516,9992,124,11508,6676,05011
282,05009,"Boone County, Arkansas",2010,15120,16827,1707,153,64,674,36229,873,36903,35139,05009
283,05003,"Ashley County, Arkansas",2010,8765,10137,1372,40,5619,1069,20784,224,21853,14901,05003
284,05005,"Baxter County, Arkansas",2010,18748,22580,3832,163,59,688,40825,766,41513,39837,05005
285,05007,"Benton County, Arkansas",2010,82087,93084,10997,6245,2647,34283,187056,8559,221339,169605,05007
286,05013,"Calhoun County, Arkansas",2010,2262,2897,635,11,1190,152,5216,76,5368,3939,05013
287,05017,"Chicot County, Arkansas",2010,4579,5421,842,53,6347,542,11258,97,11800,4761,05017
288,05029,"Conway County, Arkansas",2010,8463,9720,1257,76,2376,757,20516,531,21273,17533,05029
289,05019,"Clark County, Arkansas",2010,8783,10385,1602,120,5366,926,22069,406,22995,16177,05019
290,05021,"Clay County, Arkansas",2010,6845,8031,1186,18,56,217,15866,215,16083,15577,05021
291,05023,"Cleburne County, Arkansas",2010,11078,15826,4748,51,67,517,25453,441,25970,24894,05023
292,05025,"Cleveland County, Arkansas",2010,3416,4064,648,10,1053,145,8544,87,8689,7394,05025
293,05027,"Columbia County, Arkansas",2010,9759,11596,1837,171,9006,533,24019,297,24552,14545,05027
294,05041,"Desha County, Arkansas",2010,5321,6261,940,43,6176,578,12430,128,13008,6083,05041
295,05031,"Craighead County, Arkansas",2010,37291,40515,3224,1068,12564,4277,92166,1774,96443,76760,05031
296,05033,"Crawford County, Arkansas",2010,23447,26115,2668,874,696,3760,58188,2848,61948,53770,05033
297,05035,"Crittenden County, Arkansas",2010,19026,21489,2463,301,25953,1014,49888,606,50902,23028,05035
298,05037,"Cross County, Arkansas",2010,7002,7853,851,83,3966,266,17604,212,17870,13343,05037
299,05039,"Dallas County, Arkansas",2010,3280,4305,1025,10,3396,188,7928,129,8116,4393,05039
300,05057,"Hempstead County, Arkansas",2010,8839,10419,1580,82,6623,2713,19896,421,22609,12770,05057
301,05043,"Drew County, Arkansas",2010,7360,8408,1048,91,5139,454,18055,238,18509,12587,05043
302,05045,"Faulkner County, Arkansas",2010,42614,46612,3998,1266,11495,4435,108802,2715,113237,93326,05045
303,05051,"Garland County, Arkansas",2010,40994,50548,9554,689,7552,4622,91402,2540,96024,80621,05051
304,05047,"Franklin County, Arkansas",2010,7037,8021,984,162,124,371,17754,471,18125,16997,05047
305,05049,"Fulton County, Arkansas",2010,5196,6778,1582,28,39,97,12148,276,12245,11805,05049
306,05053,"Grant County, Arkansas",2010,6933,7758,825,47,385,392,17461,228,17853,16801,05053
307,05055,"Greene County, Arkansas",2010,16425,17892,1467,107,232,901,41189,684,42090,40166,05055
308,05069,"Jefferson County, Arkansas",2010,28873,33006,4133,595,42485,1219,76216,1086,77435,32050,05069
309,05059,"Hot Spring County, Arkansas",2010,12664,14332,1668,93,3544,919,32004,664,32923,27703,05059
310,05061,"Howard County, Arkansas",2010,5365,6238,873,84,2813,1349,12440,251,13789,9292,05061
311,05063,"Independence County, Arkansas",2010,14391,16187,1796,276,709,2139,34508,609,36647,32914,05063
312,05065,"Izard County, Arkansas",2010,5731,7232,1501,39,175,208,13488,268,13696,13006,05065
313,05067,"Jackson County, Arkansas",2010,6724,7601,877,53,2988,436,17561,340,17997,14180,05067
314,05091,"Miller County, Arkansas",2010,17219,19281,2062,196,10589,1038,42424,948,43462,30691,05091
315,05071,"Johnson County, Arkansas",2010,9812,11311,1499,175,336,3094,22446,607,25540,21328,05071
316,05073,"Lafayette County, Arkansas",2010,3150,4353,1203,26,2837,131,7514,68,7645,4583,05073
317,05075,"Lawrence County, Arkansas",2010,6938,8000,1062,22,134,158,17257,253,17415,16848,05075
318,05077,"Lee County, Arkansas",2010,3624,4356,732,41,5740,168,10256,155,10424,4320,05077
319,05079,"Lincoln County, Arkansas",2010,4207,4860,653,20,4211,452,13682,155,14134,9296,05079
320,05087,"Madison County, Arkansas",2010,6174,7481,1307,81,27,759,14958,399,15717,14451,05087
321,05089,"Marion County, Arkansas",2010,7411,9354,1943,37,28,287,16366,338,16653,15963,05089
322,05081,"Little River County, Arkansas",2010,5411,6460,1049,39,2508,357,12814,436,13171,9831,05081
323,05083,"Logan County, Arkansas",2010,8704,10108,1404,361,285,510,21843,589,22353,20608,05083
324,05085,"Lonoke County, Arkansas",2010,25295,27239,1944,526,4059,2246,66110,1417,68356,60108,05085
325,05103,"Ouachita County, Arkansas",2010,11003,13121,2118,95,10434,408,25712,477,26120,14706,05103
326,05093,"Mississippi County, Arkansas",2010,17741,20459,2718,229,15761,1695,44785,689,46480,28106,05093
327,05095,"Monroe County, Arkansas",2010,3481,4455,974,36,3314,132,8017,118,8149,4549,05095
328,05097,"Montgomery County, Arkansas",2010,4000,5763,1763,49,17,361,9126,254,9487,8806,05097
329,05099,"Nevada County, Arkansas",2010,3697,4563,866,23,2758,220,8777,135,8997,5861,05099
330,05101,"Newton County, Arkansas",2010,3571,4664,1093,22,5,141,8189,268,8330,7894,05101
331,05109,"Pike County, Arkansas",2010,4457,5580,1123,55,327,727,10564,219,11291,9963,05109
332,05105,"Perry County, Arkansas",2010,4170,4907,737,17,196,247,10198,206,10445,9779,05105
333,05107,"Phillips County, Arkansas",2010,8491,10126,1635,64,13652,287,21470,219,21757,7535,05107
334,13011,"Banks County, Georgia",2010,6700,7595,895,165,416,1041,17354,247,18395,16526,13011
335,13013,"Barrow County, Georgia",2010,23971,26400,2429,2359,7769,6037,63330,1466,69367,51736,13013
336,13017,"Ben Hill County, Georgia",2010,6794,7942,1148,120,6087,1026,16608,237,17634,10164,13017
337,13039,"Camden County, Georgia",2010,18047,21114,3067,706,9621,2590,47923,1619,50513,35977,13039
338,13023,"Bleckley County, Georgia",2010,4660,5304,644,109,3533,301,12762,120,13063,9000,13023
339,13009,"Baldwin County, Georgia",2010,16788,20159,3371,580,18866,919,44801,651,45720,24704,13009
340,13005,"Bacon County, Georgia",2010,4214,4801,587,34,1696,791,10305,144,11096,8431,13005
341,13007,"Baker County, Georgia",2010,1372,1652,280,24,1600,145,3306,40,3451,1642,13007
342,13021,"Bibb County, Georgia",2010,60295,69662,9367,2492,80744,4389,151158,2428,155547,65494,13021
343,13015,"Bartow County, Georgia",2010,35782,39823,4041,705,10024,7690,92467,1935,100157,79803,13015
344,13019,"Berrien County, Georgia",2010,7443,8709,1266,82,2040,885,18401,229,19286,16050,13019
345,13027,"Brooks County, Georgia",2010,6457,7706,1249,51,5695,853,15390,219,16243,9425,13027
346,13029,"Bryan County, Georgia",2010,10738,11842,1104,473,4210,1336,28897,768,30233,23446,13029
347,13031,"Bulloch County, Georgia",2010,25575,28794,3219,1013,19252,2439,67778,1262,70217,46251,13031
348,13033,"Burke County, Georgia",2010,8533,9865,1332,68,11469,617,22699,318,23316,10844,13033
349,13035,"Butts County, Georgia",2010,7881,9357,1476,100,6431,597,23058,327,23655,16200,13035
350,13037,"Calhoun County, Georgia",2010,2002,2409,407,30,4092,262,6432,60,6694,2250,13037
351,13053,"Chattahoochee County, Georgia",2010,2686,3376,690,231,2047,1398,9869,502,11267,7089,13053
352,13043,"Candler County, Georgia",2010,4041,4761,720,57,2669,1227,9771,96,10998,6949,13043
353,13045,"Carroll County, Georgia",2010,39187,44607,5420,836,19862,6800,103727,2498,110527,80531,13045
354,13047,"Catoosa County, Georgia",2010,24475,26606,2131,762,1356,1469,62473,1206,63942,59149,13047
355,13049,"Charlton County, Georgia",2010,3927,4475,548,76,3443,310,11861,226,12171,8116,13049
356,13051,"Chatham County, Georgia",2010,103038,119323,16285,6229,105274,14370,250758,5763,265128,133492,13051
357,13069,"Coffee County, Georgia",2010,14817,17061,2244,302,11227,4352,38004,568,42356,25907,13069
358,13055,"Chattooga County, Georgia",2010,9548,10977,1429,108,2886,1043,24972,389,26015,21589,13055
359,13057,"Cherokee County, Georgia",2010,75936,82360,6424,3484,11633,20566,193780,4420,214346,174243,13057
360,13059,"Clarke County, Georgia",2010,45414,51068,5654,4811,30695,12192,104522,2342,116714,66674,13059
361,13061,"Clay County, Georgia",2010,1331,2102,771,10,1920,26,3157,39,3183,1188,13061
362,13063,"Clayton County, Georgia",2010,90633,104705,14072,12839,169020,35447,223977,5508,259424,36610,13063
363,13065,"Clinch County, Georgia",2010,2572,3007,435,13,1876,236,6562,137,6798,4536,13065
364,13067,"Cobb County, Georgia",2010,260056,286490,26434,30432,168053,84330,603748,17825,688078,387438,13067
365,13081,"Crisp County, Georgia",2010,9079,10734,1655,183,10033,748,22691,259,23439,12216,13081
366,13077,"Coweta County, Georgia",2010,45673,50171,4498,1895,21744,8493,118824,2581,127317,92604,13077
367,13079,"Crawford County, Georgia",2010,4822,5292,470,32,2806,301,12329,209,12630,9282,13079
368,13071,"Colquitt County, Georgia",2010,16317,18311,1994,289,10143,7763,37735,544,45498,26759,13071
369,13073,"Columbia County, Georgia",2010,44898,48626,3728,4726,18084,6175,117878,3551,124053,91517,13073
370,13075,"Cook County, Georgia",2010,6339,7287,948,113,4684,1024,16188,220,17212,11171,13075
371,13093,"Dooly County, Georgia",2010,5286,6328,1042,93,7381,862,14056,121,14918,6461,13093
372,13083,"Dade County, Georgia",2010,6291,7305,1014,114,142,292,16341,289,16633,15796,13083
373,13085,"Dawson County, Georgia",2010,8433,10425,1992,124,97,920,21410,342,22330,20847,13085
374,13087,"Decatur County, Georgia",2010,10390,12125,1735,138,11366,1404,26438,319,27842,14615,13087
375,13089,"DeKalb County, Georgia",2010,271809,304968,33159,35173,370963,67824,624069,14538,691893,203395,13089
376,13091,"Dodge County, Georgia",2010,8177,9857,1680,101,6451,732,21064,239,21796,14273,13091
377,13109,"Evans County, Georgia",2010,4033,4664,631,60,3165,1441,9559,106,11000,6228,13109
378,13095,"Dougherty County, Georgia",2010,36508,40801,4293,719,63198,2073,92492,1260,94565,27315,13095
379,13097,"Douglas County, Georgia",2010,46624,51672,5048,1876,51387,11125,121278,3104,132403,64911,13097
380,13099,"Early County, Georgia",2010,4228,4975,747,37,5441,171,10837,109,11008,5250,13099
381,13101,"Echols County, Georgia",2010,1329,1558,229,12,163,1183,2851,121,4034,2555,13101
382,13103,"Effingham County, Georgia",2010,18092,19884,1792,425,6982,1501,50749,1031,52250,42311,13103
383,13105,"Elbert County, Georgia",2010,8063,9583,1520,121,5906,967,19199,216,20166,12956,13105
384,13107,"Emanuel County, Georgia",2010,8430,9968,1538,154,7541,921,21677,249,22598,13733,13107
385,06077,"San Joaquin County, California",2010,215007,233755,18748,94547,48540,266341,418965,29959,685306,245919,06077
386,13111,"Fannin County, Georgia",2010,10187,16207,6020,72,75,431,23251,343,23682,22761,13111
387,13113,"Fayette County, Georgia",2010,38167,40793,2626,4106,21117,6760,99807,2382,106567,72202,13113
388,13115,"Floyd County, Georgia",2010,35930,40551,4621,1225,13494,8987,87330,1652,96317,70959,13115
389,13117,"Forsyth County, Georgia",2010,59433,64052,4619,10875,4287,16550,158961,2856,175511,140943,13117
390,13119,"Franklin County, Georgia",2010,8540,10553,2013,121,1821,866,21218,363,22084,18913,13119
391,06073,"San Diego County, California",2010,1086865,1164786,77921,328058,146600,991348,2103965,129260,3095313,1500047,06073
392,06075,"San Francisco County, California",2010,345811,376942,31131,265700,46781,121774,683461,33529,805235,337451,06075
393,06093,"Siskiyou County, California",2010,19505,23910,4405,528,552,4615,40285,3522,44900,35683,06093
394,06079,"San Luis Obispo County, California",2010,102016,117315,15299,8106,5128,55973,213664,8734,269637,191696,06079
395,06081,"San Mateo County, California",2010,257837,271031,13194,175934,18763,182502,535949,37643,718451,303609,06081
396,06083,"Santa Barbara County, California",2010,142104,152834,10730,19591,7242,181687,242208,12253,423895,203122,06083
397,06085,"Santa Clara County, California",2010,604204,631920,27716,565466,42331,479210,1302432,67726,1781642,626909,06085
398,06087,"Santa Cruz County, California",2010,94355,104476,10121,10658,2304,84092,178290,8931,262382,156397,06087
399,06089,"Shasta County, California",2010,70346,77313,6967,4297,1438,14878,162345,10566,177223,146044,06089
400,06091,"Sierra County, California",2010,1482,2328,846,12,5,269,2971,99,3240,2855,06091
401,06115,"Yuba County, California",2010,24307,27635,3328,4710,2122,18051,54104,4856,72155,42416,06115
402,06095,"Solano County, California",2010,141758,152698,10940,59027,58743,99356,313988,27590,413344,168628,06095
403,06097,"Sonoma County, California",2010,185825,204572,18747,17777,6769,120430,363448,18875,483878,320027,06097
404,06099,"Stanislaus County, California",2010,165180,179503,14323,24712,13065,215658,298795,20595,514453,240423,06099
405,06101,"Sutter County, California",2010,31437,33858,2421,13442,1713,27251,67486,4549,94737,47782,06101
406,06103,"Tehama County, California",2010,23767,26987,3220,625,349,13906,49557,2980,63463,45603,06103
407,06105,"Trinity County, California",2010,6083,8681,2598,93,45,959,12827,1171,13786,11518,06105
408,06111,"Ventura County, California",2010,266920,281695,14775,54099,13082,331567,491751,23702,823318,400868,06111
409,06113,"Yolo County, California",2010,70872,75054,4182,25640,4752,60953,139896,9264,200849,100240,06113
410,06107,"Tulare County, California",2010,130352,141696,11344,14204,5497,268065,174114,10478,442179,143935,06107
411,06109,"Tuolumne County, California",2010,22156,31244,9088,530,1114,5918,49447,2478,55365,45325,06109
412,08011,"Bent County, Colorado",2010,1832,2242,410,56,491,1985,4514,135,6499,3832,08011
413,08001,"Adams County, Colorado",2010,153764,163136,9372,15431,12207,167878,273725,11117,441603,234970,08001
414,08005,"Arapahoe County, Colorado",2010,224011,238301,14290,28595,55657,105522,466481,20482,572003,361747,08005
415,08007,"Archuleta County, Colorado",2010,5267,8762,3495,79,33,2148,9936,378,12084,9446,08007
416,08009,"Baca County, Colorado",2010,1685,2248,563,6,20,348,3440,91,3788,3323,08009
417,08003,"Alamosa County, Colorado",2010,5995,6554,559,130,138,7110,8335,400,15445,7667,08003
418,08021,"Conejos County, Colorado",2010,3118,4286,1168,18,12,4620,3636,155,8256,3451,08021
419,08013,"Boulder County, Colorado",2010,119300,127071,7771,11996,2265,39276,255291,7289,294567,233741,08013
420,08014,"Broomfield County, Colorado",2010,21414,22646,1232,3368,530,6216,49673,1417,55889,44358,08014
421,08015,"Chaffee County, Colorado",2010,7601,10020,2419,104,267,1678,16131,343,17809,15417,08015
422,08017,"Cheyenne County, Colorado",2010,786,975,189,10,7,178,1658,24,1836,1617,08017
423,08019,"Clear Creek County, Colorado",2010,4208,5685,1477,51,50,429,8659,187,9088,8371,08019
424,08037,"Eagle County, Colorado",2010,19236,31312,12076,517,243,15689,36508,643,52197,35105,08037
425,05123,"St. Francis County, Arkansas",2010,9616,10903,1287,133,14565,1149,27109,438,28258,11973,05123
426,05147,"Woodruff County, Arkansas",2010,3134,3893,759,15,1989,87,7173,128,7260,5041,05147
427,05115,"Pope County, Arkansas",2010,23353,25551,2198,597,1748,4168,57586,1574,61754,53667,05115
428,05119,"Pulaski County, Arkansas",2010,158772,175555,16783,7425,133242,22168,360580,8216,382748,211697,05119
429,01003,"Baldwin County, Alabama",2010,73180,104061,30881,1340,16966,7992,174273,3767,182265,152200,01003
430,01005,"Barbour County, Alabama",2010,9820,11829,2009,107,12820,1387,26070,306,27457,12837,01005
431,01015,"Calhoun County, Alabama",2010,47331,53289,5958,830,24177,3893,114679,2387,118572,87285,01015
432,05111,"Poinsett County, Arkansas",2010,9754,10923,1169,45,1764,543,24040,350,24583,21881,05111
433,05113,"Polk County, Arkansas",2010,8450,10002,1552,88,54,1190,19472,781,20662,18549,05113
434,05117,"Prairie County, Arkansas",2010,3685,4503,818,5,1061,81,8634,98,8715,7470,05117
435,05121,"Randolph County, Arkansas",2010,7299,8513,1214,28,128,283,17686,304,17969,17226,05121
436,05125,"Saline County, Arkansas",2010,41441,44811,3370,920,4945,4087,103031,1868,107118,95298,05125
437,05127,"Scott County, Arkansas",2010,4368,5193,825,379,51,782,10451,434,11233,9587,05127
438,05129,"Searcy County, Arkansas",2010,3574,4900,1326,11,3,121,8074,260,8195,7800,05129
439,29181,"Ripley County, Missouri",2010,5637,6597,960,44,49,142,13958,302,14100,13563,29181
440,29183,"St. Charles County, Missouri",2010,134274,141016,6742,7789,14827,9983,350502,6808,360485,321078,29183
441,29203,"Shannon County, Missouri",2010,3448,4164,716,15,16,139,8302,257,8441,8014,29203
442,29186,"Ste. Genevieve County, Missouri",2010,7040,8637,1597,49,117,149,17996,223,18145,17607,29186
443,29187,"St. Francois County, Missouri",2010,23981,28458,4477,242,2759,778,64581,949,65359,60631,29187
444,29189,"St. Louis County, Missouri",2010,404765,438032,33267,34466,231801,25024,973930,19679,998954,687984,29189
445,29195,"Saline County, Missouri",2010,8883,10117,1234,123,1217,1925,21445,664,23370,19441,29195
446,29197,"Schuyler County, Missouri",2010,1796,2102,306,10,1,29,4402,38,4431,4353,29197
447,29199,"Scotland County, Missouri",2010,1880,2369,489,11,3,33,4810,36,4843,4760,29199
448,29201,"Scott County, Missouri",2010,15538,16987,1449,133,4436,705,38486,660,39191,33257,29201
449,29215,"Texas County, Missouri",2010,10057,11685,1628,80,871,425,25583,622,26008,24010,29215
450,29205,"Shelby County, Missouri",2010,2581,3206,625,13,32,71,6302,55,6373,6202,29205
451,29207,"Stoddard County, Missouri",2010,12255,13609,1354,51,274,356,29612,356,29968,28931,29207
452,29209,"Stone County, Missouri",2010,13690,20373,6683,95,46,553,31649,570,32202,30938,29209
453,29211,"Sullivan County, Missouri",2010,2740,3358,618,8,30,1248,5466,78,6714,5350,29211
454,29213,"Taney County, Missouri",2010,20755,29255,8500,329,405,2494,49181,1364,51675,47083,29213
455,29217,"Vernon County, Missouri",2010,8396,9495,1099,103,100,336,20823,423,21159,20197,29217
456,29219,"Warren County, Missouri",2010,12339,14685,2346,123,598,957,31556,634,32513,30201,29219
457,29221,"Washington County, Missouri",2010,9355,11017,1662,48,554,255,24940,369,25195,23969,29221
458,29223,"Wayne County, Missouri",2010,5717,8083,2366,32,33,140,13381,263,13521,13053,29223
459,29225,"Webster County, Missouri",2010,13062,14417,1355,70,320,612,35590,731,36202,34469,29225
460,29227,"Worth County, Missouri",2010,944,1281,337,6,11,23,2148,16,2171,2115,29227
461,29229,"Wright County, Missouri",2010,7499,8700,1201,51,87,238,18577,316,18815,18123,29229
462,29510,"St. Louis city, Missouri",2010,142057,176002,33945,9233,156389,11130,308164,7840,319294,134702,29510
463,30005,"Blaine County, Montana",2010,2357,2843,486,6,7,115,6376,3256,6491,3107,30005
464,30003,"Big Horn County, Montana",2010,4004,4695,691,59,30,510,12355,8358,12865,3908,30003
465,30001,"Beaverhead County, Montana",2010,4014,5273,1259,36,19,338,8908,286,9246,8567,30001
466,30007,"Broadwater County, Montana",2010,2347,2695,348,9,15,126,5486,152,5612,5310,30007
467,30021,"Dawson County, Montana",2010,3749,4233,484,26,25,178,8788,260,8966,8477,30021
468,30011,"Carter County, Montana",2010,532,810,278,1,1,8,1152,18,1160,1132,30011
469,30009,"Carbon County, Montana",2010,4571,6441,1870,22,30,188,9890,170,10078,9668,30009
470,30013,"Cascade County, Montana",2010,33809,37276,3467,665,958,2711,78616,5893,81327,71100,30013
471,30015,"Chouteau County, Montana",2010,2294,2879,585,21,1,94,5719,1310,5813,4387,30015
472,30023,"Deer Lodge County, Montana",2010,4018,5122,1104,28,36,271,9027,445,9298,8518,30023
473,30025,"Fallon County, Montana",2010,1233,1470,237,17,2,34,2856,44,2890,2793,30025
474,30027,"Fergus County, Montana",2010,5099,5836,737,27,18,171,11415,285,11586,11085,30027
475,30017,"Custer County, Montana",2010,5031,5560,529,37,31,263,11436,359,11699,11009,30017
476,30019,"Daniels County, Montana",2010,798,1111,313,4,3,27,1724,64,1751,1653,30019
477,30039,"Granite County, Montana",2010,1417,2822,1405,2,3,44,3035,62,3079,2968,30039
478,30029,"Flathead County, Montana",2010,37504,46963,9459,522,180,2070,88858,2717,90928,85439,30029
479,30031,"Gallatin County, Montana",2010,36550,42289,5739,1011,277,2470,87043,2210,89513,83545,30031
480,30033,"Garfield County, Montana",2010,532,844,312,1,3,3,1203,12,1206,1187,30033
481,30035,"Glacier County, Montana",2010,4361,5348,987,26,17,241,13158,8998,13399,4117,30035
482,30037,"Golden Valley County, Montana",2010,363,476,113,6,0,31,853,25,884,822,30037
483,36037,"Genesee County, New York",2010,23728,25589,1861,355,1491,1616,58463,1627,60079,54990,36037
484,36039,"Greene County, New York",2010,19823,29210,9387,382,2606,2419,46802,957,49221,42857,36039
485,36051,"Livingston County, New York",2010,24409,27123,2714,780,1491,1802,63591,1024,65393,60296,36051
486,30041,"Hill County, Montana",2010,6275,7250,975,66,47,373,15723,3869,16096,11741,30041
487,30043,"Jefferson County, Montana",2010,4512,5055,543,39,16,224,11182,403,11406,10724,30043
488,30045,"Judith Basin County, Montana",2010,924,1336,412,2,1,24,2048,31,2072,2014,30045
489,30047,"Lake County, Montana",2010,11432,16588,5156,112,88,998,27748,7980,28746,19568,30047
490,36043,"Herkimer County, New York",2010,26324,33381,7057,325,640,1040,63479,824,64519,61690,36043
491,36041,"Hamilton County, New York",2010,2262,8694,6432,24,33,51,4785,64,4836,4664,36041
492,36045,"Jefferson County, New York",2010,43451,57966,14515,1464,5475,6143,110086,3465,116229,99682,36045
493,36047,"Kings County, New York",2010,916856,1000293,83437,260129,799066,496285,2008415,55914,2504700,893306,36047
494,36049,"Lewis County, New York",2010,10514,15112,4598,72,170,357,26730,263,27087,26225,36049
495,36063,"Niagara County, New York",2010,90556,99120,8564,1807,14511,4694,211775,6550,216469,188907,36063
496,36053,"Madison County, New York",2010,27754,31757,4003,576,1260,1316,72126,1374,73442,68916,36053
497,36055,"Monroe County, New York",2010,300422,320593,20171,24023,107448,54005,690339,16834,744344,542034,36055
498,36057,"Montgomery County, New York",2010,20272,23063,2791,356,712,5654,44565,765,50219,42732,36057
499,36059,"Nassau County, New York",2010,448528,468346,19818,101558,141305,195355,1144177,24005,1339532,877309,36059
500,36061,"New York County, New York",2010,763846,847090,83244,177624,205340,403577,1182296,37839,1585873,761493,36061
501,36079,"Putnam County, New York",2010,35041,38224,3183,1832,2047,11661,88049,1461,99710,82709,36079
502,36065,"Oneida County, New York",2010,93028,104180,11152,6522,13682,10819,224059,4601,234878,199254,36065
503,36067,"Onondaga County, New York",2010,187686,202357,14671,14370,48696,18829,448197,15091,467026,370040,36067
504,36069,"Ontario County, New York",2010,43019,48193,5174,1111,2226,3679,104252,1796,107931,99119,36069
505,36071,"Orange County, New York",2010,125925,137025,11100,8685,33895,67185,305628,8789,372813,254259,36071
506,36073,"Orleans County, New York",2010,16119,18431,2312,173,2368,1757,41126,927,42883,37658,36073
507,36077,"Otsego County, New York",2010,24620,30777,6157,660,958,1921,60338,986,62259,57734,36077
508,36075,"Oswego County, New York",2010,46400,53598,7198,709,862,2552,119557,1895,122109,116091,36075
509,36091,"Saratoga County, New York",2010,88296,98656,10360,3880,3053,5279,214328,3748,219607,203647,36091
510,36081,"Queens County, New York",2010,780117,835127,55010,508334,395881,613750,1616972,96030,2230722,616727,36081
511,36083,"Rensselaer County, New York",2010,64702,71475,6773,3469,9592,6080,153349,3733,159429,136555,36083
512,36085,"Richmond County, New York",2010,165516,176656,11140,34697,44313,81051,387679,8500,468730,300169,36085
513,36087,"Rockland County, New York",2010,99242,104057,4815,19099,34623,48783,262904,5512,311687,203670,36087
514,36089,"St. Lawrence County, New York",2010,41605,52133,10528,1074,2259,2146,109798,2522,111944,103943,36089
515,36107,"Tioga County, New York",2010,20350,22203,1853,371,349,694,50431,606,51125,49105,36107
516,36093,"Schenectady County, New York",2010,62886,68196,5310,4917,13528,8827,145900,8046,154727,119409,36093
517,36095,"Schoharie County, New York",2010,13166,17231,4065,217,394,924,31825,472,32749,30742,36095
518,36097,"Schuyler County, New York",2010,7530,9455,1925,51,143,234,18109,269,18343,17646,36097
519,36099,"Seneca County, New York",2010,13393,16043,2650,238,1513,952,34299,549,35251,31999,36099
520,36101,"Steuben County, New York",2010,40344,48875,8531,1151,1487,1371,97619,1505,98990,93476,36101
521,36103,"Suffolk County, New York",2010,499922,569985,70063,50295,102117,246239,1247111,25971,1493350,1068728,36103
522,36105,"Sullivan County, New York",2010,30139,49186,19047,1033,6349,10554,66993,1831,77547,57780,36105
523,36115,"Washington County, New York",2010,24142,28844,4702,260,1734,1446,61770,780,63216,58996,36115
524,36109,"Tompkins County, New York",2010,38967,41674,2707,8680,3773,4264,97300,3357,101564,81490,36109
525,36111,"Ulster County, New York",2010,71049,83638,12589,3060,9982,15909,166584,4443,182493,149099,36111
526,36113,"Warren County, New York",2010,27990,38726,10736,449,556,1178,64529,939,65707,62585,36113
527,36117,"Wayne County, New York",2010,36585,41057,4472,465,2743,3476,90296,1770,93772,85318,36117
528,36119,"Westchester County, New York",2010,347232,370821,23589,51123,126585,207032,742081,19810,949113,544563,36119
529,36121,"Wyoming County, New York",2010,15501,17970,2469,156,2233,1244,40911,480,42155,38042,36121
530,36123,"Yates County, New York",2010,9517,13491,3974,96,196,421,24927,264,25348,24371,36123
531,37007,"Anson County, North Carolina",2010,9755,11576,1821,281,13038,812,26136,473,26948,12344,37007
532,37011,"Avery County, North Carolina",2010,6664,13890,7226,56,706,797,17000,209,17797,16029,37011
533,37003,"Alexander County, North Carolina",2010,14425,16189,1764,357,2025,1601,35597,544,37198,32671,37003
534,37015,"Bertie County, North Carolina",2010,8359,9822,1463,103,13252,267,21015,267,21282,7393,37015
535,37013,"Beaufort County, North Carolina",2010,19941,24688,4747,158,12105,3166,44593,625,47759,31705,37013
536,37005,"Alleghany County, North Carolina",2010,4778,8094,3316,53,133,1004,10151,103,11155,9862,37005
537,37001,"Alamance County, North Carolina",2010,59960,66576,6616,1806,27985,16639,134492,2983,151131,101718,37001
538,37009,"Ashe County, North Carolina",2010,11755,17342,5587,105,148,1311,25970,297,27281,25420,37009
539,37017,"Bladen County, North Carolina",2010,14430,17718,3288,67,12202,2502,32688,1177,35190,19242,37017
540,18061,"Harrison County, Indiana",2010,15192,16534,1342,153,167,581,38783,479,39364,37984,18061
541,18073,"Jasper County, Indiana",2010,12232,13168,936,123,208,1823,31655,336,33478,30988,18073
542,18059,"Hancock County, Indiana",2010,26304,28125,1821,554,1420,1216,68786,953,70002,65859,18059
543,37019,"Brunswick County, North Carolina",2010,46297,77482,31185,560,12120,5549,101882,2384,107431,86818,37019
544,37021,"Buncombe County, North Carolina",2010,100412,113365,12953,2388,14979,14254,224064,5456,238318,201241,37021
545,37023,"Burke County, North Carolina",2010,35804,40879,5075,3163,5953,4634,86278,1690,90912,75472,37023
546,18063,"Hendricks County, Indiana",2010,52368,55454,3086,2984,6988,4379,141069,2433,145448,128664,18063
547,18065,"Henry County, Indiana",2010,19077,21288,2211,154,1064,691,48771,620,49462,46933,18065
548,18067,"Howard County, Indiana",2010,34301,38679,4378,737,5585,2203,80549,2136,82752,72091,18067
549,18069,"Huntington County, Indiana",2010,14218,15805,1587,167,155,631,36493,479,37124,35692,18069
550,18071,"Jackson County, Indiana",2010,16501,18202,1701,356,265,2410,39966,519,42376,38826,18071
551,18089,"Lake County, Indiana",2010,188157,208750,20593,5981,125506,82663,413342,7693,496005,274162,18089
552,18075,"Jay County, Indiana",2010,8133,9221,1088,77,58,577,20676,185,21253,20356,18075
553,18077,"Jefferson County, Indiana",2010,12635,14311,1676,211,530,755,31673,469,32428,30463,18077
554,18079,"Jennings County, Indiana",2010,10680,12069,1389,62,206,571,27954,325,28525,27361,18079
555,18087,"LaGrange County, Indiana",2010,11598,14094,2496,118,109,1317,35811,294,37128,35290,18087
556,18085,"Kosciusko County, Indiana",2010,29197,37038,7841,642,542,5634,71724,1009,77358,69531,18085
557,18081,"Johnson County, Indiana",2010,52242,56649,4407,2716,1536,4270,135384,2229,139654,128903,18081
558,18083,"Knox County, Indiana",2010,15249,17038,1789,214,994,590,37850,488,38440,36154,18083
559,12123,"Taylor County, Florida",2010,7920,11004,3084,149,4629,777,21793,532,22570,16483,12123
560,12125,"Union County, Florida",2010,4048,4508,460,32,3391,743,14792,246,15535,11123,12125
561,12127,"Volusia County, Florida",2010,208236,254226,45990,7368,49548,55217,439376,9478,494593,372982,12127
562,13001,"Appling County, Georgia",2010,6969,8512,1543,125,3360,1704,16532,193,18236,12854,13001
563,13025,"Brantley County, Georgia",2010,6885,8086,1201,37,531,343,18068,302,18411,17198,13025
564,13003,"Atkinson County, Georgia",2010,2983,3522,539,17,1428,2039,6336,115,8375,4776,13003
565,12131,"Walton County, Florida",2010,22301,45132,22831,491,3147,2921,52122,1627,55043,46857,12131
566,12133,"Washington County, Florida",2010,8864,10796,1932,131,3698,733,24163,783,24896,19551,12133
567,29071,"Franklin County, Missouri",2010,39170,43419,4249,410,847,1397,100095,1448,101492,97390,29071
568,29077,"Greene County, Missouri",2010,114244,125387,11143,4489,7738,8207,266967,8362,275174,246378,29077
569,29061,"Daviess County, Missouri",2010,3214,4199,985,5,23,87,8346,107,8433,8211,29061
570,29057,"Dade County, Missouri",2010,3271,3965,694,22,29,121,7762,235,7883,7476,29057
571,29059,"Dallas County, Missouri",2010,6524,7662,1138,40,29,260,16517,411,16777,16037,29059
572,29063,"DeKalb County, Missouri",2010,3839,4329,490,31,1454,219,12673,143,12892,11045,29063
573,29069,"Dunklin County, Missouri",2010,12837,14419,1582,107,3081,1727,30226,540,31953,26498,29069
574,29065,"Dent County, Missouri",2010,6338,7285,947,41,55,148,15509,392,15657,15021,29065
575,29073,"Gasconade County, Missouri",2010,6250,8205,1955,53,26,152,15070,190,15222,14801,29073
576,29075,"Gentry County, Missouri",2010,2674,3209,535,18,20,36,6702,60,6738,6604,29075
577,29067,"Douglas County, Missouri",2010,5587,6519,932,30,28,110,13574,298,13684,13218,29067
578,29099,"Jefferson County, Missouri",2010,81700,87626,5926,1403,1776,3408,215325,3404,218733,208742,29099
579,29079,"Grundy County, Missouri",2010,4204,5023,819,36,58,178,10083,135,10261,9854,29079
580,29081,"Harrison County, Missouri",2010,3669,4407,738,16,28,141,8816,113,8957,8659,29081
581,29083,"Henry County, Missouri",2010,9405,10886,1481,52,219,369,21903,402,22272,21230,29083
582,29091,"Howell County, Missouri",2010,16192,18021,1829,195,154,697,39703,855,40400,38499,29091
583,29093,"Iron County, Missouri",2010,4378,5329,951,11,131,133,10497,193,10630,10162,29093
584,29041,"Chariton County, Missouri",2010,3242,4167,925,7,155,40,7791,85,7831,7544,29041
585,29085,"Hickory County, Missouri",2010,4371,6835,2464,16,24,91,9536,218,9627,9278,29085
586,29087,"Holt County, Missouri",2010,2133,2806,673,15,7,39,4873,76,4912,4775,29087
587,29089,"Howard County, Missouri",2010,3981,4582,601,25,527,122,10022,230,10144,9240,29089
588,29095,"Jackson County, Missouri",2010,274804,312105,37301,10621,159442,56434,617724,21087,674158,426574,29095
589,29097,"Jasper County, Missouri",2010,45639,50668,5029,1160,2166,8027,109377,5032,117404,101019,29097
590,29111,"Lewis County, Missouri",2010,3874,4535,661,22,321,159,10052,163,10211,9546,29111
591,29101,"Johnson County, Missouri",2010,19311,21528,2217,781,2227,1611,50984,1609,52595,46367,29101
592,29103,"Knox County, Missouri",2010,1708,2289,581,8,14,34,4097,48,4131,4027,29103
593,29105,"Laclede County, Missouri",2010,14081,15778,1697,148,237,719,34852,871,35571,33596,29105
594,29107,"Lafayette County, Missouri",2010,13022,14718,1696,125,726,740,32641,788,33381,31002,29107
595,29109,"Lawrence County, Missouri",2010,14869,16649,1780,124,83,2444,36190,843,38634,35140,29109
596,29123,"Madison County, Missouri",2010,4898,5970,1072,41,32,244,11982,128,12226,11781,29123
597,29113,"Lincoln County, Missouri",2010,18906,21011,2105,191,963,1032,51534,1016,52566,49364,29113
598,29115,"Linn County, Missouri",2010,5299,6429,1130,26,85,193,12568,160,12761,12297,29115
599,29117,"Livingston County, Missouri",2010,5871,6730,859,40,365,181,15014,223,15195,14386,29117
600,29119,"McDonald County, Missouri",2010,8404,9925,1521,186,127,2587,20496,1483,23083,18700,29119
601,29121,"Macon County, Missouri",2010,6412,7665,1253,63,349,150,15416,269,15566,14735,29121
602,29139,"Montgomery County, Missouri",2010,4868,6130,1262,31,199,172,12064,192,12236,11642,29139
603,29131,"Miller County, Missouri",2010,9917,12758,2841,69,95,343,24405,479,24748,23762,29131
604,29129,"Mercer County, Missouri",2010,1560,2135,575,19,6,28,3757,49,3785,3683,29129
605,29133,"Mississippi County, Missouri",2010,5180,5711,531,19,3423,231,14127,164,14358,10521,29133
606,29125,"Maries County, Missouri",2010,3705,4611,906,5,24,75,9101,160,9176,8912,29125
607,29127,"Marion County, Missouri",2010,11377,12826,1449,153,1400,391,28390,635,28781,26202,29127
608,29135,"Moniteau County, Missouri",2010,5532,6176,644,48,580,586,15021,233,15607,14160,29135
609,29137,"Monroe County, Missouri",2010,3638,4798,1160,27,263,85,8755,125,8840,8340,29137
610,29151,"Osage County, Missouri",2010,5328,6533,1205,14,28,84,13794,98,13878,13654,29151
611,29141,"Morgan County, Missouri",2010,8450,15517,7067,75,123,365,20200,429,20565,19573,29141
612,29143,"New Madrid County, Missouri",2010,7742,8531,789,75,2983,214,18742,304,18956,15380,29143
613,29145,"Newton County, Missouri",2010,22021,24313,2292,758,429,2537,55577,3423,58114,50967,29145
614,29147,"Nodaway County, Missouri",2010,8545,9524,979,377,563,302,23068,247,23370,21881,29147
615,29149,"Oregon County, Missouri",2010,4527,5486,959,32,15,131,10750,296,10881,10407,29149
616,29153,"Ozark County, Missouri",2010,4194,5652,1458,13,11,128,9595,184,9723,9387,29153
617,29155,"Pemiscot County, Missouri",2010,7350,8161,811,41,4879,341,17955,294,18296,12741,29155
618,29157,"Perry County, Missouri",2010,7357,8568,1211,85,70,318,18653,199,18971,18299,29157
619,29159,"Pettis County, Missouri",2010,16428,18249,1821,247,1244,3046,39155,963,42201,36701,29159
620,29161,"Phelps County, Missouri",2010,17564,19533,1969,1313,977,923,44233,1151,45156,40792,29161
621,29163,"Pike County, Missouri",2010,6560,7875,1315,43,1327,331,18185,296,18516,16519,29163
622,29165,"Platte County, Missouri",2010,36103,39223,3120,2031,5147,4424,84898,2585,89322,75135,29165
623,34041,"Warren County, New Jersey",2010,41480,44925,3445,2642,3592,7659,101033,1634,108692,93165,34041
624,35005,"Chaves County, New Mexico",2010,23691,26697,3006,373,1079,34139,31506,1253,65645,28801,35005
625,34033,"Salem County, New Jersey",2010,25290,27417,2127,548,8940,4507,61576,1352,66083,50736,34033
626,34035,"Somerset County, New Jersey",2010,117759,123127,5368,45473,27480,42091,281353,6551,323444,201849,34035
627,34037,"Sussex County, New Jersey",2010,54752,62057,7305,2605,2448,9617,139648,2111,149265,132484,34037
628,34039,"Union County, New Jersey",2010,188118,199489,11371,24496,111705,146704,389795,10282,536499,243312,34039
629,35003,"Catron County, New Mexico",2010,1787,3289,1502,5,15,709,3016,164,3725,2832,35003
630,35001,"Bernalillo County, New Mexico",2010,266000,284234,18234,14631,16293,317089,345475,39689,662564,274862,35001
631,35019,"Guadalupe County, New Mexico",2010,1766,2393,627,58,66,3730,957,80,4687,753,35019
632,35006,"Cibola County, New Mexico",2010,8860,11101,2241,136,221,9934,17279,11065,27213,5857,35006
633,35007,"Colfax County, New Mexico",2010,6011,10023,4012,48,39,6488,7262,312,13750,6863,35007
634,35009,"Curry County, New Mexico",2010,18015,20062,2047,574,2774,19117,29259,1366,48376,24545,35009
635,35011,"De Baca County, New Mexico",2010,912,1344,432,0,2,779,1243,41,2022,1200,35011
636,35013,"Dona Ana County, New Mexico",2010,75532,81492,5960,2029,2825,137514,71719,3873,209233,62992,35013
637,35015,"Eddy County, New Mexico",2010,20411,22585,2174,325,589,23731,30098,1073,53829,28111,35015
638,35017,"Grant County, New Mexico",2010,12586,14693,2107,109,185,14252,15262,612,29514,14356,35017
639,35033,"Mora County, New Mexico",2010,2114,3232,1118,11,10,3953,928,34,4881,873,35033
640,35021,"Harding County, New Mexico",2010,349,526,177,0,2,299,396,3,695,391,35021
641,35023,"Hidalgo County, New Mexico",2010,1936,2393,457,23,17,2769,2125,60,4894,2025,35023
642,35025,"Lea County, New Mexico",2010,22236,24919,2683,302,2399,33063,31664,1118,64727,27845,35025
643,35027,"Lincoln County, New Mexico",2010,9219,17519,8300,67,74,6110,14387,646,20497,13600,35027
644,35028,"Los Alamos County, New Mexico",2010,7663,8354,691,1060,97,2646,15304,458,17950,13689,35028
645,35029,"Luna County, New Mexico",2010,9593,10999,1406,112,189,15423,9672,374,25095,8997,35029
646,35035,"Otero County, New Mexico",2010,24464,30992,6528,716,2048,22026,41771,5291,63797,33716,35035
647,35031,"McKinley County, New Mexico",2010,21968,25813,3845,542,317,9473,62019,53776,71492,7384,35031
648,35051,"Sierra County, New Mexico",2010,5917,8356,2439,49,44,3352,8636,338,11988,8205,35051
649,35037,"Quay County, New Mexico",2010,4072,5569,1497,78,82,3834,5207,200,9041,4847,35037
650,35039,"Rio Arriba County, New Mexico",2010,15768,19638,3870,138,103,28703,11543,6154,40246,5148,35039
651,35041,"Roosevelt County, New Mexico",2010,7299,8163,864,161,296,7913,11933,454,19846,11022,35041
652,35043,"Sandoval County, New Mexico",2010,47602,52287,4685,1763,2462,46129,85432,18762,131561,62445,35043
653,35045,"San Juan County, New Mexico",2010,44404,49341,4937,445,617,24776,105268,48952,130044,55254,35045
654,35047,"San Miguel County, New Mexico",2010,11978,15595,3617,175,339,22583,6810,515,29393,5781,35047
655,35049,"Santa Fe County, New Mexico",2010,61963,71267,9304,1569,947,73015,71155,5348,144170,63291,35049
656,36001,"Albany County, New York",2010,126251,137739,11488,14500,36396,14917,289287,7239,304204,231152,36001
657,35053,"Socorro County, New Mexico",2010,7014,8059,1045,208,142,8664,9202,2141,17866,6711,35053
658,35055,"Taos County, New Mexico",2010,14806,20265,5459,201,104,18381,14556,2293,32937,11958,35055
659,35057,"Torrance County, New Mexico",2010,6264,7798,1534,61,172,6399,9984,578,16383,9173,35057
660,35059,"Union County, New Mexico",2010,1695,2305,610,22,74,1805,2744,99,4549,2549,35059
661,35061,"Valencia County, New Mexico",2010,27500,30085,2585,314,839,44605,31964,3077,76569,27734,35061
662,36009,"Cattaraugus County, New York",2010,32263,41111,8848,524,966,1345,78972,3633,80317,73849,36009
663,36011,"Cayuga County, New York",2010,31445,36489,5044,387,3009,1896,78130,1636,80026,73098,36011
664,36029,"Erie County, New York",2010,383164,419974,36810,23621,119916,41731,877309,19616,919040,714156,36029
665,36007,"Broome County, New York",2010,82167,90563,8396,7019,8850,6778,193822,4879,200600,173074,36007
666,36003,"Allegany County, New York",2010,18208,26140,7932,451,494,670,48276,630,48946,46701,36003
667,36005,"Bronx County, New York",2010,483449,511896,28447,47335,416695,741413,643695,28456,1385108,151209,36005
668,36013,"Chautauqua County, New York",2010,54244,66920,12676,676,2763,8241,126664,2762,134905,120463,36013
669,36015,"Chemung County, New York",2010,35462,38369,2907,1041,5528,2240,86590,2378,88830,77643,36015
670,36017,"Chenango County, New York",2010,20436,24710,4274,200,323,929,49548,760,50477,48265,36017
671,36019,"Clinton County, New York",2010,31582,35888,4306,890,2953,2054,80074,1399,82128,74832,36019
672,36021,"Columbia County, New York",2010,25906,32775,6869,998,2691,2454,60642,1281,63096,55672,36021
673,36023,"Cortland County, New York",2010,18671,20577,1906,412,705,1094,48242,873,49336,46252,36023
674,36025,"Delaware County, New York",2010,19898,31222,11324,363,691,1560,46420,660,47980,44706,36025
675,36027,"Dutchess County, New York",2010,107965,118638,10673,10330,27395,31267,266221,6684,297488,221812,36027
676,36031,"Essex County, New York",2010,16262,25603,9341,260,982,993,38377,547,39370,36588,36031
677,36033,"Franklin County, New York",2010,19054,25306,6252,215,2834,1506,50093,4404,51599,42640,36033
678,36035,"Fulton County, New York",2010,22554,28562,6008,320,981,1263,54268,857,55531,52110,36035
679,17165,"Saline County, Illinois",2010,10379,11697,1318,100,974,340,24573,488,24913,23011,17165
680,17151,"Pope County, Illinois",2010,1829,2491,662,11,269,64,4406,71,4470,4055,17151
681,17153,"Pulaski County, Illinois",2010,2642,3155,513,13,1976,97,6064,138,6161,3937,17153
682,17155,"Putnam County, Illinois",2010,2509,3074,565,13,31,252,5754,56,6006,5654,17155
683,17157,"Randolph County, Illinois",2010,12314,13707,1393,102,3245,867,32609,329,33476,28933,17157
684,17159,"Richland County, Illinois",2010,6726,7513,787,117,78,205,16028,160,16233,15673,17159
685,17161,"Rock Island County, Illinois",2010,61303,65756,4453,2383,12911,17118,130428,3370,147546,111764,17161
686,17163,"St. Clair County, Illinois",2010,105045,116249,11204,3213,81860,8785,261271,6340,270056,169858,17163
687,17167,"Sangamon County, Illinois",2010,82986,89901,6915,3198,23146,3480,193985,4654,197465,162987,17167
688,17169,"Schuyler County, Illinois",2010,3040,3459,419,9,240,90,7454,42,7544,7163,17169
689,17177,"Stephenson County, Illinois",2010,19845,22081,2236,295,4226,1406,46305,1172,47711,40612,17177
690,17179,"Tazewell County, Illinois",2010,54146,57516,3370,990,1351,2514,132880,1914,135394,128625,17179
691,17173,"Shelby County, Illinois",2010,9216,10396,1180,56,48,180,22183,157,22363,21922,17173
692,17175,"Stark County, Illinois",2010,2425,2674,249,19,28,59,5935,62,5994,5826,17175
693,17193,"White County, Illinois",2010,6313,7181,868,31,37,158,14507,131,14665,14308,17193
694,17181,"Union County, Illinois",2010,7167,7924,757,52,151,863,16945,288,17808,16454,17181
695,17171,"Scott County, Illinois",2010,2214,2459,245,12,5,43,5312,49,5355,5246,17171
696,17183,"Vermilion County, Illinois",2010,32655,36318,3663,559,10394,3441,78184,1641,81625,65590,17183
697,17185,"Wabash County, Illinois",2010,5012,5585,573,63,73,158,11789,155,11947,11498,17185
698,17187,"Warren County, Illinois",2010,6918,7682,764,93,287,1490,16217,255,17707,15582,17187
699,17189,"Washington County, Illinois",2010,5926,6534,608,41,94,197,14519,124,14716,14260,17189
700,17191,"Wayne County, Illinois",2010,7102,7975,873,70,40,176,16584,134,16760,16340,17191
701,17195,"Whiteside County, Illinois",2010,23740,25770,2030,269,705,6455,52043,806,58498,50263,17195
702,17197,"Will County, Illinois",2010,225256,237501,12245,30458,74419,105817,571743,11289,677560,455577,17197
703,17199,"Williamson County, Illinois",2010,27421,30359,2938,557,2514,1301,65056,1266,66357,60719,17199
704,17201,"Winnebago County, Illinois",2010,115501,125965,10464,6722,35358,32177,263089,6813,295266,214196,17201
705,17203,"Woodford County, Illinois",2010,14276,15145,869,208,186,527,38137,449,38664,37294,17203
706,18015,"Carroll County, Indiana",2010,7900,9472,1572,20,42,711,19444,194,20155,19188,18015
707,18005,"Bartholomew County, Indiana",2010,29860,33098,3238,2622,1360,4762,72032,1233,76794,66817,18005
708,18001,"Adams County, Indiana",2010,12011,13014,1003,78,102,1412,32975,274,34387,32521,18001
709,18003,"Allen County, Indiana",2010,137851,152184,14333,9611,40998,23093,332236,9838,355329,271789,18003
710,18007,"Benton County, Indiana",2010,3479,3937,458,15,36,431,8423,74,8854,8298,18007
711,18009,"Blackford County, Indiana",2010,5236,6051,815,19,48,117,12649,179,12766,12403,18009
712,18011,"Boone County, Indiana",2010,21149,22754,1605,941,484,1270,55370,794,56640,53151,18011
713,18013,"Brown County, Indiana",2010,6199,8285,2086,44,53,178,15064,206,15242,14761,18013
714,18039,"Elkhart County, Indiana",2010,70244,77767,7523,1879,10989,27886,169673,4250,197559,152555,18039
715,18017,"Cass County, Indiana",2010,14858,16474,1616,407,519,4897,34069,519,38966,32624,18017
716,18019,"Clark County, Indiana",2010,44248,47776,3528,858,7541,5350,104882,2596,110232,93887,18019
717,18021,"Clay County, Indiana",2010,10447,11703,1256,60,85,307,26583,292,26890,26146,18021
718,18023,"Clinton County, Indiana",2010,12105,13321,1216,65,138,4395,28829,277,33224,28349,18023
719,18025,"Crawford County, Indiana",2010,4303,5520,1217,20,21,126,10587,156,10713,10390,18025
720,18027,"Daviess County, Indiana",2010,11329,12471,1142,161,165,1314,30334,312,31648,29696,18027
721,18029,"Dearborn County, Indiana",2010,18743,20171,1428,187,291,502,49545,581,50047,48486,18029
722,18031,"Decatur County, Indiana",2010,9977,11209,1232,178,76,426,25314,264,25740,24796,18031
723,18033,"DeKalb County, Indiana",2010,15951,17558,1607,186,141,1031,41192,459,42223,40406,18033
724,18035,"Delaware County, Indiana",2010,46516,52357,5841,1128,8051,2088,115583,2683,117671,103721,18035
725,18037,"Dubois County, Indiana",2010,16133,17384,1251,189,109,2521,39368,279,41889,38791,18037
726,18049,"Fulton County, Indiana",2010,8237,9708,1471,101,144,882,19954,271,20836,19438,18049
727,18041,"Fayette County, Indiana",2010,9719,10898,1179,79,318,223,24054,265,24277,23392,18041
728,18043,"Floyd County, Indiana",2010,29479,31968,2489,694,3822,1972,72606,1585,74578,66505,18043
729,18045,"Fountain County, Indiana",2010,6935,7865,930,35,26,373,16867,208,17240,16598,18045
730,18051,"Gibson County, Indiana",2010,13255,14645,1390,155,589,441,33062,566,33503,31752,18051
731,18047,"Franklin County, Indiana",2010,8579,9538,959,55,34,210,22877,188,23087,22600,18047
732,29167,"Polk County, Missouri",2010,11677,13304,1627,104,226,615,30522,627,31137,29565,29167
733,29185,"St. Clair County, Missouri",2010,4161,5640,1479,12,47,170,9635,210,9805,9366,29185
734,18053,"Grant County, Indiana",2010,27245,30443,3198,408,4805,2517,67544,1698,70061,60633,18053
735,18055,"Greene County, Indiana",2010,13487,15211,1724,96,49,322,32843,355,33165,32343,18055
736,18057,"Hamilton County, Indiana",2010,99835,106772,6937,13122,9395,9426,265143,5309,274569,237317,18057
737,29169,"Pulaski County, Missouri",2010,16004,17904,1900,1295,5680,4705,47569,2731,52274,37863,29169
738,29171,"Putnam County, Missouri",2010,2132,2982,850,22,9,36,4943,47,4979,4865,29171
739,29173,"Ralls County, Missouri",2010,4091,5183,1092,19,107,98,10069,115,10167,9828,29173
740,29177,"Ray County, Missouri",2010,8957,9984,1027,60,265,415,23079,416,23494,22338,29177
741,29175,"Randolph County, Missouri",2010,9342,10714,1372,105,1477,413,25001,554,25414,22865,29175
742,29179,"Reynolds County, Missouri",2010,2778,4033,1255,12,45,64,6632,142,6696,6433,29179
743,37079,"Greene County, North Carolina",2010,7313,8213,900,67,7902,3054,18308,301,21362,10038,37079
744,37069,"Franklin County, North Carolina",2010,23023,26577,3554,272,15995,4776,55843,1098,60619,38478,37069
745,37071,"Gaston County, North Carolina",2010,79867,88686,8819,2462,31002,12201,193885,4111,206086,156310,37071
746,37073,"Gates County, North Carolina",2010,4665,5208,543,17,4040,173,12024,283,12197,7684,37073
747,37075,"Graham County, North Carolina",2010,3701,5930,2229,29,17,194,8667,679,8861,7942,37075
748,37077,"Granville County, North Carolina",2010,20628,22827,2199,321,19454,4482,55434,1109,59916,34550,37077
749,37091,"Hertford County, North Carolina",2010,9334,10635,1301,127,14845,644,24025,574,24669,8479,37091
750,37087,"Haywood County, North Carolina",2010,25563,34954,9391,212,615,1999,57037,842,59036,55368,37087
751,37089,"Henderson County, North Carolina",2010,45448,54710,9262,994,3149,10424,96316,2068,106740,90105,37089
752,37081,"Guilford County, North Carolina",2010,196628,218017,21389,19059,156982,34826,453580,12311,488406,265228,37081
753,37083,"Halifax County, North Carolina",2010,21970,25781,3811,357,28986,1152,53539,2627,54691,21569,37083
754,37085,"Harnett County, North Carolina",2010,41594,46731,5137,983,23591,12359,102319,4038,114678,73707,37085
755,37107,"Lenoir County, North Carolina",2010,24327,27437,3110,256,23968,3917,55578,862,59495,30492,37107
756,37093,"Hoke County, North Carolina",2010,16532,18211,1679,467,15392,5823,41129,6128,46952,19142,37093
757,37095,"Hyde County, North Carolina",2010,2119,3347,1228,16,1833,411,5399,114,5810,3436,37095
758,37097,"Iredell County, North Carolina",2010,61215,69013,7798,2899,18748,10844,148593,2839,159437,124107,37097
759,37099,"Jackson County, North Carolina",2010,16446,25948,9502,339,729,2038,38233,4370,40271,32795,37099
760,37101,"Johnston County, North Carolina",2010,61909,67682,5773,976,25082,21814,147064,3137,168878,117869,37101
761,37103,"Jones County, North Carolina",2010,4167,4838,671,32,3276,398,9755,230,10153,6217,37103
762,37105,"Lee County, North Carolina",2010,22058,24136,2078,475,11369,10576,47290,1125,57866,34321,37105
763,37129,"New Hanover County, North Carolina",2010,86046,101436,15390,2380,29469,10716,191951,4471,202667,155631,37129
764,37109,"Lincoln County, North Carolina",2010,30343,33641,3298,415,4269,5238,73027,1204,78265,67139,37109
765,37113,"Macon County, North Carolina",2010,14591,25245,10654,201,419,2230,31692,473,33922,30599,37113
766,37115,"Madison County, North Carolina",2010,8494,10608,2114,70,233,423,20341,304,20764,19734,37115
767,37117,"Martin County, North Carolina",2010,10318,11704,1386,71,10601,769,23736,274,24505,12790,37117
768,37119,"Mecklenburg County, North Carolina",2010,362213,398510,36297,41991,278042,111944,807684,22279,919628,465372,37119
769,37123,"Montgomery County, North Carolina",2010,10544,15914,5370,439,5182,3926,23872,376,27798,17875,37123
770,37121,"Mitchell County, North Carolina",2010,6685,8713,2028,46,53,631,14948,193,15579,14656,37121
771,37125,"Moore County, North Carolina",2010,37540,43940,6400,736,11727,5261,82986,2036,88247,68487,37125
772,37127,"Nash County, North Carolina",2010,37782,42286,4504,713,35449,6015,89825,1893,95840,51770,37127
773,48023,"Baylor County, Texas",2010,1669,2665,996,4,71,455,3271,49,3726,3147,48023
774,37111,"McDowell County, North Carolina",2010,17838,20808,2970,344,1663,2392,42604,615,44996,39982,37111
775,37131,"Northampton County, North Carolina",2010,9193,11674,2481,38,12847,305,21794,313,22099,8596,37131
776,37133,"Onslow County, North Carolina",2010,60092,68226,8134,3163,26577,17896,159876,7578,177772,122558,37133
777,37135,"Orange County, North Carolina",2010,51457,55597,4140,8996,15722,11017,122784,3395,133801,94671,37135
778,48001,"Anderson County, Texas",2010,17218,20116,2898,283,12222,9287,49171,874,58458,35792,48001
779,48007,"Aransas County, Texas",2010,9795,15355,5560,443,258,5690,17468,417,23158,16350,48007
780,48003,"Andrews County, Texas",2010,5259,5814,555,85,199,7195,7591,224,14786,7083,48003
781,48005,"Angelina County, Texas",2010,31090,35589,4499,744,12840,17145,69626,1153,86771,54889,48005
782,48009,"Archer County, Texas",2010,3538,4107,569,18,34,675,8379,145,9054,8182,48009
783,48011,"Armstrong County, Texas",2010,751,904,153,0,11,124,1777,41,1901,1725,48011
784,48015,"Austin County, Texas",2010,10837,12926,2089,110,2622,6641,21776,387,28417,18657,48015
785,48017,"Bailey County, Texas",2010,2468,2784,316,23,67,4283,2882,47,7165,2745,48017
786,48019,"Bandera County, Texas",2010,8564,11561,2997,55,90,3415,17070,349,20485,16576,48019
787,48021,"Bastrop County, Texas",2010,25840,29316,3476,449,5535,24190,49981,1551,74171,42446,48021
788,48013,"Atascosa County, Texas",2010,15246,17631,2385,130,256,27785,17126,445,44911,16295,48013
789,47179,"Washington County, Tennessee",2010,51322,57254,5932,1461,4727,3633,119346,2256,122979,110902,47179
790,47187,"Williamson County, Tennessee",2010,64886,68498,3612,5497,7828,8166,175016,2922,183182,158769,47187
791,47181,"Wayne County, Tennessee",2010,6136,7287,1151,30,975,277,16744,204,17021,15535,47181
792,47183,"Weakley County, Tennessee",2010,13898,15495,1597,365,2717,700,34321,543,35021,30696,47183
793,47189,"Wilson County, Tennessee",2010,42563,45568,3005,1259,7234,3691,110302,2092,113993,99717,47189
794,48025,"Bee County, Texas",2010,9042,10649,1607,162,2525,17906,13955,301,31861,10967,48025
795,48027,"Bell County, Texas",2010,114035,125470,11435,8350,63380,67010,243225,14206,310235,157289,48027
796,48031,"Blanco County, Texas",2010,4309,5532,1223,49,62,1909,8588,141,10497,8336,48031
797,48035,"Bosque County, Texas",2010,7254,9623,2369,38,277,2926,15286,270,18212,14701,48035
798,48039,"Brazoria County, Texas",2010,106589,118336,11747,17013,36880,86643,226523,5956,313166,166674,48039
799,48043,"Brewster County, Texas",2010,4207,5383,1176,58,79,3918,5314,166,9232,5011,48043
800,48045,"Briscoe County, Texas",2010,692,953,261,0,40,411,1226,23,1637,1163,48045
801,48047,"Brooks County, Texas",2010,2642,3239,597,18,19,6590,633,23,7223,573,48047
802,48029,"Bexar County, Texas",2010,608931,662872,53941,39561,118460,1006958,707815,30671,1714773,519123,48029
803,48041,"Brazos County, Texas",2010,71739,77700,5961,9982,20827,45405,149446,3385,194851,115252,48041
804,48033,"Borden County, Texas",2010,264,385,121,1,0,95,546,6,641,539,48033
805,48037,"Bowie County, Texas",2010,34669,38493,3824,721,22230,6062,86503,2209,92565,61343,48037
806,48051,"Burleson County, Texas",2010,6822,8832,2010,25,2064,3166,14021,236,17187,11696,48051
807,48049,"Brown County, Texas",2010,14778,18287,3509,160,1303,7453,30653,712,38106,28478,48049
808,48069,"Castro County, Texas",2010,2744,3166,422,30,149,4828,3234,51,8062,3004,48069
809,48059,"Callahan County, Texas",2010,5447,6549,1102,56,135,1025,12519,263,13544,12065,48059
810,48053,"Burnet County, Texas",2010,16511,20870,4359,198,700,8652,34098,670,42750,32530,48053
811,48055,"Caldwell County, Texas",2010,12301,13759,1458,344,2456,17922,20144,503,38066,16841,48055
812,48057,"Calhoun County, Texas",2010,7766,11410,3644,943,519,9922,11459,203,21381,9794,48057
813,48061,"Cameron County, Texas",2010,119631,141924,22293,2486,1192,357747,48473,1368,406220,43427,48061
814,48063,"Camp County, Texas",2010,4678,5656,978,59,2133,2648,9753,263,12401,7298,48063
815,48065,"Carson County, Texas",2010,2452,2784,332,19,35,525,5657,130,6182,5473,48065
816,48067,"Cass County, Texas",2010,12429,14379,1950,89,5299,1053,29411,501,30464,23522,48067
817,48085,"Collin County, Texas",2010,283759,300960,17201,87276,64715,115354,666987,21504,782341,493492,48085
818,48071,"Chambers County, Texas",2010,11952,13291,1339,326,2817,6635,28461,551,35096,24767,48071
819,48073,"Cherokee County, Texas",2010,17894,20859,2965,221,7401,10499,40346,832,50845,31892,48073
820,48075,"Childress County, Texas",2010,2326,2883,557,47,684,1885,5156,98,7041,4327,48075
821,48077,"Clay County, Texas",2010,4319,5150,831,28,53,467,10285,263,10752,9941,48077
822,48079,"Cochran County, Texas",2010,1113,1360,247,3,110,1654,1473,31,3127,1329,48079
823,48081,"Coke County, Texas",2010,1466,2667,1201,5,7,602,2718,55,3320,2651,48081
824,48083,"Coleman County, Texas",2010,3857,5543,1686,32,186,1419,7476,135,8895,7123,48083
825,48087,"Collingsworth County, Texas",2010,1179,1616,437,3,122,916,2141,79,3057,1937,48087
826,48089,"Colorado County, Texas",2010,8182,10527,2345,75,2636,5452,15422,215,20874,12496,48089
827,48091,"Comal County, Texas",2010,41363,47108,5745,813,1606,26989,81483,1677,108472,77387,48091
828,48093,"Comanche County, Texas",2010,5580,7223,1643,34,25,3605,10369,165,13974,10145,48093
829,48095,"Concho County, Texas",2010,1041,1637,596,14,57,2173,1914,33,4087,1810,48095
830,48097,"Cooke County, Texas",2010,14513,16606,2093,278,1018,5997,32440,889,38437,30255,48097
831,48103,"Crane County, Texas",2010,1471,1632,161,13,122,2409,1966,70,4375,1761,48103
832,48099,"Coryell County, Texas",2010,22545,25178,2633,1332,11450,11973,63415,3857,75388,46776,48099
833,18171,"Warren County, Indiana",2010,3337,3680,343,36,10,70,8438,71,8508,8321,18171
834,18173,"Warrick County, Indiana",2010,22505,24203,1698,957,780,946,58743,911,59689,56095,18173
835,18175,"Washington County, Indiana",2010,10850,12220,1370,86,63,304,27958,270,28262,27539,18175
836,18177,"Wayne County, Indiana",2010,27551,31242,3691,522,3349,1804,67113,1920,68917,61322,18177
837,18179,"Wells County, Indiana",2010,10780,11659,879,102,89,564,27072,277,27636,26604,18179
838,18181,"White County, Indiana",2010,9741,12970,3229,83,51,1746,22897,293,24643,22470,18181
839,18183,"Whitley County, Indiana",2010,13001,14281,1280,105,96,515,32777,429,33292,32147,18183
840,19001,"Adair County, Iowa",2010,3292,3698,406,22,11,101,7581,41,7682,7507,19001
841,19017,"Bremer County, Iowa",2010,9385,9915,530,173,186,239,24037,219,24276,23459,19017
842,19005,"Allamakee County, Iowa",2010,5845,7617,1772,33,109,757,13573,106,14330,13325,19005
843,19003,"Adams County, Iowa",2010,1715,2010,295,23,8,37,3992,39,4029,3922,19003
844,19013,"Black Hawk County, Iowa",2010,52470,55887,3417,1685,11493,4907,126183,3037,131090,109968,19013
845,19011,"Benton County, Iowa",2010,10302,11095,793,66,93,275,25801,255,26076,25387,19011
846,19009,"Audubon County, Iowa",2010,2617,2972,355,25,9,37,6082,41,6119,6007,19009
847,19007,"Appanoose County, Iowa",2010,5627,6633,1006,35,55,181,12706,146,12887,12470,19007
848,19015,"Boone County, Iowa",2010,10728,11756,1028,87,202,505,25801,318,26306,25194,19015
849,19019,"Buchanan County, Iowa",2010,8161,8968,807,90,59,243,20715,222,20958,20344,19019
850,19035,"Cherokee County, Iowa",2010,5207,5777,570,62,64,274,11798,119,12072,11553,19035
851,19021,"Buena Vista County, Iowa",2010,7522,8237,715,1119,497,4608,15652,280,20260,13756,19021
852,19023,"Butler County, Iowa",2010,6120,6682,562,35,25,133,14734,122,14867,14552,19023
853,19025,"Calhoun County, Iowa",2010,4242,5108,866,20,19,90,9580,71,9670,9470,19025
854,19027,"Carroll County, Iowa",2010,8683,9376,693,92,82,333,20483,190,20816,20119,19027
855,19029,"Cass County, Iowa",2010,5980,6591,611,30,33,253,13703,138,13956,13502,19029
856,19031,"Cedar County, Iowa",2010,7511,8064,553,78,52,284,18215,188,18499,17897,19031
857,19033,"Cerro Gordo County, Iowa",2010,19350,22163,2813,368,555,1694,42457,658,44151,40876,19033
858,19047,"Crawford County, Iowa",2010,6413,6943,530,97,195,4131,12965,132,17096,12541,19047
859,19037,"Chickasaw County, Iowa",2010,5204,5679,475,40,29,269,12170,53,12439,12048,19037
860,19039,"Clarke County, Iowa",2010,3701,4086,385,32,38,927,8359,81,9286,8208,19039
861,19041,"Clay County, Iowa",2010,7282,8062,780,98,68,477,16190,181,16667,15843,19041
862,19043,"Clayton County, Iowa",2010,7599,8999,1400,42,60,306,17823,158,18129,17563,19043
863,19045,"Clinton County, Iowa",2010,20223,21733,1510,277,1258,1243,47873,884,49116,45454,19045
864,38005,"Benson County, North Dakota",2010,2233,2950,717,3,1,77,6583,3718,6660,2861,38005
865,38009,"Bottineau County, North Dakota",2010,2832,4341,1509,16,25,82,6347,244,6429,6062,38009
866,38007,"Billings County, North Dakota",2010,358,484,126,4,0,4,779,4,783,771,38007
867,38015,"Burleigh County, North Dakota",2010,33976,35754,1778,386,476,986,80322,4406,81308,75054,38015
868,38017,"Cass County, North Dakota",2010,63899,67938,4039,3524,3372,3015,146763,4337,149778,135530,38017
869,38031,"Foster County, North Dakota",2010,1495,1801,306,3,3,29,3314,36,3343,3272,38031
870,38021,"Dickey County, North Dakota",2010,2180,2636,456,22,35,100,5189,88,5289,5044,38021
871,38023,"Divide County, North Dakota",2010,977,1324,347,6,5,30,2041,24,2071,2006,38023
872,38025,"Dunn County, North Dakota",2010,1401,2132,731,10,8,38,3498,496,3536,2984,38025
873,38027,"Eddy County, North Dakota",2010,1057,1323,266,6,4,52,2333,81,2385,2242,38027
874,38029,"Emmons County, North Dakota",2010,1594,2085,491,6,2,34,3516,40,3550,3468,38029
875,48101,"Cottle County, Texas",2010,677,968,291,0,129,316,1189,17,1505,1043,48101
876,48105,"Crockett County, Texas",2010,1422,1866,444,11,13,2352,1367,31,3719,1312,48105
877,48107,"Crosby County, Texas",2010,2237,2902,665,4,199,3171,2888,60,6059,2625,48107
878,48119,"Delta County, Texas",2010,2088,2458,370,30,375,288,4943,187,5231,4351,48119
879,38033,"Golden Valley County, North Dakota",2010,774,967,193,1,9,35,1645,22,1680,1613,38033
880,38035,"Grand Forks County, North Dakota",2010,27417,29344,1927,1280,1322,1951,64910,3037,66861,59271,38035
881,38037,"Grant County, North Dakota",2010,1128,1690,562,3,1,7,2387,58,2394,2325,38037
882,38039,"Griggs County, North Dakota",2010,1131,1461,330,4,7,9,2411,13,2420,2387,38039
883,38041,"Hettinger County, North Dakota",2010,1056,1414,358,1,6,12,2465,86,2477,2372,38041
884,38047,"Logan County, North Dakota",2010,843,1144,301,5,2,12,1978,17,1990,1954,38047
885,38051,"McIntosh County, North Dakota",2010,1307,1858,551,10,6,38,2771,30,2809,2725,38051
886,38053,"McKenzie County, North Dakota",2010,2410,3090,680,19,4,139,6221,1452,6360,4746,38053
887,48109,"Culberson County, Texas",2010,908,1137,229,22,8,1827,571,37,2398,504,48109
888,48111,"Dallam County, Texas",2010,2448,2827,379,37,81,2717,3986,142,6703,3726,48111
889,48113,"Dallas County, Texas",2010,855960,943257,87297,117797,518732,905940,1462199,40977,2368139,784693,48113
890,48115,"Dawson County, Texas",2010,4385,5220,835,46,860,7387,6446,138,13833,5402,48115
891,48117,"Deaf Smith County, Texas",2010,6365,7077,712,56,158,13039,6333,180,19372,5939,48117
892,48131,"Duval County, Texas",2010,4090,5523,1433,17,86,10424,1358,49,11782,1206,48131
893,48121,"Denton County, Texas",2010,240289,256139,15850,43091,54034,120836,541778,17766,662614,426887,48121
894,48123,"DeWitt County, Texas",2010,7407,9176,1769,44,1781,6502,13595,288,20097,11482,48123
895,48125,"Dickens County, Texas",2010,930,1282,352,18,92,708,1736,36,2444,1590,48125
896,48127,"Dimmit County, Texas",2010,3421,4350,929,51,81,8616,1380,31,9996,1217,48127
897,48129,"Donley County, Texas",2010,1517,2142,625,9,163,309,3368,60,3677,3136,48129
898,48147,"Fannin County, Texas",2010,12149,14191,2042,122,2273,3226,30689,861,33915,27433,48147
899,48139,"Ellis County, Texas",2010,50503,54365,3862,811,13161,35161,114449,2490,149610,97987,48139
900,48137,"Edwards County, Texas",2010,839,1606,767,3,10,1027,975,15,2002,947,48137
901,48141,"El Paso County, Texas",2010,256557,270307,13750,7551,20649,658134,142513,9067,800647,105246,48141
902,48133,"Eastland County, Texas",2010,7465,10258,2793,62,318,2673,15910,259,18583,15271,48133
903,48135,"Ector County, Texas",2010,48688,53027,4339,1004,5596,72331,64799,1893,137130,56306,48135
904,48143,"Erath County, Texas",2010,14569,16987,2418,240,431,7279,30611,558,37890,29382,48143
905,48145,"Falls County, Texas",2010,6302,7724,1422,46,4463,3716,14150,260,17866,9381,48145
906,48159,"Franklin County, Texas",2010,4159,5770,1611,49,411,1333,9272,211,10605,8601,48159
907,48149,"Fayette County, Texas",2010,10078,13868,3790,61,1599,4585,19969,271,24554,18038,48149
908,48151,"Fisher County, Texas",2010,1668,2212,544,7,124,999,2975,47,3974,2797,48151
909,48153,"Floyd County, Texas",2010,2402,3004,602,11,211,3410,3036,37,6446,2777,48153
910,48155,"Foard County, Texas",2010,573,789,216,4,53,187,1149,5,1336,1087,48155
911,48157,"Fort Bend County, Texas",2010,187384,197030,9646,98762,123267,138967,446408,12699,585375,211680,48157
912,48173,"Glasscock County, Texas",2010,441,580,139,1,15,378,848,7,1226,825,48173
913,48161,"Freestone County, Texas",2010,7259,9265,2006,50,3164,2694,17122,252,19816,13656,48161
914,48163,"Frio County, Texas",2010,4854,5846,992,362,524,13401,3816,134,17217,2796,48163
915,48165,"Gaines County, Texas",2010,5606,6301,695,37,261,6413,11113,187,17526,10628,48165
916,48167,"Galveston County, Texas",2010,108969,132492,23523,8515,39229,65270,226039,5643,291309,172652,48167
917,48169,"Garza County, Texas",2010,1671,2237,566,8,392,3046,3415,53,6461,2962,48169
918,48175,"Goliad County, Texas",2010,2868,3710,842,11,310,2462,4748,90,7210,4337,48175
919,48171,"Gillespie County, Texas",2010,10572,12778,2206,88,47,4969,19868,261,24837,19472,48171
920,48187,"Guadalupe County, Texas",2010,45762,50015,4253,1748,7963,46889,84644,2847,131533,72086,48187
921,48177,"Gonzales County, Texas",2010,7120,8794,1674,73,1353,9353,10454,192,19807,8836,48177
922,48179,"Gray County, Texas",2010,8443,10158,1715,83,1055,5365,17170,468,22535,15564,48179
923,48181,"Grayson County, Texas",2010,46905,53727,6822,1034,6938,13688,107189,4114,120877,95103,48181
924,48183,"Gregg County, Texas",2010,45798,49514,3716,1316,24068,20018,101712,2323,121730,74005,48183
925,48185,"Grimes County, Texas",2010,8902,10917,2015,61,4348,5652,20952,410,26604,16133,48185
926,48203,"Harrison County, Texas",2010,24523,27704,3181,331,14303,7254,58377,1089,65631,42654,48203
927,48189,"Hale County, Texas",2010,11846,13541,1695,133,1803,20269,16004,421,36273,13647,48189
928,48191,"Hall County, Texas",2010,1372,1943,571,2,235,1087,2266,31,3353,1998,48191
929,48193,"Hamilton County, Texas",2010,3442,4566,1124,31,38,863,7654,90,8517,7495,48193
930,48195,"Hansford County, Texas",2010,2006,2338,332,16,31,2430,3183,48,5613,3088,48195
931,48197,"Hardeman County, Texas",2010,1722,2417,695,12,217,889,3250,83,4139,2938,48197
932,48199,"Hardin County, Texas",2010,20462,22597,2135,269,3181,2384,52251,713,54635,48088,48199
933,48201,"Harris County, Texas",2010,1435155,1598698,163543,249853,754258,1671540,2420919,67162,4092459,1349646,48201
934,48211,"Hemphill County, Texas",2010,1382,1629,247,18,4,1086,2721,43,3807,2656,48211
935,48213,"Henderson County, Texas",2010,31020,39595,8575,318,4813,8490,70042,1417,78532,63494,48213
936,48205,"Hartley County, Texas",2010,1771,1946,175,29,416,1448,4614,58,6062,4111,48205
937,48207,"Haskell County, Texas",2010,2297,3443,1146,31,203,1414,4485,103,5899,4148,48207
938,48209,"Hays County, Texas",2010,55245,59417,4172,1699,4970,55401,101706,2975,157107,92062,48209
939,19119,"Lyon County, Iowa",2010,4442,4848,406,25,9,212,11369,68,11581,11267,19119
940,19099,"Jasper County, Iowa",2010,14806,16181,1375,163,464,537,36305,394,36842,35284,19099
941,19101,"Jefferson County, Iowa",2010,6846,7594,748,1420,199,410,16433,275,16843,14539,19101
942,19103,"Johnson County, Iowa",2010,52715,55967,3252,6774,6163,6200,124682,2978,130882,108767,19103
943,19111,"Lee County, Iowa",2010,14610,16205,1595,181,1094,1092,34770,662,35862,32833,19111
944,19113,"Linn County, Iowa",2010,86134,92251,6117,3783,8160,5534,205692,5157,211226,188592,19113
945,19105,"Jones County, Iowa",2010,8181,8911,730,90,405,270,20368,157,20638,19716,19105
946,19107,"Keokuk County, Iowa",2010,4408,4931,523,16,50,90,10421,69,10511,10286,19107
947,19109,"Kossuth County, Iowa",2010,6697,7486,789,59,43,215,15328,105,15543,15121,19109
948,19115,"Louisa County, Iowa",2010,4346,5002,656,101,52,1797,9590,128,11387,9309,19115
949,19117,"Lucas County, Iowa",2010,3689,4238,549,15,15,89,8809,59,8898,8720,19117
950,19131,"Mitchell County, Iowa",2010,4395,4850,455,28,20,110,10666,54,10776,10564,19131
951,19121,"Madison County, Iowa",2010,6025,6554,529,51,45,197,15482,153,15679,15233,19121
952,19123,"Mahaska County, Iowa",2010,8975,9766,791,250,251,360,22021,278,22381,21242,19123
953,19125,"Marion County, Iowa",2010,12723,13914,1191,379,211,531,32778,354,33309,31834,19125
954,19127,"Marshall County, Iowa",2010,15538,16831,1293,526,629,7017,33631,669,40648,31807,19127
955,19129,"Mills County, Iowa",2010,5605,6109,504,55,57,359,14700,198,15059,14390,19129
956,19143,"Osceola County, Iowa",2010,2682,2990,308,19,15,430,6032,61,6462,5937,19143
957,19133,"Monona County, Iowa",2010,4050,4697,647,20,33,107,9136,179,9243,8904,19133
958,19135,"Monroe County, Iowa",2010,3213,3884,671,29,22,169,7801,73,7970,7677,19135
959,19137,"Montgomery County, Iowa",2010,4558,5239,681,23,25,305,10435,122,10740,10265,19137
960,19139,"Muscatine County, Iowa",2010,16412,17910,1498,334,545,6803,35942,545,42745,34518,19139
961,19141,"O'Brien County, Iowa",2010,6069,6649,580,82,56,545,13853,110,14398,13605,19141
962,19163,"Scott County, Iowa",2010,66765,71835,5070,3295,11413,9197,156027,4435,165224,136884,19163
963,19145,"Page County, Iowa",2010,6393,7181,788,116,344,438,15494,267,15932,14767,19145
964,19147,"Palo Alto County, Iowa",2010,3994,4628,634,31,44,152,9269,86,9421,9108,19147
965,19149,"Plymouth County, Iowa",2010,9875,10550,675,115,73,742,24244,274,24986,23782,19149
966,19151,"Pocahontas County, Iowa",2010,3233,3794,561,12,26,166,7144,63,7310,7043,19151
967,19153,"Polk County, Iowa",2010,170197,182262,12065,15118,25344,32647,397993,9821,430640,347710,19153
968,19155,"Pottawattamie County, Iowa",2010,36775,39330,2555,549,1216,6151,87007,1633,93158,83609,19155
969,19157,"Poweshiek County, Iowa",2010,7555,8949,1394,255,213,456,18458,285,18914,17705,19157
970,19159,"Ringgold County, Iowa",2010,2047,2613,566,16,17,91,5040,41,5131,4966,19159
971,19165,"Shelby County, Iowa",2010,5085,5542,457,46,31,219,11948,108,12167,11763,19165
972,19161,"Sac County, Iowa",2010,4482,5429,947,15,31,195,10155,78,10350,10031,19161
973,19181,"Warren County, Iowa",2010,17262,18371,1109,249,213,899,45326,598,46225,44266,19181
974,19167,"Sioux County, Iowa",2010,11584,12279,695,264,104,3001,30703,245,33704,30090,19167
975,19169,"Story County, Iowa",2010,34736,36789,2053,5369,2125,2695,86847,1541,89542,77812,19169
976,19171,"Tama County, Iowa",2010,6947,7766,819,45,59,1320,16447,1469,17767,14874,19171
977,19173,"Taylor County, Iowa",2010,2679,3107,428,17,12,364,5953,52,6317,5872,19173
978,19175,"Union County, Iowa",2010,5271,5937,666,59,88,225,12309,133,12534,12029,19175
979,19177,"Van Buren County, Iowa",2010,3108,3670,562,40,15,88,7482,54,7570,7373,19177
980,19179,"Wapello County, Iowa",2010,14552,16098,1546,250,447,3234,32391,537,35625,31157,19179
981,19193,"Woodbury County, Iowa",2010,39052,41484,2432,2395,2384,13993,88179,4118,102172,79282,19193
982,19183,"Washington County, Iowa",2010,8741,9516,775,72,140,1138,20566,240,21704,20114,19183
983,19185,"Wayne County, Iowa",2010,2652,3212,560,15,17,69,6334,58,6403,6244,19185
984,19187,"Webster County, Iowa",2010,15580,17035,1455,241,1435,1446,36567,681,38013,34210,19187
985,19189,"Winnebago County, Iowa",2010,4597,5194,597,85,78,360,10506,96,10866,10247,19189
986,19191,"Winneshiek County, Iowa",2010,7997,8721,724,224,130,418,20638,131,21056,20153,19191
987,38049,"McHenry County, North Dakota",2010,2377,2948,571,16,8,80,5315,73,5395,5218,38049
988,38043,"Kidder County, North Dakota",2010,1059,1674,615,22,6,71,2364,7,2435,2329,38043
989,19063,"Emmet County, Iowa",2010,4236,4758,522,44,61,763,9539,115,10302,9319,19063
990,19049,"Dallas County, Iowa",2010,25240,27260,2020,1652,890,4059,62076,904,66135,58630,19049
991,19051,"Davis County, Iowa",2010,3201,3600,399,24,7,85,8668,81,8753,8556,19051
992,19057,"Des Moines County, Iowa",2010,17003,18535,1532,285,2005,1042,39283,934,40325,36059,19057
993,19053,"Decatur County, Iowa",2010,3223,3834,611,53,149,181,8276,128,8457,7946,19053
994,19055,"Delaware County, Iowa",2010,7062,8028,966,44,45,139,17625,128,17764,17408,19055
995,19059,"Dickinson County, Iowa",2010,7554,12849,5295,72,29,178,16489,133,16667,16255,19059
996,19061,"Dubuque County, Iowa",2010,36815,38951,2136,871,2436,1807,91846,1558,93653,86981,19061
997,19075,"Grundy County, Iowa",2010,5131,5530,399,27,26,122,12331,88,12453,12190,19075
998,19065,"Fayette County, Iowa",2010,8634,9558,924,105,196,380,20500,212,20880,19987,19065
999,19067,"Floyd County, Iowa",2010,6886,7526,640,213,200,331,15972,116,16303,15443,19067
1000,19069,"Franklin County, Iowa",2010,4332,4894,562,28,19,1209,9471,90,10680,9334,19069
1001,19071,"Fremont County, Iowa",2010,3064,3431,367,18,32,187,7254,81,7441,7123,19071
1002,19073,"Greene County, Iowa",2010,3996,4546,550,30,22,171,9165,96,9336,9017,19073
1003,19091,"Humboldt County, Iowa",2010,4209,4684,475,31,39,357,9458,100,9815,9288,19091
1004,19077,"Guthrie County, Iowa",2010,4544,5756,1212,37,16,202,10752,104,10954,10595,19077
1005,19079,"Hamilton County, Iowa",2010,6540,7219,679,311,40,782,14891,196,15673,14344,19079
1006,19081,"Hancock County, Iowa",2010,4741,5330,589,47,50,398,10943,102,11341,10744,19081
1007,19083,"Hardin County, Iowa",2010,7296,8224,928,68,208,651,16883,177,17534,16430,19083
1008,19085,"Harrison County, Iowa",2010,5987,6731,744,41,25,183,14745,147,14928,14532,19085
1009,19087,"Henry County, Iowa",2010,7666,8280,614,450,435,764,19381,355,20145,18141,19087
1010,19089,"Howard County, Iowa",2010,3944,4367,423,24,25,118,9448,85,9566,9314,19089
1011,37141,"Pender County, North Carolina",2010,20333,26724,6391,197,9208,3194,49023,1050,52217,38568,37141
1012,19093,"Ida County, Iowa",2010,3052,3426,374,19,17,100,6989,46,7089,6907,19093
1013,19095,"Iowa County, Iowa",2010,6677,7258,581,54,53,307,16048,123,16355,15818,19095
1014,19097,"Jackson County, Iowa",2010,8289,9415,1126,47,58,220,19628,300,19848,19223,19097
1015,37137,"Pamlico County, North Carolina",2010,5490,7534,2044,48,2618,412,12732,238,13144,9828,37137
1016,37139,"Pasquotank County, North Carolina",2010,14956,16833,1877,449,15256,1642,39019,945,40661,22369,37139
1017,37153,"Richmond County, North Carolina",2010,18430,20738,2308,419,14159,2741,43898,1951,46639,27369,37153
1018,37143,"Perquimans County, North Carolina",2010,5598,6986,1388,36,3328,286,13167,195,13453,9608,37143
1019,37145,"Person County, North Carolina",2010,15826,18193,2367,115,10599,1593,37871,803,39464,26354,37145
1020,37147,"Pitt County, North Carolina",2010,67577,74990,7413,2561,56813,9202,158946,3534,168148,96038,37147
1021,37149,"Polk County, North Carolina",2010,8989,11432,2443,60,911,1122,19388,291,20510,18126,37149
1022,37151,"Randolph County, North Carolina",2010,55373,61041,5668,1406,7979,14698,127054,2464,141752,115205,37151
1023,37169,"Stokes County, North Carolina",2010,19416,21924,2508,125,1897,1254,46147,678,47401,43447,37169
1024,37161,"Rutherford County, North Carolina",2010,27466,33878,6412,289,6804,2397,65413,1266,67810,57054,37161
1025,37159,"Rowan County, North Carolina",2010,53140,60211,7071,1353,22153,10644,127784,2292,138428,101986,37159
1026,37163,"Sampson County, North Carolina",2010,24005,27234,3229,217,16948,10440,52991,2072,63431,33754,37163
1027,37155,"Robeson County, North Carolina",2010,47997,52751,4754,971,32347,10932,123236,53758,134168,36160,37155
1028,37157,"Rockingham County, North Carolina",2010,38693,43696,5003,423,17529,5159,88484,1788,93643,68744,37157
1029,37165,"Scotland County, North Carolina",2010,13614,15193,1579,276,13884,754,35403,4638,36157,16605,37165
1030,37167,"Stanly County, North Carolina",2010,23589,27110,3521,1108,6590,2166,58419,844,60585,49877,37167
1031,37181,"Vance County, North Carolina",2010,17395,20082,2687,199,22477,3051,42371,594,45422,19101,37181
1032,37171,"Surry County, North Carolina",2010,29914,33667,3753,339,2644,7155,66518,924,73673,62611,37171
1033,37173,"Swain County, North Carolina",2010,5672,8723,3051,66,75,540,13441,4132,13981,9168,37173
1034,37175,"Transylvania County, North Carolina",2010,14394,19163,4769,143,1279,964,32126,655,33090,30049,37175
1035,37177,"Tyrrell County, North Carolina",2010,1595,2068,473,80,1677,240,4167,60,4407,2350,37177
1036,37179,"Union County, North Carolina",2010,67864,72870,5006,3243,23134,20967,180325,3850,201292,150098,37179
1037,37195,"Wilson County, North Carolina",2010,31962,35511,3549,664,31462,7724,73510,1227,81234,40157,37195
1038,37183,"Wake County, North Carolina",2010,345645,371836,26191,48287,182793,87922,813071,21455,900993,560536,37183
1039,37185,"Warren County, North Carolina",2010,8321,11806,3485,49,10911,692,20280,1349,20972,7971,37185
1040,37187,"Washington County, North Carolina",2010,5526,6491,965,38,6567,466,12762,159,13228,5998,37187
1041,37189,"Watauga County, North Carolina",2010,20403,32137,11734,467,855,1713,49366,776,51079,47268,37189
1042,37191,"Wayne County, North Carolina",2010,47831,52949,5118,1405,38107,12162,110461,2733,122623,68216,37191
1043,37197,"Yadkin County, North Carolina",2010,15486,17341,1855,71,1165,3749,34657,399,38406,33022,37197
1044,37193,"Wilkes County, North Carolina",2010,28360,33065,4705,295,2785,3772,65568,901,69340,61587,37193
1045,37199,"Yancey County, North Carolina",2010,7644,11032,3388,34,128,814,17004,190,17818,16652,37199
1046,38011,"Bowman County, North Dakota",2010,1385,1683,298,2,3,78,3073,29,3151,3039,38011
1047,38019,"Cavalier County, North Dakota",2010,1818,2309,491,9,4,24,3969,66,3993,3890,38019
1048,38001,"Adams County, North Dakota",2010,1098,1377,279,9,8,20,2323,40,2343,2266,38001
1049,38003,"Barnes County, North Dakota",2010,4826,5704,878,58,83,123,10943,203,11066,10599,38003
1050,38013,"Burke County, North Dakota",2010,913,1340,427,13,4,37,1931,23,1968,1891,38013
1051,18101,"Martin County, Indiana",2010,4216,4786,570,29,10,70,10264,100,10334,10125,18101
1052,18091,"LaPorte County, Indiana",2010,42331,48448,6117,570,11835,6093,105374,2274,111467,90695,18091
1053,18093,"Lawrence County, Indiana",2010,18811,21074,2263,224,181,545,45589,622,46134,44562,18093
1054,18095,"Madison County, Indiana",2010,51927,59068,7141,547,10887,4189,127447,2436,131636,113577,18095
1055,18097,"Marion County, Indiana",2010,366176,417862,51686,18119,238454,84466,818927,24449,903393,537905,18097
1056,18099,"Marshall County, Indiana",2010,17406,19845,2439,210,196,3971,43080,576,47051,42098,18099
1057,18113,"Noble County, Indiana",2010,17355,20109,2754,174,170,4567,42969,521,47536,42104,18113
1058,18103,"Miami County, Indiana",2010,13456,15479,2023,128,1649,906,35997,913,36903,33307,18103
1059,18105,"Monroe County, Indiana",2010,54864,59107,4243,7190,4363,4029,133945,3555,137974,118837,18105
1060,18107,"Montgomery County, Indiana",2010,14979,16535,1556,209,307,1739,36385,495,38124,35374,18107
1061,18109,"Morgan County, Indiana",2010,25765,27754,1989,241,175,820,68074,876,68894,66782,18109
1062,18111,"Newton County, Indiana",2010,5503,6030,527,38,53,717,13527,140,14244,13296,18111
1063,18129,"Posey County, Indiana",2010,10171,11207,1036,70,230,248,25662,316,25910,25046,18129
1064,18115,"Ohio County, Indiana",2010,2477,2784,307,19,21,69,6059,52,6128,5967,18115
1065,18117,"Orange County, Indiana",2010,7872,9176,1304,61,168,194,19646,273,19840,19144,18117
1066,18119,"Owen County, Indiana",2010,8486,10091,1605,65,65,198,21377,264,21575,20983,18119
1067,18121,"Parke County, Indiana",2010,6222,8085,1863,33,391,215,17124,155,17339,16545,18121
1068,18123,"Perry County, Indiana",2010,7476,8495,1019,69,469,192,19146,180,19338,18428,18123
1069,18127,"Porter County, Indiana",2010,61998,66179,4181,1960,4649,13933,150410,2558,164343,141243,18127
1070,18125,"Pike County, Indiana",2010,5186,5735,549,25,38,120,12725,118,12845,12544,18125
1071,18141,"St. Joseph County, Indiana",2010,103069,114849,11780,4985,33407,19395,247536,7443,266931,201701,18141
1072,18131,"Pulaski County, Indiana",2010,5282,6060,778,27,87,325,13077,140,13402,12823,18131
1073,18133,"Putnam County, Indiana",2010,12917,14706,1789,273,1485,587,37376,490,37963,35128,18133
1074,18135,"Randolph County, Indiana",2010,10451,11743,1292,57,114,790,25381,315,26171,24895,18135
1075,18137,"Ripley County, Indiana",2010,10789,11952,1163,146,67,445,28373,281,28818,27879,18137
1076,18139,"Rush County, Indiana",2010,6767,7508,741,57,129,190,17202,177,17392,16839,18139
1077,18157,"Tippecanoe County, Indiana",2010,65532,71096,5564,10679,6731,12947,159833,3568,172780,138855,18157
1078,18143,"Scott County, Indiana",2010,9397,10440,1043,104,52,354,23827,200,24181,23471,18143
1079,18145,"Shelby County, Indiana",2010,17302,19080,1778,242,428,1647,42789,497,44436,41622,18145
1080,18147,"Spencer County, Indiana",2010,8082,8872,790,69,96,517,20435,169,20952,20101,18147
1081,18149,"Starke County, Indiana",2010,9038,10962,1924,41,63,766,22597,281,23363,22212,18149
1082,18151,"Steuben County, Indiana",2010,13310,19377,6067,162,155,982,33203,373,34185,32513,18151
1083,18153,"Sullivan County, Indiana",2010,7823,8939,1116,39,946,294,21181,266,21475,19930,18153
1084,18155,"Switzerland County, Indiana",2010,4034,4969,935,18,31,147,10466,99,10613,10318,18155
1085,18169,"Wabash County, Indiana",2010,12777,14171,1394,134,155,697,32191,533,32888,31369,18169
1086,18165,"Vermillion County, Indiana",2010,6619,7488,869,31,21,130,16082,168,16212,15862,18165
1087,18167,"Vigo County, Indiana",2010,41361,46006,4645,1777,7371,2469,105379,2681,107848,93550,18167
1088,18159,"Tipton County, Indiana",2010,6376,6998,622,64,28,346,15590,143,15936,15355,18159
1089,18161,"Union County, Indiana",2010,2938,3239,301,19,33,82,7434,102,7516,7280,18161
1090,18163,"Vanderburgh County, Indiana",2010,74454,83003,8549,1986,16228,3873,175830,4536,179703,153080,18163
1091,37039,"Cherokee County, North Carolina",2010,11753,17515,5762,131,327,688,26756,957,27444,25341,37039
1092,37025,"Cabarrus County, North Carolina",2010,65666,71937,6271,3460,26660,16767,161244,3598,178011,127526,37025
1093,37027,"Caldwell County, North Carolina",2010,33388,37659,4271,421,4025,3796,79233,1222,83029,73565,37027
1094,37029,"Camden County, North Carolina",2010,3675,4104,429,145,1299,215,9765,218,9980,8103,37029
1095,37031,"Carteret County, North Carolina",2010,28870,48179,19309,576,3986,2241,64228,1565,66469,58101,37031
1096,37033,"Caswell County, North Carolina",2010,9190,10619,1429,60,7991,744,22975,411,23719,14513,37033
1097,37035,"Catawba County, North Carolina",2010,60887,67886,6999,5311,12857,13032,141326,2770,154358,120388,37035
1098,37037,"Chatham County, North Carolina",2010,25845,28753,2908,694,8272,8228,55277,1126,63505,45185,37037
1099,37049,"Craven County, North Carolina",2010,40299,45002,4703,2058,22868,6272,97233,2882,103505,69425,37049
1100,37041,"Chowan County, North Carolina",2010,6059,7289,1230,51,5054,467,14326,181,14793,9040,37041
1101,37043,"Clay County, North Carolina",2010,4660,7140,2480,24,64,258,10329,161,10587,10080,37043
1102,37045,"Cleveland County, North Carolina",2010,38555,43373,4818,735,20237,2756,95322,1557,98078,72793,37045
1103,37051,"Cumberland County, North Carolina",2010,122431,135524,13093,6885,113939,30190,289241,17668,319431,150749,37051
1104,37047,"Columbus County, North Carolina",2010,22489,26042,3553,143,17587,2662,55436,2638,58098,35068,37047
1105,37067,"Forsyth County, North Carolina",2010,141163,156872,15709,6427,89533,41775,308895,7001,350670,205934,37067
1106,37053,"Currituck County, North Carolina",2010,8880,14453,5573,141,1348,704,22843,478,23547,20876,37053
1107,37055,"Dare County, North Carolina",2010,14335,33492,19157,211,812,2210,31710,626,33920,30061,37055
1108,37057,"Davidson County, North Carolina",2010,64515,72655,8140,1957,14269,10408,152470,2758,162878,133486,37057
1109,37059,"Davie County, North Carolina",2010,16245,18238,1993,228,2552,2496,38744,707,41240,35257,37059
1110,37061,"Duplin County, North Carolina",2010,22495,25728,3233,135,14640,12059,46446,712,58505,30959,37061
1111,37063,"Durham County, North Carolina",2010,109348,120217,10869,12180,100260,36077,231510,6373,267587,112697,37063
1112,37065,"Edgecombe County, North Carolina",2010,21680,24838,3158,113,32318,2104,54448,657,56552,21360,37065
1113,39081,"Jefferson County, Ohio",2010,29109,32826,3717,284,3856,773,68936,1277,69709,63519,39081
1114,39099,"Mahoning County, Ohio",2010,98712,111833,13121,1647,36400,11136,227687,4410,238823,185230,39099
1115,39085,"Lake County, Ohio",2010,94156,101202,7046,2586,7156,7825,222216,3480,230041,208994,39085
1116,39087,"Lawrence County, Ohio",2010,24974,27603,2629,240,1267,445,62005,951,62450,59547,39087
1117,39089,"Licking County, Ohio",2010,63989,69291,5302,1224,5643,2312,164180,3502,166492,153811,39089
1118,39097,"Madison County, Ohio",2010,14734,15939,1205,231,2852,622,42813,736,43435,38994,39097
1119,39095,"Lucas County, Ohio",2010,180267,202630,22363,6676,82541,26974,414841,12028,441815,313596,39095
1120,39091,"Logan County, Ohio",2010,18111,23181,5070,238,728,539,45319,968,45858,43385,39091
1121,39093,"Lorain County, Ohio",2010,116274,127036,10762,2758,24289,25290,276066,7476,301356,241543,39093
1122,39111,"Monroe County, Ohio",2010,6065,7567,1502,16,60,59,14583,181,14642,14326,39111
1123,39101,"Marion County, Ohio",2010,24691,27834,3143,326,3754,1503,64998,1185,66501,59733,39101
1124,39103,"Medina County, Ohio",2010,65143,69181,4038,1638,1982,2747,169585,2171,172332,163794,39103
1125,39105,"Meigs County, Ohio",2010,9557,11191,1634,51,202,115,23655,315,23770,23087,39105
1126,39107,"Mercer County, Ohio",2010,15532,17633,2101,180,91,614,40200,476,40814,39453,39107
1127,39109,"Miami County, Ohio",2010,40917,44256,3339,1213,2063,1341,101165,1981,102506,95908,39109
1128,39127,"Perry County, Ohio",2010,13576,15211,1635,37,92,195,35863,564,36058,35170,39127
1129,39113,"Montgomery County, Ohio",2010,223943,254775,30832,9195,111105,12177,522976,13759,535153,388917,39113
1130,39115,"Morgan County, Ohio",2010,6034,7892,1858,17,428,97,14957,540,15054,13972,39115
1131,39117,"Morrow County, Ohio",2010,12855,14155,1300,84,117,380,34447,474,34827,33772,39117
1132,39119,"Muskingum County, Ohio",2010,34271,38074,3803,285,3214,650,85424,2325,86074,79600,39119
1133,39121,"Noble County, Ohio",2010,4852,6053,1201,20,368,52,14593,169,14645,14036,39121
1134,39123,"Ottawa County, Ohio",2010,17503,27909,10406,114,302,1755,39673,477,41428,38780,39123
1135,39125,"Paulding County, Ohio",2010,7769,8749,980,38,158,838,18776,232,19614,18348,39125
1136,39139,"Richland County, Ohio",2010,48921,54599,5678,800,11612,1732,122743,2605,124475,107726,39139
1137,39129,"Pickaway County, Ohio",2010,19624,21275,1651,206,1876,588,55110,769,55698,52259,39129
1138,39131,"Pike County, Ohio",2010,11012,12481,1469,55,251,207,28502,586,28709,27610,39131
1139,39133,"Portage County, Ohio",2010,62222,67472,5250,2283,6611,2073,159346,2925,161419,147527,39133
1140,39135,"Preble County, Ohio",2010,16341,17888,1547,170,177,254,42016,581,42270,41088,39135
1141,39137,"Putnam County, Ohio",2010,12872,13731,859,78,79,1890,32609,206,34499,32246,39137
1142,39151,"Stark County, Ohio",2010,151089,165215,14126,2736,28272,5965,369621,9116,375586,329497,39151
1143,39141,"Ross County, Ohio",2010,28919,32148,3229,295,4804,748,77316,1839,78064,70378,39141
1144,39143,"Sandusky County, Ohio",2010,24182,26390,2208,185,1624,5435,55509,1173,60944,52527,39143
1145,39145,"Scioto County, Ohio",2010,30870,34142,3272,248,2107,888,78611,1725,79499,74531,39145
1146,39147,"Seneca County, Ohio",2010,21774,24122,2348,321,1227,2524,54221,934,56745,51739,39147
1147,39149,"Shelby County, Ohio",2010,18467,20173,1706,421,928,661,48762,990,49423,46423,39149
1148,48327,"Menard County, Texas",2010,994,1702,708,3,11,790,1452,13,2242,1425,48327
1149,48333,"Mills County, Texas",2010,1975,2846,871,10,26,818,4118,58,4936,4024,48333
1150,39153,"Summit County, Ohio",2010,222781,245109,22328,11841,77373,8660,533121,12283,541781,431624,39153
1151,39155,"Trumbull County, Ohio",2010,86011,96163,10152,979,17200,2801,207511,3944,210312,185388,39155
1152,39161,"Van Wert County, Ohio",2010,11439,12615,1176,65,237,740,28004,351,28744,27351,39161
1153,39157,"Tuscarawas County, Ohio",2010,36965,40206,3241,286,696,1767,90815,1219,92582,88614,39157
1154,39159,"Union County, Ohio",2010,18065,19429,1364,1419,1202,661,51639,849,52300,48169,39159
1155,39163,"Vinton County, Ohio",2010,5260,6291,1031,23,37,71,13364,201,13435,13103,39163
1156,39165,"Warren County, Ohio",2010,76424,80750,4326,8261,6838,4784,207909,3505,212693,189305,39165
1157,48329,"Midland County, Texas",2010,50845,54351,3506,1639,8675,51600,85272,2136,136872,72822,48329
1158,48331,"Milam County, Texas",2010,9408,11305,1897,95,2380,5780,18977,286,24757,16216,48331
1159,48345,"Motley County, Texas",2010,542,779,237,0,24,163,1047,10,1210,1013,48345
1160,48335,"Mitchell County, Texas",2010,2809,4064,1255,27,1043,3481,5922,99,9403,4753,48335
1161,48337,"Montague County, Texas",2010,7989,10131,2142,59,38,1930,17789,345,19719,17347,48337
1162,48339,"Montgomery County, Texas",2010,162530,177647,15117,9347,18537,94698,361048,8553,455746,324611,48339
1163,48341,"Moore County, Texas",2010,7197,7881,684,1323,287,11542,10362,382,21904,8370,48341
1164,48343,"Morris County, Texas",2010,5226,6024,798,43,2952,1003,11931,300,12934,8636,48343
1165,48367,"Parker County, Texas",2010,42069,46628,4559,631,1842,12410,104517,2346,116927,99698,48367
1166,48347,"Nacogdoches County, Texas",2010,23861,27406,3545,775,11573,11356,53168,1121,64524,39699,48347
1167,48349,"Navarro County, Texas",2010,17380,20234,2854,239,6490,11345,36390,1074,47735,28587,48349
1168,48351,"Newton County, Texas",2010,5476,7142,1666,62,2891,403,14042,264,14445,10825,48351
1169,48353,"Nolan County, Texas",2010,5999,7152,1153,58,666,5103,10113,198,15216,9191,48353
1170,48355,"Nueces County, Texas",2010,124587,141033,16446,5495,12178,206293,133930,4387,340223,111870,48355
1171,48357,"Ochiltree County, Texas",2010,3617,4062,445,24,19,4982,5241,136,10223,5062,48357
1172,48359,"Oldham County, Texas",2010,691,841,150,17,60,243,1809,33,2052,1699,48359
1173,48361,"Orange County, Texas",2010,31031,35313,4282,797,6922,4766,77071,1457,81837,67895,48361
1174,48365,"Panola County, Texas",2010,9271,10920,1649,72,3850,1970,21826,383,23796,17521,48365
1175,48363,"Palo Pinto County, Texas",2010,10871,15214,4343,132,597,4985,23126,439,28111,21958,48363
1176,48379,"Rains County, Texas",2010,4377,5269,892,55,249,839,10075,218,10914,9553,48379
1177,48369,"Parmer County, Texas",2010,3413,3799,386,18,91,6164,4105,53,10269,3943,48369
1178,48371,"Pecos County, Texas",2010,4894,5585,691,74,528,10430,5077,149,15507,4326,48371
1179,48373,"Polk County, Texas",2010,16503,22683,6180,180,5153,5959,39454,1291,45413,32830,48373
1180,48375,"Potter County, Texas",2010,42933,47271,4338,4675,11823,42692,78381,2561,121073,59322,48375
1181,48377,"Presidio County, Texas",2010,2906,3825,919,75,27,6521,1297,59,7818,1136,48377
1182,48395,"Robertson County, Texas",2010,6541,8484,1943,96,3509,2990,13632,206,16622,9821,48395
1183,48381,"Randall County, Texas",2010,47975,51587,3612,1625,2701,19775,100950,2263,120725,94361,48381
1184,48383,"Reagan County, Texas",2010,1156,1372,216,1,65,2051,1316,31,3367,1219,48383
1185,48385,"Real County, Texas",2010,1374,2599,1225,2,20,814,2495,75,3309,2398,48385
1186,48387,"Red River County, Texas",2010,5469,6826,1357,23,2211,849,12011,274,12860,9503,48387
1187,48389,"Reeves County, Texas",2010,3839,4640,801,118,672,10233,3550,70,13783,2690,48389
1188,48391,"Refugio County, Texas",2010,2841,3726,885,27,445,3487,3896,87,7383,3337,48391
1189,48393,"Roberts County, Texas",2010,359,439,80,2,0,74,855,12,929,841,48393
1190,48407,"San Jacinto County, Texas",2010,10096,13187,3091,120,2662,2880,23504,518,26384,20204,48407
1191,48397,"Rockwall County, Texas",2010,26448,27939,1491,1850,4397,12470,65867,1574,78337,58046,48397
1192,48399,"Runnels County, Texas",2010,4165,5298,1133,19,165,3361,7140,115,10501,6841,48399
1193,48401,"Rusk County, Texas",2010,18476,21191,2715,203,9359,7609,45721,922,53330,35237,48401
1194,48403,"Sabine County, Texas",2010,4738,7988,3250,33,778,344,10490,195,10834,9484,48403
1195,48405,"San Augustine County, Texas",2010,3625,5342,1717,22,2013,532,8333,115,8865,6183,48405
1196,48429,"Stephens County, Texas",2010,3665,4938,1273,31,195,2011,7619,104,9630,7289,48429
1197,48409,"San Patricio County, Texas",2010,22637,26521,3884,506,902,35248,29556,818,64804,27330,48409
1198,48411,"San Saba County, Texas",2010,2257,3177,920,13,194,1715,4416,74,6131,4135,48411
1199,48413,"Schleicher County, Texas",2010,1182,1489,307,4,32,1536,1925,17,3461,1872,48413
1200,48415,"Scurry County, Texas",2010,5838,6963,1125,48,764,6149,10772,187,16921,9773,48415
1201,48417,"Shackelford County, Texas",2010,1367,1754,387,9,14,340,3038,54,3378,2961,48417
1202,48419,"Shelby County, Texas",2010,9648,11873,2225,76,4414,4164,21284,259,25448,16535,48419
1203,48421,"Sherman County, Texas",2010,1081,1252,171,6,12,1227,1807,27,3034,1762,48421
1204,48423,"Smith County, Texas",2010,79055,87309,8254,2550,37195,36088,173626,3635,209714,130246,48423
1205,48427,"Starr County, Texas",2010,17001,19526,2525,119,15,58337,2631,48,60968,2449,48427
1206,48425,"Somervell County, Texas",2010,3078,3674,596,40,54,1626,6864,175,8490,6595,48425
1207,48431,"Sterling County, Texas",2010,440,615,175,0,13,365,778,32,1143,733,48431
1208,48433,"Stonewall County, Texas",2010,642,928,286,14,38,209,1281,23,1490,1206,48433
1209,48435,"Sutton County, Texas",2010,1550,2031,481,5,6,2459,1669,19,4128,1639,48435
1210,48437,"Swisher County, Texas",2010,2762,3221,459,5,552,3149,4705,123,7854,4025,48437
1211,20123,"Mitchell County, Kansas",2010,2790,3296,506,19,13,73,6300,71,6373,6197,20123
1212,20125,"Montgomery County, Kansas",2010,14382,16578,2196,202,2022,1844,33627,2691,35471,28712,20125
1213,20129,"Morton County, Kansas",2010,1250,1467,217,60,14,623,2610,70,3233,2466,20129
1214,20131,"Nemaha County, Kansas",2010,4115,4562,447,15,51,121,10057,148,10178,9843,20131
1215,20147,"Phillips County, Kansas",2010,2432,3049,617,41,22,121,5521,64,5642,5394,20147
1216,20133,"Neosho County, Kansas",2010,6645,7513,868,83,192,686,15826,415,16512,15136,20133
1217,20135,"Ness County, Kansas",2010,1365,1740,375,3,17,229,2878,30,3107,2828,20135
1218,20137,"Norton County, Kansas",2010,2163,2542,379,30,162,240,5431,73,5671,5166,20137
1219,20139,"Osage County, Kansas",2010,6552,7503,951,35,44,330,15965,326,16295,15560,20139
1220,20141,"Osborne County, Kansas",2010,1742,2206,464,17,8,46,3812,44,3858,3743,20141
1221,20143,"Ottawa County, Kansas",2010,2456,2779,323,9,49,121,5970,84,6091,5828,20143
1222,20145,"Pawnee County, Kansas",2010,2665,3152,487,32,318,461,6512,144,6973,6018,20145
1223,20159,"Rice County, Kansas",2010,3906,4548,642,37,112,1018,9065,233,10083,8683,20159
1224,20149,"Pottawatomie County, Kansas",2010,7878,8626,748,143,214,957,20647,600,21604,19690,20149
1225,20151,"Pratt County, Kansas",2010,3956,4514,558,26,100,525,9131,193,9656,8812,20151
1226,20153,"Rawlins County, Kansas",2010,1176,1458,282,5,8,80,2439,26,2519,2400,20153
1227,20155,"Reno County, Kansas",2010,25794,28274,2480,296,1843,5209,59302,1620,64511,55543,20155
1228,20157,"Republic County, Kansas",2010,2274,2877,603,15,22,53,4927,39,4980,4851,20157
1229,20175,"Seward County, Kansas",2010,7460,8061,601,594,687,12990,9962,420,22952,8261,20175
1230,20167,"Russell County, Kansas",2010,3173,3910,737,33,53,115,6855,129,6970,6640,20167
1231,20165,"Rush County, Kansas",2010,1511,1869,358,6,8,84,3223,44,3307,3165,20165
1232,20169,"Saline County, Kansas",2010,22416,24101,1685,1138,1743,5403,50203,1651,55606,45671,20169
1233,20161,"Riley County, Kansas",2010,25796,28212,2416,2960,4344,4610,66505,2630,71115,56571,20161
1234,20163,"Rooks County, Kansas",2010,2238,2768,530,19,21,107,5074,53,5181,4981,20163
1235,20171,"Scott County, Kansas",2010,1983,2193,210,20,16,753,4183,50,4936,4097,20171
1236,20173,"Sedgwick County, Kansas",2010,193502,211593,18091,20167,44931,64636,433729,20197,498365,348434,20173
1237,20187,"Stanton County, Kansas",2010,825,990,165,1,12,828,1407,43,2235,1351,20187
1238,20177,"Shawnee County, Kansas",2010,72600,79140,6540,2048,14598,19303,158631,7436,177934,134549,20177
1239,20179,"Sheridan County, Kansas",2010,1099,1265,166,5,3,84,2472,28,2556,2436,20179
1240,38045,"LaMoure County, North Dakota",2010,1825,2238,413,6,5,34,4105,41,4139,4053,38045
1241,38065,"Oliver County, North Dakota",2010,756,905,149,4,3,19,1827,38,1846,1782,38065
1242,19195,"Worth County, Iowa",2010,3172,3548,376,24,21,147,7451,71,7598,7335,19195
1243,19197,"Wright County, Iowa",2010,5625,6529,904,33,40,1274,11955,144,13229,11738,19197
1244,20001,"Allen County, Kansas",2010,5475,6226,751,67,243,392,12979,384,13371,12285,20001
1245,20011,"Bourbon County, Kansas",2010,5986,7167,1181,69,409,309,14864,433,15173,13953,20011
1246,20013,"Brown County, Kansas",2010,4094,4779,685,31,116,306,9678,1140,9984,8391,20013
1247,20005,"Atchison County, Kansas",2010,6241,6990,749,70,844,383,16541,475,16924,15152,20005
1248,20003,"Anderson County, Kansas",2010,3260,3720,460,36,40,123,7979,129,8102,7774,20003
1249,20007,"Barber County, Kansas",2010,2139,2765,626,20,20,119,4742,94,4861,4608,20007
1250,38055,"McLean County, North Dakota",2010,3897,5590,1693,12,6,111,8851,718,8962,8115,38055
1251,38057,"Mercer County, North Dakota",2010,3625,4450,825,27,16,121,8303,264,8424,7996,38057
1252,38059,"Morton County, North Dakota",2010,11289,12079,790,53,112,400,27071,1369,27471,25537,38059
1253,38061,"Mountrail County, North Dakota",2010,2793,4119,1326,15,16,286,7387,2425,7673,4931,38061
1254,38063,"Nelson County, North Dakota",2010,1474,1927,453,2,8,33,3093,65,3126,3018,38063
1255,38081,"Sargent County, North Dakota",2010,1675,2004,329,9,2,51,3778,50,3829,3717,38081
1256,38067,"Pembina County, North Dakota",2010,3257,3859,602,11,21,190,7223,244,7413,6947,38067
1257,38069,"Pierce County, North Dakota",2010,1835,2199,364,3,19,44,4313,207,4357,4084,38069
1258,38071,"Ramsey County, North Dakota",2010,4955,5615,660,45,41,137,11314,1248,11451,9980,38071
1259,38073,"Ransom County, North Dakota",2010,2310,2656,346,20,19,66,5391,67,5457,5285,38073
1260,38075,"Renville County, North Dakota",2010,1061,1386,325,5,2,24,2446,38,2470,2401,38075
1261,38077,"Richland County, North Dakota",2010,6651,7503,852,88,110,271,16050,501,16321,15351,38077
1262,38079,"Rolette County, North Dakota",2010,4783,5372,589,16,21,133,13804,10965,13937,2802,38079
1263,38093,"Stutsman County, North Dakota",2010,8931,9862,931,99,126,361,20739,518,21100,19996,38093
1264,38083,"Sheridan County, North Dakota",2010,645,894,249,2,0,16,1305,31,1321,1272,38083
1265,38085,"Sioux County, North Dakota",2010,1158,1311,153,4,6,82,4071,3544,4153,517,38085
1266,38087,"Slope County, North Dakota",2010,326,436,110,0,0,12,715,8,727,707,38087
1267,38089,"Stark County, North Dakota",2010,10085,10735,650,288,186,454,23745,506,24199,22765,38089
1268,38091,"Steele County, North Dakota",2010,864,1171,307,2,3,20,1955,34,1975,1916,38091
1269,38105,"Williams County, North Dakota",2010,9293,10464,1171,78,57,436,21962,1463,22398,20364,38105
1270,38101,"Ward County, North Dakota",2010,25029,26744,1715,550,1469,1869,59806,3070,61675,54717,38101
1271,38103,"Wells County, North Dakota",2010,1943,2481,538,4,3,21,4186,36,4207,4143,38103
1272,38095,"Towner County, North Dakota",2010,1048,1449,401,1,2,10,2236,68,2246,2165,38095
1273,38097,"Traill County, North Dakota",2010,3394,3780,386,21,39,214,7907,154,8121,7693,38097
1274,38099,"Walsh County, North Dakota",2010,4746,5498,752,36,24,969,10150,256,11119,9834,38099
1275,39013,"Belmont County, Ohio",2010,28679,32452,3773,257,2815,429,69971,997,70400,65902,39013
1276,39003,"Allen County, Ohio",2010,40619,44999,4380,725,12508,2513,103818,2877,106331,87708,39003
1277,39001,"Adams County, Ohio",2010,11147,12978,1831,31,84,243,28307,479,28550,27713,39001
1278,39007,"Ashtabula County, Ohio",2010,39363,46099,6736,372,3467,3441,98056,2091,101497,92126,39007
1279,39005,"Ashland County, Ohio",2010,20196,22141,1945,275,395,501,52638,616,53139,51352,39005
1280,39009,"Athens County, Ohio",2010,23578,26385,2807,1741,1741,1002,63755,1494,64757,58779,39009
1281,39015,"Brown County, Ohio",2010,17014,19301,2287,107,382,269,44577,518,44846,43570,39015
1282,39011,"Auglaize County, Ohio",2010,17972,19585,1613,165,124,543,45406,492,45949,44625,39011
1283,39017,"Butler County, Ohio",2010,135960,148273,12313,8759,26463,14670,353460,8055,368130,310183,39017
1284,39019,"Carroll County, Ohio",2010,11385,13698,2313,56,133,238,28598,365,28836,28044,39019
1285,39021,"Champaign County, Ohio",2010,15329,16755,1426,151,874,451,39646,878,40097,37743,39021
1286,39037,"Darke County, Ohio",2010,20929,22730,1801,159,233,646,52313,556,52959,51365,39037
1287,39023,"Clark County, Ohio",2010,55244,61419,6175,849,11999,3805,134528,3704,138333,117976,39023
1288,39025,"Clermont County, Ohio",2010,74828,80656,5828,1900,2234,2896,194467,3002,197363,187331,39025
1289,39027,"Clinton County, Ohio",2010,16210,18133,1923,211,905,559,41481,869,42040,39496,39027
1290,39029,"Columbiana County, Ohio",2010,42683,47088,4405,319,2323,1348,106493,1525,107841,102326,39029
1291,39031,"Coshocton County, Ohio",2010,14658,16545,1887,103,391,279,36622,496,36901,35632,39031
1292,39033,"Crawford County, Ohio",2010,18099,20167,2068,156,375,533,43251,493,43784,42227,39033
1293,39035,"Cuyahoga County, Ohio",2010,545056,621763,76707,32615,374968,61270,1218852,25292,1280122,785977,39035
1294,39049,"Franklin County, Ohio",2010,477235,527186,49951,44723,244200,55718,1107696,35725,1163414,783048,39049
1295,39039,"Defiance County, Ohio",2010,15268,16729,1461,117,666,3409,35628,500,39037,34345,39039
1296,39041,"Delaware County, Ohio",2010,62760,66378,3618,7393,5756,3669,170545,3427,174214,153969,39041
1297,39043,"Erie County, Ohio",2010,31860,37845,5985,456,6534,2604,74475,2022,77079,65463,39043
1298,39047,"Fayette County, Ohio",2010,11436,12693,1257,151,569,520,28510,563,29030,27227,39047
1299,39045,"Fairfield County, Ohio",2010,54310,58687,4377,1626,8609,2510,143646,3034,146156,130377,39045
1300,48215,"Hidalgo County, Texas",2010,216471,248287,31816,7122,2777,702206,72563,2111,774769,60553,48215
1301,48231,"Hunt County, Texas",2010,32076,36704,4628,897,6976,11751,74378,2112,86129,64393,48231
1302,39051,"Fulton County, Ohio",2010,16188,17407,1219,176,138,3341,39357,474,42698,38569,39051
1303,39053,"Gallia County, Ohio",2010,12062,13925,1863,139,800,275,30659,570,30934,29150,39053
1304,48217,"Hill County, Texas",2010,13238,16118,2880,105,2161,6427,28662,560,35089,25836,48217
1305,48219,"Hockley County, Texas",2010,8242,9293,1051,60,801,9993,12942,286,22935,11795,48219
1306,48221,"Hood County, Texas",2010,20795,24951,4156,296,225,5234,45948,839,51182,44588,48221
1307,48223,"Hopkins County, Texas",2010,13308,15029,1721,172,2448,5368,29793,672,35161,26501,48223
1308,48225,"Houston County, Texas",2010,8656,11532,2876,95,6129,2364,21368,333,23732,14811,48225
1309,48227,"Howard County, Texas",2010,11333,13124,1791,256,2079,13255,21757,621,35012,18801,48227
1310,48229,"Hudspeth County, Texas",2010,1174,1527,353,13,30,2768,708,37,3476,628,48229
1311,48249,"Jim Wells County, Texas",2010,13961,16147,2186,134,156,32254,8584,232,40838,8062,48249
1312,48233,"Hutchinson County, Texas",2010,8812,10629,1817,91,512,4386,17764,679,22150,16482,48233
1313,48235,"Irion County, Texas",2010,653,856,203,3,11,407,1192,25,1599,1153,48235
1314,48237,"Jack County, Texas",2010,3136,4095,959,30,340,1283,7761,102,9044,7289,48237
1315,48245,"Jefferson County, Texas",2010,93441,104424,10983,8525,84500,42899,209374,3846,252273,112503,48245
1316,48247,"Jim Hogg County, Texas",2010,1902,2441,539,14,18,4907,393,27,5300,334,48247
1317,48239,"Jackson County, Texas",2010,5284,6590,1306,50,942,4079,9996,149,14075,8855,48239
1318,48241,"Jasper County, Texas",2010,13770,16798,3028,200,5931,2017,33693,623,35710,26939,48241
1319,48243,"Jeff Davis County, Texas",2010,1034,1613,579,7,10,790,1552,45,2342,1490,48243
1320,48265,"Kerr County, Texas",2010,20550,23831,3281,361,739,11895,37730,779,49625,35851,48265
1321,48251,"Johnson County, Texas",2010,52193,56719,4526,951,3797,27319,123615,3322,150934,115545,48251
1322,48253,"Jones County, Texas",2010,6034,7422,1388,76,2292,5009,15193,276,20202,12549,48253
1323,48255,"Karnes County, Texas",2010,4463,5650,1187,25,1351,7376,7448,116,14824,5956,48255
1324,48257,"Kaufman County, Texas",2010,34964,38322,3358,869,10571,17548,85802,2034,103350,72328,48257
1325,48259,"Kendall County, Texas",2010,12617,14055,1438,202,138,6829,26581,495,33410,25746,48259
1326,48261,"Kenedy County, Texas",2010,147,233,86,1,1,319,97,9,416,86,48261
1327,48263,"Kent County, Texas",2010,350,552,202,0,6,120,688,13,808,669,48263
1328,48277,"Lamar County, Texas",2010,19829,22481,2652,304,6628,3223,46570,1747,49793,37891,48277
1329,48267,"Kimble County, Texas",2010,2016,3371,1355,19,16,1077,3530,45,4607,3450,48267
1330,48269,"King County, Texas",2010,113,186,73,0,0,39,247,5,286,242,48269
1331,48271,"Kinney County, Texas",2010,1350,1940,590,10,39,2004,1594,49,3598,1496,48271
1332,48273,"Kleberg County, Texas",2010,11097,12787,1690,715,1070,22495,9566,302,32061,7479,48273
1333,48275,"Knox County, Texas",2010,1506,2044,538,7,209,1101,2618,55,3719,2347,48275
1334,48293,"Limestone County, Texas",2010,8499,10536,2037,84,4041,4465,18919,361,23384,14433,48293
1335,48279,"Lamb County, Texas",2010,5081,6128,1047,17,555,7231,6746,154,13977,6020,48279
1336,48281,"Lampasas County, Texas",2010,7539,8718,1179,184,581,3443,16234,633,19677,14836,48281
1337,48283,"La Salle County, Texas",2010,1931,2746,815,6,18,5920,966,48,6886,894,48283
1338,48285,"Lavaca County, Texas",2010,7808,10344,2536,56,1255,3077,16186,201,19263,14674,48285
1339,48287,"Lee County, Texas",2010,6151,7499,1348,52,1772,3724,12888,266,16612,10798,48287
1340,48289,"Leon County, Texas",2010,6896,9509,2613,75,1181,2260,14541,207,16801,13078,48289
1341,48291,"Liberty County, Texas",2010,25073,28759,3686,337,8074,13602,62041,1309,75643,52321,48291
1342,48303,"Lubbock County, Texas",2010,105781,115064,9283,5650,19957,88924,189907,4485,278831,159815,48303
1343,48295,"Lipscomb County, Texas",2010,1263,1512,249,10,7,1007,2295,65,3302,2213,48295
1344,48297,"Live Oak County, Texas",2010,4257,6065,1808,56,453,4060,7471,157,11531,6805,48297
1345,48299,"Llano County, Texas",2010,9008,14280,5272,76,102,1542,17759,278,19301,17303,48299
1346,48305,"Lynn County, Texas",2010,2246,2676,430,8,113,2743,3172,67,5915,2984,48305
1347,48301,"Loving County, Texas",2010,39,50,11,0,0,18,64,4,82,60,48301
1348,48317,"Martin County, Texas",2010,1649,1852,203,11,67,2086,2713,57,4799,2578,48317
1349,48307,"McCulloch County, Texas",2010,3338,4302,964,28,133,2476,5807,78,8283,5568,48307
1350,48309,"McLennan County, Texas",2010,86892,95124,8232,3128,33892,55471,179435,4120,234906,138295,48309
1351,48311,"McMullen County, Texas",2010,310,485,175,3,8,261,446,3,707,432,48311
1352,48313,"Madison County, Texas",2010,4187,5096,909,77,2687,2688,10976,182,13664,8030,48313
1353,48315,"Marion County, Texas",2010,4595,6218,1623,50,2319,328,10218,285,10546,7564,48315
1354,48319,"Mason County, Texas",2010,1754,2733,979,7,14,864,3148,35,4012,3092,48319
1355,48321,"Matagorda County, Texas",2010,13894,18801,4907,693,4060,14074,22628,475,36702,17400,48321
1356,48323,"Maverick County, Texas",2010,15563,17462,1899,140,75,51914,2344,577,54258,1552,48323
1357,48325,"Medina County, Texas",2010,15530,17991,2461,272,913,22871,23135,542,46006,21408,48325
1358,20009,"Barton County, Kansas",2010,11283,12696,1413,53,367,3683,23991,479,27674,23092,20009
1359,20017,"Chase County, Kansas",2010,1150,1503,353,8,34,100,2690,51,2790,2597,20017
1360,20015,"Butler County, Kansas",2010,23992,26058,2066,452,1054,2602,63278,1852,65880,59920,20015
1361,20051,"Ellis County, Kansas",2010,11908,12872,964,390,232,1299,27153,428,28452,26103,20051
1362,20027,"Clay County, Kansas",2010,3559,4042,483,26,34,162,8373,129,8535,8184,20027
1363,20025,"Clark County, Kansas",2010,923,1135,212,17,0,163,2052,68,2215,1967,20025
1364,20029,"Cloud County, Kansas",2010,3910,4659,749,20,49,283,9250,146,9533,9035,20029
1365,20019,"Chautauqua County, Kansas",2010,1612,2150,538,3,13,87,3582,275,3669,3291,20019
1366,20021,"Cherokee County, Kansas",2010,8625,9890,1265,64,116,424,21179,1719,21603,19280,20021
1367,20023,"Cheyenne County, Kansas",2010,1260,1518,258,19,2,142,2584,20,2726,2543,20023
1368,20031,"Coffey County, Kansas",2010,3497,3964,467,34,47,176,8425,168,8601,8176,20031
1369,20033,"Comanche County, Kansas",2010,824,1044,220,5,6,73,1818,24,1891,1783,20033
1370,20035,"Cowley County, Kansas",2010,13940,16030,2090,578,971,3292,33019,1638,36311,29832,20035
1371,20037,"Crawford County, Kansas",2010,15729,17801,2072,468,757,1762,37372,1305,39134,34842,20037
1372,20039,"Decatur County, Kansas",2010,1378,1818,440,7,17,30,2931,38,2961,2869,20039
1373,20041,"Dickinson County, Kansas",2010,8073,8972,899,59,139,769,18985,475,19754,18312,20041
1374,20043,"Doniphan County, Kansas",2010,3136,3576,440,16,242,165,7780,240,7945,7282,20043
1375,20047,"Edwards County, Kansas",2010,1302,1636,334,12,5,534,2503,40,3037,2446,20047
1376,20049,"Elk County, Kansas",2010,1284,1760,476,12,0,79,2803,97,2882,2694,20049
1377,20063,"Gove County, Kansas",2010,1154,1373,219,11,7,42,2653,17,2695,2618,20063
1378,20053,"Ellsworth County, Kansas",2010,2463,3239,776,24,299,322,6175,119,6497,5733,20053
1379,20055,"Finney County, Kansas",2010,12359,13276,917,1207,707,17182,19594,631,36776,17049,20055
1380,20057,"Ford County, Kansas",2010,11145,12005,860,470,605,17321,16527,555,33848,14897,20057
1381,20059,"Franklin County, Kansas",2010,10104,11147,1043,99,320,937,25055,756,25992,23880,20059
1382,20061,"Geary County, Kansas",2010,12690,14517,1827,1069,6015,4252,30110,2439,34362,20587,20061
1383,20045,"Douglas County, Kansas",2010,43576,46731,3155,4112,4204,5651,105175,6327,110826,90532,20045
1384,20085,"Jackson County, Kansas",2010,5228,5779,551,48,69,438,13024,1348,13462,11559,20085
1385,20065,"Graham County, Kansas",2010,1196,1484,288,6,96,59,2538,79,2597,2357,20065
1386,20067,"Grant County, Kansas",2010,2716,2945,229,26,31,3439,4390,93,7829,4240,20067
1387,20069,"Gray County, Kansas",2010,2153,2340,187,13,22,855,5151,66,6006,5050,20069
1388,20071,"Greeley County, Kansas",2010,525,629,104,4,3,171,1076,13,1247,1056,20071
1389,20073,"Greenwood County, Kansas",2010,2988,4068,1080,18,23,220,6469,171,6689,6257,20073
1390,20075,"Hamilton County, Kansas",2010,1060,1236,176,7,8,827,1863,47,2690,1801,20075
1391,20077,"Harper County, Kansas",2010,2545,3116,571,5,21,298,5736,128,6034,5582,20077
1392,20079,"Harvey County, Kansas",2010,13411,14527,1116,253,530,3747,30937,822,34684,29332,20079
1393,20087,"Jefferson County, Kansas",2010,7366,8160,794,38,100,339,18787,479,19126,18170,20087
1394,20081,"Haskell County, Kansas",2010,1510,1666,156,10,4,1149,3107,57,4256,3036,20081
1395,20083,"Hodgeman County, Kansas",2010,803,973,170,8,20,118,1798,22,1916,1748,20083
1396,20089,"Jewell County, Kansas",2010,1450,2032,582,6,4,63,3014,45,3077,2959,20089
1397,20091,"Johnson County, Kansas",2010,212882,226571,13689,22598,23028,38949,505230,13560,544179,446044,20091
1398,20107,"Linn County, Kansas",2010,4020,5446,1426,30,41,186,9470,215,9656,9184,20107
1399,20093,"Kearny County, Kansas",2010,1400,1556,156,10,16,1135,2842,90,3977,2726,20093
1400,20095,"Kingman County, Kansas",2010,3227,3818,591,36,13,199,7659,124,7858,7486,20095
1401,20097,"Kiowa County, Kansas",2010,1014,1220,206,16,12,99,2454,48,2553,2378,20097
1402,20099,"Labette County, Kansas",2010,8822,10092,1270,76,987,875,20732,1202,21607,18467,20099
1403,20101,"Lane County, Kansas",2010,799,990,191,4,8,74,1676,36,1750,1628,20101
1404,20103,"Leavenworth County, Kansas",2010,26447,28697,2250,950,7007,4308,71919,2736,76227,61226,20103
1405,20105,"Lincoln County, Kansas",2010,1423,1864,441,6,8,72,3169,39,3241,3116,20105
1406,20119,"Meade County, Kansas",2010,1713,1998,285,18,31,676,3899,89,4575,3761,20119
1407,20109,"Logan County, Kansas",2010,1219,1441,222,10,16,80,2676,41,2756,2609,20109
1408,20111,"Lyon County, Kansas",2010,13303,15237,1934,759,731,6755,26935,741,33690,24704,20111
1409,20113,"McPherson County, Kansas",2010,11748,12721,973,144,279,1025,28155,556,29180,27176,20113
1410,20115,"Marion County, Kansas",2010,5005,5946,941,25,95,296,12364,252,12660,11992,20115
1411,20117,"Marshall County, Kansas",2010,4300,4866,566,22,26,193,9924,149,10117,9727,20117
1412,39055,"Geauga County, Ohio",2010,34264,36574,2310,552,1187,1001,92388,883,93389,89766,39055
1413,39083,"Knox County, Ohio",2010,22607,25118,2511,348,485,737,60184,853,60921,58498,39083
1414,20127,"Morris County, Kansas",2010,2554,3206,652,14,25,212,5711,100,5923,5572,20127
1415,20121,"Miami County, Kansas",2010,12161,13190,1029,114,411,828,31959,726,32787,30708,20121
1416,39057,"Greene County, Ohio",2010,62770,68241,5471,4663,11506,3439,158134,4525,161573,137440,39057
1417,39059,"Guernsey County, Ohio",2010,16210,19193,2983,109,580,349,39738,773,40087,38276,39059
1418,39061,"Hamilton County, Ohio",2010,333945,377364,43419,16080,204748,20607,781767,18666,802374,542273,39061
1419,39063,"Hancock County, Ohio",2010,30197,33174,2977,1258,1084,3363,71419,1189,74782,67888,39063
1420,39065,"Hardin County, Ohio",2010,11762,13100,1338,180,255,407,31651,442,32058,30774,39065
1421,39067,"Harrison County, Ohio",2010,6526,8170,1644,22,324,79,15785,270,15864,15169,39067
1422,39069,"Henry County, Ohio",2010,10934,11963,1029,103,103,1860,26355,288,28215,25861,39069
1423,39071,"Highland County, Ohio",2010,16693,19380,2687,99,597,319,43270,722,43589,41852,39071
1424,39073,"Hocking County, Ohio",2010,11369,13417,2048,47,215,198,29182,411,29380,28509,39073
1425,39075,"Holmes County, Ohio",2010,12554,13666,1112,49,123,329,42037,258,42366,41607,39075
1426,39077,"Huron County, Ohio",2010,22820,25196,2376,170,560,3333,56293,914,59626,54649,39077
1427,39079,"Jackson County, Ohio",2010,13010,14587,1577,109,191,265,32960,564,33225,32096,39079
1428,40061,"Haskell County, Oklahoma",2010,5044,6028,984,68,51,426,12343,2862,12769,9362,40061
1429,40063,"Hughes County, Oklahoma",2010,5050,6183,1133,27,739,530,13473,3356,14003,9351,40063
1430,40065,"Jackson County, Oklahoma",2010,10247,12077,1830,303,1918,5538,20908,1284,26446,17403,40065
1431,40067,"Jefferson County, Oklahoma",2010,2634,3378,744,22,41,552,5920,641,6472,5216,40067
1432,40069,"Johnston County, Oklahoma",2010,4312,5126,814,27,209,423,10534,2444,10957,7854,40069
1433,40071,"Kay County, Oklahoma",2010,18577,21708,3131,233,910,2992,43570,6314,46562,36113,40071
1434,40073,"Kingfisher County, Oklahoma",2010,5731,6409,678,38,157,2022,13012,787,15034,12030,40073
1435,40087,"McClain County, Oklahoma",2010,12891,13996,1105,127,229,2400,32106,3808,34506,27942,40087
1436,40083,"Logan County, Oklahoma",2010,15290,17195,1905,189,3752,2170,39678,2873,41848,32864,40083
1437,40085,"Love County, Oklahoma",2010,3713,4539,826,45,163,1113,8310,916,9423,7186,40085
1438,40077,"Latimer County, Oklahoma",2010,4208,4979,771,31,80,293,10861,3032,11154,7718,40077
1439,40079,"Le Flore County, Oklahoma",2010,18878,21448,2570,258,1016,3454,46930,8814,50384,36842,40079
1440,40081,"Lincoln County, Oklahoma",2010,13243,15208,1965,64,608,838,33435,3778,34273,28985,40081
1441,48439,"Tarrant County, Texas",2010,657134,714803,57669,83378,262522,482977,1326057,43022,1809034,937135,48439
1442,48441,"Taylor County, Texas",2010,50725,55750,5025,1978,9122,29074,102432,3211,131506,88121,48441
1443,48451,"Tom Green County, Texas",2010,42331,46571,4240,1046,3997,39315,70909,2067,110224,63799,48451
1444,40089,"McCurtain County, Oklahoma",2010,12958,15533,2575,112,2872,1552,31599,6786,33151,21829,40089
1445,40091,"McIntosh County, Oklahoma",2010,8460,13350,4890,68,642,390,19862,5099,20252,14053,40091
1446,40093,"Major County, Oklahoma",2010,3109,3671,562,25,32,565,6962,276,7527,6629,40093
1447,40095,"Marshall County, Oklahoma",2010,6338,10006,3668,29,227,2212,13628,2322,15840,11050,40095
1448,40097,"Mayes County, Oklahoma",2010,16008,19239,3231,144,161,1097,40162,12267,41259,27590,40097
1449,40099,"Murray County, Oklahoma",2010,5350,6746,1396,47,176,662,12826,2362,13488,10241,40099
1450,40101,"Muskogee County, Oklahoma",2010,27054,30908,3854,381,7960,3688,67302,17599,70990,41362,40101
1451,48443,"Terrell County, Texas",2010,430,700,270,4,6,467,517,12,984,495,48443
1452,48445,"Terry County, Texas",2010,4200,4828,628,23,565,6211,6440,105,12651,5747,48445
1453,48447,"Throckmorton County, Texas",2010,721,1079,358,7,9,152,1489,20,1641,1453,48447
1454,48449,"Titus County, Texas",2010,10813,12054,1241,229,3000,12799,19535,402,32334,15904,48449
1455,48463,"Uvalde County, Texas",2010,9025,10811,1786,116,110,18299,8106,214,26405,7666,48463
1456,48453,"Travis County, Texas",2010,404467,441240,36773,58404,82805,342766,681500,22647,1024266,517644,48453
1457,48455,"Trinity County, Texas",2010,6142,8713,2571,36,1377,1117,13468,236,14585,11819,48455
1458,48457,"Tyler County, Texas",2010,8007,10579,2572,49,2376,1487,20279,347,21766,17507,48457
1459,48459,"Upshur County, Texas",2010,14925,16613,1688,146,3388,2613,36696,905,39309,32257,48459
1460,48461,"Upton County, Texas",2010,1256,1548,292,0,49,1644,1711,51,3355,1611,48461
1461,48479,"Webb County, Texas",2010,67106,73496,6390,1320,487,239653,10651,499,250304,8345,48479
1462,48465,"Val Verde County, Texas",2010,15654,18651,2997,207,563,39199,9680,362,48879,8548,48465
1463,48467,"Van Zandt County, Texas",2010,20047,22817,2770,168,1403,4847,47732,1074,52579,45087,48467
1464,48469,"Victoria County, Texas",2010,32187,35417,3230,860,5190,38113,48680,1066,86793,41564,48469
1465,48471,"Walker County, Texas",2010,20969,24058,3089,617,15098,11389,56472,1086,67861,39671,48471
1466,48473,"Waller County, Texas",2010,14040,15839,1799,213,10537,12536,30669,659,43205,19260,48473
1467,48475,"Ward County, Texas",2010,3995,4694,699,31,474,5074,5584,157,10658,4922,48475
1468,48477,"Washington County, Texas",2010,13037,15514,2477,432,5861,4641,29077,390,33718,22394,48477
1469,48491,"Williamson County, Texas",2010,152606,162773,10167,20084,24744,98034,324645,10336,422679,269481,48491
1470,48487,"Wilbarger County, Texas",2010,5289,6318,1029,97,1049,3508,10027,296,13535,8585,48487
1471,48489,"Willacy County, Texas",2010,5764,7040,1276,134,389,19297,2837,79,22134,2235,48489
1472,48481,"Wharton County, Texas",2010,15132,17127,1995,154,5668,15445,25835,332,41280,19681,48481
1473,48483,"Wheeler County, Texas",2010,2181,2730,549,23,112,1344,4066,84,5410,3847,48483
1474,48485,"Wichita County, Texas",2010,49016,55566,6550,2586,13322,21859,109641,3732,131500,90001,48485
1475,48503,"Young County, Texas",2010,7343,8622,1279,55,220,3045,15505,271,18550,14959,48503
1476,48493,"Wilson County, Texas",2010,15009,16766,1757,143,644,16412,26506,533,42918,25186,48493
1477,48495,"Winkler County, Texas",2010,2578,3027,449,16,129,3824,3286,117,7110,3024,48495
1478,48497,"Wise County, Texas",2010,21015,23781,2766,234,573,10112,49015,1086,59127,47122,48497
1479,48499,"Wood County, Texas",2010,17118,20861,3743,156,1951,3551,38413,678,41964,35628,48499
1480,48501,"Yoakum County, Texas",2010,2643,2978,335,26,55,4622,3257,86,7879,3090,48501
1481,48505,"Zapata County, Texas",2010,4297,6203,1906,28,11,13084,934,34,14018,861,48505
1482,48507,"Zavala County, Texas",2010,3573,4283,710,3,35,10961,716,31,11677,647,48507
1483,49001,"Beaver County, Utah",2010,2265,2908,643,70,14,716,5913,129,6629,5700,49001
1484,49003,"Box Elder County, Utah",2010,16058,17326,1268,430,139,4152,45823,1145,49975,44109,49003
1485,49007,"Carbon County, Utah",2010,7978,9551,1573,122,84,2659,18744,531,21403,18007,49007
1486,49009,"Daggett County, Utah",2010,426,1141,715,4,4,33,1026,18,1059,1000,49009
1487,49023,"Juab County, Utah",2010,3093,3502,409,22,21,379,9867,193,10246,9631,49023
1488,49011,"Davis County, Utah",2010,93545,97570,4025,5245,3435,25753,280726,8997,306479,263049,49011
1489,49005,"Cache County, Utah",2010,34722,37024,2302,2096,596,11216,101440,2465,112656,96283,49005
1490,49013,"Duchesne County, Utah",2010,6003,9493,3490,45,31,1117,17490,1203,18607,16211,49013
1491,49015,"Emery County, Utah",2010,3732,4489,757,38,25,654,10322,151,10976,10108,49015
1492,49017,"Garfield County, Utah",2010,1930,3726,1796,61,13,234,4938,124,5172,4740,49017
1493,49019,"Grand County, Utah",2010,3889,4816,927,77,27,881,8344,481,9225,7759,49019
1494,49021,"Iron County, Utah",2010,15022,19667,4645,333,204,3563,42600,1837,46163,40226,49021
1495,49039,"Sanpete County, Utah",2010,7952,10379,2427,145,209,2619,25203,740,27822,24109,49039
1496,49025,"Kane County, Utah",2010,2900,5815,2915,31,15,263,6862,177,7125,6639,49025
1497,49027,"Millard County, Utah",2010,4201,4939,738,76,10,1603,10900,225,12503,10589,49027
1498,49033,"Rich County, Utah",2010,805,2834,2029,2,0,96,2168,35,2264,2131,49033
1499,49029,"Morgan County, Utah",2010,2820,3006,186,33,15,226,9243,97,9469,9098,49029
1500,49031,"Piute County, Utah",2010,576,898,322,6,2,109,1447,20,1556,1419,49031
1501,49035,"Salt Lake County, Utah",2010,342622,364031,21409,33454,14622,176015,853640,43679,1029655,761885,49035
1502,49037,"San Juan County, Utah",2010,4505,5734,1229,35,21,649,14097,7567,14746,6474,49037
1503,49041,"Sevier County, Utah",2010,7094,8449,1355,58,34,932,19870,453,20802,19325,49041
1504,21139,"Livingston County, Kentucky",2010,3985,4824,839,18,16,123,9396,119,9519,9243,21139
1505,21163,"Meade County, Kentucky",2010,10471,11762,1291,154,899,859,27743,785,28602,25905,21163
1506,51059,"Fairfax County, Virginia",2010,391627,407998,16371,188737,96078,168482,913244,37807,1081726,590622,51059
1507,51061,"Fauquier County, Virginia",2010,23658,25600,1942,826,5232,4178,61025,1557,65203,53410,51061
1508,51063,"Floyd County, Virginia",2010,6415,7790,1375,35,270,412,14867,177,15279,14385,51063
1509,51065,"Fluvanna County, Virginia",2010,9449,10383,934,136,3913,760,24931,564,25691,20318,51065
1510,51067,"Franklin County, Virginia",2010,22780,29315,6535,251,4541,1424,54735,871,56159,49072,51067
1511,51069,"Frederick County, Virginia",2010,28864,31346,2482,959,3067,5168,73137,1521,78305,67590,51069
1512,21141,"Logan County, Kentucky",2010,10666,12339,1673,64,1734,651,26184,452,26835,23934,21141
1513,21143,"Lyon County, Kentucky",2010,3287,4791,1504,24,437,77,8237,104,8314,7672,21143
1514,21145,"McCracken County, Kentucky",2010,28227,31079,2852,521,7179,1383,64182,1457,65565,55025,21145
1515,21153,"Magoffin County, Kentucky",2010,5309,5950,641,8,18,95,13238,106,13333,13106,21153
1516,21155,"Marion County, Kentucky",2010,7358,8182,824,115,1593,482,19338,345,19820,17285,21155
1517,21157,"Marshall County, Kentucky",2010,13073,15748,2675,83,48,350,31098,298,31448,30669,21157
1518,21147,"McCreary County, Kentucky",2010,6477,7507,1030,25,977,392,17914,355,18306,16557,21147
1519,21149,"McLean County, Kentucky",2010,3833,4264,431,10,53,106,9425,84,9531,9278,21149
1520,21151,"Madison County, Kentucky",2010,31973,35043,3070,753,3565,1813,81103,1818,82916,74967,21151
1521,21159,"Martin County, Kentucky",2010,4516,5164,648,22,882,388,12541,104,12929,11533,21159
1522,21161,"Mason County, Kentucky",2010,7031,8105,1074,99,1117,248,17242,340,17490,15686,21161
1523,21179,"Nelson County, Kentucky",2010,16826,18075,1249,216,2168,888,42549,667,43437,39498,21179
1524,21165,"Menifee County, Kentucky",2010,2440,3744,1304,7,112,51,6255,80,6306,6056,21165
1525,21167,"Mercer County, Kentucky",2010,8682,9941,1259,76,751,490,20841,400,21331,19614,21167
1526,21169,"Metcalfe County, Kentucky",2010,4055,4681,626,12,153,115,9984,89,10099,9730,21169
1527,21171,"Monroe County, Kentucky",2010,4509,5204,695,8,231,289,10674,121,10963,10314,21171
1528,21173,"Montgomery County, Kentucky",2010,10435,11699,1264,83,712,660,25839,329,26499,24715,21173
1529,21175,"Morgan County, Kentucky",2010,4860,5830,970,42,598,108,13815,127,13923,13048,21175
1530,21177,"Muhlenberg County, Kentucky",2010,12052,13699,1647,43,1417,367,31132,371,31499,29301,21177
1531,21189,"Owsley County, Kentucky",2010,1914,2328,414,2,13,39,4716,42,4755,4659,21189
1532,21181,"Nicholas County, Kentucky",2010,2809,3261,452,16,41,98,7037,58,7135,6922,21181
1533,21183,"Ohio County, Kentucky",2010,9176,10219,1043,47,187,844,22998,233,23842,22531,21183
1534,21185,"Oldham County, Kentucky",2010,19431,20688,1257,785,2571,2133,58183,1031,60316,53796,21185
1535,21191,"Pendleton County, Kentucky",2010,5494,6339,845,20,47,143,14734,146,14877,14521,21191
1536,21187,"Owen County, Kentucky",2010,4296,5634,1338,17,90,246,10595,121,10841,10367,21187
1537,21207,"Russell County, Kentucky",2010,7401,9993,2592,40,79,585,16980,185,17565,16676,21207
1538,21193,"Perry County, Kentucky",2010,11319,12791,1472,148,432,185,28527,325,28712,27622,21193
1539,21195,"Pike County, Kentucky",2010,26728,30304,3576,291,348,446,64578,508,65024,63431,21195
1540,21197,"Powell County, Kentucky",2010,4834,5598,764,17,78,132,12481,122,12613,12264,21197
1541,21199,"Pulaski County, Kentucky",2010,25722,31443,5721,289,705,1318,61745,808,63063,59943,21199
1542,21201,"Robertson County, Kentucky",2010,902,1095,193,2,3,22,2260,23,2282,2232,21201
1543,21203,"Rockcastle County, Kentucky",2010,6750,7703,953,13,19,103,16953,180,17056,16741,21203
1544,21205,"Rowan County, Kentucky",2010,8864,10102,1238,178,341,294,23039,254,23333,22266,21205
1545,21219,"Todd County, Kentucky",2010,4647,5286,639,10,989,494,11966,170,12460,10797,21219
1546,21209,"Scott County, Kentucky",2010,17408,19303,1895,412,2433,1994,45179,893,47173,41441,21209
1547,21211,"Shelby County, Kentucky",2010,15321,16606,1285,251,3038,3812,38262,893,42074,34080,21211
1548,21213,"Simpson County, Kentucky",2010,6753,7435,682,111,1615,325,17002,335,17327,14941,21213
1549,21215,"Spencer County, Kentucky",2010,6165,6704,539,70,256,239,16822,218,17061,16278,21215
1550,21217,"Taylor County, Kentucky",2010,9832,10864,1032,128,1210,433,24079,412,24512,22329,21217
1551,21239,"Woodford County, Kentucky",2010,9806,10711,905,124,1216,1680,23259,363,24939,21556,21239
1552,21221,"Trigg County, Kentucky",2010,5883,7810,1927,44,1171,175,14164,274,14339,12675,21221
1553,21223,"Trimble County, Kentucky",2010,3420,3930,510,37,21,223,8586,120,8809,8408,21223
1554,21225,"Union County, Kentucky",2010,5549,6141,592,50,1803,243,14764,257,15007,12654,21225
1555,21227,"Warren County, Kentucky",2010,43674,47223,3549,3151,10204,5174,108618,2456,113792,92807,21227
1556,21229,"Washington County, Kentucky",2010,4507,5044,537,31,736,393,11324,156,11717,10401,21229
1557,21231,"Wayne County, Kentucky",2010,8646,10942,2296,67,308,601,20212,246,20813,19591,21231
1558,21233,"Webster County, Kentucky",2010,5272,5936,664,35,553,580,13041,220,13621,12233,21233
1559,21235,"Whitley County, Kentucky",2010,13575,15166,1591,123,205,310,35327,478,35637,34521,21235
1560,22001,"Acadia Parish, Louisiana",2010,22841,25387,2546,137,11133,1060,60713,888,61773,48555,22001
1561,21237,"Wolfe County, Kentucky",2010,3065,3660,595,3,10,41,7314,60,7355,7241,21237
1562,41061,"Union County, Oregon",2010,10501,11489,988,204,126,1002,24746,1009,25748,23407,41061
1563,41063,"Wallowa County, Oregon",2010,3133,4108,975,24,26,156,6852,177,7008,6625,41063
1564,42007,"Beaver County, Pennsylvania",2010,71383,78211,6828,717,10586,1998,168541,3042,170539,154196,42007
1565,22007,"Assumption Parish, Louisiana",2010,8736,10351,1615,56,7111,498,22923,314,23421,15442,22007
1566,22003,"Allen Parish, Louisiana",2010,8516,9733,1217,176,5957,342,25422,1013,25764,18276,22003
1567,22005,"Ascension Parish, Louisiana",2010,37790,40784,2994,995,23727,5024,102191,1520,107215,75949,22005
1568,22011,"Beauregard Parish, Louisiana",2010,13159,15040,1881,217,4597,1003,34651,1107,35654,28730,22011
1569,41065,"Wasco County, Oregon",2010,10031,11487,1456,191,85,3743,21470,1638,25213,19556,41065
1570,41067,"Washington County, Oregon",2010,200934,212450,11516,45354,8861,83270,446440,22772,529710,369453,41067
1571,41069,"Wheeler County, Oregon",2010,651,895,244,8,0,62,1379,64,1441,1307,41069
1572,41071,"Yamhill County, Oregon",2010,34726,37110,2384,1418,784,14592,84601,3951,99193,78448,41071
1573,42001,"Adams County, Pennsylvania",2010,38013,40820,2807,737,1450,6115,95292,1275,101407,91830,42001
1574,21023,"Bracken County, Kentucky",2010,3317,3840,523,5,29,96,8392,107,8488,8251,21023
1575,21037,"Campbell County, Kentucky",2010,36069,39523,3454,720,2253,1495,88841,1462,90336,84406,21037
1576,21029,"Bullitt County, Kentucky",2010,27673,29318,1645,369,472,1038,73281,1072,74319,71368,21029
1577,21031,"Butler County, Kentucky",2010,5057,5877,820,19,47,322,12368,120,12690,12182,21031
1578,21033,"Caldwell County, Kentucky",2010,5393,6292,899,33,664,129,12855,206,12984,11952,21033
1579,21039,"Carlisle County, Kentucky",2010,2116,2441,325,14,35,83,5021,66,5104,4906,21039
1580,21035,"Calloway County, Kentucky",2010,15530,18065,2535,650,1375,890,36301,604,37191,33672,21035
1581,21055,"Crittenden County, Kentucky",2010,3781,4569,788,17,76,48,9267,109,9315,9065,21055
1582,21041,"Carroll County, Kentucky",2010,4061,4696,635,58,160,789,10022,229,10811,9575,21041
1583,21043,"Carter County, Kentucky",2010,10760,12311,1551,46,145,321,27399,278,27720,26930,21043
1584,21045,"Casey County, Kentucky",2010,6351,7487,1136,27,80,378,15577,144,15955,15326,21045
1585,21047,"Christian County, Kentucky",2010,26144,29459,3315,728,15445,4541,69414,2532,73955,50709,21047
1586,21049,"Clark County, Kentucky",2010,14267,15706,1439,125,1693,891,34722,497,35613,32407,21049
1587,21051,"Clay County, Kentucky",2010,7732,8875,1143,26,900,402,21328,213,21730,20189,21051
1588,21053,"Clinton County, Kentucky",2010,4358,5311,953,13,39,231,10041,124,10272,9865,21053
1589,21067,"Fayette County, Kentucky",2010,123043,135160,12117,9506,42336,20474,275329,7415,295803,216072,21067
1590,21057,"Cumberland County, Kentucky",2010,2883,3690,807,8,177,63,6793,100,6856,6508,21057
1591,21059,"Daviess County, Kentucky",2010,38619,41452,2833,670,4583,2525,94131,1873,96656,87005,21059
1592,21061,"Edmonson County, Kentucky",2010,4857,6467,1610,25,166,100,12061,137,12161,11733,21061
1593,21063,"Elliott County, Kentucky",2010,2773,3371,598,4,262,62,7790,51,7852,7473,21063
1594,21065,"Estill County, Kentucky",2010,5984,6865,881,14,28,101,14571,122,14672,14407,21065
1595,21083,"Graves County, Kentucky",2010,14978,16777,1799,124,1597,2099,35022,693,37121,32608,21083
1596,21069,"Fleming County, Kentucky",2010,5729,6623,894,32,181,149,14199,128,14348,13858,21069
1597,21071,"Floyd County, Kentucky",2010,16060,18175,2115,75,292,219,39232,241,39451,38624,21071
1598,21073,"Franklin County, Kentucky",2010,20662,23164,2502,692,5078,1374,47911,1115,49285,41026,21073
1599,21077,"Gallatin County, Kentucky",2010,3160,3786,626,15,109,372,8217,141,8589,7952,21077
1600,21075,"Fulton County, Kentucky",2010,2864,3372,508,45,1607,53,6760,135,6813,4973,21075
1601,21079,"Garrard County, Kentucky",2010,6668,7463,795,37,339,403,16509,168,16912,15965,21079
1602,21081,"Grant County, Kentucky",2010,8614,9942,1328,78,173,577,24085,289,24662,23545,21081
1603,21095,"Harlan County, Kentucky",2010,11789,13513,1724,100,639,210,29068,299,29278,28030,21095
1604,21085,"Grayson County, Kentucky",2010,10082,13561,3479,61,260,258,25488,282,25746,24885,21085
1605,21087,"Green County, Kentucky",2010,4601,5324,723,17,222,159,11099,169,11258,10691,21087
1606,21089,"Greenup County, Kentucky",2010,14671,16330,1659,184,255,284,36626,435,36910,35752,21089
1607,21091,"Hancock County, Kentucky",2010,3285,3734,449,19,70,94,8471,100,8565,8282,21091
1608,21093,"Hardin County, Kentucky",2010,39853,43261,3408,2067,11878,5317,100226,4142,105543,82139,21093
1609,21117,"Kenton County, Kentucky",2010,62768,68975,6207,1398,7267,4225,155495,3400,159720,143430,21117
1610,21097,"Harrison County, Kentucky",2010,7343,8208,865,37,379,337,18509,247,18846,17846,21097
1611,21099,"Hart County, Kentucky",2010,7097,8559,1462,36,883,261,17938,248,18199,16771,21099
1612,21101,"Henderson County, Kentucky",2010,18705,20320,1615,193,3568,858,45392,858,46250,40773,21101
1613,21103,"Henry County, Kentucky",2010,5963,6640,677,29,410,447,14969,258,15416,14272,21103
1614,21105,"Hickman County, Kentucky",2010,2028,2342,314,11,451,57,4845,85,4902,4298,21105
1615,21107,"Hopkins County, Kentucky",2010,18980,21180,2200,257,3069,734,46186,920,46920,41940,21107
1616,21109,"Jackson County, Kentucky",2010,5486,6523,1037,11,13,84,13410,88,13494,13298,21109
1617,21111,"Jefferson County, Kentucky",2010,309175,337616,28441,16171,152451,32542,708554,17371,741096,522561,21111
1618,21115,"Johnson County, Kentucky",2010,9362,10624,1262,91,56,109,23247,200,23356,22900,21115
1619,21113,"Jessamine County, Kentucky",2010,17642,19331,1689,475,1487,1353,47233,935,48586,44336,21113
1620,21129,"Lee County, Kentucky",2010,2910,3436,526,11,185,58,7829,69,7887,7564,21129
1621,21119,"Knott County, Kentucky",2010,6414,7461,1047,14,116,99,16247,102,16346,16015,21119
1622,21121,"Knox County, Kentucky",2010,12722,14485,1763,67,344,270,31613,397,31883,30805,21121
1623,21123,"Larue County, Kentucky",2010,5615,6172,557,25,441,401,13792,230,14193,13096,21123
1624,21125,"Laurel County, Kentucky",2010,23014,25446,2432,286,405,717,58132,709,58849,56732,21125
1625,21127,"Lawrence County, Kentucky",2010,6239,7286,1047,26,32,77,15783,143,15860,15582,21127
1626,40103,"Noble County, Oklahoma",2010,4614,5341,727,45,202,300,11261,1388,11561,9626,40103
1627,40121,"Pittsburg County, Oklahoma",2010,18012,22634,4622,185,1497,1786,44051,9410,45837,32959,40121
1628,21131,"Leslie County, Kentucky",2010,4555,5278,723,15,22,40,11270,81,11310,11152,21131
1629,21133,"Letcher County, Kentucky",2010,10014,11601,1587,39,85,124,24395,151,24519,24120,21133
1630,21135,"Lewis County, Kentucky",2010,5497,6481,984,8,35,78,13792,99,13870,13650,21135
1631,21137,"Lincoln County, Kentucky",2010,9777,10819,1042,39,560,372,24370,367,24742,23404,21137
1632,40105,"Nowata County, Oklahoma",2010,4224,4828,604,7,202,240,10296,2939,10536,7148,40105
1633,40107,"Okfuskee County, Oklahoma",2010,4354,5282,928,18,1001,356,11835,3117,12191,7699,40107
1634,40109,"Oklahoma County, Oklahoma",2010,287598,319828,32230,21151,108954,108543,610090,54194,718633,425791,40109
1635,40111,"Okmulgee County, Oklahoma",2010,15362,17891,2529,126,3459,1293,38776,9388,40069,25803,40111
1636,40113,"Osage County, Oklahoma",2010,18205,21143,2938,118,5355,1366,46106,9924,47472,30709,40113
1637,40115,"Ottawa County, Oklahoma",2010,12345,14060,1715,158,234,1499,30349,8503,31848,21454,40115
1638,40119,"Payne County, Oklahoma",2010,30177,33991,3814,2679,2757,2990,74360,7269,77350,61655,40119
1639,40117,"Pawnee County, Oklahoma",2010,6486,7745,1259,42,116,336,16241,2867,16577,13216,40117
1640,40137,"Stephens County, Oklahoma",2010,18127,20658,2531,210,841,2790,42258,4034,45048,37173,40137
1641,40123,"Pontotoc County, Oklahoma",2010,14654,16595,1941,244,879,1523,35969,8873,37492,25973,40123
1642,40125,"Pottawatomie County, Oklahoma",2010,25911,29139,3228,373,1969,2878,66564,12580,69442,51642,40125
1643,40127,"Pushmataha County, Oklahoma",2010,4809,6110,1301,25,74,280,11292,2643,11572,8550,40127
1644,40129,"Roger Mills County, Oklahoma",2010,1470,1905,435,11,13,165,3482,274,3647,3184,40129
1645,40131,"Rogers County, Oklahoma",2010,31884,35160,3276,914,819,3229,83676,17913,86905,64030,40131
1646,40133,"Seminole County, Oklahoma",2010,9750,11642,1892,65,1152,903,24579,6229,25482,17133,40133
1647,40135,"Sequoyah County, Oklahoma",2010,16208,18656,2448,199,718,1438,40953,12402,42391,27634,40135
1648,40149,"Washita County, Oklahoma",2010,4599,5479,880,24,71,944,10685,601,11629,9989,40149
1649,40139,"Texas County, Oklahoma",2010,7212,8208,996,318,294,8659,11981,480,20640,10889,40139
1650,40141,"Tillman County, Oklahoma",2010,3216,4077,861,21,567,1783,6209,456,7992,5165,40141
1651,40143,"Tulsa County, Oklahoma",2010,241737,268426,26689,13892,63737,66582,536821,65791,603403,393401,40143
1652,40145,"Wagoner County, Oklahoma",2010,26878,29694,2816,995,2669,3488,69597,12285,73085,53648,40145
1653,40147,"Washington County, Oklahoma",2010,21036,23451,2415,552,1194,2556,48420,7983,50976,38691,40147
1654,41017,"Deschutes County, Oregon",2010,64090,80139,16049,1412,524,11718,146015,4609,157733,139470,41017
1655,40151,"Woods County, Oklahoma",2010,3533,4478,945,77,286,424,8454,407,8878,7684,40151
1656,40153,"Woodward County, Oklahoma",2010,7654,8838,1184,115,308,2128,17953,898,20081,16632,40153
1657,41001,"Baker County, Oregon",2010,7040,8826,1786,78,52,528,15606,532,16134,14944,41001
1658,41003,"Benton County, Oregon",2010,34317,36245,1928,4404,715,5467,80112,3441,85579,71552,41003
1659,41005,"Clackamas County, Oregon",2010,145790,156945,11155,13575,2761,29138,346854,12870,375992,317648,41005
1660,41007,"Clatsop County, Oregon",2010,15742,21546,5804,445,163,2838,34201,1298,37039,32295,41007
1661,41009,"Columbia County, Oregon",2010,19183,20698,1515,446,195,1987,47364,2160,49351,44563,41009
1662,41011,"Coos County, Oregon",2010,27133,30593,3460,644,234,3391,59652,3954,63043,54820,41011
1663,41013,"Crook County, Oregon",2010,8558,10202,1644,96,30,1463,19515,631,20978,18758,41013
1664,41015,"Curry County, Oregon",2010,10417,12613,2196,157,62,1201,21163,1107,22364,19837,41015
1665,41019,"Douglas County, Oregon",2010,44581,48915,4334,1008,279,5055,102612,4982,107667,96343,41019
1666,41021,"Gilliam County, Oregon",2010,864,1156,292,3,3,88,1783,52,1871,1725,41021
1667,41023,"Grant County, Oregon",2010,3352,4344,992,24,11,207,7238,252,7445,6951,41023
1668,41039,"Lane County, Oregon",2010,145966,156112,10146,8169,3102,26167,325548,16469,351715,297808,41039
1669,41025,"Harney County, Oregon",2010,3205,3835,630,34,16,294,7128,430,7422,6648,41025
1670,41027,"Hood River County, Oregon",2010,8173,9271,1098,305,63,6589,15757,675,22346,14714,41027
1671,41029,"Jackson County, Oregon",2010,83076,90937,7861,2304,1227,21745,181461,7907,203206,170023,41029
1672,41035,"Klamath County, Oregon",2010,27280,32774,5494,615,394,6915,59465,4634,66380,53822,41035
1673,41037,"Lake County, Oregon",2010,3378,4439,1061,44,37,545,7350,394,7895,6875,41037
1674,41031,"Jefferson County, Oregon",2010,7790,9815,2025,83,117,4195,17525,3896,21720,13429,41031
1675,41033,"Josephine County, Oregon",2010,34646,38001,3355,667,295,5251,77462,3211,82713,73289,41033
1676,41051,"Multnomah County, Oregon",2010,304540,324832,20292,47508,39919,80138,655196,37466,735334,530303,41051
1677,41041,"Lincoln County, Oregon",2010,20550,30610,10060,482,159,3655,42379,2875,46034,38863,41041
1678,41043,"Linn County, Oregon",2010,45204,48821,3617,1078,456,9127,107545,4432,116672,101579,41043
1679,41045,"Malheur County, Oregon",2010,10411,11692,1281,511,331,9867,21446,698,31313,19906,41045
1680,41047,"Marion County, Oregon",2010,112957,120948,7991,5790,2906,76594,238741,13287,315335,216758,41047
1681,41049,"Morrow County, Oregon",2010,3916,4442,526,100,36,3497,7676,322,11173,7218,41049
1682,49043,"Summit County, Utah",2010,12990,26545,13555,440,110,4190,32134,572,36324,31012,49043
1683,49045,"Tooele County, Utah",2010,17971,19455,1484,357,372,6661,51557,1654,58218,49174,49045
1684,49057,"Weber County, Utah",2010,78748,86187,7439,2784,2748,38711,192525,6355,231236,180638,49057
1685,41053,"Polk County, Oregon",2010,28288,30302,2014,1403,394,9088,66315,3816,75403,60702,41053
1686,41055,"Sherman County, Oregon",2010,777,918,141,3,2,98,1667,46,1765,1616,41055
1687,41057,"Tillamook County, Oregon",2010,10834,18359,7525,223,62,2284,22966,779,25250,21902,41057
1688,41059,"Umatilla County, Oregon",2010,26904,29693,2789,626,557,18107,57782,3908,75889,52691,41059
1689,49047,"Uintah County, Utah",2010,10563,11972,1409,159,96,2330,30258,3004,32588,26999,49047
1690,49049,"Utah County, Utah",2010,140602,148350,7748,6912,2421,55793,460771,16730,516564,434708,49049
1691,49051,"Wasatch County, Utah",2010,7287,10577,3290,168,49,3184,20346,311,23530,19818,49051
1692,49053,"Washington County, Utah",2010,46334,57734,11400,954,632,13486,124629,4761,138115,118282,49053
1693,49055,"Wayne County, Utah",2010,1059,1591,532,19,2,116,2662,45,2778,2596,49055
1694,50015,"Lamoille County, Vermont",2010,10014,12969,2955,124,142,322,24153,460,24475,23427,50015
1695,50001,"Addison County, Vermont",2010,14084,16760,2676,524,269,685,36136,683,36821,34660,50001
1696,50003,"Bennington County, Vermont",2010,15470,20922,5452,264,291,525,36600,528,37125,35517,50003
1697,50005,"Caledonia County, Vermont",2010,12553,15942,3389,251,150,331,30896,586,31227,29909,50005
1698,50007,"Chittenden County, Vermont",2010,61827,65722,3895,4368,3172,2856,153689,3301,156545,142848,50007
1699,50009,"Essex County, Vermont",2010,2818,5019,2201,22,16,59,6247,115,6306,6094,50009
1700,50011,"Franklin County, Vermont",2010,18513,21588,3075,223,200,571,47175,1462,47746,45290,50011
1701,50013,"Grand Isle County, Vermont",2010,2902,5048,2146,21,23,80,6890,246,6970,6600,50013
1702,50025,"Windham County, Vermont",2010,19290,29735,10445,460,384,820,43693,943,44513,41906,50025
1703,50017,"Orange County, Vermont",2010,11887,14845,2958,137,107,282,28654,512,28936,27898,50017
1704,50019,"Orleans County, Vermont",2010,11320,16162,4842,90,152,305,26926,545,27231,26139,50019
1705,50021,"Rutland County, Vermont",2010,25984,33768,7784,370,315,681,60961,907,61642,59369,50021
1706,50027,"Windsor County, Vermont",2010,24753,34118,9365,526,311,696,55974,1044,56670,54093,50027
1707,50023,"Washington County, Vermont",2010,25027,29941,4914,495,411,995,58539,1160,59534,56473,50023
1708,51025,"Brunswick County, Virginia",2010,6366,8166,1800,47,9944,298,17136,202,17434,6943,51025
1709,51027,"Buchanan County, Virginia",2010,9968,11576,1608,53,614,95,24003,131,24098,23205,51027
1710,51023,"Botetourt County, Virginia",2010,13126,14562,1436,174,987,356,32792,419,33148,31212,51023
1711,51001,"Accomack County, Virginia",2010,13798,21002,7204,177,9253,2850,30314,618,33164,20266,51001
1712,51003,"Albemarle County, Virginia",2010,38157,42122,3965,4597,9487,5417,93553,2339,98970,77130,51003
1713,51005,"Alleghany County, Virginia",2010,6891,8074,1183,37,751,176,16074,246,16250,15040,51005
1714,51007,"Amelia County, Virginia",2010,4821,5359,538,27,2925,290,12400,215,12690,9233,51007
1715,51009,"Amherst County, Virginia",2010,12560,13976,1416,153,6104,625,31728,980,32353,24491,51009
1716,51011,"Appomattox County, Virginia",2010,6033,6921,888,35,2998,167,14806,290,14973,11483,51011
1717,51013,"Arlington County, Virginia",2010,98050,105404,7354,19762,17088,31382,176245,6434,207627,132961,51013
1718,51017,"Bath County, Virginia",2010,2162,3270,1108,7,213,101,4630,47,4731,4363,51017
1719,51021,"Bland County, Virginia",2010,2566,3265,699,18,228,39,6785,45,6824,6494,51021
1720,51015,"Augusta County, Virginia",2010,28516,31194,2678,365,2881,1525,72225,968,73750,68011,51015
1721,51019,"Bedford County, Virginia",2010,27465,31937,4472,700,3909,1090,67586,942,68676,62035,51019
1722,51043,"Clarke County, Virginia",2010,5509,6235,726,121,742,490,13544,294,14034,12387,51043
1723,51029,"Buckingham County, Virginia",2010,5965,7244,1279,63,5979,288,16858,322,17146,10494,51029
1724,51031,"Campbell County, Virginia",2010,22441,24769,2328,543,7737,918,53924,1049,54842,44595,51031
1725,51036,"Charles City County, Virginia",2010,2955,3229,274,24,3511,88,7168,694,7256,2939,51036
1726,51033,"Caroline County, Virginia",2010,10456,11729,1273,170,8297,959,27586,974,28545,18145,51033
1727,51035,"Carroll County, Virginia",2010,12831,16569,3738,51,177,776,29266,218,30042,28820,51035
1728,51037,"Charlotte County, Virginia",2010,5109,6273,1164,26,3739,240,12346,198,12586,8383,51037
1729,51041,"Chesterfield County, Virginia",2010,115680,122555,6875,10219,68196,22864,293372,8165,316236,206792,51041
1730,51057,"Essex County, Virginia",2010,4517,5757,1240,86,4224,349,10802,253,11151,6239,51057
1731,51045,"Craig County, Virginia",2010,2183,2809,626,8,5,36,5154,38,5190,5103,51045
1732,51047,"Culpeper County, Virginia",2010,16231,17657,1426,593,7212,4157,42532,1245,46689,33482,51047
1733,51049,"Cumberland County, Virginia",2010,3980,4626,646,35,3253,181,9871,230,10052,6353,51049
1734,51051,"Dickenson County, Virginia",2010,6590,7579,989,17,51,86,15817,99,15903,15650,51051
1735,51053,"Dinwiddie County, Virginia",2010,10504,11422,918,122,9134,674,27327,454,28001,17617,51053
1736,20181,"Sherman County, Kansas",2010,2608,3148,540,16,34,647,5363,99,6010,5214,20181
1737,20183,"Smith County, Kansas",2010,1748,2232,484,7,10,57,3796,67,3853,3712,20183
1738,20185,"Stafford County, Kansas",2010,1907,2319,412,16,10,529,3908,77,4437,3805,20185
1739,20209,"Wyandotte County, Kansas",2010,58399,66747,8348,3886,39046,41633,115872,4770,157505,68170,20209
1740,20189,"Stevens County, Kansas",2010,2044,2306,262,15,14,1866,3858,85,5724,3744,20189
1741,20191,"Sumner County, Kansas",2010,9454,10865,1411,50,211,1097,23035,730,24132,22044,20191
1742,20193,"Thomas County, Kansas",2010,3196,3536,340,38,47,370,7530,109,7900,7336,20193
1743,20195,"Trego County, Kansas",2010,1358,1682,324,7,13,51,2950,28,3001,2902,20195
1744,20197,"Wabaunsee County, Kansas",2010,2737,3227,490,10,28,205,6848,146,7053,6664,20197
1745,20199,"Wallace County, Kansas",2010,620,781,161,1,2,108,1377,20,1485,1354,20199
1746,20201,"Washington County, Kansas",2010,2474,2955,481,19,23,144,5655,55,5799,5558,20201
1747,20203,"Wichita County, Kansas",2010,891,1054,163,3,14,550,1684,20,2234,1647,20203
1748,20207,"Woodson County, Kansas",2010,1524,2022,498,2,12,69,3240,87,3309,3139,20207
1749,20205,"Wilson County, Kansas",2010,3933,4682,749,36,30,217,9192,260,9409,8866,20205
1750,21011,"Bath County, Kentucky",2010,4587,5405,818,17,152,157,11434,135,11591,11130,21011
1751,21003,"Allen County, Kentucky",2010,7848,9307,1459,31,159,297,19659,266,19956,19203,21003
1752,21007,"Ballard County, Kentucky",2010,3397,3885,488,13,238,90,8159,146,8249,7762,21007
1753,21013,"Bell County, Kentucky",2010,11787,13154,1367,77,633,198,28493,486,28691,27297,21013
1754,21005,"Anderson County, Kentucky",2010,8369,9127,758,104,427,288,21133,288,21421,20314,21005
1755,21001,"Adair County, Kentucky",2010,7285,8568,1283,43,501,319,18337,235,18656,17558,21001
1756,21009,"Barren County, Kentucky",2010,16999,19188,2189,181,1617,1110,41063,668,42173,38597,21009
1757,21015,"Boone County, Kentucky",2010,43216,46154,2938,2514,2928,4205,114606,2209,118811,106955,21015
1758,21019,"Boyd County, Kentucky",2010,19787,21803,2016,222,1374,714,48828,769,49542,46463,21019
1759,21021,"Boyle County, Kentucky",2010,11075,12312,1237,211,2106,796,27636,615,28432,24704,21021
1760,21017,"Bourbon County, Kentucky",2010,7976,8927,951,59,1187,1368,18617,344,19985,17027,21017
1761,39167,"Washington County, Ohio",2010,25587,28367,2780,341,657,461,61317,1038,61778,59281,39167
1762,40011,"Blaine County, Oklahoma",2010,3959,5193,1234,21,298,2873,9070,1239,11943,7512,40011
1763,21025,"Breathitt County, Kentucky",2010,5494,6231,737,67,43,89,13789,104,13878,13575,21025
1764,21027,"Breckinridge County, Kentucky",2010,7827,10630,2803,42,404,175,19884,304,20059,19134,21027
1765,39169,"Wayne County, Ohio",2010,42638,45847,3209,864,1689,1800,112720,1717,114520,108450,39169
1766,39171,"Williams County, Ohio",2010,15075,16668,1593,212,358,1390,36252,399,37642,35283,39171
1767,39173,"Wood County, Ohio",2010,49043,53376,4333,1924,2906,5663,119825,1974,125488,113021,39173
1768,39175,"Wyandot County, Ohio",2010,9091,9870,779,133,42,504,22111,209,22615,21727,39175
1769,40001,"Adair County, Oklahoma",2010,8156,9142,986,129,53,1197,21486,11746,22683,9558,40001
1770,40003,"Alfalfa County, Oklahoma",2010,2022,2763,741,11,224,224,5418,260,5642,4923,40003
1771,40007,"Beaver County, Oklahoma",2010,2192,2670,478,7,31,1135,4501,150,5636,4313,40007
1772,40005,"Atoka County, Oklahoma",2010,5391,6312,921,55,527,409,13773,2873,14182,10318,40005
1773,40009,"Beckham County, Oklahoma",2010,8163,9647,1484,173,842,2619,19500,1026,22119,17459,40009
1774,40013,"Bryan County, Oklahoma",2010,16838,19586,2748,214,640,2107,40309,8161,42416,31294,40013
1775,40015,"Caddo County, Oklahoma",2010,10645,13141,2496,72,804,2995,26605,8111,29600,17618,40015
1776,40023,"Choctaw County, Oklahoma",2010,6270,7521,1251,38,1654,427,14778,3393,15205,9693,40023
1777,40025,"Cimarron County, Oklahoma",2010,1047,1587,540,7,6,514,1961,54,2475,1894,40025
1778,40029,"Coal County, Oklahoma",2010,2350,2810,460,10,25,152,5773,1409,5925,4329,40029
1779,40031,"Comanche County, Oklahoma",2010,44982,50739,5757,2663,20794,13896,110202,13623,124098,73122,40031
1780,40021,"Cherokee County, Oklahoma",2010,17836,21455,3619,250,582,2952,44035,19612,46987,23591,40021
1781,40045,"Ellis County, Oklahoma",2010,1782,2285,503,8,11,251,3900,122,4151,3759,40045
1782,40017,"Canadian County, Oklahoma",2010,42434,45810,3376,3459,2820,7794,107747,9348,115541,92120,40017
1783,40019,"Carter County, Oklahoma",2010,18635,21148,2513,502,3134,2528,45029,6895,47557,34498,40019
1784,40027,"Cleveland County, Oklahoma",2010,98306,104821,6515,9626,10572,17892,237863,24116,255755,193549,40027
1785,40033,"Cotton County, Oklahoma",2010,2483,3016,533,12,126,344,5849,806,6193,4905,40033
1786,40035,"Craig County, Oklahoma",2010,5691,6749,1058,105,440,370,14659,4262,15029,9852,40035
1787,40037,"Creek County, Oklahoma",2010,26539,29761,3222,230,1528,2152,67815,11236,69967,54821,40037
1788,40039,"Custer County, Oklahoma",2010,10698,12204,1506,276,794,3830,23639,2400,27469,20169,40039
1789,40041,"Delaware County, Oklahoma",2010,17093,24818,7725,514,83,1248,40239,12314,41487,27328,40041
1790,40047,"Garfield County, Oklahoma",2010,24175,26831,2656,577,1765,5353,55227,4141,60580,48744,40047
1791,40043,"Dewey County, Oklahoma",2010,1944,2445,501,33,16,231,4579,394,4810,4136,40043
1792,40059,"Harper County, Oklahoma",2010,1527,1908,381,6,2,645,3040,75,3685,2957,40059
1793,40049,"Garvin County, Oklahoma",2010,11069,12827,1758,102,690,1713,25863,3280,27576,21791,40049
1794,40051,"Grady County, Oklahoma",2010,19892,22219,2327,192,1239,2405,50026,4742,52431,43853,40051
1795,40053,"Grant County, Oklahoma",2010,1910,2486,576,9,35,158,4369,183,4527,4142,40053
1796,40055,"Greer County, Oklahoma",2010,2181,2738,557,10,438,609,5630,288,6239,4894,40055
1797,40057,"Harmon County, Oklahoma",2010,1112,1544,432,12,197,756,2166,118,2922,1839,40057
1798,40075,"Kiowa County, Oklahoma",2010,3978,5216,1238,29,390,832,8614,893,9446,7302,40075
1799,55045,"Green County, Wisconsin",2010,14866,15856,990,197,137,1033,35809,362,36842,35113,55045
1800,55047,"Green Lake County, Wisconsin",2010,7919,10616,2697,85,79,743,18308,154,19051,17990,55047
1801,55049,"Iowa County, Wisconsin",2010,9547,10719,1172,124,86,336,23351,237,23687,22904,55049
1802,55051,"Iron County, Wisconsin",2010,2822,5999,3177,18,3,35,5881,88,5916,5772,55051
1803,55053,"Jackson County, Wisconsin",2010,7843,9727,1884,51,390,519,19930,1502,20449,17987,55053
1804,17039,"De Witt County, Illinois",2010,6811,7521,710,58,82,354,16207,212,16561,15855,17039
1805,17041,"Douglas County, Illinois",2010,7720,8390,670,82,53,1210,18770,208,19980,18427,17041
1806,17057,"Fulton County, Illinois",2010,14536,16195,1659,111,1268,896,36173,397,37069,34397,17057
1807,34021,"Mercer County, New Jersey",2010,133155,143169,10014,32545,71378,55318,311195,7363,366513,199909,34021
1808,34023,"Middlesex County, New Jersey",2010,281186,294800,13614,172534,71557,148975,660883,18068,809858,398724,34023
1809,34025,"Monmouth County, New Jersey",2010,233983,258410,24427,31018,43931,60939,569441,11057,630380,483435,34025
1810,26125,"Oakland County, Michigan",2010,483698,527255,43557,67577,162303,41920,1160442,27164,1202362,903398,26125
1811,55057,"Juneau County, Wisconsin",2010,10527,14669,4142,113,545,687,25977,613,26664,24706,55057
1812,55059,"Kenosha County, Wisconsin",2010,62650,69288,6638,2343,10655,19592,146834,3944,166426,129892,55059
1813,26111,"Midland County, Michigan",2010,33437,35960,2523,1555,983,1704,81925,1541,83629,77846,26111
1814,26113,"Missaukee County, Michigan",2010,5843,9117,3274,45,42,306,14543,226,14849,14230,26113
1815,26115,"Monroe County, Michigan",2010,58230,62971,4741,837,3144,4667,147354,2764,152021,140609,26115
1816,26117,"Montcalm County, Michigan",2010,23432,28221,4789,220,1476,1932,61410,1079,63342,58635,26117
1817,26119,"Montmorency County, Michigan",2010,4416,9597,5181,14,15,96,9669,175,9765,9465,26119
1818,26121,"Muskegon County, Michigan",2010,65616,73561,7945,919,24599,8261,163927,5277,172188,133132,26121
1819,26123,"Newaygo County, Michigan",2010,18406,25075,6669,184,474,2663,45797,1020,48460,44119,26123
1820,26137,"Otsego County, Michigan",2010,9756,14731,4975,92,78,299,23865,509,24164,23186,26137
1821,26127,"Oceana County, Michigan",2010,10174,15944,5770,60,100,3629,22941,554,26570,22227,26127
1822,26129,"Ogemaw County, Michigan",2010,9283,16047,6764,76,37,309,21390,412,21699,20865,26129
1823,26131,"Ontonagon County, Michigan",2010,3258,5672,2414,11,6,64,6716,153,6780,6546,26131
1824,26133,"Osceola County, Michigan",2010,9222,13632,4410,48,125,344,23184,480,23528,22531,26133
1825,26135,"Oscoda County, Michigan",2010,3772,9118,5346,7,14,79,8561,160,8640,8380,26135
1826,26153,"Schoolcraft County, Michigan",2010,3759,6313,2554,13,11,64,8421,1003,8485,7394,26153
1827,26139,"Ottawa County, Michigan",2010,93775,102495,8720,6576,3551,22761,241040,4757,263801,226156,26139
1828,26141,"Presque Isle County, Michigan",2010,5982,10428,4446,40,56,116,13260,192,13376,12972,26141
1829,26143,"Roscommon County, Michigan",2010,11433,24459,13026,72,89,275,24174,421,24449,23592,26143
1830,26145,"Saginaw County, Michigan",2010,79011,86844,7833,2067,37222,15573,184596,4120,200169,141187,26145
1831,26147,"St. Clair County, Michigan",2010,63841,71822,7981,763,3860,4708,158332,3496,163040,150213,26147
1832,26149,"St. Joseph County, Michigan",2010,23244,27778,4534,416,1555,4034,57261,1360,61295,53930,26149
1833,26151,"Sanilac County, Michigan",2010,17132,22725,5593,125,142,1439,41675,556,43114,40852,26151
1834,26163,"Wayne County, Michigan",2010,702749,821693,118944,45590,732801,95260,1725324,44753,1820584,902180,26163
1835,26155,"Shiawassee County, Michigan",2010,27481,30319,2838,247,305,1695,68953,1161,70648,67240,26155
1836,26157,"Tuscola County, Michigan",2010,21590,24451,2861,155,621,1571,54158,835,55729,52547,26157
1837,26159,"Van Buren County, Michigan",2010,28928,36785,7857,300,3007,7758,68500,2165,76258,63028,26159
1838,26165,"Wexford County, Michigan",2010,13021,16736,3715,193,122,519,32216,655,32735,31246,26165
1839,26161,"Washtenaw County, Michigan",2010,137193,147573,10380,27005,43152,13860,330931,12099,344791,248675,26161
1840,27013,"Blue Earth County, Minnesota",2010,24445,26202,1757,1247,1717,1586,62427,1069,64013,58394,27013
1841,27015,"Brown County, Minnesota",2010,10782,11493,711,152,56,860,25033,163,25893,24662,27015
1842,27011,"Big Stone County, Minnesota",2010,2293,3115,822,4,10,41,5228,64,5269,5150,27011
1843,27001,"Aitkin County, Minnesota",2010,7299,16029,8730,27,53,151,16051,573,16202,15398,27001
1844,27003,"Anoka County, Minnesota",2010,121227,126688,5461,12796,14282,12020,318824,9817,330844,281929,27003
1845,27007,"Beltrami County, Minnesota",2010,16846,20527,3681,304,251,676,43766,10145,44442,33066,27007
1846,27005,"Becker County, Minnesota",2010,13224,18784,5560,124,128,398,32106,3315,32504,28539,27005
1847,27009,"Benton County, Minnesota",2010,15079,16140,1061,420,738,632,37819,722,38451,35939,27009
1848,27027,"Clay County, Minnesota",2010,22279,23959,1680,836,825,2056,56943,1848,58999,53434,27027
1849,27017,"Carlton County, Minnesota",2010,13538,15656,2118,160,494,484,34902,2790,35386,31458,27017
1850,27019,"Carver County, Minnesota",2010,32891,34536,1645,2456,1068,3515,87527,1467,91042,82536,27019
1851,27021,"Cass County, Minnesota",2010,11948,24903,12955,88,59,340,28227,3697,28567,24383,27021
1852,27023,"Chippewa County, Minnesota",2010,5241,5721,480,57,65,611,11830,338,12441,11370,27023
1853,27025,"Chisago County, Minnesota",2010,19470,21172,1702,471,636,835,53052,932,53887,51013,27025
1854,27043,"Faribault County, Minnesota",2010,6236,7090,854,43,43,817,13736,131,14553,13519,27043
1855,27029,"Clearwater County, Minnesota",2010,3527,4773,1246,21,30,120,8575,987,8695,7537,27029
1856,27031,"Cook County, Minnesota",2010,2494,5839,3345,27,15,58,5118,548,5176,4528,27031
1857,27033,"Cottonwood County, Minnesota",2010,4857,5412,555,302,82,720,10967,151,11687,10432,27033
1858,27035,"Crow Wing County, Minnesota",2010,26033,40180,14147,232,297,652,61848,1340,62500,59979,27035
1859,27037,"Dakota County, Minnesota",2010,152060,159598,7538,17350,18235,23966,374586,11039,398552,327962,27037
1860,27039,"Dodge County, Minnesota",2010,7460,7947,487,90,59,915,19172,243,20087,18780,27039
1861,27041,"Douglas County, Minnesota",2010,15289,19905,4616,163,146,341,35668,385,36009,34974,27041
1862,47057,"Grainger County, Tennessee",2010,9029,10894,1865,24,101,530,22127,249,22657,21753,47057
1863,47065,"Hamilton County, Tennessee",2010,136682,151107,14425,5855,67483,14993,321470,5978,336463,242154,47065
1864,47073,"Hawkins County, Tennessee",2010,23343,26870,3527,277,735,669,56164,699,56833,54453,47073
1865,34027,"Morris County, New Jersey",2010,180534,189842,9308,43862,14134,56482,435794,8247,492276,369551,34027
1866,34029,"Ocean County, New Jersey",2010,221111,278052,56941,9924,16583,47783,528784,6743,576567,495534,34029
1867,17043,"DuPage County, Illinois",2010,337132,356179,19047,91793,41024,121506,795418,16471,916924,646130,17043
1868,17045,"Edgar County, Illinois",2010,7839,8803,964,33,63,187,18389,151,18576,18142,17045
1869,17053,"Ford County, Illinois",2010,5676,6282,606,36,78,294,13787,153,14081,13520,17053
1870,17055,"Franklin County, Illinois",2010,16617,18525,1908,122,118,475,39086,493,39561,38353,17055
1871,17047,"Edwards County, Illinois",2010,2840,3187,347,21,30,59,6662,56,6721,6555,17047
1872,17049,"Effingham County, Illinois",2010,13515,14570,1055,147,76,597,33645,267,34242,33155,17049
1873,17051,"Fayette County, Illinois",2010,8311,9302,991,47,969,304,21836,235,22140,20585,17051
1874,17069,"Hardin County, Illinois",2010,1915,2488,573,22,13,56,4264,58,4320,4171,17069
1875,17059,"Gallatin County, Illinois",2010,2403,2746,343,5,12,66,5523,79,5589,5427,17059
1876,17061,"Greene County, Illinois",2010,5570,6389,819,16,119,115,13771,119,13886,13517,17061
1877,17063,"Grundy County, Illinois",2010,18546,19996,1450,318,577,4096,45967,546,50063,44526,17063
1878,17065,"Hamilton County, Illinois",2010,3489,4104,615,19,31,105,8352,68,8457,8234,17065
1879,17067,"Hancock County, Illinois",2010,8040,9274,1234,45,51,185,18919,212,19104,18611,17067
1880,17091,"Kankakee County, Illinois",2010,41511,45246,3735,1030,16998,10167,103282,2036,113449,83218,17091
1881,17071,"Henderson County, Illinois",2010,3149,3827,678,15,15,79,7252,89,7331,7133,17071
1882,17073,"Henry County, Illinois",2010,20373,22161,1788,183,762,2402,48084,646,50486,46493,17073
1883,17075,"Iroquois County, Illinois",2010,11956,13452,1496,102,233,1584,28134,332,29718,27467,17075
1884,17077,"Jackson County, Illinois",2010,25538,28578,3040,1890,8488,2403,57815,1691,60218,45746,17077
1885,17079,"Jasper County, Illinois",2010,3940,4345,405,24,10,79,9619,68,9698,9517,17079
1886,17081,"Jefferson County, Illinois",2010,15365,16954,1589,246,3194,799,38028,669,38827,33919,17081
1887,17083,"Jersey County, Illinois",2010,8828,9848,1020,76,89,222,22763,317,22985,22281,17083
1888,17085,"Jo Daviess County, Illinois",2010,9753,13574,3821,72,100,609,22069,216,22678,21681,17085
1889,17087,"Johnson County, Illinois",2010,4584,5598,1014,21,1004,376,12206,125,12582,11056,17087
1890,17089,"Kane County, Illinois",2010,170479,182047,11568,17505,27819,158390,356879,7504,515269,304051,17089
1891,17099,"LaSalle County, Illinois",2010,45347,49978,4631,755,2104,9135,104789,1385,113924,100545,17099
1892,17101,"Lawrence County, Illinois",2010,6130,6936,806,38,1583,553,16280,168,16833,14491,17101
1893,17103,"Lee County, Illinois",2010,13758,15049,1291,244,1709,1802,34229,452,36031,31824,17103
1894,17113,"McLean County, Illinois",2010,65104,69656,4552,7180,12246,7434,162138,3877,169572,138835,17113
1895,17093,"Kendall County, Illinois",2010,38022,40321,2299,3403,6343,17898,96838,1936,114736,85156,17093
1896,17095,"Knox County, Illinois",2010,21535,24077,2542,331,3741,2558,50361,1157,52919,45132,17095
1897,17097,"Lake County, Illinois",2010,241712,260310,18598,43954,46989,139987,563475,13831,703462,458701,17097
1898,17105,"Livingston County, Illinois",2010,14613,15895,1282,197,1887,1532,37418,431,38950,34903,17105
1899,17107,"Logan County, Illinois",2010,11070,12107,1037,184,2243,893,29412,399,30305,26586,17107
1900,17109,"McDonough County, Illinois",2010,13057,14419,1362,572,1594,867,31745,600,32612,28979,17109
1901,17111,"McHenry County, Illinois",2010,109199,116040,6841,7712,3045,35249,273511,4170,308760,258584,17111
1902,17125,"Mason County, Illinois",2010,6079,7077,998,40,53,117,14549,160,14666,14296,17125
1903,17115,"Macon County, Illinois",2010,45855,50475,4620,1107,17916,2072,108696,2851,110768,86822,17115
1904,17117,"Macoupin County, Illinois",2010,19381,21584,2203,129,359,418,47347,544,47765,46315,17117
1905,17119,"Madison County, Illinois",2010,108094,117106,9012,2211,21066,7313,261969,5177,269282,233515,17119
1906,17121,"Marion County, Illinois",2010,16148,18296,2148,224,1536,542,38895,679,39437,36456,17121
1907,17123,"Marshall County, Illinois",2010,5161,5914,753,43,44,314,12326,111,12640,12128,17123
1908,17141,"Ogle County, Illinois",2010,20856,22561,1705,241,468,4741,48756,622,53497,47425,17141
1909,17127,"Massac County, Illinois",2010,6362,7113,751,41,891,290,15139,347,15429,13860,17127
1910,17129,"Menard County, Illinois",2010,5140,5654,514,29,74,121,12584,161,12705,12320,17129
1911,17131,"Mercer County, Illinois",2010,6734,7358,624,51,46,307,16127,118,16434,15912,17131
1912,17137,"Morgan County, Illinois",2010,14104,15515,1411,163,2104,712,34835,631,35547,31937,17137
1913,17139,"Moultrie County, Illinois",2010,5758,6260,502,29,40,129,14717,124,14846,14524,17139
1914,17133,"Monroe County, Illinois",2010,12589,13392,803,142,64,450,32507,310,32957,31991,17133
1915,17135,"Montgomery County, Illinois",2010,11652,13080,1428,111,949,459,29645,251,30104,28334,17135
1916,17149,"Pike County, Illinois",2010,6639,7951,1312,38,274,172,16258,144,16430,15802,17149
1917,17143,"Peoria County, Illinois",2010,75793,83034,7241,5819,32720,7102,179392,5233,186494,135620,17143
1918,17145,"Perry County, Illinois",2010,8335,9426,1091,87,1856,599,21751,345,22350,19463,17145
1919,17147,"Piatt County, Illinois",2010,6782,7269,487,49,56,167,16562,181,16729,16276,17147
1920,42003,"Allegheny County, Pennsylvania",2010,533960,589201,55241,33944,159998,19070,1204278,24124,1223348,986212,42003
1921,42005,"Armstrong County, Pennsylvania",2010,28713,32520,3807,147,540,366,68575,562,68941,67326,42005
1922,42009,"Bedford County, Pennsylvania",2010,20233,23954,3721,101,236,450,49312,440,49762,48535,42009
1923,42013,"Blair County, Pennsylvania",2010,52159,56276,4117,689,2051,1230,125859,1624,127089,121495,42013
1924,42011,"Berks County, Pennsylvania",2010,154356,164827,10471,5244,16517,67355,344087,5920,411442,316406,42011
1925,42057,"Fulton County, Pennsylvania",2010,6014,7122,1108,19,144,123,14722,172,14845,14387,42057
1926,42015,"Bradford County, Pennsylvania",2010,25321,29979,4658,330,269,702,61920,737,62622,60584,42015
1927,42017,"Bucks County, Pennsylvania",2010,234849,245956,11107,23893,21454,26782,598467,9913,625249,543207,42017
1928,42025,"Carbon County, Pennsylvania",2010,26684,34299,7615,304,888,2145,63104,744,65249,61168,42025
1929,42027,"Centre County, Pennsylvania",2010,57573,63297,5724,7934,4456,3690,150300,2483,153990,135427,42027
1930,42029,"Chester County, Pennsylvania",2010,182900,192462,9562,19216,29388,32503,466383,8218,498886,409561,42029
1931,42021,"Cambria County, Pennsylvania",2010,58950,65650,6700,720,5073,2006,141673,1807,143679,134073,42021
1932,42023,"Cameron County, Pennsylvania",2010,2273,4455,2182,14,12,19,5066,55,5085,4985,42023
1933,42035,"Clinton County, Pennsylvania",2010,15151,19080,3929,199,612,437,38801,372,39238,37618,42035
1934,42039,"Crawford County, Pennsylvania",2010,35028,44686,9658,397,1503,823,87942,1112,88765,84930,42039
1935,42041,"Cumberland County, Pennsylvania",2010,93943,99988,6045,7028,7237,6448,228958,4179,235406,210514,42041
1936,42043,"Dauphin County, Pennsylvania",2010,110435,120406,9971,8507,46320,18795,249305,7076,268100,187402,42043
1937,42045,"Delaware County, Pennsylvania",2010,208700,222902,14202,26144,108231,16537,542442,10643,558979,397424,42045
1938,42047,"Elk County, Pennsylvania",2010,13693,17585,3892,95,85,183,31763,238,31946,31345,42047
1939,42049,"Erie County, Pennsylvania",2010,110413,119138,8725,3036,19485,9518,271048,5740,280566,242787,42049
1940,42051,"Fayette County, Pennsylvania",2010,55997,62773,6776,397,6270,1049,135557,2002,136606,126888,42051
1941,42053,"Forest County, Pennsylvania",2010,2511,8760,6249,12,1374,418,7298,62,7716,5850,42053
1942,42055,"Franklin County, Pennsylvania",2010,58389,63219,4830,1294,4348,6438,143180,2534,149618,135004,42055
1943,42019,"Butler County, Pennsylvania",2010,72835,78167,5332,1826,1954,1941,181921,1882,183862,176259,42019
1944,42031,"Clarion County, Pennsylvania",2010,16128,19962,3834,191,468,245,39743,360,39988,38724,42031
1945,42033,"Clearfield County, Pennsylvania",2010,32288,38644,6356,384,1697,1907,79735,623,81642,77031,42033
1946,42037,"Columbia County, Pennsylvania",2010,26479,29498,3019,547,1190,1349,65946,709,67295,63500,42037
1947,42069,"Lackawanna County, Pennsylvania",2010,87226,96832,9606,3601,4794,10682,203755,3110,214437,192250,42069
1948,42059,"Greene County, Pennsylvania",2010,14724,16460,1736,113,1272,465,38221,427,38686,36409,42059
1949,42061,"Huntingdon County, Pennsylvania",2010,17280,22365,5085,181,2369,727,45186,439,45913,42197,42061
1950,42063,"Indiana County, Pennsylvania",2010,35005,38236,3231,768,2374,947,87933,927,88880,83864,42063
1951,42065,"Jefferson County, Pennsylvania",2010,18561,22434,3873,91,147,275,44925,423,45200,44264,42065
1952,42067,"Juniata County, Pennsylvania",2010,9476,10978,1502,85,134,623,24013,210,24636,23584,42067
1953,42091,"Montgomery County, Pennsylvania",2010,307750,325735,17985,51354,67582,34233,765641,14921,799874,631784,42091
1954,42071,"Lancaster County, Pennsylvania",2010,193602,202952,9350,9726,16087,44930,474515,7733,519445,440969,42071
1955,42073,"Lawrence County, Pennsylvania",2010,37126,40975,3849,365,3448,931,90177,1492,91108,84872,42073
1956,42075,"Lebanon County, Pennsylvania",2010,52258,55592,3334,1504,2134,12410,121158,1510,133568,116010,42075
1957,42077,"Lehigh County, Pennsylvania",2010,133983,142613,8630,10090,17230,65615,283882,6317,349497,250245,42077
1958,42079,"Luzerne County, Pennsylvania",2010,131932,148748,16816,3079,9539,21491,299427,3751,320918,283058,42079
1959,42081,"Lycoming County, Pennsylvania",2010,46700,52500,5800,663,5060,1559,114552,2119,116111,106710,42081
1960,42087,"Mifflin County, Pennsylvania",2010,18743,21537,2794,167,282,534,46148,500,46682,45199,42087
1961,42089,"Monroe County, Pennsylvania",2010,61091,80359,19268,3395,20461,22288,147554,3957,169842,119741,42089
1962,42083,"McKean County, Pennsylvania",2010,17183,21225,4042,191,1008,757,42693,455,43450,41039,42083
1963,42085,"Mercer County, Pennsylvania",2010,46442,51733,5291,726,6620,1248,115390,1868,116638,106176,42085
1964,51071,"Giles County, Virginia",2010,7215,8319,1104,54,259,209,17077,184,17286,16580,51071
1965,51073,"Gloucester County, Virginia",2010,14293,15852,1559,282,3152,935,35923,905,36858,31584,51073
1966,51085,"Hanover County, Virginia",2010,36589,38360,1771,1333,9202,2116,97747,1821,99863,85391,51085
1967,42093,"Montour County, Pennsylvania",2010,7393,7965,572,323,237,324,17943,177,18267,17206,42093
1968,42095,"Northampton County, Pennsylvania",2010,113565,120363,6798,7131,13207,31179,266556,5055,297735,241163,42095
1969,42097,"Northumberland County, Pennsylvania",2010,39242,45125,5883,325,1814,2253,92275,970,94528,89166,42097
1970,42099,"Perry County, Pennsylvania",2010,17903,20424,2521,163,284,588,45381,507,45969,44427,42099
1971,51077,"Grayson County, Virginia",2010,6846,9156,2310,15,317,416,15117,158,15533,14627,51077
1972,51075,"Goochland County, Virginia",2010,7998,8618,620,219,4151,455,21262,309,21717,16583,51075
1973,51079,"Greene County, Virginia",2010,6780,7509,729,247,1160,781,17622,430,18403,15785,51079
1974,51081,"Greensville County, Virginia",2010,3566,4090,524,35,7294,173,12070,113,12243,4628,51081
1975,51083,"Halifax County, Virginia",2010,15085,18004,2919,132,13224,587,35654,494,36241,21804,51083
1976,51101,"King William County, Virginia",2010,5979,6522,543,118,2806,324,15611,580,15935,12107,51101
1977,51087,"Henrico County, Virginia",2010,124601,132778,8177,19956,89449,15001,291934,7730,306935,174799,51087
1978,51089,"Henry County, Virginia",2010,23151,26268,3117,236,11786,2545,51606,847,54151,38737,51089
1979,51091,"Highland County, Virginia",2010,1081,1837,756,4,6,18,2303,9,2321,2284,51091
1980,47075,"Haywood County, Tennessee",2010,7459,8315,856,21,9431,723,18064,193,18787,8419,47075
1981,47095,"Lake County, Tennessee",2010,2270,2598,328,11,2162,136,7696,114,7832,5409,47095
1982,27045,"Fillmore County, Minnesota",2010,8545,9732,1187,71,48,207,20659,165,20866,20375,27045
1983,27047,"Freeborn County, Minnesota",2010,13177,14231,1054,232,200,2750,28505,372,31255,27701,27047
1984,27049,"Goodhue County, Minnesota",2010,18730,20337,1607,271,429,1342,44841,1114,46183,43027,27049
1985,27057,"Hubbard County, Minnesota",2010,8661,14622,5961,49,47,327,20101,883,20428,19122,27057
1986,27051,"Grant County, Minnesota",2010,2601,3324,723,14,19,94,5924,59,6018,5832,27051
1987,27053,"Hennepin County, Minnesota",2010,475913,509469,33556,71535,134240,77676,1074749,42304,1152425,826670,27053
1988,47081,"Hickman County, Tennessee",2010,8976,10311,1335,47,1102,455,24235,429,24690,22657,47081
1989,47083,"Houston County, Tennessee",2010,3349,4188,839,25,190,129,8297,151,8426,7931,47083
1990,47085,"Humphreys County, Tennessee",2010,7454,8865,1411,34,455,278,18260,273,18538,17498,47085
1991,47087,"Jackson County, Tennessee",2010,4789,5843,1054,10,29,164,11474,168,11638,11267,47087
1992,47089,"Jefferson County, Tennessee",2010,19864,23499,3635,212,1031,1619,49788,807,51407,47738,47089
1993,47091,"Johnson County, Tennessee",2010,7195,8956,1761,35,373,269,17975,194,18244,17373,47091
1994,47093,"Knox County, Tennessee",2010,177249,194949,17700,7998,37648,15012,417214,8988,432226,362580,47093
1995,47071,"Hardin County, Tennessee",2010,10643,13946,3303,102,888,497,25529,429,26026,24110,47071
1996,47079,"Henry County, Tennessee",2010,13604,17054,3450,95,2578,553,31777,582,32330,28522,47079
1997,47117,"Marshall County, Tennessee",2010,11850,13119,1269,130,1985,1386,29231,551,30617,26565,47117
1998,47097,"Lauderdale County, Tennessee",2010,9795,11256,1461,55,9676,564,27251,485,27815,17035,47097
1999,47099,"Lawrence County, Tennessee",2010,16275,18177,1902,120,637,689,41180,733,41869,39690,47099
2000,47101,"Lewis County, Tennessee",2010,4781,5470,689,43,198,221,11940,192,12161,11507,47101
2001,47103,"Lincoln County, Tennessee",2010,13382,15241,1859,115,2256,885,32476,703,33361,29402,47103
2002,47105,"Loudon County, Tennessee",2010,19826,21725,1899,284,517,3395,45161,584,48556,43776,47105
2003,47107,"McMinn County, Tennessee",2010,20865,23341,2476,385,2021,1482,50784,1105,52266,47273,47107
2004,47111,"Macon County, Tennessee",2010,8561,9861,1300,44,79,919,21329,245,22248,20961,47111
2005,47109,"McNairy County, Tennessee",2010,10326,11933,1607,49,1541,396,25679,373,26075,23716,47109
2006,47113,"Madison County, Tennessee",2010,38073,41877,3804,895,35530,3306,94988,1503,98294,57060,47113
2007,47115,"Marion County, Tennessee",2010,11403,12954,1551,111,1007,361,27876,430,28237,26328,47115
2008,47129,"Morgan County, Tennessee",2010,7692,8920,1228,38,803,188,21799,320,21987,20638,47129
2009,47119,"Maury County, Tennessee",2010,31663,35254,3591,482,10076,3909,77047,1570,80956,64919,47119
2010,47121,"Meigs County, Tennessee",2010,4686,5628,942,18,116,176,11577,182,11753,11261,47121
2011,47123,"Monroe County, Tennessee",2010,17711,20787,3076,151,900,1448,43071,874,44519,41146,47123
2012,47125,"Montgomery County, Tennessee",2010,63673,70098,6425,3480,32003,13752,158579,7543,172331,115553,47125
2013,47127,"Moore County, Tennessee",2010,2492,2915,423,24,145,70,6292,86,6362,6037,47127
2014,47151,"Scott County, Tennessee",2010,8671,9910,1239,42,19,120,22108,252,22228,21795,47151
2015,47131,"Obion County, Tennessee",2010,13077,14659,1582,75,3353,999,30808,392,31807,26988,47131
2016,47133,"Overton County, Tennessee",2010,8820,10295,1475,43,86,202,21881,300,22083,21452,47133
2017,47135,"Perry County, Tennessee",2010,3160,4599,1439,14,116,131,7784,152,7915,7502,47135
2018,47137,"Pickett County, Tennessee",2010,2177,3462,1285,4,5,67,5010,37,5077,4964,47137
2019,47139,"Polk County, Tennessee",2010,6653,7991,1338,23,50,233,16592,257,16825,16262,47139
2020,47141,"Putnam County, Tennessee",2010,28930,31882,2952,839,1421,3858,68463,1151,72321,65052,47141
2021,47143,"Rhea County, Tennessee",2010,12276,14365,2089,128,609,1187,30622,582,31809,29303,47143
2022,47145,"Roane County, Tennessee",2010,22376,25716,3340,274,1430,710,53471,1015,54181,50752,47145
2023,47149,"Rutherford County, Tennessee",2010,96232,102968,6736,7901,32534,17500,245104,6186,262604,198483,47149
2024,47147,"Robertson County, Tennessee",2010,24197,26086,1889,323,4877,3903,62380,1021,66283,56159,47147
2025,47163,"Sullivan County, Tennessee",2010,66298,73760,7462,881,3272,2321,154502,2316,156823,148033,47163
2026,47153,"Sequatchie County, Tennessee",2010,5519,6368,849,40,19,462,13650,189,14112,13402,47153
2027,47155,"Sevier County, Tennessee",2010,35343,55918,20575,769,640,4787,85102,1319,89889,82374,47155
2028,47157,"Shelby County, Tennessee",2010,350971,398274,47303,21245,481431,52092,875552,13770,927644,359106,47157
2029,47159,"Smith County, Tennessee",2010,7410,8529,1119,32,405,417,18749,310,19166,18002,47159
2030,47161,"Stewart County, Tennessee",2010,5386,6778,1392,135,187,250,13074,283,13324,12469,47161
2031,47175,"Van Buren County, Tennessee",2010,2246,2663,417,7,22,50,5498,61,5548,5408,47175
2032,47177,"Warren County, Tennessee",2010,15850,17821,1971,190,1085,3224,36615,601,39839,34739,47177
2033,47185,"White County, Tennessee",2010,10272,11511,1239,69,450,425,25416,401,25841,24496,47185
2034,55061,"Kewaunee County, Wisconsin",2010,8239,9304,1065,59,63,463,20111,265,20574,19724,55061
2035,55071,"Manitowoc County, Wisconsin",2010,34013,37189,3176,2027,412,2565,78877,1228,81442,75210,55071
2036,47165,"Sumner County, Tennessee",2010,60975,65968,4993,1616,10213,6308,154337,2815,160645,139693,47165
2037,47167,"Tipton County, Tennessee",2010,21617,23199,1582,356,11393,1269,59812,1232,61081,46831,47167
2038,47169,"Trousdale County, Tennessee",2010,2976,3368,392,18,748,198,7672,145,7870,6761,47169
2039,47171,"Unicoi County, Tennessee",2010,7726,8830,1104,30,35,694,17619,206,18313,17348,47171
2040,47173,"Union County, Tennessee",2010,7391,8958,1567,19,21,249,18860,281,19109,18539,47173
2041,55067,"Langlade County, Wisconsin",2010,8587,12360,3773,62,70,324,19653,412,19977,19109,55067
2042,51093,"Isle of Wight County, Virginia",2010,13718,14633,915,275,8656,658,34612,712,35270,24969,51093
2043,51095,"James City County, Virginia",2010,26860,29797,2937,1488,8662,3024,63985,1786,67009,52049,51095
2044,51097,"King and Queen County, Virginia",2010,2882,3414,532,17,1970,184,6761,227,6945,4547,51097
2045,51099,"King George County, Virginia",2010,8376,9477,1101,268,4177,790,22794,746,23584,17603,51099
2046,51113,"Madison County, Virginia",2010,5083,5932,849,74,1292,236,13072,312,13308,11394,51113
2047,51103,"Lancaster County, Virginia",2010,5265,7402,2137,65,3166,118,11273,117,11391,7925,51103
2048,51105,"Lee County, Virginia",2010,10159,11745,1586,55,909,406,25181,324,25587,23893,51105
2049,51107,"Loudoun County, Virginia",2010,104583,109442,4859,45795,21934,38576,273735,11161,312311,194845,51107
2050,51109,"Louisa County, Virginia",2010,12944,16319,3375,158,5832,762,32391,839,33153,25562,51109
2051,51111,"Lunenburg County, Virginia",2010,4957,5935,978,25,4451,470,12444,238,12914,7730,51111
2052,51133,"Northumberland County, Virginia",2010,5540,8995,3455,36,3106,382,11948,168,12330,8638,51133
2053,51115,"Mathews County, Virginia",2010,3858,5669,1811,30,822,104,8874,187,8978,7835,51115
2054,51117,"Mecklenburg County, Virginia",2010,13495,18591,5096,213,11958,806,31921,535,32727,19215,51117
2055,51119,"Middlesex County, Virginia",2010,4708,7133,2425,37,1956,166,10793,196,10959,8604,51119
2056,51121,"Montgomery County, Virginia",2010,35767,38569,2802,5089,3631,2536,91856,2045,94392,81091,51121
2057,51125,"Nelson County, Virginia",2010,6396,9931,3535,66,1941,459,14561,271,15020,12283,51125
2058,51127,"New Kent County, Virginia",2010,6813,7295,482,159,2474,390,18039,602,18429,14804,51127
2059,51131,"Northampton County, Virginia",2010,5323,7301,1978,81,4491,874,11515,188,12389,6755,51131
2060,51145,"Powhatan County, Virginia",2010,9494,10043,549,131,3798,502,27544,384,28046,23231,51145
2061,51135,"Nottoway County, Virginia",2010,5706,6650,944,50,6179,609,15244,216,15853,8799,51135
2062,51137,"Orange County, Virginia",2010,12895,14616,1721,240,4206,1139,32342,863,33481,27033,51137
2063,51139,"Page County, Virginia",2010,9746,11600,1854,71,456,373,23669,271,24042,22871,51139
2064,51143,"Pittsylvania County, Virginia",2010,26183,31307,5124,176,13963,1332,62174,785,63506,47250,51143
2065,51141,"Patrick County, Virginia",2010,8081,10083,2002,42,1085,444,18046,239,18490,16680,51141
2066,51159,"Richmond County, Virginia",2010,3159,3850,691,39,2793,510,8744,157,9254,5755,51159
2067,51147,"Prince Edward County, Virginia",2010,7916,9149,1233,203,7668,525,22843,428,23368,14544,51147
2068,51149,"Prince George County, Virginia",2010,11451,12056,605,520,11150,2058,33667,1175,35725,20822,51149
2069,51153,"Prince William County, Virginia",2010,130785,137115,6330,29986,78492,81460,320542,16408,402002,195656,51153
2070,51155,"Pulaski County, Virginia",2010,14821,17235,2414,179,1744,432,34440,545,34872,31972,51155
2071,51157,"Rappahannock County, Virginia",2010,3072,3839,767,39,318,228,7145,135,7373,6653,51157
2072,51175,"Southampton County, Virginia",2010,6719,7473,754,46,6893,203,18367,290,18570,11138,51175
2073,51161,"Roanoke County, Virginia",2010,37608,40016,2408,2455,4580,1951,90425,1504,92376,81886,51161
2074,51163,"Rockbridge County, Virginia",2010,9555,11152,1597,103,585,296,22011,408,22307,20915,51163
2075,51165,"Rockingham County, Virginia",2010,29177,33660,4483,454,1216,4076,72238,928,76314,69640,51165
2076,51167,"Russell County, Virginia",2010,11943,13484,1541,53,227,275,28622,200,28897,28142,51167
2077,51169,"Scott County, Virginia",2010,9775,11916,2141,35,135,234,22943,188,23177,22585,51169
2078,51171,"Shenandoah County, Virginia",2010,17076,20876,3800,210,699,2577,39416,621,41993,37886,51171
2079,51173,"Smyth County, Virginia",2010,13319,15427,2108,82,630,527,31681,327,32208,30642,51173
2080,51187,"Warren County, Virginia",2010,14085,16034,1949,350,1709,1318,36257,853,37575,33345,51187
2081,51177,"Spotsylvania County, Virginia",2010,41942,45185,3243,2768,18298,9278,113119,3976,122397,88077,51177
2082,51179,"Stafford County, Virginia",2010,41769,43978,2209,3545,21259,11875,117086,4848,128961,87434,51179
2083,51181,"Surry County, Virginia",2010,2826,3444,618,23,3240,86,6972,126,7058,3583,51181
2084,51183,"Sussex County, Virginia",2010,3994,4696,702,46,6996,268,11819,114,12087,4663,51183
2085,51185,"Tazewell County, Virginia",2010,18449,20826,2377,286,1330,296,44782,474,45078,42692,51185
2086,55069,"Lincoln County, Wisconsin",2010,12094,16784,4690,124,152,340,28403,364,28743,27763,55069
2087,55063,"La Crosse County, Wisconsin",2010,46137,48402,2265,4727,1553,1741,112897,2200,114638,104417,55063
2088,55065,"Lafayette County, Wisconsin",2010,6609,7230,621,57,39,522,16314,116,16836,16102,55065
2089,55081,"Monroe County, Wisconsin",2010,17376,19204,1828,281,475,1661,43012,996,44673,41260,55081
2090,55073,"Marathon County, Wisconsin",2010,53176,57734,4558,7107,820,2992,131071,2137,134063,121007,55073
2091,55075,"Marinette County, Wisconsin",2010,17974,30379,12405,217,106,522,41227,644,41749,40260,55075
2092,55077,"Marquette County, Wisconsin",2010,6571,9896,3325,68,75,391,15013,173,15404,14697,55077
2093,55078,"Menominee County, Wisconsin",2010,1318,2253,935,1,19,178,4054,3587,4232,447,55078
2094,55079,"Milwaukee County, Wisconsin",2010,383591,418053,34462,32007,248794,126039,821696,25937,947735,514958,55079
2095,55093,"Pierce County, Wisconsin",2010,15002,16132,1130,299,223,623,40396,610,41019,39264,55093
2096,55083,"Oconto County, Wisconsin",2010,15415,23537,8122,110,68,519,37141,796,37660,36167,55083
2097,55085,"Oneida County, Wisconsin",2010,16003,30125,14122,188,150,385,35613,715,35998,34560,55085
2098,55087,"Outagamie County, Wisconsin",2010,69648,73149,3501,5208,1682,6359,170336,5080,176695,158366,55087
2099,55089,"Ozaukee County, Wisconsin",2010,34228,36267,2039,1505,1144,1956,84439,1101,86395,80689,55089
2100,55091,"Pepin County, Wisconsin",2010,3051,3579,528,13,18,72,7397,61,7469,7305,55091
2101,55109,"St. Croix County, Wisconsin",2010,31799,33983,2184,894,542,1692,82653,1322,84345,79895,55109
2102,55095,"Polk County, Wisconsin",2010,18004,24248,6244,148,91,656,43549,835,44205,42475,55095
2103,55097,"Portage County, Wisconsin",2010,27814,30054,2240,1955,362,1853,68166,952,70019,64897,55097
2104,55099,"Price County, Wisconsin",2010,6329,11120,4791,58,34,153,14006,253,14159,13661,55099
2105,55101,"Racine County, Wisconsin",2010,75651,82164,6513,2081,21212,22546,172862,4155,195408,145414,55101
2106,55103,"Richland County, Wisconsin",2010,7349,8868,1519,88,79,360,17661,179,18021,17315,55103
2107,55105,"Rock County, Wisconsin",2010,62905,68422,5517,1603,7766,12124,148207,3312,160331,135526,55105
2108,55107,"Rusk County, Wisconsin",2010,6232,8883,2651,41,56,173,14582,201,14755,14284,55107
2109,55131,"Washington County, Wisconsin",2010,51605,54695,3090,1401,1115,3385,128502,1638,131887,124348,55131
2110,55111,"Sauk County, Wisconsin",2010,25192,29708,4516,332,330,2675,59301,1308,61976,57331,55111
2111,55113,"Sawyer County, Wisconsin",2010,7038,15975,8937,49,76,268,16289,3160,16557,13004,55113
2112,55115,"Shawano County, Wisconsin",2010,17019,20720,3701,180,131,905,41044,3782,41949,36951,55115
2113,55117,"Sheboygan County, Wisconsin",2010,46390,50766,4376,5279,1605,6329,109178,1774,115507,100520,55117
2114,55119,"Taylor County, Wisconsin",2010,8388,10582,2194,54,54,316,20373,155,20689,20110,55119
2115,55121,"Trempealeau County, Wisconsin",2010,11524,12619,1095,119,54,1667,27149,202,28816,26774,55121
2116,55125,"Vilas County, Wisconsin",2010,9658,25116,15458,61,31,268,21162,2524,21430,18546,55125
2117,55123,"Vernon County, Wisconsin",2010,11616,13720,2104,92,106,394,29379,308,29773,28873,55123
2118,55127,"Walworth County, Wisconsin",2010,39699,51531,11832,819,904,10578,91650,1237,102228,88690,55127
2119,55129,"Washburn County, Wisconsin",2010,6916,12979,6063,59,26,208,15703,390,15911,15228,55129
2120,56001,"Albany County, Wyoming",2010,15691,17939,2248,1005,390,3202,33097,906,36299,30796,56001
2121,55133,"Waukesha County, Wisconsin",2010,152663,160864,8201,10675,4726,16123,373768,5253,389891,353114,55133
2122,55135,"Waupaca County, Wisconsin",2010,21387,25396,4009,190,149,1307,51103,614,52410,50150,55135
2123,55137,"Waushara County, Wisconsin",2010,9949,14843,4894,90,445,1329,23167,315,24496,22317,55137
2124,55139,"Winnebago County, Wisconsin",2010,67875,73329,5454,3795,2856,5784,161210,3050,166994,151509,55139
2125,55141,"Wood County, Wisconsin",2010,31598,34088,2490,1304,382,1680,73069,1206,74749,70177,55141
2126,56023,"Lincoln County, Wyoming",2010,6861,8946,2085,55,32,781,17325,308,18106,16930,56023
2127,56003,"Big Horn County, Wyoming",2010,4561,5379,818,37,25,984,10684,187,11668,10435,56003
2128,56005,"Campbell County, Wyoming",2010,17172,18955,1783,250,134,3611,42522,1106,46133,41032,56005
2129,56007,"Carbon County, Wyoming",2010,6388,8576,2188,103,109,2668,13217,322,15885,12683,56007
2130,56009,"Converse County, Wyoming",2010,5673,6403,730,41,43,867,12966,250,13833,12632,56009
2131,56011,"Crook County, Wyoming",2010,2921,3595,674,11,14,141,6942,123,7083,6794,56011
2132,56013,"Fremont County, Wyoming",2010,15455,17796,2341,151,86,2264,37859,8945,40123,28677,56013
2133,56015,"Goshen County, Wyoming",2010,5311,5972,661,32,70,1288,11961,208,13249,11651,56015
2134,56017,"Hot Springs County, Wyoming",2010,2185,2582,397,20,12,105,4707,125,4812,4550,56017
2135,56019,"Johnson County, Wyoming",2010,3782,4553,771,36,14,276,8293,151,8569,8092,56019
2136,56021,"Laramie County, Wyoming",2010,37576,40462,2886,935,2063,11978,79760,2642,91738,74120,56021
2137,13121,"Fulton County, Georgia",2010,376377,437105,60728,51304,400457,72566,848015,20240,920581,376014,13121
2138,13149,"Heard County, Georgia",2010,4400,5148,748,56,1152,223,11611,213,11834,10190,13149
2139,56025,"Natrona County, Wyoming",2010,30616,33807,3191,479,621,5231,70219,1928,75450,67191,56025
2140,56027,"Niobrara County, Wyoming",2010,1069,1338,269,9,4,52,2432,58,2484,2361,56027
2141,13123,"Gilmer County, Georgia",2010,11314,16564,5250,65,98,2677,25615,374,28292,25078,13123
2142,13125,"Glascock County, Georgia",2010,1162,1519,357,1,251,33,3049,47,3082,2750,13125
2143,13133,"Greene County, Georgia",2010,6519,8688,2169,54,6078,893,15101,198,15994,8771,13133
2144,13135,"Gwinnett County, Georgia",2010,268519,291547,23028,84763,184122,162035,643286,20085,805321,354316,13135
2145,13127,"Glynn County, Georgia",2010,31774,40716,8942,894,20525,5126,74500,1479,79626,51602,13127
2146,13131,"Grady County, Georgia",2010,9418,10760,1342,94,7129,2500,22511,409,25011,14879,13131
2147,13139,"Hall County, Georgia",2010,60691,68825,8134,3181,12757,46906,132778,2540,179684,114300,13139
2148,22009,"Avoyelles Parish, Louisiana",2010,15432,18042,2610,140,12318,606,41467,1132,42073,27877,22009
2149,22013,"Bienville Parish, Louisiana",2010,5838,7718,1880,34,6048,207,14146,214,14353,7850,22013
2150,22023,"Cameron Parish, Louisiana",2010,2575,3593,1018,6,119,154,6685,95,6839,6465,22023
2151,22015,"Bossier Parish, Louisiana",2010,45215,49351,4136,1873,24245,7026,109953,2844,116979,80991,22015
2152,22017,"Caddo Parish, Louisiana",2010,102139,112028,9889,2653,119697,6129,248840,4521,254969,121969,22017
2153,22019,"Calcasieu Parish, Louisiana",2010,73996,82058,8062,2052,47490,4945,187823,4578,192768,133703,22019
2154,22021,"Caldwell Parish, Louisiana",2010,3905,4994,1089,25,1735,222,9910,105,10132,8045,22021
2155,22035,"East Carroll Parish, Louisiana",2010,2552,2904,352,44,5324,127,7632,66,7759,2198,22035
2156,22025,"Catahoula Parish, Louisiana",2010,3834,4877,1043,3,3273,90,10317,95,10407,6946,22025
2157,22027,"Claiborne Parish, Louisiana",2010,6017,7761,1744,39,8707,171,17024,194,17195,8084,22027
2158,22029,"Concordia Parish, Louisiana",2010,7613,9383,1770,49,8503,209,20613,232,20822,11829,22029
2159,22031,"De Soto Parish, Louisiana",2010,10562,12290,1728,37,10402,661,25995,464,26656,15092,22031
2160,22033,"East Baton Rouge Parish, Louisiana",2010,172057,187353,15296,12290,198590,16274,423897,6353,440171,206664,22033
2161,22057,"Lafourche Parish, Louisiana",2010,35486,38582,3096,707,12679,3647,92671,4205,96318,75080,22057
2162,22037,"East Feliciana Parish, Louisiana",2010,7022,8014,992,51,9052,208,20059,290,20267,10666,22037
2163,13141,"Hancock County, Georgia",2010,3341,5360,2019,47,6959,139,9290,72,9429,2212,13141
2164,13143,"Haralson County, Georgia",2010,10757,12287,1530,139,1342,318,28462,465,28780,26516,13143
2165,13145,"Harris County, Georgia",2010,11823,13397,1574,280,5457,872,31152,567,32024,24848,13145
2166,13147,"Hart County, Georgia",2010,10121,13007,2886,211,4691,786,24427,312,25213,19213,13147
2167,13171,"Lamar County, Georgia",2010,6618,7474,856,68,5621,341,17976,344,18317,11943,13171
2168,13151,"Henry County, Georgia",2010,70255,76533,6278,5902,74056,11813,192109,5068,203922,107083,13151
2169,13153,"Houston County, Georgia",2010,53051,58325,5274,3360,39535,8515,131385,3787,139900,84703,13153
2170,13155,"Irwin County, Georgia",2010,3495,4033,538,61,2459,228,9310,71,9538,6719,13155
2171,13159,"Jasper County, Georgia",2010,5044,6153,1109,30,3030,510,13390,235,13900,10095,13159
2172,13161,"Jeff Davis County, Georgia",2010,5689,6488,799,70,2212,1577,13491,153,15068,11056,13161
2173,13163,"Jefferson County, Georgia",2010,6241,7298,1057,64,9187,517,16413,147,16930,7015,13163
2174,13165,"Jenkins County, Georgia",2010,3192,4221,1029,36,3353,334,8006,109,8340,4508,13165
2175,13167,"Johnson County, Georgia",2010,3347,4120,773,22,3461,186,9794,92,9980,6219,13167
2176,13169,"Jones County, Georgia",2010,10586,11688,1102,186,6977,315,28354,361,28669,20830,13169
2177,13129,"Gordon County, Georgia",2010,19715,22278,2563,522,1945,7738,47448,874,55186,44107,13129
2178,13137,"Habersham County, Georgia",2010,15472,18146,2674,955,1412,5333,37708,720,43041,34621,13137
2179,13157,"Jackson County, Georgia",2010,21343,23752,2409,1026,4050,3736,56749,978,60485,50695,13157
2180,13193,"Macon County, Georgia",2010,4999,6136,1137,190,8902,527,14213,160,14740,4961,13193
2181,13173,"Lanier County, Georgia",2010,3608,4249,641,101,2367,461,9617,250,10078,6899,13173
2182,13175,"Laurens County, Georgia",2010,18641,21368,2727,478,17268,1143,47291,625,48434,28920,13175
2183,13177,"Lee County, Georgia",2010,9706,10276,570,609,5239,560,27738,437,28298,21453,13177
2184,13179,"Liberty County, Georgia",2010,22155,26731,4576,1182,26018,6159,57294,3009,63453,27085,13179
2185,13181,"Lincoln County, Georgia",2010,3281,4786,1505,32,2562,98,7898,103,7996,5201,13181
2186,13183,"Long County, Georgia",2010,5023,6039,1016,110,3541,1778,12686,544,14464,8491,13183
2187,13185,"Lowndes County, Georgia",2010,39747,43921,4174,1561,38815,5238,103995,2385,109233,61234,13185
2188,13187,"Lumpkin County, Georgia",2010,10989,12925,1936,133,310,1344,28622,660,29966,27519,13187
2189,13189,"McDuffie County, Georgia",2010,8289,9319,1030,74,8661,475,21400,355,21875,12310,13189
2190,13191,"McIntosh County, Georgia",2010,5971,9220,3249,45,5132,227,14106,213,14333,8716,13191
2191,13207,"Monroe County, Georgia",2010,9662,10710,1048,209,6249,535,25889,330,26424,19101,13207
2192,13195,"Madison County, Georgia",2010,10508,11784,1276,173,2320,1139,26981,382,28120,24106,13195
2193,13197,"Marion County, Georgia",2010,3420,4156,736,77,2837,570,8172,158,8742,5100,13197
2194,13199,"Meriwether County, Georgia",2010,8522,9957,1435,141,8583,347,21645,315,21992,12606,13199
2195,13201,"Miller County, Georgia",2010,2426,2791,365,23,1697,93,6032,75,6125,4237,13201
2196,13205,"Mitchell County, Georgia",2010,8055,8996,941,120,11185,1028,22470,271,23498,10894,13205
2197,13219,"Oconee County, Georgia",2010,11622,12383,761,1016,1610,1436,31372,440,32808,28306,13219
2198,13209,"Montgomery County, Georgia",2010,3287,3921,634,26,2372,480,8643,101,9123,6144,13209
2199,13211,"Morgan County, Georgia",2010,6660,7472,812,106,4199,494,17374,255,17868,12814,13211
2200,13213,"Murray County, Georgia",2010,14080,15979,1899,110,212,5154,34474,486,39628,33666,13213
2201,13215,"Muscogee County, Georgia",2010,74081,82690,8609,4061,85119,12110,177775,5705,189885,82890,13215
2202,13217,"Newton County, Georgia",2010,34390,38342,3952,881,40371,4635,95323,2076,99958,51995,13217
2203,27055,"Houston County, Minnesota",2010,7849,8601,752,86,98,132,18895,229,19027,18482,27055
2204,27059,"Isanti County, Minnesota",2010,13972,15321,1349,302,228,582,37234,746,37816,35958,27059
2205,27061,"Itasca County, Minnesota",2010,18773,27065,8292,142,136,417,44641,2412,45058,41951,27061
2206,27071,"Koochiching County, Minnesota",2010,5874,7900,2026,44,76,147,13164,532,13311,12512,27071
2207,13221,"Oglethorpe County, Georgia",2010,5647,6484,837,65,2557,546,14353,302,14899,11429,13221
2208,13223,"Paulding County, Georgia",2010,48105,52130,4025,1237,23810,7264,135060,3274,142324,106739,13223
2209,13231,"Pike County, Georgia",2010,6187,6820,633,55,1825,193,17676,290,17869,15506,13231
2210,13233,"Polk County, Georgia",2010,15092,16908,1816,270,5150,4885,36590,678,41475,30492,13233
2211,13225,"Peach County, Georgia",2010,9958,11050,1092,222,12647,1890,25805,437,27695,12499,13225
2212,13227,"Pickens County, Georgia",2010,11291,13692,2401,118,297,819,28612,395,29431,27802,13227
2213,13229,"Pierce County, Georgia",2010,7083,7986,903,58,1646,887,17871,307,18758,15860,13229
2214,27063,"Jackson County, Minnesota",2010,4429,4990,561,136,47,277,9989,105,10266,9701,27063
2215,27065,"Kanabec County, Minnesota",2010,6413,7849,1436,53,52,214,16025,314,16239,15606,27065
2216,27067,"Kandiyohi County, Minnesota",2010,16732,19476,2744,167,952,4710,37529,446,42239,35964,27067
2217,27069,"Kittson County, Minnesota",2010,1986,2605,619,14,11,69,4483,24,4552,4434,27069
2218,27083,"Lyon County, Minnesota",2010,10227,11098,871,677,575,1541,24316,427,25857,22637,27083
2219,27073,"Lac qui Parle County, Minnesota",2010,3155,3692,537,29,17,108,7151,65,7259,7040,27073
2220,27075,"Lake County, Minnesota",2010,4825,7681,2856,31,16,80,10786,181,10866,10558,27075
2221,27077,"Lake of the Woods County, Minnesota",2010,1784,3672,1888,32,13,35,4010,102,4045,3863,27077
2222,27079,"Le Sueur County, Minnesota",2010,10758,12416,1658,159,88,1444,26259,321,27703,25691,27079
2223,27081,"Lincoln County, Minnesota",2010,2574,3108,534,14,8,72,5824,53,5896,5749,27081
2224,27095,"Mille Lacs County, Minnesota",2010,10166,12750,2584,79,96,377,25720,1963,26097,23582,27095
2225,22039,"Evangeline Parish, Louisiana",2010,12829,14662,1833,112,9565,776,33208,460,33984,23071,22039
2226,22041,"Franklin Parish, Louisiana",2010,7904,9034,1130,42,6500,196,20571,176,20767,13853,22041
2227,22049,"Jackson Parish, Louisiana",2010,6261,7680,1419,28,4829,209,16065,219,16274,10989,22049
2228,22051,"Jefferson Parish, Louisiana",2010,169647,189135,19488,16542,112013,53702,378850,8027,432552,242268,22051
2229,22043,"Grant Parish, Louisiana",2010,7496,8886,1390,53,3441,931,21378,523,22309,17361,22043
2230,22045,"Iberia Parish, Louisiana",2010,26778,29698,2920,1745,23280,2299,70941,1414,73240,44502,22045
2231,22047,"Iberville Parish, Louisiana",2010,11072,12707,1635,101,16338,664,32723,297,33387,15987,22047
2232,22053,"Jefferson Davis Parish, Louisiana",2010,11771,13306,1535,62,5450,538,31056,709,31594,24835,22053
2233,22055,"Lafayette Parish, Louisiana",2010,87027,93656,6629,3293,56633,8597,212981,4083,221578,148972,22055
2234,22069,"Natchitoches Parish, Louisiana",2010,15614,18587,2973,134,16296,735,38831,1292,39566,21109,22069
2235,22059,"La Salle Parish, Louisiana",2010,5468,6560,1092,26,1758,331,14559,255,14890,12520,22059
2236,22061,"Lincoln Parish, Louisiana",2010,17599,19479,1880,786,18860,1189,45546,587,46735,25313,22061
2237,22063,"Livingston Parish, Louisiana",2010,46007,50170,4163,616,6455,3801,124225,1792,128026,115362,22063
2238,22065,"Madison Parish, Louisiana",2010,4025,4804,779,26,7357,188,11905,126,12093,4396,22065
2239,22067,"Morehouse Parish, Louisiana",2010,10853,12423,1570,98,13078,255,27724,297,27979,14251,22067
2240,22091,"St. Helena Parish, Louisiana",2010,4333,5150,817,9,5964,99,11104,132,11203,4999,22091
2241,22071,"Orleans Parish, Louisiana",2010,142158,189896,47738,9883,204866,18051,325778,6259,343829,104770,22071
2242,22073,"Ouachita Parish, Louisiana",2010,58691,64481,5790,1429,55946,2760,150960,2012,153720,91573,22073
2243,22075,"Plaquemines Parish, Louisiana",2010,8077,9596,1519,726,4675,1067,21975,957,23042,15617,22075
2244,22077,"Pointe Coupee Parish, Louisiana",2010,9082,11130,2048,57,8247,492,22310,258,22802,13748,22077
2245,22079,"Rapides Parish, Louisiana",2010,50401,55684,5283,1545,41937,3418,128195,3090,131613,81623,22079
2246,22081,"Red River Parish, Louisiana",2010,3472,4128,656,12,3586,101,8990,87,9091,5305,22081
2247,22083,"Richland Parish, Louisiana",2010,7551,8621,1070,54,7406,332,20393,219,20725,12714,22083
2248,22085,"Sabine Parish, Louisiana",2010,9622,14130,4508,53,4009,820,23413,2575,24233,16776,22085
2249,22089,"St. Charles Parish, Louisiana",2010,18557,19896,1339,435,13925,2648,50132,847,52780,34925,22089
2250,22087,"St. Bernard Parish, Louisiana",2010,13221,16794,3573,678,6272,3309,32588,1031,35897,24607,22087
2251,22103,"St. Tammany Parish, Louisiana",2010,87521,95412,7891,2914,26430,10970,222770,5109,233740,188317,22103
2252,22093,"St. James Parish, Louisiana",2010,7717,8455,738,29,11145,256,21846,194,22102,10478,22093
2253,22095,"St. John the Baptist Parish, Louisiana",2010,15965,17510,1545,312,24405,2175,43749,658,45924,18374,22095
2254,22097,"St. Landry Parish, Louisiana",2010,31857,35692,3835,314,34295,1321,82063,1429,83384,46025,22097
2255,22099,"St. Martin Parish, Louisiana",2010,19216,21941,2725,393,15956,1071,51089,909,52160,33831,22099
2256,22101,"St. Mary Parish, Louisiana",2010,20457,23028,2571,935,17648,2920,51730,1880,54650,31267,22101
2257,22119,"Webster Parish, Louisiana",2010,16537,19336,2799,116,13756,670,40537,598,41207,26067,22119
2258,22105,"Tangipahoa Parish, Louisiana",2010,45135,50073,4938,714,36485,4260,116837,1831,121097,77807,22105
2259,22107,"Tensas Parish, Louisiana",2010,2172,3357,1185,8,2957,65,5187,44,5252,2178,22107
2260,22109,"Terrebonne Parish, Louisiana",2010,40091,43887,3796,1127,21046,4421,107439,8477,111860,76789,22109
2261,22111,"Union Parish, Louisiana",2010,9144,11346,2202,31,6153,943,21778,196,22721,15398,22111
2262,22113,"Vermilion Parish, Louisiana",2010,21889,25235,3346,1148,8246,1381,56618,919,57999,46305,22113
2263,22115,"Vernon Parish, Louisiana",2010,19165,21433,2268,881,7280,3775,48559,2604,52334,37794,22115
2264,22117,"Washington Parish, Louisiana",2010,18113,21039,2926,108,14561,887,46281,593,47168,31019,22117
2265,42101,"Philadelphia County, Pennsylvania",2010,599736,670171,70435,95521,644287,187611,1338395,36002,1526006,562585,42101
2266,42103,"Pike County, Pennsylvania",2010,21925,38350,16425,583,3050,5173,52196,1014,57369,47549,42103
2267,42129,"Westmoreland County, Pennsylvania",2010,153650,168199,14549,2692,8425,3179,361990,4762,365169,346111,42129
2268,22127,"Winn Parish, Louisiana",2010,5469,7234,1765,39,4666,240,15073,260,15313,10108,22127
2269,42105,"Potter County, Pennsylvania",2010,7227,12932,5705,45,61,181,17276,170,17457,17000,42105
2270,42107,"Schuylkill County, Pennsylvania",2010,60192,69323,9131,703,3841,4080,144209,1417,148289,138248,42107
2271,42109,"Snyder County, Pennsylvania",2010,14750,16027,1277,211,375,657,39045,332,39702,38127,42109
2272,42111,"Somerset County, Pennsylvania",2010,31090,38113,7023,238,1856,840,76902,543,77742,74265,42111
2273,42113,"Sullivan County, Pennsylvania",2010,2777,6304,3527,19,163,92,6336,65,6428,6089,42113
2274,42115,"Susquehanna County, Pennsylvania",2010,17798,22968,5170,121,150,564,42792,404,43356,42117,42115
2275,42117,"Tioga County, Pennsylvania",2010,16727,21364,4637,181,322,437,41544,481,41981,40560,42117
2276,42119,"Union County, Pennsylvania",2010,14765,16997,2232,520,3048,2346,42601,722,44947,38311,42119
2277,42121,"Venango County, Pennsylvania",2010,22621,27464,4843,196,567,478,54506,691,54984,53052,42121
2278,42123,"Warren County, Pennsylvania",2010,17767,23560,5793,156,136,305,41510,391,41815,40827,42123
2279,42125,"Washington County, Pennsylvania",2010,85089,92977,7888,1313,6650,2366,205454,3320,207820,194171,42125
2280,42131,"Wyoming County, Pennsylvania",2010,11237,13254,2017,94,185,437,27839,290,28276,27270,42131
2281,42127,"Wayne County, Pennsylvania",2010,20625,31653,11028,252,1563,1816,51006,601,52822,48590,42127
2282,45009,"Bamberg County, South Carolina",2010,6048,7716,1668,68,9786,258,15729,184,15987,5691,45009
2283,42133,"York County, Pennsylvania",2010,168372,178671,10299,5336,22493,24397,410575,7967,434972,374779,42133
2284,44001,"Bristol County, Rhode Island",2010,19150,20850,1700,704,363,989,48886,767,49875,47052,44001
2285,27085,"McLeod County, Minnesota",2010,14639,15760,1121,265,184,1811,34840,386,36651,34005,27085
2286,27087,"Mahnomen County, Minnesota",2010,2019,2786,767,3,11,99,5314,2602,5413,2698,27087
2287,27089,"Marshall County, Minnesota",2010,3981,4812,831,18,25,337,9102,107,9439,8952,27089
2288,27091,"Martin County, Minnesota",2010,9035,10009,974,103,62,744,20096,165,20840,19766,27091
2289,27093,"Meeker County, Minnesota",2010,9176,10674,1498,59,68,767,22533,173,23300,22233,27093
2290,27115,"Pine County, Minnesota",2010,11373,17276,5903,129,576,723,29027,1398,29750,26924,27115
2291,27097,"Morrison County, Minnesota",2010,13080,15731,2651,101,122,402,32796,399,33198,32174,27097
2292,27099,"Mower County, Minnesota",2010,15828,17027,1199,636,791,4138,35025,623,39163,32975,27099
2293,27101,"Murray County, Minnesota",2010,3717,4556,839,78,20,242,8483,59,8725,8326,27101
2294,27103,"Nicollet County, Minnesota",2010,12201,12873,672,429,658,1226,31501,470,32727,29944,27103
2295,27105,"Nobles County, Minnesota",2010,7946,8535,589,1144,727,4820,16558,322,21378,14365,27105
2296,27107,"Norman County, Minnesota",2010,2863,3421,558,25,11,276,6576,247,6852,6293,27107
2297,27109,"Olmsted County, Minnesota",2010,57080,60495,3415,7771,6751,6081,138167,3297,144248,120348,27109
2298,27111,"Otter Tail County, Minnesota",2010,24055,35594,11539,264,422,1490,55813,883,57303,54244,27111
2299,27117,"Pipestone County, Minnesota",2010,4054,4483,429,69,52,355,9241,240,9596,8880,27117
2300,27113,"Pennington County, Minnesota",2010,5836,6297,461,86,181,380,13550,416,13930,12867,27113
2301,27133,"Rock County, Minnesota",2010,3918,4262,344,53,58,197,9490,140,9687,9239,27133
2302,27119,"Polk County, Minnesota",2010,12704,14610,1906,210,248,1720,29880,925,31600,28497,27119
2303,27121,"Pope County, Minnesota",2010,4736,6435,1699,39,35,95,10900,106,10995,10720,27121
2304,27123,"Ramsey County, Minnesota",2010,202691,217197,14506,59033,54835,36483,472157,18095,508640,340194,27123
2305,27125,"Red Lake County, Minnesota",2010,1737,1948,211,4,7,101,3988,101,4089,3876,27125
2306,27127,"Redwood County, Minnesota",2010,6580,7272,692,504,71,335,15724,1030,16059,14119,27127
2307,27129,"Renville County, Minnesota",2010,6564,7355,791,54,40,1046,14684,239,15730,14351,27129
2308,27131,"Rice County, Minnesota",2010,22315,24453,2138,1289,2021,5122,59020,1144,64142,54566,27131
2309,27145,"Stearns County, Minnesota",2010,56232,61974,5742,2949,4595,4190,146452,2494,150642,136414,27145
2310,27135,"Roseau County, Minnesota",2010,6300,7469,1169,385,37,116,15513,395,15629,14696,27135
2311,27137,"St. Louis County, Minnesota",2010,84783,103058,18275,1760,2688,2409,197817,8600,200226,184769,27137
2312,27139,"Scott County, Minnesota",2010,45108,47124,2016,7303,3298,5771,124157,3740,129928,109816,27139
2313,27141,"Sherburne County, Minnesota",2010,30212,32379,2167,1126,1644,1941,86558,1805,88499,81983,27141
2314,27143,"Sibley County, Minnesota",2010,6034,6582,548,80,41,1098,14128,172,15226,13835,27143
2315,27157,"Wabasha County, Minnesota",2010,8822,9997,1175,93,80,592,21084,199,21676,20712,27157
2316,27147,"Steele County, Minnesota",2010,14330,15343,1013,278,1003,2282,34294,469,36576,32544,27147
2317,27149,"Stevens County, Minnesota",2010,3726,4160,434,146,75,337,9389,237,9726,8931,27149
2318,27151,"Swift County, Minnesota",2010,4236,4835,599,21,48,350,9433,93,9783,9271,27151
2319,27153,"Todd County, Minnesota",2010,9756,12917,3161,102,73,1288,23607,380,24895,23052,27153
2320,27155,"Traverse County, Minnesota",2010,1524,2073,549,4,12,50,3508,168,3558,3324,27155
2321,30049,"Lewis and Clark County, Montana",2010,26694,30180,3486,350,203,1582,61813,2661,63395,58599,30049
2322,30061,"Mineral County, Montana",2010,1911,2446,535,30,9,80,4143,152,4223,3952,30061
2323,27159,"Wadena County, Minnesota",2010,5705,6899,1194,36,109,176,13667,260,13843,13262,27159
2324,27161,"Waseca County, Minnesota",2010,7281,7903,622,127,371,985,18151,345,19136,17308,27161
2325,27163,"Washington County, Minnesota",2010,87859,92374,4515,12023,8376,8127,230009,5499,238136,204111,27163
2326,27165,"Watonwan County, Minnesota",2010,4520,5047,527,86,74,2338,8873,81,11211,8632,27165
2327,27167,"Wilkin County, Minnesota",2010,2690,3078,388,18,13,130,6446,121,6576,6294,27167
2328,30057,"Madison County, Montana",2010,3560,6940,3380,26,15,186,7505,129,7691,7335,30057
2329,30059,"Meagher County, Montana",2010,806,1432,626,6,2,28,1863,28,1891,1827,30059
2330,30051,"Liberty County, Montana",2010,822,1043,221,3,2,8,2331,33,2339,2293,30051
2331,30053,"Lincoln County, Montana",2010,8843,11413,2570,58,20,462,19225,601,19687,18546,30053
2332,30055,"McCone County, Montana",2010,774,1008,234,2,3,13,1721,27,1734,1689,30055
2333,30073,"Pondera County, Montana",2010,2285,2659,374,13,7,87,6066,986,6153,5060,30073
2334,30063,"Missoula County, Montana",2010,45926,50106,4180,1220,412,2861,106438,5317,109299,99489,30063
2335,30065,"Musselshell County, Montana",2010,2046,2654,608,10,10,118,4420,122,4538,4278,30065
2336,30067,"Park County, Montana",2010,7310,9375,2065,51,19,325,15311,348,15636,14893,30067
2337,30069,"Petroleum County, Montana",2010,225,324,99,0,0,5,489,3,494,486,30069
2338,30071,"Phillips County, Montana",2010,1819,2335,516,10,1,81,4172,496,4253,3665,30071
2339,30089,"Sanders County, Montana",2010,5121,6678,1557,32,17,233,11180,811,11413,10320,30089
2340,30075,"Powder River County, Montana",2010,755,1022,267,3,1,24,1719,70,1743,1645,30075
2341,30077,"Powell County, Montana",2010,2466,3105,639,31,65,117,6910,389,7027,6425,30077
2342,30079,"Prairie County, Montana",2010,551,673,122,6,0,16,1163,32,1179,1125,30079
2343,30081,"Ravalli County, Montana",2010,16933,19583,2650,205,72,1195,39017,976,40212,37764,30081
2344,30083,"Richland County, Montana",2010,4167,4550,383,24,12,297,9449,324,9746,9089,30083
2345,30085,"Roosevelt County, Montana",2010,3553,4063,510,45,12,132,10293,6527,10425,3709,30085
2346,30087,"Rosebud County, Montana",2010,3395,4057,662,42,23,313,8920,3299,9233,5556,30087
2347,44003,"Kent County, Rhode Island",2010,68645,73701,5056,3346,2157,5309,160849,3205,166158,152141,44003
2348,44005,"Newport County, Rhode Island",2010,34911,41796,6885,1263,2645,3512,79376,2632,82888,72836,44005
2349,44007,"Providence County, Rhode Island",2010,241717,264835,23118,22621,45048,117819,508848,26853,626667,414326,44007
2350,44009,"Washington County, Rhode Island",2010,49177,62206,13029,2054,1347,3026,123953,3222,126979,117330,44009
2351,45001,"Abbeville County, South Carolina",2010,9990,12079,2089,75,7160,255,25162,363,25417,17564,45001
2352,45005,"Allendale County, South Carolina",2010,3706,4486,780,41,7645,239,10180,84,10419,2410,45005
2353,45007,"Anderson County, South Carolina",2010,73829,84774,10945,1384,29810,5447,181679,3123,187126,147362,45007
2354,45021,"Cherokee County, South Carolina",2010,21519,23997,2478,308,11214,2032,53310,849,55342,40939,45021
2355,45011,"Barnwell County, South Carolina",2010,8937,10484,1547,126,9964,411,22210,405,22621,11715,45011
2356,45013,"Beaufort County, South Carolina",2010,64945,93023,28078,1822,30662,19567,142666,2903,162233,107279,45013
2357,45015,"Berkeley County, South Carolina",2010,65419,73372,7953,3981,44023,10755,167088,5531,177843,113553,45015
2358,45017,"Calhoun County, South Carolina",2010,6080,7340,1260,31,6420,458,14717,207,15175,8059,45017
2359,45019,"Charleston County, South Carolina",2010,144309,169984,25675,4660,103479,18877,331332,5933,350209,217260,45019
2360,45003,"Aiken County, South Carolina",2010,64253,72249,7996,1318,39043,7824,152275,3348,160099,108566,45003
2361,45037,"Edgefield County, South Carolina",2010,9348,10559,1211,94,9951,1414,25571,330,26985,15196,45037
2362,45023,"Chester County, South Carolina",2010,12876,14701,1825,104,12349,479,32661,618,33140,19590,45023
2363,45025,"Chesterfield County, South Carolina",2010,18173,21482,3309,171,15179,1666,45068,928,46734,28790,45025
2364,45027,"Clarendon County, South Carolina",2010,13132,17467,4335,222,17379,899,34072,311,34971,16160,45027
2365,45033,"Dillon County, South Carolina",2010,11923,13742,1819,76,14730,833,31229,1271,32062,15152,45033
2366,45035,"Dorchester County, South Carolina",2010,50259,55186,4927,2016,34861,6075,130480,4176,136555,89427,45035
2367,45029,"Colleton County, South Carolina",2010,15131,19901,4770,125,15109,1094,37798,828,38892,21736,45029
2368,45031,"Darlington County, South Carolina",2010,26531,30297,3766,201,28463,1140,67541,884,68681,37993,45031
2369,45049,"Hampton County, South Carolina",2010,7598,9140,1542,106,11264,744,20346,277,21090,8699,45049
2370,45039,"Fairfield County, South Carolina",2010,9419,11681,2262,54,14112,374,23582,318,23956,9098,45039
2371,45041,"Florence County, South Carolina",2010,52653,58666,6013,1660,56204,3030,133855,1886,136885,74105,45041
2372,45043,"Georgetown County, South Carolina",2010,24524,33672,9148,269,20128,1867,58291,583,60158,37311,45043
2373,45045,"Greenville County, South Carolina",2010,176531,195462,18931,8772,80569,36495,414730,8192,451225,317197,45045
2374,45047,"Greenwood County, South Carolina",2010,27547,31054,3507,568,21728,3789,65872,867,69661,42709,45047
2375,45065,"McCormick County, South Carolina",2010,4027,5453,1426,34,5069,81,10152,108,10233,4941,45065
2376,45051,"Horry County, South Carolina",2010,112225,185992,73767,2774,35753,16683,252608,5985,269291,208096,45051
2377,45053,"Jasper County, South Carolina",2010,8517,10299,1782,169,11303,3752,21025,290,24777,9263,45053
2378,45055,"Kershaw County, South Carolina",2010,23928,27478,3550,296,15057,2298,59399,1037,61697,43009,45055
2379,45057,"Lancaster County, South Carolina",2010,29697,32687,2990,492,18162,3384,73268,1124,76652,53490,45057
2380,45059,"Laurens County, South Carolina",2010,25525,30709,5184,175,16808,2729,63808,925,66537,45900,45059
2381,45061,"Lee County, South Carolina",2010,6797,7775,978,58,12315,334,18886,191,19220,6322,45061
2382,45063,"Lexington County, South Carolina",2010,102733,113957,11224,3693,36995,14529,247862,5228,262391,201946,45063
2383,51550,"Chesapeake city, Virginia",2010,79574,83196,3622,6289,65204,9706,212503,6759,222209,134251,51550
2384,45073,"Oconee County, South Carolina",2010,30676,38763,8087,421,5550,3349,70924,1146,74273,63807,45073
2385,51191,"Washington County, Virginia",2010,22843,25601,2758,202,686,724,54152,466,54876,52798,51191
2386,51193,"Westmoreland County, Virginia",2010,7310,10618,3308,91,4855,1002,16452,419,17454,11087,51193
2387,51195,"Wise County, Virginia",2010,15968,17940,1972,141,2118,471,40981,421,41452,38301,51195
2388,51197,"Wythe County, Virginia",2010,12472,14079,1607,124,809,280,28955,373,29235,27649,51197
2389,51199,"York County, Virginia",2010,24006,26849,2843,3169,8599,2892,62572,2334,65464,48470,51199
2390,51530,"Buena Vista city, Virginia",2010,2603,2936,333,29,345,103,6547,191,6650,5982,51530
2391,51540,"Charlottesville city, Virginia",2010,17778,19189,1411,2758,8344,2223,41252,1323,43475,28827,51540
2392,51510,"Alexandria city, Virginia",2010,68082,72376,4294,8351,29778,22524,117442,4435,139966,74878,51510
2393,51515,"Bedford city, Virginia",2010,2627,2920,293,41,1245,134,6088,131,6222,4671,51515
2394,51520,"Bristol city, Virginia",2010,7879,8831,952,121,1000,221,17614,394,17835,16099,51520
2395,51610,"Falls Church city, Virginia",2010,5101,5489,388,1150,523,1109,11223,457,12332,9093,51610
2396,51570,"Colonial Heights city, Virginia",2010,7275,7831,556,570,1732,674,16737,415,17411,14020,51570
2397,51580,"Covington city, Virginia",2010,2632,3067,435,33,741,92,5869,140,5961,4955,51580
2398,51590,"Danville city, Virginia",2010,18831,22438,3607,394,20725,1245,41810,584,43055,20107,51590
2399,51595,"Emporia city, Virginia",2010,2316,2565,249,43,3685,262,5665,89,5927,1848,51595
2400,51600,"Fairfax city, Virginia",2010,8347,8680,333,3403,1030,3556,19009,727,22565,13849,51600
2401,51690,"Martinsville city, Virginia",2010,6084,7205,1121,127,6191,552,13269,244,13821,6707,51690
2402,51620,"Franklin city, Virginia",2010,3530,3901,371,63,4867,141,8441,178,8582,3333,51620
2403,51630,"Fredericksburg city, Virginia",2010,9505,10467,962,670,5367,2607,21679,882,24286,14760,51630
2404,51640,"Galax city, Virginia",2010,2922,3252,330,37,407,989,6053,108,7042,5501,51640
2405,51650,"Hampton city, Virginia",2010,55031,59566,4535,2950,66878,6241,131195,5084,137436,56283,51650
2406,30101,"Toole County, Montana",2010,2015,2336,321,23,28,129,5195,331,5324,4813,30101
2407,30091,"Sheridan County, Montana",2010,1587,2089,502,14,7,51,3333,111,3384,3201,30091
2408,30093,"Silver Bow County, Montana",2010,14932,16717,1785,161,103,1253,32947,1168,34200,31515,30093
2409,30095,"Stillwater County, Montana",2010,3796,4803,1007,28,9,214,8903,178,9117,8688,30095
2410,30097,"Sweet Grass County, Montana",2010,1590,2148,558,22,4,51,3600,83,3651,3491,30097
2411,30099,"Teton County, Montana",2010,2450,2892,442,8,3,76,5997,194,6073,5792,30099
2412,31013,"Box Butte County, Nebraska",2010,4738,5478,740,33,49,1157,10151,505,11308,9564,31013
2413,30103,"Treasure County, Montana",2010,335,422,87,3,0,25,693,24,718,666,30103
2414,30105,"Valley County, Montana",2010,3198,4879,1681,36,17,91,7278,861,7369,6364,30105
2415,30107,"Wheatland County, Montana",2010,887,1197,310,11,7,32,2136,54,2168,2064,30107
2416,30109,"Wibaux County, Montana",2010,457,538,81,5,0,13,1004,12,1017,987,30109
2417,30111,"Yellowstone County, Montana",2010,60672,63943,3271,915,852,6955,141017,8787,147972,130463,30111
2418,31001,"Adams County, Nebraska",2010,12466,13350,884,436,219,2544,28820,418,31364,27747,31001
2419,31009,"Blaine County, Nebraska",2010,196,326,130,0,1,0,478,3,478,474,31009
2420,31011,"Boone County, Nebraska",2010,2336,2649,313,10,23,65,5440,24,5505,5383,31011
2421,31015,"Boyd County, Nebraska",2010,942,1390,448,17,1,33,2066,24,2099,2024,31015
2422,31005,"Arthur County, Nebraska",2010,187,254,67,1,0,19,441,5,460,435,31005
2423,31003,"Antelope County, Nebraska",2010,2841,3284,443,20,19,178,6507,50,6685,6418,31003
2424,31007,"Banner County, Nebraska",2010,293,369,76,0,0,26,664,8,690,656,31007
2425,31017,"Brown County, Nebraska",2010,1449,1865,416,7,2,29,3116,35,3145,3072,31017
2426,31021,"Burt County, Nebraska",2010,2906,3467,561,17,23,126,6732,172,6858,6520,31021
2427,31023,"Butler County, Nebraska",2010,3391,4053,662,27,24,195,8200,57,8395,8092,31023
2428,31027,"Cedar County, Nebraska",2010,3539,4148,609,7,7,113,8739,66,8852,8659,31027
2429,31025,"Cass County, Nebraska",2010,9698,11117,1419,84,82,608,24633,384,25241,24083,31025
2430,31019,"Buffalo County, Nebraska",2010,18037,19064,1027,587,354,3432,42670,601,46102,41128,31019
2431,31039,"Cuming County, Nebraska",2010,3756,4204,448,17,8,754,8385,89,9139,8271,31039
2432,31029,"Chase County, Nebraska",2010,1681,1946,265,4,5,442,3524,24,3966,3491,31029
2433,31031,"Cherry County, Nebraska",2010,2530,3157,627,20,11,95,5618,446,5713,5141,31031
2434,31033,"Cheyenne County, Nebraska",2010,4298,4888,590,158,19,610,9388,132,9998,9079,31033
2435,31035,"Clay County, Nebraska",2010,2649,3001,352,10,21,502,6040,68,6542,5941,31035
2436,31037,"Colfax County, Nebraska",2010,3618,4097,479,24,49,4315,6200,96,10515,6031,31037
2437,56029,"Park County, Wyoming",2010,11885,13562,1677,164,50,1365,26840,536,28205,26090,56029
2438,13235,"Pulaski County, Georgia",2010,4475,5151,676,103,3808,465,11545,140,12010,7494,13235
2439,13257,"Stephens County, Georgia",2010,10289,12662,2373,175,2821,633,25542,540,26175,22006,13257
2440,31041,"Custer County, Nebraska",2010,4714,5579,865,15,28,216,10723,129,10939,10551,31041
2441,31043,"Dakota County, Nebraska",2010,7218,7631,413,621,641,7419,13587,729,21006,11596,31043
2442,31045,"Dawes County, Nebraska",2010,3684,4252,568,94,130,306,8876,594,9182,8058,31045
2443,31047,"Dawson County, Nebraska",2010,8899,10123,1224,135,710,7746,16580,271,24326,15464,31047
2444,56031,"Platte County, Wyoming",2010,3838,4667,829,31,25,580,8087,123,8667,7908,56031
2445,56033,"Sheridan County, Wyoming",2010,12360,13939,1579,192,94,1013,28103,698,29116,27119,56033
2446,56035,"Sublette County, Wyoming",2010,3906,5770,1864,51,30,712,9535,194,10247,9260,56035
2447,56037,"Sweetwater County, Wyoming",2010,16475,18735,2260,324,415,6689,37117,946,43806,35432,56037
2448,56039,"Teton County, Wyoming",2010,8973,12813,3840,228,32,3191,18103,338,21294,17505,56039
2449,56041,"Uinta County, Wyoming",2010,7668,8713,1045,59,48,1855,19263,460,21118,18696,56041
2450,56045,"Weston County, Wyoming",2010,3021,3533,512,20,18,216,6992,192,7208,6762,56045
2451,56043,"Washakie County, Wyoming",2010,3492,3833,341,46,22,1162,7371,145,8533,7158,56043
2452,72001,"Adjuntas Municipio, Puerto Rico",2010,6851,8125,1274,1,2,19401,82,1,19483,78,72001
2453,72003,"Aguada Municipio, Puerto Rico",2010,15156,18258,3102,15,13,41701,258,12,41959,218,72003
2454,72015,"Arroyo Municipio, Puerto Rico",2010,7191,8875,1684,4,32,19390,185,21,19575,128,72015
2455,72017,"Barceloneta Municipio, Puerto Rico",2010,9165,10693,1528,16,17,24659,157,5,24816,119,72017
2456,72005,"Aguadilla Municipio, Puerto Rico",2010,23552,28430,4878,58,105,60046,903,38,60949,702,72005
2457,72007,"Aguas Buenas Municipio, Puerto Rico",2010,10040,11490,1450,6,12,28513,146,21,28659,107,72007
2458,72009,"Aibonito Municipio, Puerto Rico",2010,9367,10409,1042,3,9,25729,171,18,25900,141,72009
2459,72011,"Añasco Municipio, Puerto Rico",2010,10942,12755,1813,8,22,29034,227,9,29261,188,72011
2460,72013,"Arecibo Municipio, Puerto Rico",2010,36579,43253,6674,53,69,95677,763,54,96440,587,72013
2461,72019,"Barranquitas Municipio, Puerto Rico",2010,10191,11404,1213,4,13,30110,208,18,30318,173,72019
2462,72021,"Bayamón Municipio, Puerto Rico",2010,76834,86060,9226,258,239,206008,2108,178,208116,1433,72021
2463,72023,"Cabo Rojo Municipio, Puerto Rico",2010,19816,30206,10390,17,36,50376,541,33,50917,455,72023
2464,72025,"Caguas Municipio, Puerto Rico",2010,53273,60371,7098,141,131,141668,1225,101,142893,852,72025
2465,72027,"Camuy Municipio, Puerto Rico",2010,12752,14431,1679,8,9,34950,209,16,35159,176,72027
2466,72029,"Canóvanas Municipio, Puerto Rico",2010,16579,19474,2895,9,120,47285,363,25,47648,209,72029
2467,51660,"Harrisonburg city, Virginia",2010,15988,17444,1456,1705,2911,7665,41249,1242,48914,35391,51660
2468,51670,"Hopewell city, Virginia",2010,9129,10121,992,174,8216,1480,21111,716,22591,12005,51670
2469,51678,"Lexington city, Virginia",2010,2237,2546,309,153,668,271,6771,143,7042,5807,51678
2470,51680,"Lynchburg city, Virginia",2010,28476,31992,3516,1852,21984,2300,73268,1858,75568,47574,51680
2471,51685,"Manassas Park city, Virginia",2010,4507,4904,397,1261,1784,4645,9628,513,14273,6070,51685
2472,51683,"Manassas city, Virginia",2010,12527,13123,596,1861,4905,11876,25945,1185,37821,17994,51683
2473,51740,"Portsmouth city, Virginia",2010,37324,40806,3482,994,50327,2919,92616,2769,95535,38526,51740
2474,51700,"Newport News city, Virginia",2010,70664,76198,5534,4858,71727,13590,167129,7391,180719,83153,51700
2475,51710,"Norfolk city, Virginia",2010,86485,95018,8533,7861,102452,16144,226659,8883,242803,107463,51710
2476,51720,"Norton city, Virginia",2010,1750,1945,195,56,250,68,3890,106,3958,3478,51720
2477,51730,"Petersburg city, Virginia",2010,13634,16326,2692,263,25419,1216,31204,620,32420,4902,51730
2478,51735,"Poquoson city, Virginia",2010,4525,4726,201,259,78,221,11929,194,12150,11398,51735
2479,51820,"Waynesboro city, Virginia",2010,8903,9717,814,154,2176,1337,19669,635,21006,16704,51820
2480,51750,"Radford city, Virginia",2010,5990,6427,437,251,1262,385,16023,435,16408,14075,51750
2481,51760,"Richmond city, Virginia",2010,87151,98349,11198,4679,102264,12803,191411,4655,204214,79813,51760
2482,51770,"Roanoke city, Virginia",2010,42712,47453,4741,1676,27256,5345,91687,2713,97032,60042,51770
2483,51775,"Salem city, Virginia",2010,10045,10832,787,398,1732,601,24201,418,24802,21653,51775
2484,51790,"Staunton city, Virginia",2010,10480,11738,1258,182,2859,513,23233,608,23746,19584,51790
2485,51800,"Suffolk city, Virginia",2010,30868,33035,2167,1324,35771,2415,82170,2041,84585,43034,51800
2486,51810,"Virginia Beach city, Virginia",2010,165089,177879,12790,26312,83210,28987,409007,17015,437994,282470,51810
2487,53017,"Douglas County, Washington",2010,13894,16004,2110,269,85,11013,27418,994,38431,26070,53017
2488,53003,"Asotin County, Washington",2010,9236,9872,636,114,89,643,20980,751,21623,20026,53003
2489,53007,"Chelan County, Washington",2010,27827,35465,7638,570,177,18713,53740,1791,72453,51202,53007
2490,53005,"Benton County, Washington",2010,65304,68618,3314,4621,2031,32696,142481,5392,175177,130437,53005
2491,51830,"Williamsburg city, Virginia",2010,4571,5176,605,802,1918,941,13127,455,14068,9952,51830
2492,51840,"Winchester city, Virginia",2010,10607,11872,1265,599,2783,4041,22162,695,26203,18085,51840
2493,53001,"Adams County, Washington",2010,5720,6242,522,99,47,11099,7629,221,18728,7262,53001
2494,53009,"Clallam County, Washington",2010,31329,35582,4253,993,558,3627,67777,5826,71404,60400,53009
2495,53011,"Clark County, Washington",2010,158099,167413,9314,17276,8025,32166,393197,20103,425363,347793,53011
2496,53013,"Columbia County, Washington",2010,1762,2136,374,23,12,254,3824,140,4078,3649,53013
2497,53015,"Cowlitz County, Washington",2010,40244,43450,3206,1472,572,7975,94435,4566,102410,87825,53015
2498,53019,"Ferry County, Washington",2010,3190,4403,1213,52,18,254,7297,1565,7551,5662,53019
2499,53021,"Franklin County, Washington",2010,23245,24423,1178,1384,1339,40004,38159,1632,78163,33804,53021
2500,53023,"Garfield County, Washington",2010,989,1233,244,38,0,91,2175,35,2266,2102,53023
2501,72037,"Ceiba Municipio, Puerto Rico",2010,5213,7755,2542,7,23,13461,170,13,13631,127,72037
2502,72035,"Cayey Municipio, Puerto Rico",2010,17681,20935,3254,33,18,47806,313,17,48119,245,72035
2503,72031,"Carolina Municipio, Puerto Rico",2010,67192,79842,12650,305,378,174234,2528,214,176762,1631,72031
2504,72033,"Cataño Municipio, Puerto Rico",2010,10108,11203,1095,41,49,27866,274,16,28140,168,72033
2505,72039,"Ciales Municipio, Puerto Rico",2010,6487,7736,1249,0,4,18725,57,15,18782,38,72039
2506,72041,"Cidra Municipio, Puerto Rico",2010,15135,17103,1968,10,23,43239,241,22,43480,186,72041
2507,72043,"Coamo Municipio, Puerto Rico",2010,14281,16716,2435,12,21,40338,174,10,40512,131,72043
2508,72045,"Comerío Municipio, Puerto Rico",2010,7097,8091,994,1,9,20691,87,7,20778,70,72045
2509,72049,"Culebra Municipio, Puerto Rico",2010,749,1603,854,3,4,1668,150,3,1818,140,72049
2510,72051,"Dorado Municipio, Puerto Rico",2010,13342,16687,3345,48,48,37418,747,37,38165,614,72051
2511,72053,"Fajardo Municipio, Puerto Rico",2010,13922,19391,5469,44,111,36342,651,51,36993,445,72053
2512,72054,"Florida Municipio, Puerto Rico",2010,4494,5137,643,5,5,12624,56,0,12680,46,72054
2513,72047,"Corozal Municipio, Puerto Rico",2010,12446,13999,1553,5,25,36927,215,18,37142,167,72047
2514,72055,"Guánica Municipio, Puerto Rico",2010,7223,9666,2443,3,17,19301,126,7,19427,99,72055
2515,72057,"Guayama Municipio, Puerto Rico",2010,16244,19711,3467,19,74,44958,404,56,45362,255,72057
2516,72059,"Guayanilla Municipio, Puerto Rico",2010,7503,8725,1222,8,19,21475,106,14,21581,65,72059
2517,72061,"Guaynabo Municipio, Puerto Rico",2010,37402,42012,4610,129,234,96193,1731,105,97924,1263,72061
2518,72063,"Gurabo Municipio, Puerto Rico",2010,15753,18108,2355,25,45,45015,354,31,45369,253,72063
2519,72065,"Hatillo Municipio, Puerto Rico",2010,15386,17365,1979,28,33,41604,349,19,41953,269,72065
2520,72067,"Hormigueros Municipio, Puerto Rico",2010,6821,7783,962,11,7,17158,92,11,17250,63,72067
2521,72069,"Humacao Municipio, Puerto Rico",2010,21780,28100,6320,56,66,57856,610,53,58466,435,72069
2522,72075,"Juana Díaz Municipio, Puerto Rico",2010,17252,20019,2767,11,44,50437,310,33,50747,222,72075
2523,72077,"Juncos Municipio, Puerto Rico",2010,14382,16718,2336,10,47,40003,287,29,40290,201,72077
2524,72071,"Isabela Municipio, Puerto Rico",2010,17072,21267,4195,35,33,45193,438,25,45631,345,72071
2525,72073,"Jayuya Municipio, Puerto Rico",2010,5569,6541,972,7,6,16582,60,3,16642,44,72073
2526,72079,"Lajas Municipio, Puerto Rico",2010,9670,12397,2727,13,9,25578,175,6,25753,147,72079
2527,72081,"Lares Municipio, Puerto Rico",2010,11154,12956,1802,4,3,30535,218,10,30753,201,72081
2528,72083,"Las Marías Municipio, Puerto Rico",2010,3561,3987,426,1,1,9821,60,3,9881,55,72083
2529,72089,"Luquillo Municipio, Puerto Rico",2010,7302,10968,3666,22,70,19651,417,38,20068,287,72089
2530,72091,"Manatí Municipio, Puerto Rico",2010,16309,19260,2951,17,32,43779,334,15,44113,270,72091
2531,72085,"Las Piedras Municipio, Puerto Rico",2010,14058,16248,2190,18,20,38435,240,29,38675,173,72085
2532,72087,"Loíza Municipio, Puerto Rico",2010,10130,12689,2559,4,63,29883,177,20,30060,90,72087
2533,13237,"Putnam County, Georgia",2010,8601,12804,4203,107,5497,1347,19871,243,21218,14024,13237
2534,13239,"Quitman County, Georgia",2010,1053,2047,994,2,1198,34,2479,14,2513,1265,13239
2535,13241,"Rabun County, Georgia",2010,6780,12313,5533,114,144,1301,14975,249,16276,14468,13241
2536,13243,"Randolph County, Georgia",2010,3187,4153,966,22,4747,119,7600,50,7719,2781,13243
2537,13245,"Richmond County, Georgia",2010,76924,86331,9407,3278,107365,8207,192342,5463,200549,76236,13245
2538,13247,"Rockdale County, Georgia",2010,30027,33272,3245,1498,38996,8063,77152,1832,85215,34826,13247
2539,13249,"Schley County, Georgia",2010,1872,2208,336,36,1167,161,4849,34,5010,3612,13249
2540,13251,"Screven County, Georgia",2010,5596,6739,1143,56,6283,180,14413,176,14593,7898,13251
2541,13253,"Seminole County, Georgia",2010,3509,4797,1288,33,2887,204,8525,89,8729,5516,13253
2542,13255,"Spalding County, Georgia",2010,23565,26777,3212,567,20937,2451,61622,1132,64073,38986,13255
2543,13275,"Thomas County, Georgia",2010,17573,20177,2604,306,16416,1275,43445,642,44720,26081,13275
2544,13259,"Stewart County, Georgia",2010,1862,2383,521,44,2833,1454,4604,72,6058,1655,13259
2545,13261,"Sumter County, Georgia",2010,12123,13909,1786,418,16894,1717,31102,377,32819,13413,13261
2546,13263,"Talbot County, Georgia",2010,2832,3399,567,9,4039,91,6774,87,6865,2639,13263
2547,13271,"Telfair County, Georgia",2010,5543,7297,1754,90,5830,2026,14474,125,16500,8429,13271
2548,13273,"Terrell County, Georgia",2010,3519,4080,561,29,5683,157,9158,80,9315,3366,13273
2549,13265,"Taliaferro County, Georgia",2010,759,1015,256,8,1024,35,1682,25,1717,625,13265
2550,13267,"Tattnall County, Georgia",2010,8210,9966,1756,99,7424,2502,23018,299,25520,15196,13267
2551,13269,"Taylor County, Georgia",2010,3522,4563,1041,57,3485,164,8742,77,8906,5123,13269
2552,13291,"Union County, Georgia",2010,9116,14052,4936,75,95,519,20837,322,21356,20345,13291
2553,13277,"Tift County, Georgia",2010,14836,16434,1598,507,11549,4037,36081,470,40118,23555,13277
2554,13279,"Toombs County, Georgia",2010,10375,12144,1769,199,6716,3055,24168,366,27223,16887,13279
2555,13281,"Towns County, Georgia",2010,4510,7731,3221,43,39,206,10265,81,10471,10102,13281
2556,13283,"Treutlen County, Georgia",2010,2543,2992,449,13,2239,103,6782,64,6885,4466,13283
2557,13285,"Troup County, Georgia",2010,24828,28046,3218,1054,22319,2170,64874,1093,67044,40408,13285
2558,13287,"Turner County, Georgia",2010,3339,3841,502,40,3697,282,8648,91,8930,4820,13287
2559,13289,"Twiggs County, Georgia",2010,3634,4235,601,14,3703,124,8899,123,9023,5059,13289
2560,13303,"Washington County, Georgia",2010,7547,9047,1500,104,11124,407,20780,213,21187,9339,13303
2561,23001,"Androscoggin County, Maine",2010,44315,49090,4775,773,3858,1669,106033,2471,107702,98931,23001
2562,23003,"Aroostook County, Maine",2010,30961,39529,8568,310,430,667,71203,2122,71870,68341,23003
2563,23009,"Hancock County, Maine",2010,24221,40184,15963,445,206,594,53824,820,54418,52353,23009
2564,22121,"West Baton Rouge Parish, Louisiana",2010,8688,9324,636,72,8953,544,23244,288,23788,13931,22121
2565,22123,"West Carroll Parish, Louisiana",2010,4452,5046,594,26,1810,299,11305,132,11604,9337,22123
2566,22125,"West Feliciana Parish, Louisiana",2010,3971,5097,1126,31,7235,251,15374,106,15625,8002,22125
2567,23005,"Cumberland County, Maine",2010,117339,138657,21318,5705,6577,5045,276629,5879,281674,258468,23005
2568,23007,"Franklin County, Maine",2010,13000,21709,8709,129,70,315,30453,523,30768,29731,23007
2569,23025,"Somerset County, Maine",2010,21927,30569,8642,294,185,409,51819,903,52228,50437,23025
2570,23011,"Kennebec County, Maine",2010,51128,60972,9844,886,642,1504,120647,2570,122151,116549,23011
2571,23013,"Knox County, Maine",2010,17258,23744,6486,184,192,337,39399,686,39736,38337,23013
2572,23015,"Lincoln County, Maine",2010,15149,23493,8344,185,96,287,34170,452,34457,33437,23015
2573,23017,"Oxford County, Maine",2010,24300,36055,11755,355,202,587,57246,1105,57833,55584,23017
2574,23019,"Penobscot County, Maine",2010,62966,73860,10894,1405,1117,1620,152303,4081,153923,145700,23019
2575,23021,"Piscataquis County, Maine",2010,7825,15340,7515,128,52,169,17366,293,17535,16893,23021
2576,23023,"Sagadahoc County, Maine",2010,15088,18288,3200,258,237,453,34840,682,35293,33663,23023
2577,24017,"Charles County, Maryland",2010,51214,54963,3749,4296,59201,6259,140292,5890,146551,70905,24017
2578,23027,"Waldo County, Maine",2010,16431,21566,5135,149,122,349,38437,713,38786,37453,23027
2579,23029,"Washington County, Maine",2010,14302,23001,8699,148,132,452,32404,2126,32856,29998,23029
2580,23031,"York County, Maine",2010,81009,105773,24764,2088,1036,2478,194653,3107,197131,188422,23031
2581,24001,"Allegany County, Maryland",2010,29177,33311,4134,566,5959,1085,74002,1282,75087,66195,24001
2582,24003,"Anne Arundel County, Maryland",2010,199378,212562,13184,18154,81819,32902,504754,15395,537656,389386,24003
2583,24005,"Baltimore County, Maryland",2010,316715,335622,18907,39865,206913,33735,771294,19960,805029,504556,24005
2584,24015,"Cecil County, Maryland",2010,36867,41103,4236,1078,6080,3407,97701,2195,101108,88348,24015
2585,24013,"Carroll County, Maryland",2010,59786,62406,2620,2402,5229,4363,162771,2712,167134,152428,24013
2586,24009,"Calvert County, Maryland",2010,30873,33780,2907,1246,11816,2437,86300,2558,88737,70680,24009
2587,13293,"Upson County, Georgia",2010,10716,12161,1445,124,7544,588,26565,375,27153,18522,13293
2588,13295,"Walker County, Georgia",2010,26497,30100,3603,291,2809,1113,67643,1200,68756,63343,13295
2589,13297,"Walton County, Georgia",2010,29583,32435,2852,947,12993,2683,81085,1468,83768,65677,13297
2590,13299,"Ware County, Georgia",2010,13654,16326,2672,278,10662,1207,35105,582,36312,23583,13299
2591,13301,"Warren County, Georgia",2010,2315,2985,670,21,3584,54,5780,42,5834,2133,13301
2592,13319,"Wilkinson County, Georgia",2010,3666,4487,821,31,3664,214,9349,125,9563,5529,13319
2593,13311,"White County, Georgia",2010,10646,16062,5416,124,454,647,26497,466,27144,25453,13311
2594,13313,"Whitfield County, Georgia",2010,35180,39899,4719,1292,3631,32471,70128,1387,102599,63818,13313
2595,13305,"Wayne County, Georgia",2010,10562,12199,1637,160,5928,1719,28380,543,30099,21749,13305
2596,13307,"Webster County, Georgia",2010,1119,1523,404,7,1177,98,2701,25,2799,1492,13307
2597,13309,"Wheeler County, Georgia",2010,2152,2625,473,16,2582,356,7065,62,7421,4405,13309
2598,13315,"Wilcox County, Georgia",2010,2891,3510,619,41,3233,338,8917,99,9255,5544,13315
2599,13317,"Wilkes County, Georgia",2010,4263,5158,895,48,4516,361,10232,173,10593,5495,13317
2600,15009,"Maui County, Hawaii",2010,53886,70379,16493,43384,818,15710,139124,45729,154834,49193,15009
2601,13321,"Worth County, Georgia",2010,8214,9251,1037,74,5951,335,21344,275,21679,15044,13321
2602,15001,"Hawaii County, Hawaii",2010,67096,82324,15228,39588,899,21383,163696,65378,185079,57831,15001
2603,15003,"Honolulu County, Hawaii",2010,311047,336899,25852,410019,17929,77433,875774,266142,953207,181684,15003
2604,15005,"Kalawao County, Hawaii",2010,69,113,44,7,0,1,89,58,90,24,15005
2605,15007,"Kauai County, Hawaii",2010,23240,29793,6553,20296,258,6315,60776,19611,67091,20611,15007
2606,27173,"Yellow Medicine County, Minnesota",2010,4292,4760,468,30,15,397,10041,415,10438,9581,27173
2607,16007,"Bear Lake County, Idaho",2010,2281,3914,1633,22,6,216,5770,71,5986,5671,16007
2608,16009,"Benewah County, Idaho",2010,3837,4629,792,27,25,235,9050,1079,9285,7919,16009
2609,16001,"Ada County, Idaho",2010,148445,159471,11026,9234,4180,27905,364460,11714,392365,339332,16001
2610,16003,"Adams County, Idaho",2010,1748,2636,888,16,4,94,3882,94,3976,3768,16003
2611,16005,"Bannock County, Idaho",2010,30682,33191,2509,1060,591,5587,77252,4035,82839,71566,16005
2612,16011,"Bingham County, Idaho",2010,14999,16141,1142,268,78,7864,37743,3221,45607,34176,16011
2613,16013,"Blaine County, Idaho",2010,8823,15050,6227,174,23,4272,17104,238,21376,16669,16013
2614,27169,"Winona County, Minnesota",2010,19554,20760,1206,1097,642,1244,50217,650,51461,47828,27169
2615,27171,"Wright County, Minnesota",2010,44473,49000,4527,1459,1286,3052,121648,2117,124700,116786,27171
2616,28011,"Bolivar County, Mississippi",2010,12727,14070,1343,186,21839,639,33506,240,34145,11241,28011
2617,28001,"Adams County, Mississippi",2010,12643,14656,2013,126,17150,2150,30147,386,32297,12485,28001
2618,28003,"Alcorn County, Mississippi",2010,15039,17077,2038,116,4209,1010,36047,409,37057,31313,28003
2619,28005,"Amite County, Mississippi",2010,5351,6635,1284,12,5396,110,13021,97,13131,7516,28005
2620,28007,"Attala County, Mississippi",2010,7619,9126,1507,53,8180,323,19241,142,19564,10866,28007
2621,28009,"Benton County, Mississippi",2010,3404,4186,782,6,3244,148,8581,102,8729,5229,28009
2622,28027,"Coahoma County, Mississippi",2010,9461,10792,1331,114,19698,293,25858,128,26151,5918,28027
2623,28013,"Calhoun County, Mississippi",2010,5988,6913,925,15,4128,805,14157,163,14962,9851,28013
2624,28015,"Carroll County, Mississippi",2010,4188,5052,864,19,3444,106,10491,101,10597,6927,28015
2625,28017,"Chickasaw County, Mississippi",2010,6639,7514,875,43,7292,643,16749,160,17392,9254,28017
2626,28019,"Choctaw County, Mississippi",2010,3446,4150,704,8,2571,76,8471,89,8547,5803,28019
2627,28021,"Claiborne County, Mississippi",2010,3440,4223,783,40,8072,74,9530,65,9604,1353,28021
2628,28023,"Clarke County, Mississippi",2010,6733,7876,1143,29,5749,132,16600,148,16732,10674,28023
2629,28025,"Clay County, Mississippi",2010,8029,9180,1151,45,11977,199,20435,137,20634,8276,28025
2630,28055,"Issaquena County, Mississippi",2010,472,560,88,6,905,8,1398,5,1406,482,28055
2631,28029,"Copiah County, Mississippi",2010,10708,12184,1476,89,14924,773,28676,264,29449,13399,28029
2632,28031,"Covington County, Mississippi",2010,7430,8496,1066,42,6798,369,19199,157,19568,12202,28031
2633,28033,"DeSoto County, Mississippi",2010,57748,61634,3886,2011,35124,8086,153166,2478,161252,113553,28033
2634,28069,"Kemper County, Mississippi",2010,3920,4722,802,10,6273,52,10404,456,10456,3665,28069
2635,28065,"Jefferson Davis County, Mississippi",2010,4977,5876,899,18,7461,101,12386,105,12487,4802,28065
2636,28035,"Forrest County, Mississippi",2010,28746,32289,3543,494,26956,2637,72297,1081,74934,43766,28035
2637,28037,"Franklin County, Mississippi",2010,3211,4154,943,5,2776,47,8071,60,8118,5230,28037
2638,28039,"George County, Mississippi",2010,7982,9330,1348,47,1821,453,22125,248,22578,20009,28039
2639,28041,"Greene County, Mississippi",2010,4306,5123,817,19,3735,133,14267,150,14400,10363,28041
2640,28043,"Grenada County, Mississippi",2010,8779,10155,1376,60,9106,197,21709,193,21906,12350,28043
2641,28045,"Hancock County, Mississippi",2010,17380,21840,4460,416,3075,1446,42483,1078,43929,37914,28045
2642,28047,"Harrison County, Mississippi",2010,71476,85181,13705,5258,40975,9937,177168,5194,187105,125741,28047
2643,28049,"Hinds County, Mississippi",2010,91351,103421,12070,1851,168839,3630,241655,2356,245285,68609,28049
2644,28051,"Holmes County, Mississippi",2010,6926,8415,1489,30,15925,134,19064,116,19198,2993,28051
2645,28053,"Humphreys County, Mississippi",2010,3373,3855,482,20,6949,202,9173,71,9375,2133,28053
2646,28063,"Jefferson County, Mississippi",2010,2929,3673,744,2,6601,28,7698,39,7726,1056,28063
2647,28067,"Jones County, Mississippi",2010,25247,28424,3177,302,19076,3199,64562,752,67761,44432,28067
2648,28071,"Lafayette County, Mississippi",2010,18356,22729,4373,1003,11155,1073,46278,582,47351,33538,28071
2649,24011,"Caroline County, Maryland",2010,12158,13482,1324,186,4520,1816,31250,691,33066,25853,24011
2650,24029,"Kent County, Maryland",2010,8165,10549,2384,157,3003,907,19290,347,20197,15783,24029
2651,24019,"Dorchester County, Maryland",2010,13522,16554,3032,299,8937,1130,31488,671,32618,21581,24019
2652,24021,"Frederick County, Maryland",2010,84800,90136,5336,8876,19611,17135,216250,6118,233385,181645,24021
2653,24023,"Garrett County, Maryland",2010,12057,18854,6797,76,299,220,29877,224,30097,29278,24023
2654,24025,"Harford County, Maryland",2010,90218,95554,5336,5774,30334,8613,236213,6101,244826,194004,24025
2655,24027,"Howard County, Maryland",2010,104749,109282,4533,41101,49150,16729,270356,10133,287085,169972,24027
2656,24045,"Wicomico County, Maryland",2010,37220,41192,3972,2460,23534,4478,94255,2494,98733,65767,24045
2657,24031,"Montgomery County, Maryland",2010,357086,375905,18819,134677,161689,165398,806379,31248,971777,478765,24031
2658,24033,"Prince George's County, Maryland",2010,304042,328182,24140,34815,548439,128972,734448,22341,863420,128853,24033
2659,24035,"Queen Anne's County, Maryland",2010,18016,20140,2124,460,3258,1452,46346,895,47798,41733,24035
2660,24037,"St. Mary's County, Maryland",2010,37604,41282,3678,2552,14831,3972,101179,3394,105151,80402,24037
2661,24039,"Somerset County, Maryland",2010,8788,11130,2342,183,11082,863,25607,546,26470,13796,24039
2662,24041,"Talbot County, Maryland",2010,16157,19577,3420,463,4778,2073,35709,639,37782,29829,24041
2663,24043,"Washington County, Maryland",2010,55687,60814,5127,2042,13836,5104,142326,3700,147430,122748,24043
2664,25005,"Bristol County, Massachusetts",2010,213010,230535,17525,10140,15736,33020,515265,20045,548285,469344,25005
2665,24047,"Worcester County, Maryland",2010,22229,55749,33520,569,6973,1622,49832,959,51454,41331,24047
2666,24510,"Baltimore city, Maryland",2010,249903,296685,46782,14397,392938,25960,595001,13546,620961,174120,24510
2667,25001,"Barnstable County, Massachusetts",2010,95755,160281,64526,2263,3857,4687,211201,7754,215888,197327,25001
2668,25007,"Dukes County, Massachusetts",2010,7368,17188,9820,123,477,384,16151,1276,16535,14275,25007
2669,25003,"Berkshire County, Massachusetts",2010,56091,68508,12417,1602,3334,4530,126689,2827,131219,118926,25003
2670,25023,"Plymouth County, Massachusetts",2010,181126,200161,19035,5928,33991,15619,479300,24040,494919,415341,25023
2671,25009,"Essex County, Massachusetts",2010,285956,306754,20798,22864,19566,122745,620414,12949,743159,565035,25009
2672,25011,"Franklin County, Massachusetts",2010,30462,33758,3296,887,703,2250,69122,1554,71372,65978,25011
2673,25013,"Hampden County, Massachusetts",2010,179927,192175,12248,8937,35692,96776,366714,8239,463490,313846,25013
2674,25015,"Hampshire County, Massachusetts",2010,58702,62603,3901,7123,3547,7455,150625,3706,158080,136249,25015
2675,25017,"Middlesex County, Massachusetts",2010,580688,612004,31316,139325,65733,98350,1404735,49426,1503085,1150251,25017
2676,25019,"Nantucket County, Massachusetts",2010,4229,11618,7389,118,664,957,9215,241,10172,8192,25019
2677,25021,"Norfolk County, Massachusetts",2010,257914,270359,12445,57625,36329,22004,648846,16134,670850,538758,25021
2678,45075,"Orangeburg County, South Carolina",2010,35788,42504,6716,751,57286,1767,90734,1491,92501,31206,45075
2679,45077,"Pickens County, South Carolina",2010,45228,51244,6016,1900,7792,3743,115481,1831,119224,103958,45077
2680,45089,"Williamsburg County, South Carolina",2010,13007,15359,2352,137,22526,689,33734,346,34423,10725,45089
2681,25025,"Suffolk County, Massachusetts",2010,292767,315522,22755,58963,142980,143455,578568,29646,722023,346979,25025
2682,45067,"Marion County, South Carolina",2010,13058,14953,1895,176,18365,791,32271,500,33062,13230,45067
2683,45069,"Marlboro County, South Carolina",2010,10383,12072,1689,74,14652,800,28133,1750,28933,11657,45069
2684,45071,"Newberry County, South Carolina",2010,14709,17922,3213,116,11533,2690,34818,479,37508,22690,45071
2685,45079,"Richland County, South Carolina",2010,145194,161725,16531,8433,174549,18637,365867,8618,384504,174267,45079
2686,45081,"Saluda County, South Carolina",2010,7527,9289,1762,36,5196,2857,17018,238,19875,11548,45081
2687,45083,"Spartanburg County, South Carolina",2010,109246,122628,13382,5680,58115,16658,267649,4670,284307,199184,45083
2688,45085,"Sumter County, South Carolina",2010,40398,46011,5613,1167,50110,3532,103924,2224,107456,50423,45085
2689,45087,"Union County, South Carolina",2010,11974,14153,2179,79,9022,282,28679,432,28961,19146,45087
2690,46007,"Bennett County, South Dakota",2010,1090,1263,173,13,3,67,3364,2207,3431,1141,46007
2691,45091,"York County, South Carolina",2010,85864,94196,8332,3394,42608,10075,215998,5625,226073,164371,45091
2692,46003,"Aurora County, South Dakota",2010,1102,1324,222,18,9,101,2609,51,2710,2531,46003
2693,46011,"Brookings County, South Dakota",2010,12029,13137,1108,866,246,636,31329,704,31965,29513,46011
2694,46015,"Brule County, South Dakota",2010,2136,2433,297,9,12,75,5180,544,5255,4615,46015
2695,46013,"Brown County, South Dakota",2010,15489,16706,1217,353,187,496,36035,1670,36531,33825,46013
2696,46005,"Beadle County, South Dakota",2010,7276,8304,1028,632,118,1337,16061,377,17398,14934,46005
2697,46009,"Bon Homme County, South Dakota",2010,2457,2931,474,10,65,130,6940,580,7070,6285,46009
2698,46027,"Clay County, South Dakota",2010,5110,5639,529,230,179,277,13587,694,13864,12484,46027
2699,46017,"Buffalo County, South Dakota",2010,532,609,77,1,4,35,1877,1589,1912,283,46017
2700,46019,"Butte County, South Dakota",2010,4160,4621,461,21,20,306,9804,403,10110,9360,46019
2701,46021,"Campbell County, South Dakota",2010,694,980,286,4,1,20,1446,11,1466,1430,46021
2702,46025,"Clark County, South Dakota",2010,1445,1710,265,2,6,63,3628,24,3691,3596,46025
2703,46023,"Charles Mix County, South Dakota",2010,3249,3849,600,18,8,152,8977,3052,9129,5899,46023
2704,46043,"Douglas County, South Dakota",2010,1210,1439,229,3,11,23,2979,74,3002,2891,46043
2705,46029,"Codington County, South Dakota",2010,11432,12397,965,121,88,433,26794,823,27227,25762,46029
2706,46031,"Corson County, South Dakota",2010,1260,1540,280,11,3,106,3944,2728,4050,1202,46031
2707,46033,"Custer County, South Dakota",2010,3636,4628,992,27,15,182,8034,368,8216,7624,46033
2708,46035,"Davison County, South Dakota",2010,8296,8852,556,91,71,294,19210,752,19504,18296,46035
2709,28073,"Lamar County, Mississippi",2010,21542,24070,2528,655,10834,1205,54453,668,55658,42296,28073
2710,28095,"Monroe County, Mississippi",2010,14485,16455,1970,71,11381,355,36634,335,36989,24847,28095
2711,28057,"Itawamba County, Mississippi",2010,8881,10126,1245,52,1386,300,23101,173,23401,21490,28057
2712,28059,"Jackson County, Mississippi",2010,52205,60067,7862,2991,29768,6378,133290,2861,139668,97670,28059
2713,28061,"Jasper County, Mississippi",2010,6798,8212,1414,16,8944,136,16926,111,17062,7855,28061
2714,28099,"Neshoba County, Mississippi",2010,10856,12357,1501,102,6169,469,29207,5139,29676,17797,28099
2715,28103,"Noxubee County, Mississippi",2010,4305,5170,865,22,8249,92,11453,69,11545,3113,28103
2716,28075,"Lauderdale County, Mississippi",2010,31090,34698,3608,569,34158,1448,78813,774,80261,43312,28075
2717,28077,"Lawrence County, Mississippi",2010,5078,6019,941,33,3961,274,12655,94,12929,8567,28077
2718,28079,"Leake County, Mississippi",2010,8272,9415,1143,49,9620,1020,22785,1505,23805,11611,28079
2719,28081,"Lee County, Mississippi",2010,32086,35872,3786,513,22498,1991,80919,1054,82910,56854,28081
2720,28083,"Leflore County, Mississippi",2010,11577,13199,1622,183,23246,743,31574,215,32317,7930,28083
2721,28085,"Lincoln County, Mississippi",2010,13296,15255,1959,117,10400,330,34539,320,34869,23702,28085
2722,28087,"Lowndes County, Mississippi",2010,23487,26556,3069,394,25904,914,58865,720,59779,31847,28087
2723,28089,"Madison County, Mississippi",2010,35829,38558,2729,2029,36227,2806,92397,854,95203,53287,28089
2724,28091,"Marion County, Mississippi",2010,10135,11838,1703,84,8729,336,26752,278,27088,17661,28091
2725,28093,"Marshall County, Mississippi",2010,13369,14881,1512,74,17369,1192,35952,348,37144,18161,28093
2726,28097,"Montgomery County, Mississippi",2010,4438,5194,756,39,4948,97,10828,72,10925,5769,28097
2727,28101,"Newton County, Mississippi",2010,8214,9373,1159,51,6536,287,21433,1247,21720,13599,28101
2728,28105,"Oktibbeha County, Mississippi",2010,18820,20947,2127,1151,17356,683,46988,656,47671,27825,28105
2729,31049,"Deuel County, Nebraska",2010,867,1044,177,5,1,75,1866,21,1941,1839,31049
2730,31051,"Dixon County, Nebraska",2010,2370,2688,318,10,14,622,5378,61,6000,5293,31051
2731,31067,"Gage County, Nebraska",2010,9422,10446,1024,81,72,385,21926,341,22311,21432,31067
2732,31053,"Dodge County, Nebraska",2010,14990,16584,1594,180,183,3689,33002,519,36691,32120,31053
2733,31055,"Douglas County, Nebraska",2010,202411,219580,17169,13613,59176,57804,459306,14488,517110,372029,31055
2734,31063,"Frontier County, Nebraska",2010,1168,1574,406,4,0,35,2721,30,2756,2687,31063
2735,31065,"Furnas County, Nebraska",2010,2185,2721,536,10,8,132,4827,64,4959,4745,31065
2736,31057,"Dundy County, Nebraska",2010,897,1125,228,2,7,117,1891,30,2008,1852,31057
2737,31059,"Fillmore County, Nebraska",2010,2483,2913,430,9,30,178,5712,54,5890,5619,31059
2738,31061,"Franklin County, Nebraska",2010,1406,1734,328,3,1,33,3192,43,3225,3145,31061
2739,31079,"Hall County, Nebraska",2010,22196,23549,1353,579,906,13653,44954,932,58607,42537,31079
2740,31069,"Garden County, Nebraska",2010,961,1314,353,0,4,80,1977,31,2057,1942,31069
2741,31071,"Garfield County, Nebraska",2010,935,1178,243,2,3,15,2034,7,2049,2022,31071
2742,31073,"Gosper County, Nebraska",2010,849,1267,418,4,8,49,1995,29,2044,1954,31073
2743,31075,"Grant County, Nebraska",2010,277,391,114,1,0,7,607,6,614,600,31075
2744,31077,"Greeley County, Nebraska",2010,1069,1300,231,2,16,51,2487,18,2538,2451,31077
2745,31095,"Jefferson County, Nebraska",2010,3348,3918,570,18,17,200,7347,87,7547,7225,31095
2746,31081,"Hamilton County, Nebraska",2010,3563,3968,405,18,19,181,8943,67,9124,8839,31081
2747,31083,"Harlan County, Nebraska",2010,1519,2375,856,7,1,45,3378,27,3423,3343,31083
2748,31085,"Hayes County, Nebraska",2010,414,511,97,3,0,33,934,3,967,928,31085
2749,31087,"Hitchcock County, Nebraska",2010,1301,1763,462,3,6,42,2866,37,2908,2820,31087
2750,31089,"Holt County, Nebraska",2010,4447,5215,768,16,16,305,10130,77,10435,10021,31089
2751,31091,"Hooker County, Nebraska",2010,326,431,105,0,0,8,728,7,736,721,31091
2752,31093,"Howard County, Nebraska",2010,2625,2951,326,12,15,109,6165,71,6274,6067,31093
2753,31107,"Knox County, Nebraska",2010,3647,4788,1141,17,8,155,8546,833,8701,7688,31107
2754,31097,"Johnson County, Nebraska",2010,1847,2191,344,71,278,435,4782,78,5217,4355,31097
2755,31099,"Kearney County, Nebraska",2010,2681,2886,205,11,10,244,6245,62,6489,6162,31099
2756,31101,"Keith County, Nebraska",2010,3753,5424,1671,33,16,474,7894,117,8368,7728,31101
2757,31103,"Keya Paha County, Nebraska",2010,381,549,168,1,0,4,820,4,824,815,31103
2758,31105,"Kimball County, Nebraska",2010,1673,1963,290,27,6,244,3577,83,3821,3461,31105
2759,31129,"Nuckolls County, Nebraska",2010,2079,2465,386,9,6,97,4403,55,4500,4333,31129
2760,31109,"Lancaster County, Nebraska",2010,113373,120875,7502,9895,9636,16685,268722,8489,285407,240702,31109
2761,31111,"Lincoln County, Nebraska",2010,15025,16583,1558,192,235,2602,33686,518,36288,32741,31111
2762,31113,"Logan County, Nebraska",2010,325,395,70,1,1,13,750,9,763,739,31113
2763,31115,"Loup County, Nebraska",2010,275,426,151,0,1,13,619,1,632,617,31115
2764,31117,"McPherson County, Nebraska",2010,211,283,72,0,2,2,537,7,539,528,31117
2765,31119,"Madison County, Nebraska",2010,13939,15014,1075,157,409,4504,30372,744,34876,29062,31119
2766,31121,"Merrick County, Nebraska",2010,3151,3698,547,59,14,271,7574,96,7845,7405,31121
2767,31123,"Morrill County, Nebraska",2010,2085,2442,357,18,8,687,4355,73,5042,4256,31123
2768,31127,"Nemaha County, Nebraska",2010,2952,3498,546,30,62,133,7115,84,7248,6939,31127
2769,31125,"Nance County, Nebraska",2010,1525,1801,276,2,8,65,3670,33,3735,3627,31125
2770,31141,"Platte County, Nebraska",2010,12658,13378,720,149,128,4452,27785,341,32237,27167,31141
2771,46037,"Day County, South Dakota",2010,2504,3630,1126,12,8,62,5648,624,5710,5004,46037
2772,46039,"Deuel County, South Dakota",2010,1819,2204,385,4,12,86,4278,42,4364,4220,46039
2773,46041,"Dewey County, South Dakota",2010,1730,2002,272,7,5,98,5203,4083,5301,1108,46041
2774,46065,"Hughes County, South Dakota",2010,7066,7623,557,89,84,306,16716,2072,17022,14471,46065
2775,46045,"Edmunds County, South Dakota",2010,1607,1966,359,5,5,58,4013,54,4071,3949,46045
2776,46047,"Fall River County, South Dakota",2010,3272,4191,919,26,46,159,6935,664,7094,6199,46047
2777,46049,"Faulk County, South Dakota",2010,869,1136,267,2,3,18,2346,18,2364,2323,46049
2778,46051,"Grant County, South Dakota",2010,3089,3526,437,21,10,168,7188,85,7356,7072,46051
2779,46053,"Gregory County, South Dakota",2010,1936,2503,567,11,6,38,4233,398,4271,3818,46053
2780,46055,"Haakon County, South Dakota",2010,850,1013,163,8,2,17,1920,87,1937,1823,46055
2781,46061,"Hanson County, South Dakota",2010,1045,1177,132,11,0,15,3316,26,3331,3279,46061
2782,46063,"Harding County, South Dakota",2010,539,731,192,1,1,20,1235,36,1255,1197,46063
2783,46057,"Hamlin County, South Dakota",2010,2108,2760,652,13,10,149,5754,52,5903,5679,46057
2784,46059,"Hand County, South Dakota",2010,1494,1815,321,9,3,19,3412,32,3431,3368,46059
2785,46077,"Kingsbury County, South Dakota",2010,2222,2720,498,14,7,72,5076,68,5148,4987,46077
2786,46067,"Hutchinson County, South Dakota",2010,2930,3351,421,12,28,120,7223,93,7343,7090,46067
2787,46069,"Hyde County, South Dakota",2010,600,708,108,3,1,15,1405,138,1420,1263,46069
2788,46071,"Jackson County, South Dakota",2010,996,1193,197,1,5,38,2993,1695,3031,1292,46071
2789,46073,"Jerauld County, South Dakota",2010,870,1070,200,4,1,84,1987,22,2071,1960,46073
2790,46075,"Jones County, South Dakota",2010,458,589,131,0,1,13,993,43,1006,949,46075
2791,46089,"McPherson County, South Dakota",2010,1025,1418,393,4,1,25,2434,24,2459,2405,46089
2792,46079,"Lake County, South Dakota",2010,4483,5559,1076,79,55,175,11025,183,11200,10708,46079
2793,46081,"Lawrence County, South Dakota",2010,10536,12756,2220,157,87,612,23485,892,24097,22349,46081
2794,46083,"Lincoln County, South Dakota",2010,16649,17875,1226,462,315,553,44275,798,44828,42700,46083
2795,46085,"Lyman County, South Dakota",2010,1392,1704,312,10,3,42,3713,1519,3755,2181,46085
2796,46087,"McCook County, South Dakota",2010,2168,2491,323,8,8,99,5519,52,5618,5451,46087
2797,53039,"Klickitat County, Washington",2010,8327,9786,1459,122,42,2171,18147,961,20318,17022,53039
2798,53025,"Grant County, Washington",2010,30041,35083,5042,783,710,34163,54957,2398,89120,51066,53025
2799,53027,"Grays Harbor County, Washington",2010,28579,35166,6587,995,762,6272,66525,5486,72797,59282,53027
2800,53029,"Island County, Washington",2010,32746,40234,7488,3377,1641,4295,74211,3984,78506,65209,53029
2801,53031,"Jefferson County, Washington",2010,14049,17767,3718,460,237,848,29024,1646,29872,26681,53031
2802,53033,"King County, Washington",2010,789232,851261,62029,280029,116326,172378,1758871,111216,1931249,1251300,53033
2803,53035,"Kitsap County, Washington",2010,97220,107367,10147,12082,6329,15686,235447,18291,251133,198745,53035
2804,53041,"Lewis County, Washington",2010,29743,34050,4307,643,370,6527,68928,3034,75455,64881,53041
2805,53037,"Kittitas County, Washington",2010,16595,21900,5305,795,339,3121,37794,1446,40915,35214,53037
2806,53057,"Skagit County, Washington",2010,45557,51473,5916,2025,640,19709,97192,4833,116901,89694,53057
2807,53043,"Lincoln County, Washington",2010,4422,5776,1354,41,25,239,10331,374,10570,9891,53043
2808,53045,"Mason County, Washington",2010,23832,32518,8686,692,609,4844,55855,4205,60699,50349,53045
2809,53047,"Okanogan County, Washington",2010,16519,22245,5726,223,131,7227,33893,5447,41120,28092,53047
2810,53049,"Pacific County, Washington",2010,9499,15547,6048,424,67,1677,19243,1053,20920,17699,53049
2811,53051,"Pend Oreille County, Washington",2010,5479,7936,2457,73,50,391,12610,810,13001,11677,53051
2812,53053,"Pierce County, Washington",2010,299918,325375,25457,46520,51436,72849,722376,65260,795225,559160,53053
2813,53055,"San Juan County, Washington",2010,7613,13313,5700,179,49,857,14912,456,15769,14228,53055
2814,53069,"Wahkiakum County, Washington",2010,1737,2067,330,22,8,108,3870,162,3978,3678,53069
2815,53059,"Skamania County, Washington",2010,4522,5628,1106,96,44,553,10513,455,11066,9918,53059
2816,53061,"Snohomish County, Washington",2010,268325,286659,18334,62760,17299,64249,649086,39213,713335,529814,53061
2817,53063,"Spokane County, Washington",2010,187167,201434,14267,9799,7714,21260,449961,23819,471221,408629,53063
2818,53065,"Stevens County, Washington",2010,17316,21156,3840,234,145,1185,42346,3706,43531,38261,53065
2819,53067,"Thurston County, Washington",2010,100650,108182,7532,12820,6420,17787,234477,16218,252264,199019,53067
2820,54013,"Calhoun County, West Virginia",2010,3268,3963,695,12,15,57,7570,78,7627,7465,54013
2821,53077,"Yakima County, Washington",2010,80592,85474,4882,2359,1743,109470,133761,13635,243231,116024,53077
2822,53075,"Whitman County, Washington",2010,17468,19323,1855,3449,721,2040,42736,1806,44776,36760,53075
2823,54001,"Barbour County, West Virginia",2010,6548,7849,1301,34,120,96,16493,334,16589,16005,54001
2824,53071,"Walla Walla County, Washington",2010,21719,23451,1732,733,1004,11593,47188,1847,58781,43604,53071
2825,53073,"Whatcom County, Washington",2010,80370,90665,10295,6988,1789,15756,185384,11932,201140,164675,53073
2826,54005,"Boone County, West Virginia",2010,9928,11070,1142,21,122,97,24532,169,24629,24220,54005
2827,54003,"Berkeley County, West Virginia",2010,39855,44762,4907,860,7234,3961,100208,2735,104169,89379,54003
2828,54007,"Braxton County, West Virginia",2010,6000,7415,1415,24,59,67,14456,167,14523,14206,54007
2829,54011,"Cabell County, West Virginia",2010,41223,46169,4946,931,4717,1046,95273,2105,96319,87520,54011
2830,54009,"Brooke County, West Virginia",2010,10020,10967,947,95,273,163,23906,297,24069,23241,54009
2831,54029,"Hancock County, West Virginia",2010,13297,14541,1244,80,708,314,30362,431,30676,29143,54029
2832,31131,"Otoe County, Nebraska",2010,6362,7025,663,68,68,902,14838,203,15740,14499,31131
2833,31133,"Pawnee County, Nebraska",2010,1230,1588,358,8,9,35,2738,38,2773,2683,31133
2834,31135,"Perkins County, Nebraska",2010,1239,1450,211,5,10,95,2875,12,2970,2848,31135
2835,31137,"Phelps County, Nebraska",2010,3779,4175,396,21,12,373,8815,88,9188,8694,31137
2836,31139,"Pierce County, Nebraska",2010,2911,3222,311,12,11,93,7173,52,7266,7098,31139
2837,31157,"Scotts Bluff County, Nebraska",2010,14928,16408,1480,207,157,7785,29185,890,36970,27931,31157
2838,31143,"Polk County, Nebraska",2010,2212,2731,519,6,6,156,5250,52,5406,5186,31143
2839,31145,"Red Willow County, Nebraska",2010,4663,5267,604,28,81,462,10593,139,11055,10345,31145
2840,31147,"Richardson County, Nebraska",2010,3718,4393,675,27,11,112,8251,383,8363,7830,31147
2841,31149,"Rock County, Nebraska",2010,685,912,227,3,1,2,1524,18,1526,1502,31149
2842,31151,"Saline County, Nebraska",2010,5131,5762,631,223,92,2870,11330,198,14200,10817,31151
2843,31153,"Sarpy County, Nebraska",2010,58102,61938,3836,3313,6119,11569,147271,4707,158840,133132,31153
2844,31155,"Saunders County, Nebraska",2010,8040,9221,1181,83,69,415,20365,221,20780,19992,31155
2845,16015,"Boise County, Idaho",2010,2974,5292,2318,29,13,249,6779,185,7028,6552,16015
2846,16033,"Clark County, Idaho",2010,345,531,186,5,2,398,584,19,982,558,16033
2847,31163,"Sherman County, Nebraska",2010,1392,1941,549,9,3,31,3121,14,3152,3095,31163
2848,72093,"Maricao Municipio, Puerto Rico",2010,2289,2740,451,3,3,6237,39,2,6276,31,72093
2849,72095,"Maunabo Municipio, Puerto Rico",2010,4446,5546,1100,3,7,12132,93,6,12225,77,72095
2850,72097,"Mayagüez Municipio, Puerto Rico",2010,35805,42825,7020,121,119,88132,948,83,89080,625,72097
2851,72099,"Moca Municipio, Puerto Rico",2010,14360,16800,2440,12,19,39885,224,8,40109,185,72099
2852,72101,"Morovis Municipio, Puerto Rico",2010,10859,12381,1522,13,20,32425,185,10,32610,142,72101
2853,72103,"Naguabo Municipio, Puerto Rico",2010,9755,12028,2273,15,34,26512,208,16,26720,143,72103
2854,72113,"Ponce Municipio, Puerto Rico",2010,60049,69630,9581,105,100,164955,1372,125,166327,1042,72113
2855,72111,"Peñuelas Municipio, Puerto Rico",2010,7863,9220,1357,10,14,24126,156,4,24282,128,72111
2856,72105,"Naranjito Municipio, Puerto Rico",2010,10163,11282,1119,9,14,30264,138,10,30402,105,72105
2857,72107,"Orocovis Municipio, Puerto Rico",2010,7812,9255,1443,5,4,23325,98,6,23423,83,72107
2858,72109,"Patillas Municipio, Puerto Rico",2010,7271,9360,2089,2,32,19151,126,19,19277,73,72109
2859,72115,"Quebradillas Municipio, Puerto Rico",2010,9442,10754,1312,14,7,25748,171,5,25919,145,72115
2860,72117,"Rincón Municipio, Puerto Rico",2010,5998,9694,3696,13,18,14660,540,16,15200,493,72117
2861,72119,"Río Grande Municipio, Puerto Rico",2010,18869,24299,5430,46,75,53762,542,51,54304,370,72119
2862,72121,"Sabana Grande Municipio, Puerto Rico",2010,9372,10958,1586,4,8,25139,126,8,25265,106,72121
2863,72129,"San Lorenzo Municipio, Puerto Rico",2010,14746,17226,2480,12,12,40860,198,18,41058,156,72129
2864,54015,"Clay County, West Virginia",2010,3728,4572,844,7,6,33,9353,97,9386,9243,54015
2865,54017,"Doddridge County, West Virginia",2010,3099,3946,847,14,111,39,8163,112,8202,7926,54017
2866,54019,"Fayette County, West Virginia",2010,18813,21618,2805,89,2097,402,45637,688,46039,42763,54019
2867,54021,"Gilmer County, West Virginia",2010,2753,3448,695,34,1048,493,8200,166,8693,6952,54021
2868,54023,"Grant County, West Virginia",2010,4941,6366,1425,18,72,120,11817,109,11937,11618,54023
2869,54025,"Greenbrier County, West Virginia",2010,15443,18980,3537,142,973,422,35058,613,35480,33330,54025
2870,54027,"Hampshire County, West Virginia",2010,9595,13688,4093,50,225,242,23722,301,23964,23146,54027
2871,54041,"Lewis County, West Virginia",2010,6863,7958,1095,51,65,104,16268,188,16372,15964,54041
2872,54031,"Hardy County, West Virginia",2010,5818,8078,2260,142,327,478,13547,142,14025,12936,54031
2873,54033,"Harrison County, West Virginia",2010,28533,31431,2898,320,1111,883,68216,1156,69099,65629,54033
2874,54035,"Jackson County, West Virginia",2010,11931,13305,1374,79,78,185,29026,306,29211,28563,54035
2875,54037,"Jefferson County, West Virginia",2010,19931,22037,2106,605,3445,2489,51009,1394,53498,45565,54037
2876,54039,"Kanawha County, West Virginia",2010,84201,92618,8417,1982,13950,1812,191251,4350,193063,170969,54039
2877,72127,"San Juan Municipio, Puerto Rico",2010,165316,199915,34599,673,1187,388186,7140,458,395326,4822,72127
2878,72123,"Salinas Municipio, Puerto Rico",2010,11400,14380,2980,6,31,30865,213,23,31078,153,72123
2879,72125,"San Germán Municipio, Puerto Rico",2010,13542,15920,2378,15,29,35252,275,21,35527,210,72125
2880,72131,"San Sebastián Municipio, Puerto Rico",2010,16047,18695,2648,18,26,42144,286,13,42430,229,72131
2881,72133,"Santa Isabel Municipio, Puerto Rico",2010,8225,9575,1350,5,13,23171,103,18,23274,67,72133
2882,72141,"Utuado Municipio, Puerto Rico",2010,11885,14192,2307,13,6,32956,193,10,33149,164,72141
2883,72139,"Trujillo Alto Municipio, Puerto Rico",2010,26935,30295,3360,49,132,74029,813,64,74842,568,72139
2884,72135,"Toa Alta Municipio, Puerto Rico",2010,24515,27006,2491,45,30,73566,500,63,74066,362,72135
2885,72137,"Toa Baja Municipio, Puerto Rico",2010,32617,36546,3929,82,125,88684,925,99,89609,619,72137
2886,72143,"Vega Alta Municipio, Puerto Rico",2010,13925,17002,3077,36,70,39448,503,39,39951,358,72143
2887,72145,"Vega Baja Municipio, Puerto Rico",2010,21335,25401,4066,26,39,59223,439,39,59662,335,72145
2888,72147,"Vieques Municipio, Puerto Rico",2010,3666,5541,1875,4,57,8775,526,21,9301,444,72147
2889,72149,"Villalba Municipio, Puerto Rico",2010,8373,9710,1337,7,2,25983,90,8,26073,73,72149
2890,72151,"Yabucoa Municipio, Puerto Rico",2010,13507,15798,2291,7,50,37686,255,32,37941,166,72151
2891,72153,"Yauco Municipio, Puerto Rico",2010,15138,18020,2882,21,10,41831,212,20,42043,161,72153
2892,16021,"Boundary County, Idaho",2010,4421,5175,754,56,29,402,10570,375,10972,10110,16021
2893,16017,"Bonner County, Idaho",2010,17100,24669,7569,177,51,911,39966,1132,40877,38606,16017
2894,16019,"Bonneville County, Idaho",2010,36629,39731,3102,841,533,11912,92322,2075,104234,88873,16019
2895,16023,"Butte County, Idaho",2010,1129,1354,225,5,5,119,2772,49,2891,2713,16023
2896,16025,"Camas County, Idaho",2010,487,831,344,1,2,75,1042,31,1117,1008,16025
2897,16027,"Canyon County, Idaho",2010,63604,69409,5805,1402,877,45069,143854,5022,188923,136553,16027
2898,16029,"Caribou County, Idaho",2010,2606,3226,620,14,4,336,6627,128,6963,6481,16029
2899,16031,"Cassia County, Idaho",2010,7666,8372,706,104,38,5724,17228,344,22952,16742,16031
2900,16049,"Idaho County, Idaho",2010,6834,8744,1910,65,38,421,15846,715,16267,15028,16049
2901,16035,"Clearwater County, Idaho",2010,3660,4453,793,61,16,268,8493,353,8761,8063,16035
2902,16037,"Custer County, Idaho",2010,1936,3103,1167,10,5,176,4192,69,4368,4108,16037
2903,16039,"Elmore County, Idaho",2010,10140,12162,2022,748,696,4118,22920,1171,27038,20305,16039
2904,16041,"Franklin County, Idaho",2010,4079,4528,449,15,28,838,11948,162,12786,11743,16041
2905,16043,"Fremont County, Idaho",2010,4436,8531,4095,27,24,1694,11548,224,13242,11273,16043
2906,16045,"Gem County, Idaho",2010,6495,7099,604,78,20,1336,15383,387,16719,14898,16045
2907,16047,"Gooding County, Idaho",2010,5531,6093,562,60,13,4344,11120,289,15464,10758,16047
2908,16061,"Lewis County, Idaho",2010,1657,1880,223,12,14,128,3693,269,3821,3398,16061
2909,16051,"Jefferson County, Idaho",2010,8146,8722,576,103,40,2641,23499,431,26140,22925,16051
2910,16053,"Jerome County, Idaho",2010,7540,8101,561,62,39,6929,15445,386,22374,14958,16053
2911,16055,"Kootenai County, Idaho",2010,54200,63177,8977,925,381,5268,133226,4466,138494,127454,16055
2912,16057,"Latah County, Idaho",2010,14708,15988,1280,773,288,1326,35918,1111,37244,33746,16057
2913,16059,"Lemhi County, Idaho",2010,3576,4729,1153,29,16,181,7755,167,7936,7543,16059
2914,16083,"Twin Falls County, Idaho",2010,28760,31072,2312,895,307,10570,66660,1617,77230,63841,16083
2915,16063,"Lincoln County, Idaho",2010,1705,1976,271,18,18,1476,3732,89,5208,3607,16063
2916,16065,"Madison County, Idaho",2010,10611,11280,669,348,178,2218,35318,574,37536,34218,16065
2917,16067,"Minidoka County, Idaho",2010,7170,7665,495,70,44,6493,13576,367,20069,13095,16067
2918,16069,"Nez Perce County, Idaho",2010,16241,17438,1197,277,112,1109,38156,2932,39265,34835,16069
2919,16071,"Oneida County, Idaho",2010,1545,1906,361,20,9,126,4160,58,4286,4073,16071
2920,16079,"Shoshone County, Idaho",2010,5605,7061,1456,44,20,380,12385,392,12765,11929,16079
2921,16081,"Teton County, Idaho",2010,3651,5478,1827,48,12,1721,8449,103,10170,8286,16081
2922,16073,"Owyhee County, Idaho",2010,4076,4781,705,56,18,2979,8547,606,11526,7867,16073
2923,16075,"Payette County, Idaho",2010,8262,8945,683,187,41,3363,19260,644,22623,18388,16075
2924,16077,"Power County, Idaho",2010,2641,2944,303,32,18,2328,5489,275,7817,5164,16077
2925,17023,"Clark County, Illinois",2010,6782,7772,990,54,48,172,16163,136,16335,15925,17023
2926,16085,"Valley County, Idaho",2010,4393,11789,7396,41,9,386,9476,149,9862,9277,16085
2927,16087,"Washington County, Idaho",2010,4034,4529,495,90,10,1716,8482,216,10198,8166,16087
2928,17001,"Adams County, Illinois",2010,27375,29842,2467,430,2288,776,66327,1195,67103,62414,17001
2929,17019,"Champaign County, Illinois",2010,80665,87569,6904,17879,24553,10607,190474,5572,201081,142470,17019
2930,17021,"Christian County, Illinois",2010,14055,15563,1508,165,492,471,34329,341,34800,33331,17021
2931,17013,"Calhoun County, Illinois",2010,2085,2835,750,12,6,40,5049,30,5089,5001,17013
2932,17017,"Cass County, Illinois",2010,5270,5836,566,43,379,2291,11351,99,13642,10830,17017
2933,17015,"Carroll County, Illinois",2010,6622,8437,1815,53,122,437,14950,179,15387,14596,17015
2934,17003,"Alexander County, Illinois",2010,3329,4006,677,16,2908,155,8083,176,8238,4983,17003
2935,17007,"Boone County, Illinois",2010,18505,19970,1465,667,976,10967,43198,798,54165,40757,17007
2936,17005,"Bond County, Illinois",2010,6427,7089,662,67,1061,547,17221,296,17768,15797,17005
2937,17011,"Bureau County, Illinois",2010,14262,15720,1458,220,191,2695,32283,399,34978,31473,17011
2938,17009,"Brown County, Illinois",2010,2099,2462,363,16,1275,402,6535,53,6937,5191,17009
2939,25027,"Worcester County, Massachusetts",2010,303080,326788,23708,31597,29084,75422,723130,18150,798552,644299,25027
2940,26001,"Alcona County, Michigan",2010,5089,11073,5984,25,13,124,10818,159,10942,10621,26001
2941,26009,"Antrim County, Michigan",2010,9890,17824,7934,47,35,404,23176,548,23580,22546,26009
2942,54043,"Lincoln County, West Virginia",2010,8783,9887,1104,24,18,96,21624,149,21720,21433,54043
2943,54045,"Logan County, West Virginia",2010,14907,16743,1836,101,780,258,36485,319,36743,35285,54045
2944,54047,"McDowell County, West Virginia",2010,9176,11322,2146,15,2098,91,22022,272,22113,19637,54047
2945,54049,"Marion County, West Virginia",2010,23786,26463,2677,281,1838,514,55904,911,56418,52874,54049
2946,54051,"Marshall County, West Virginia",2010,13869,15918,2049,117,175,265,32842,307,33107,32243,54051
2947,54053,"Mason County, West Virginia",2010,11149,13006,1857,89,171,119,27205,327,27324,26618,54053
2948,54059,"Mingo County, West Virginia",2010,11125,12699,1574,43,471,119,26720,262,26839,25944,54059
2949,54055,"Mercer County, West Virginia",2010,26603,30115,3512,323,3740,480,61784,1010,62264,56711,54055
2950,26005,"Allegan County, Michigan",2010,42018,49426,7408,620,1264,7454,103954,2125,111408,99945,26005
2951,26003,"Alger County, Michigan",2010,3898,6554,2656,31,607,114,9487,636,9601,8213,26003
2952,26007,"Alpena County, Michigan",2010,12791,16053,3262,148,78,304,29294,445,29598,28623,26007
2953,26011,"Arenac County, Michigan",2010,6701,9803,3102,29,29,225,15674,385,15899,15231,26011
2954,26013,"Baraga County, Michigan",2010,3444,5270,1826,13,635,86,8774,1521,8860,6605,26013
2955,26041,"Delta County, Michigan",2010,15992,20214,4222,145,71,318,36751,1615,37069,34920,26041
2956,26015,"Barry County, Michigan",2010,22551,27010,4459,212,205,1336,57837,933,59173,56487,26015
2957,26017,"Bay County, Michigan",2010,44603,48220,3617,566,1574,5093,102678,2297,107771,98241,26017
2958,26019,"Benzie County, Michigan",2010,7298,12199,4901,44,71,302,17223,450,17525,16658,26019
2959,26021,"Berrien County, Michigan",2010,63054,76922,13868,2410,23766,7054,149759,4194,156813,119389,26021
2960,26023,"Branch County, Michigan",2010,16419,20841,4422,196,1380,1804,43444,752,45248,41116,26023
2961,26025,"Calhoun County, Michigan",2010,54016,61042,7026,2154,14630,6177,129969,4521,136146,108664,26025
2962,26027,"Cass County, Michigan",2010,20604,25887,5283,334,2776,1570,50723,1909,52293,45704,26027
2963,26029,"Charlevoix County, Michigan",2010,10882,17249,6367,99,76,359,25590,813,25949,24602,26029
2964,26031,"Cheboygan County, Michigan",2010,11133,18298,7165,71,129,211,25941,1417,26152,24324,26031
2965,26033,"Chippewa County, Michigan",2010,14329,21253,6924,228,2503,480,38040,7767,38520,27542,26033
2966,26035,"Clare County, Michigan",2010,12966,23233,10267,90,145,464,30462,615,30926,29612,26035
2967,26037,"Clinton County, Michigan",2010,28766,30695,1929,1105,1506,2947,72435,1581,75382,68243,26037
2968,26039,"Crawford County, Michigan",2010,6016,11092,5076,52,42,182,13892,212,14074,13586,26039
2969,26045,"Eaton County, Michigan",2010,43494,47050,3556,1790,6661,5101,102658,2667,107759,91540,26045
2970,26043,"Dickinson County, Michigan",2010,11359,13990,2631,120,86,270,25898,423,26168,25269,26043
2971,26047,"Emmet County, Michigan",2010,13601,21304,7703,174,152,429,32265,1807,32694,30132,26047
2972,26063,"Huron County, Michigan",2010,14348,21199,6851,148,121,657,32461,362,33118,31830,26063
2973,26049,"Genesee County, Michigan",2010,169202,192180,22978,3834,87352,12983,412807,11938,425790,309683,26049
2974,26051,"Gladwin County, Michigan",2010,10753,17672,6919,76,60,310,25382,342,25692,24904,26051
2975,26053,"Gogebic County, Michigan",2010,7037,10795,3758,37,676,142,16285,607,16427,14965,26053
2976,26055,"Grand Traverse County, Michigan",2010,35328,41599,6271,588,1023,1874,85112,2313,86986,81188,26055
2977,26057,"Gratiot County, Michigan",2010,14852,16339,1487,145,2341,2301,40175,545,42476,37144,26057
2978,26059,"Hillsdale County, Michigan",2010,17792,21757,3965,185,206,826,45862,706,46688,44765,26059
2979,26061,"Houghton County, Michigan",2010,14232,18636,4404,1050,193,415,36213,671,36628,34299,26061
2980,26075,"Jackson County, Michigan",2010,60771,69458,8687,1122,12560,4837,155411,4141,160248,137588,26075
2981,26065,"Ingham County, Michigan",2010,111162,121281,10119,14504,31931,20526,260369,10475,280895,203459,26065
2982,26067,"Ionia County, Michigan",2010,22144,24778,2634,241,2962,2791,61114,949,63905,56962,26067
2983,26069,"Iosco County, Michigan",2010,11757,20443,8686,125,121,403,25484,528,25887,24710,26069
2984,26071,"Iron County, Michigan",2010,5577,9197,3620,32,14,161,11656,240,11817,11370,26071
2985,26073,"Isabella County, Michigan",2010,25586,28381,2795,1141,1643,2197,68114,3816,70311,61514,26073
2986,17035,"Cumberland County, Illinois",2010,4377,4874,497,25,35,75,10973,98,11048,10815,17035
2987,17025,"Clay County, Illinois",2010,5697,6404,707,63,43,151,13664,129,13815,13429,17025
2988,17027,"Clinton County, Illinois",2010,14005,15311,1306,167,1323,1058,36704,448,37762,34766,17027
2989,17029,"Coles County, Illinois",2010,21463,23425,1962,523,2022,1155,52718,843,53873,49330,17029
2990,17031,"Cook County, Illinois",2010,1966356,2180359,214003,318869,1265778,1244762,3949913,86908,5194675,2278358,17031
2991,17033,"Crawford County, Illinois",2010,7763,8661,898,100,923,362,19455,216,19817,18216,17033
2992,28143,"Tunica County, Mississippi",2010,3927,4803,876,60,7894,245,10533,93,10778,2486,28143
2993,17037,"DeKalb County, Illinois",2010,38484,41079,2595,2400,6579,10647,94513,1709,105160,83825,17037
2994,28107,"Panola County, Mississippi",2010,12839,14697,1858,61,16801,494,34213,370,34707,16981,28107
2995,28109,"Pearl River County, Mississippi",2010,20816,23968,3152,222,6853,1636,54198,1212,55834,45911,28109
2996,28111,"Perry County, Mississippi",2010,4674,5519,845,14,2449,119,12131,154,12250,9514,28111
2997,28149,"Warren County, Mississippi",2010,18941,21896,2955,412,22836,896,47877,486,48773,24143,28149
2998,28153,"Wayne County, Mississippi",2010,8104,9213,1109,34,8035,246,20501,189,20747,12243,28153
2999,28145,"Union County, Mississippi",2010,10317,11520,1203,46,3911,1210,25924,318,27134,21649,28145
3000,28141,"Tishomingo County, Mississippi",2010,8148,10295,2147,21,516,553,19040,177,19593,18326,28141
3001,28113,"Pike County, Mississippi",2010,15370,17861,2491,229,20740,489,39915,382,40404,18564,28113
3002,28115,"Pontotoc County, Mississippi",2010,11172,12440,1268,56,4096,1849,28108,425,29957,23531,28115
3003,28117,"Prentiss County, Mississippi",2010,9812,11054,1242,33,3481,307,24969,283,25276,21172,28117
3004,28119,"Quitman County, Mississippi",2010,3058,3589,531,11,5709,55,8168,79,8223,2369,28119
3005,28121,"Rankin County, Mississippi",2010,52836,56487,3651,1574,26519,3795,137822,1643,141617,108086,28121
3006,28123,"Scott County, Mississippi",2010,10248,11470,1222,50,10502,3013,25251,346,28264,14353,28123
3007,28125,"Sharkey County, Mississippi",2010,1834,2100,266,11,3475,39,4877,25,4916,1366,28125
3008,28127,"Simpson County, Mississippi",2010,10330,11934,1604,78,9624,387,27116,283,27503,17131,28127
3009,28129,"Smith County, Mississippi",2010,6221,7237,1016,13,3758,198,16293,101,16491,12421,28129
3010,28131,"Stone County, Mississippi",2010,6165,7161,996,57,3395,239,17547,275,17786,13820,28131
3011,28133,"Sunflower County, Mississippi",2010,8822,9685,863,82,21362,404,29046,192,29450,7410,28133
3012,28135,"Tallahatchie County, Mississippi",2010,4856,5530,674,116,8634,866,14512,182,15378,5580,28135
3013,28137,"Tate County, Mississippi",2010,10035,10947,912,65,8723,639,28247,368,28886,19091,28137
3014,28139,"Tippah County, Mississippi",2010,8597,9696,1099,34,3509,985,21247,300,22232,17404,28139
3015,28147,"Walthall County, Mississippi",2010,5888,7132,1244,24,6837,238,15205,199,15443,8145,28147
3016,28151,"Washington County, Mississippi",2010,18936,21708,2772,291,36348,529,50608,315,51137,13654,28151
3017,28155,"Webster County, Mississippi",2010,4060,4804,744,11,2036,104,10149,95,10253,8007,28155
3018,28157,"Wilkinson County, Mississippi",2010,3455,5037,1582,1,6969,41,9837,47,9878,2820,28157
3019,29007,"Audrain County, Missouri",2010,9590,10852,1262,115,1637,665,24864,499,25529,22613,29007
3020,29025,"Caldwell County, Missouri",2010,3676,4605,929,18,39,143,9281,189,9424,9035,29025
3021,29023,"Butler County, Missouri",2010,17614,19731,2117,283,2235,666,42128,1106,42794,38504,29023
3022,29027,"Callaway County, Missouri",2010,16333,18522,2189,236,2006,707,43625,1033,44332,40350,29027
3023,29031,"Cape Girardeau County, Missouri",2010,29848,32616,2768,887,5290,1476,74198,1489,75674,66532,29031
3024,29029,"Camden County, Missouri",2010,19068,41183,22115,175,170,1014,42988,730,44002,41913,29029
3025,29003,"Andrew County, Missouri",2010,6700,7306,606,75,70,290,17001,215,17291,16641,29003
3026,29001,"Adair County, Missouri",2010,9877,11263,1386,453,392,523,25084,488,25607,23751,29001
3027,29005,"Atchison County, Missouri",2010,2498,2985,487,9,17,55,5630,48,5685,5556,29005
3028,29009,"Barry County, Missouri",2010,14057,17523,3466,459,87,2745,32852,801,35597,31505,29009
3029,28159,"Winston County, Mississippi",2010,7494,8745,1251,37,8729,184,19014,357,19198,9891,28159
3030,28161,"Yalobusha County, Mississippi",2010,5166,6344,1178,20,4772,151,12527,129,12678,7606,28161
3031,28163,"Yazoo County, Mississippi",2010,8860,10074,1214,124,15893,1301,26764,270,28065,10477,28163
3032,29019,"Boone County, Missouri",2010,64077,69551,5474,6112,14943,4895,157747,5015,162642,131677,29019
3033,29017,"Bollinger County, Missouri",2010,4847,5878,1031,26,32,98,12265,170,12363,12037,29017
3034,29021,"Buchanan County, Missouri",2010,34509,38427,3918,704,4572,4674,84527,2314,89201,76937,29021
3035,29037,"Cass County, Missouri",2010,37150,40030,2880,623,3444,3988,95490,2344,99478,89079,29037
3036,29013,"Bates County, Missouri",2010,6744,7842,1098,27,143,275,16774,308,17049,16296,29013
3037,29011,"Barton County, Missouri",2010,4929,5600,671,29,42,231,12171,396,12402,11704,29011
3038,29015,"Benton County, Missouri",2010,8449,14150,5701,53,56,291,18765,345,19056,18311,29015
3039,29033,"Carroll County, Missouri",2010,3865,4630,765,10,149,118,9177,125,9295,8893,29033
3040,29035,"Carter County, Missouri",2010,2559,3247,688,9,5,104,6161,155,6265,5992,29035
3041,29039,"Cedar County, Missouri",2010,5838,7224,1386,44,14,204,13778,288,13982,13432,29039
3042,29043,"Christian County, Missouri",2010,29077,31576,2499,385,433,1898,75524,1724,77422,72982,29043
3043,29055,"Crawford County, Missouri",2010,9831,11955,2124,73,64,365,24331,390,24696,23804,29055
3044,29045,"Clark County, Missouri",2010,2933,3473,540,22,19,42,7097,78,7139,6978,29045
3045,29047,"Clay County, Missouri",2010,87217,93918,6701,4503,11220,13101,208838,6504,221939,186611,29047
3046,29049,"Clinton County, Missouri",2010,7951,8876,925,72,284,322,20421,459,20743,19606,29049
3047,29051,"Cole County, Missouri",2010,29722,32324,2602,956,8421,1795,74195,1571,75990,63247,29051
3048,26091,"Lenawee County, Michigan",2010,37514,43452,5938,492,2397,7614,92278,1906,99892,87483,26091
3049,26077,"Kalamazoo County, Michigan",2010,100610,110007,9397,5186,26677,9959,240372,8462,250331,200047,26077
3050,26079,"Kalkaska County, Michigan",2010,6962,12171,5209,41,50,214,16939,392,17153,16456,26079
3051,26081,"Kent County, Michigan",2010,227239,246901,19662,13932,56372,58437,544185,16112,602622,457769,26081
3052,26083,"Keweenaw County, Michigan",2010,1013,2467,1454,1,3,15,2141,20,2156,2117,26083
3053,26085,"Lake County, Michigan",2010,5158,14966,9808,16,1034,243,11296,349,11539,9897,26085
3054,26087,"Lapeer County, Michigan",2010,32776,36332,3556,308,896,3622,84697,1346,88319,82147,26087
3055,26089,"Leelanau County, Michigan",2010,9255,14935,5680,92,56,794,20914,967,21708,19799,26089
3056,26109,"Menominee County, Michigan",2010,10474,14227,3753,70,68,278,23751,898,24029,22715,26109
3057,26093,"Livingston County, Michigan",2010,67380,72809,5429,1412,776,3460,177507,2806,180967,172513,26093
3058,26095,"Luce County, Michigan",2010,2412,4343,1931,17,735,82,6549,522,6631,5275,26095
3059,26097,"Mackinac County, Michigan",2010,5024,11010,5986,22,57,126,10987,2497,11113,8411,26097
3060,26099,"Macomb County, Michigan",2010,331667,356626,24959,24908,72053,19095,821883,19229,840978,705693,26099
3061,26101,"Manistee County, Michigan",2010,10308,15694,5386,64,718,634,24099,915,24733,22402,26101
3062,26103,"Marquette County, Michigan",2010,27538,34330,6792,384,1126,767,66310,2388,67077,62412,26103
3063,26107,"Mecosta County, Michigan",2010,16101,21131,5030,277,1055,731,42067,1102,42798,39633,26107
3064,26105,"Mason County, Michigan",2010,11940,17293,5353,130,156,1150,27555,674,28705,26595,26105
3065,46091,"Marshall County, South Dakota",2010,1815,2534,719,9,5,317,4339,387,4656,3938,46091
3066,46093,"Meade County, South Dakota",2010,9903,11000,1097,162,307,773,24661,1241,25434,22951,46093
3067,46105,"Perkins County, South Dakota",2010,1291,1739,448,4,2,20,2962,73,2982,2883,46105
3068,46097,"Miner County, South Dakota",2010,1032,1308,276,9,3,31,2358,26,2389,2320,46097
3069,46095,"Mellette County, South Dakota",2010,693,838,145,5,2,30,2018,1206,2048,805,46095
3070,46099,"Minnehaha County, South Dakota",2010,67028,71557,4529,2489,6326,6982,162486,7512,169468,146159,46099
3071,46101,"Moody County, South Dakota",2010,2554,2824,270,70,33,111,6375,1045,6486,5227,46101
3072,46103,"Pennington County, South Dakota",2010,41251,44949,3698,1041,1013,4044,96904,12412,100948,82438,46103
3073,46117,"Stanley County, South Dakota",2010,1228,1387,159,4,9,21,2945,276,2966,2656,46117
3074,46107,"Potter County, South Dakota",2010,1062,1500,438,7,3,17,2312,42,2329,2260,46107
3075,46109,"Roberts County, South Dakota",2010,3823,4905,1082,21,11,126,10023,3753,10149,6238,46109
3076,46111,"Sanborn County, South Dakota",2010,975,1172,197,4,0,28,2327,27,2355,2296,46111
3077,46113,"Shannon County, South Dakota",2010,3144,3593,449,14,4,298,13288,12889,13586,381,46113
3078,46115,"Spink County, South Dakota",2010,2608,3139,531,7,17,71,6344,126,6415,6194,46115
3079,46137,"Ziebach County, South Dakota",2010,836,987,151,2,6,87,2714,2099,2801,607,46137
3080,46119,"Sully County, South Dakota",2010,610,845,235,0,1,12,1361,37,1373,1323,46119
3081,46121,"Todd County, South Dakota",2010,2780,3142,362,18,16,227,9385,8438,9612,913,46121
3082,46123,"Tripp County, South Dakota",2010,2419,3072,653,12,6,60,5584,890,5644,4676,46123
3083,46125,"Turner County, South Dakota",2010,3452,3939,487,17,20,112,8235,120,8347,8078,46125
3084,46127,"Union County, South Dakota",2010,5756,6280,524,127,89,305,14094,270,14399,13608,46127
3085,46129,"Walworth County, South Dakota",2010,2392,3003,611,13,6,39,5399,908,5438,4472,46129
3086,46135,"Yankton County, South Dakota",2010,8770,9652,882,115,327,614,21824,819,22438,20563,46135
3087,47021,"Cheatham County, Tennessee",2010,14520,15663,1143,139,552,910,38195,590,39105,36914,47021
3088,47007,"Bledsoe County, Tennessee",2010,4697,5718,1021,17,469,255,12621,199,12876,11936,47007
3089,47009,"Blount County, Tennessee",2010,49265,55266,6001,863,3314,3441,119569,2152,123010,113240,47009
3090,47011,"Bradley County, Tennessee",2010,37947,41395,3448,821,4116,4664,94299,1773,98963,87589,47011
3091,47019,"Carter County, Tennessee",2010,24197,27746,3549,180,743,890,56534,762,57424,54849,47019
3092,47017,"Carroll County, Tennessee",2010,11507,13184,1677,51,2851,595,27927,570,28522,24455,47017
3093,47001,"Anderson County, Tennessee",2010,31253,34717,3464,796,2817,1768,73361,1614,75129,68134,47001
3094,47003,"Bedford County, Tennessee",2010,16530,18360,1830,339,3437,5083,39975,810,45058,35389,47003
3095,47005,"Benton County, Tennessee",2010,7063,8975,1912,62,321,291,16198,252,16489,15563,47005
3096,47013,"Campbell County, Tennessee",2010,16354,19966,3612,103,117,472,40244,514,40716,39510,47013
3097,47015,"Cannon County, Tennessee",2010,5472,6037,565,19,167,210,13591,215,13801,13190,47015
3098,47033,"Crockett County, Tennessee",2010,5709,6425,716,25,1837,1274,13312,197,14586,11253,47033
3099,47023,"Chester County, Tennessee",2010,6208,6980,772,53,1561,343,16788,337,17131,14837,47023
3100,47025,"Claiborne County, Tennessee",2010,12853,14859,2006,165,280,265,31948,452,32213,31051,47025
3101,47027,"Clay County, Tennessee",2010,3358,4282,924,7,100,126,7735,104,7861,7524,47027
3102,47029,"Cocke County, Tennessee",2010,14788,17459,2671,105,659,628,35034,672,35662,33598,47029
3103,47031,"Coffee County, Tennessee",2010,20926,23434,2508,449,1820,2007,50789,981,52796,47539,47031
3104,47045,"Dyer County, Tennessee",2010,15183,16703,1520,188,5433,1002,37333,668,38335,31044,47045
3105,47035,"Cumberland County, Tennessee",2010,23791,28151,4360,237,146,1307,54746,651,56053,53712,47035
3106,47037,"Davidson County, Tennessee",2010,259499,283978,24479,18878,172075,61117,565564,14728,626681,359883,47037
3107,47039,"Decatur County, Tennessee",2010,4927,6873,1946,25,337,308,11449,140,11757,10947,47039
3108,47041,"DeKalb County, Tennessee",2010,7420,9405,1985,48,233,1239,17484,223,18723,16980,47041
3109,29053,"Cooper County, Missouri",2010,6554,7463,909,77,1201,232,17369,337,17601,15754,29053
3110,31175,"Valley County, Nebraska",2010,1922,2273,351,13,3,79,4181,36,4260,4129,31175
3111,31165,"Sioux County, Nebraska",2010,577,815,238,1,1,52,1259,17,1311,1240,31165
3112,31167,"Stanton County, Nebraska",2010,2387,2633,246,6,36,281,5848,77,6129,5729,31167
3113,31169,"Thayer County, Nebraska",2010,2296,2731,435,15,10,76,5152,50,5228,5077,31169
3114,31171,"Thomas County, Nebraska",2010,291,402,111,2,1,12,635,3,647,629,31171
3115,31173,"Thurston County, Nebraska",2010,2158,2408,250,6,17,190,6750,3988,6940,2739,31173
3116,31159,"Seward County, Nebraska",2010,6266,6875,609,71,59,272,16478,196,16750,16152,31159
3117,31161,"Sheridan County, Nebraska",2010,2380,2936,556,18,12,171,5298,709,5469,4559,31161
3118,32003,"Clark County, Nevada",2010,715365,840343,124978,165121,194821,568644,1382625,86728,1951269,935955,32003
3119,31177,"Washington County, Nebraska",2010,7761,8301,540,54,120,419,19815,236,20234,19405,31177
3120,31179,"Wayne County, Nebraska",2010,3507,3776,269,48,127,401,9194,126,9595,8893,31179
3121,31181,"Webster County, Nebraska",2010,1604,1912,308,11,18,133,3679,62,3812,3588,31181
3122,31183,"Wheeler County, Nebraska",2010,350,576,226,4,0,6,812,6,818,802,31183
3123,31185,"York County, Nebraska",2010,5564,6231,667,59,149,555,13110,177,13665,12725,31185
3124,32005,"Douglas County, Nevada",2010,19638,23671,4033,699,174,5103,41894,1927,46997,39094,32005
3125,32001,"Churchill County, Nevada",2010,9671,10826,1155,633,366,3009,21868,1839,24877,19030,32001
3126,32017,"Lincoln County, Nevada",2010,1988,2730,742,38,120,332,5013,157,5345,4698,32017
3127,32007,"Elko County, Nevada",2010,17442,19566,2124,434,329,11158,37660,3167,48818,33730,32007
3128,32009,"Esmeralda County, Nevada",2010,389,850,461,3,0,120,663,55,783,605,32009
3129,32011,"Eureka County, Nevada",2010,836,1076,240,18,2,238,1749,67,1987,1662,32011
3130,32013,"Humboldt County, Nevada",2010,6289,7123,834,108,78,4038,12490,909,16528,11395,32013
3131,32015,"Lander County, Nevada",2010,2213,2575,362,20,17,1219,4556,260,5775,4259,32015
3132,32510,"Carson City, Nevada",2010,21427,23534,2107,1139,1003,11777,43497,2272,55274,39083,32510
3133,32019,"Lyon County, Nevada",2010,19808,22547,2739,701,363,7674,44306,2608,51980,40634,32019
3134,32021,"Mineral County, Nevada",2010,2240,2830,590,49,182,436,4336,834,4772,3271,32021
3135,32023,"Nye County, Nevada",2010,18032,22350,4318,547,836,5967,37979,1933,43946,34663,32023
3136,32027,"Pershing County, Nevada",2010,2018,2464,446,87,251,1508,5245,302,6753,4605,32027
3137,32029,"Storey County, Nevada",2010,1742,1990,248,66,40,228,3782,144,4010,3532,32029
3138,32031,"Washoe County, Nevada",2010,163445,184841,21396,21288,9088,93724,327683,19094,421407,278213,32031
3139,32033,"White Pine County, Nevada",2010,3707,4498,791,96,388,1326,8704,568,10030,7652,32033
3140,33011,"Hillsborough County, New Hampshire",2010,155466,166053,10587,12898,7405,21241,379480,7953,400721,351224,33011
3141,33007,"Coos County, New Hampshire",2010,14171,21321,7150,165,141,401,32654,547,33055,31801,33007
3142,33009,"Grafton County, New Hampshire",2010,35986,51120,15134,2618,768,1600,87518,1838,89118,82294,33009
3143,33001,"Belknap County, New Hampshire",2010,24766,37386,12620,695,261,724,59364,855,60088,57553,33001
3144,33003,"Carroll County, New Hampshire",2010,21052,39813,18761,297,126,473,47345,637,47818,46285,33003
3145,33005,"Cheshire County, New Hampshire",2010,30204,34773,4569,910,363,1090,76027,1217,77117,73537,33005
3146,34007,"Camden County, New Jersey",2010,190980,204943,13963,26043,94762,73124,440533,10080,513657,309648,34007
3147,33019,"Sullivan County, New Hampshire",2010,18126,22341,4215,270,175,493,43249,717,43742,42087,33019
3148,34001,"Atlantic County, New Jersey",2010,102847,126647,23800,20419,40882,46241,228308,6136,274549,160871,34001
3149,33013,"Merrimack County, New Hampshire",2010,57069,63541,6472,2307,1452,2339,144106,2299,146445,138048,33013
3150,33015,"Rockingham County, New Hampshire",2010,115033,126709,11676,4910,1790,6142,289081,4370,295223,278011,33015
3151,33017,"Strafford County, New Hampshire",2010,47100,51697,4597,3171,1144,2201,120942,2417,123143,114210,33017
3152,34003,"Bergen County, New Jersey",2010,335730,352388,16658,130491,46850,145281,759835,16441,905116,566053,34003
3153,34005,"Burlington County, New Jersey",2010,166318,175615,9297,19193,71247,28831,419903,12442,448734,317021,34005
3154,34019,"Hunterdon County, New Jersey",2010,47169,49487,2318,4155,3233,6722,121627,1632,128349,112607,34019
3155,34009,"Cape May County, New Jersey",2010,40812,98309,57497,818,4244,6054,91211,1627,97265,84522,34009
3156,34011,"Cumberland County, New Jersey",2010,51931,55834,3903,1854,29376,42457,114441,4280,156898,78931,34011
3157,34013,"Essex County, New Jersey",2010,283712,312954,29242,35292,308358,159117,624852,21025,783969,260177,34013
3158,34015,"Gloucester County, New Jersey",2010,104271,109796,5525,7534,27906,13712,274576,5441,288288,233695,34015
3159,34017,"Hudson County, New Jersey",2010,246437,270335,23898,83825,71315,267853,366413,15763,634266,195510,34017
3160,34031,"Passaic County, New Jersey",2010,166785,175966,9181,24556,55480,185677,315549,8369,501226,227144,34031
3161,47043,"Dickson County, Tennessee",2010,19107,20820,1713,201,2035,1573,48093,977,49666,44880,47043
3162,54057,"Mineral County, West Virginia",2010,11550,13039,1489,110,769,202,28010,389,28212,26742,54057
3163,54061,"Monongalia County, West Virginia",2010,39777,43238,3461,2929,3436,1692,94497,1834,96189,86298,54061
3164,54063,"Monroe County, West Virginia",2010,5655,7601,1946,15,89,83,13419,205,13502,13110,54063
3165,54081,"Raleigh County, West Virginia",2010,31831,35931,4100,715,6390,996,77863,1512,78859,69246,54081
3166,47047,"Fayette County, Tennessee",2010,14505,15669,1164,186,10742,858,37555,434,38413,26193,47047
3167,47049,"Fentress County, Tennessee",2010,7250,8961,1711,34,26,189,17770,188,17959,17522,47049
3168,47051,"Franklin County, Tennessee",2010,16011,18697,2686,299,2086,1029,40023,799,41052,36839,47051
3169,47053,"Gibson County, Tennessee",2010,19690,21999,2309,106,9307,1012,48671,687,49683,38571,47053
3170,47055,"Giles County, Tennessee",2010,11875,13844,1969,111,3006,471,29014,676,29485,25221,47055
3171,47059,"Greene County, Tennessee",2010,28018,32025,4007,249,1355,1690,67141,900,68831,64637,47059
3172,47061,"Grundy County, Tennessee",2010,5405,6397,992,24,36,113,13590,209,13703,13321,47061
3173,47063,"Hamblen County, Tennessee",2010,24560,26963,2403,448,2394,6711,55833,1145,62544,51846,47063
3174,47067,"Hancock County, Tennessee",2010,2825,3624,799,7,24,13,6806,102,6819,6673,47067
3175,47069,"Hardeman County, Tennessee",2010,9301,10851,1550,145,11228,376,26877,307,27253,15197,47069
3176,47077,"Henderson County, Tennessee",2010,11224,12776,1552,76,2169,532,27237,510,27769,24482,47077
3177,54065,"Morgan County, West Virginia",2010,7303,9753,2450,50,96,183,17358,263,17541,16949,54065
3178,54067,"Nicholas County, West Virginia",2010,10938,13064,2126,69,42,146,26087,288,26233,25688,54067
3179,54069,"Ohio County, West Virginia",2010,18914,21172,2258,365,1614,362,44081,939,44443,41163,54069
3180,54071,"Pendleton County, West Virginia",2010,3285,5132,1847,20,149,71,7624,102,7695,7353,54071
3181,54073,"Pleasants County, West Virginia",2010,2861,3390,529,8,96,61,7544,86,7605,7354,54073
3182,54075,"Pocahontas County, West Virginia",2010,3758,8847,5089,4,58,68,8651,109,8719,8480,54075
3183,54077,"Preston County, West Virginia",2010,12895,15097,2202,48,360,229,33291,326,33520,32557,54077
3184,54079,"Putnam County, West Virginia",2010,21981,23438,1457,409,478,484,55002,738,55486,53377,54079
3185,54097,"Upshur County, West Virginia",2010,9619,11099,1480,85,145,250,24004,280,24254,23494,54097
3186,54083,"Randolph County, West Virginia",2010,11695,14189,2494,99,343,192,29213,297,29405,28474,54083
3187,54085,"Ritchie County, West Virginia",2010,4367,5843,1476,10,20,55,10394,89,10449,10275,54085
3188,54087,"Roane County, West Virginia",2010,6195,7351,1156,38,19,103,14823,153,14926,14613,54087
3189,54089,"Summers County, West Virginia",2010,5572,7680,2108,28,645,189,13738,228,13927,12837,54089
3190,54091,"Taylor County, West Virginia",2010,6778,7541,763,60,125,143,16752,190,16895,16377,54091
3191,54093,"Tucker County, West Virginia",2010,3057,5346,2289,8,11,41,7100,57,7141,7024,54093
3192,54095,"Tyler County, West Virginia",2010,3858,5000,1142,12,13,49,9159,63,9208,9071,54095
3193,54109,"Wyoming County, West Virginia",2010,9687,10958,1271,25,116,105,23691,280,23796,23270,54109
3194,54099,"Wayne County, West Virginia",2010,17347,19227,1880,72,74,218,42263,411,42481,41706,54099
3195,54101,"Webster County, West Virginia",2010,3792,5428,1636,5,14,48,9106,98,9154,8989,54101
3196,54103,"Wetzel County, West Virginia",2010,6968,8173,1205,40,24,83,16500,117,16583,16319,54103
3197,54105,"Wirt County, West Virginia",2010,2391,3231,840,10,9,26,5691,62,5717,5610,54105
3198,54107,"Wood County, West Virginia",2010,36571,40215,3644,468,940,744,86212,1452,86956,83352,54107
3199,55015,"Calumet County, Wisconsin",2010,18575,19695,1120,1027,236,1690,47281,693,48971,45325,55015
3200,55011,"Buffalo County, Wisconsin",2010,5708,6664,956,27,35,237,13350,153,13587,13135,55011
3201,55013,"Burnett County, Wisconsin",2010,6807,15278,8471,52,81,194,15263,1063,15457,14067,55013
3202,55007,"Bayfield County, Wisconsin",2010,6686,12999,6313,48,44,158,14856,1809,15014,12955,55007
3203,55005,"Barron County, Wisconsin",2010,19173,23614,4441,220,397,862,45008,824,45870,43567,55005
3204,55009,"Brown County, Wisconsin",2010,98383,104371,5988,6657,5286,17985,230022,10377,248007,207702,55009
3205,55001,"Adams County, Wisconsin",2010,8666,17436,8770,80,611,783,20092,388,20875,19013,55001
3206,55003,"Ashland County, Wisconsin",2010,6736,9656,2920,58,47,302,15855,2216,16157,13534,55003
3207,55027,"Dodge County, Wisconsin",2010,33840,37005,3165,460,2361,3522,85237,1091,88759,81325,55027
3208,55017,"Chippewa County, Wisconsin",2010,24410,27185,2775,770,961,800,61615,856,62415,59028,55017
3209,55019,"Clark County, Wisconsin",2010,12679,15076,2397,127,73,1292,33398,333,34690,32865,55019
3210,55021,"Columbia County, Wisconsin",2010,22735,26137,3402,298,697,1444,55389,766,56833,53628,55021
3211,55023,"Crawford County, Wisconsin",2010,6812,8802,1990,63,288,150,16494,152,16644,15991,55023
3212,55025,"Dane County, Wisconsin",2010,203750,216022,12272,22903,24717,28925,459148,12040,488073,399488,55025
3213,55043,"Grant County, Wisconsin",2010,19396,21581,2185,300,573,649,50559,390,51208,49296,55043
3214,55029,"Door County, Wisconsin",2010,12548,23966,11418,112,139,671,27114,380,27785,26483,55029
3215,55031,"Douglas County, Wisconsin",2010,18555,22825,4270,370,475,494,43665,1966,44159,40854,55031
3216,55033,"Dunn County, Wisconsin",2010,16373,17964,1591,1141,215,626,43231,650,43857,41225,55033
3217,55035,"Eau Claire County, Wisconsin",2010,39493,42151,2658,3276,837,1804,96932,1901,98736,90918,55035
3218,55037,"Florence County, Wisconsin",2010,1987,4780,2793,13,10,37,4386,76,4423,4287,55037
3219,55039,"Fond du Lac County, Wisconsin",2010,40697,43910,3213,1129,1226,4368,97265,1512,101633,93398,55039
3220,55041,"Forest County, Wisconsin",2010,3836,8970,5134,12,71,138,9166,1437,9304,7646,55041
3221,55055,"Jefferson County, Wisconsin",2010,32117,35147,3030,551,628,5555,78131,1049,83686,75903,55055
