,id,stco,name,yr,H_Occ,H_Tot,H_Vac,P_Asian,P_Black,P_Hisp,P_NonHisp,P_Other,P_Tot,P_White,geotype,subreg
306,09001,09001,"Fairfield County, Connecticut",2000,324232,339466,15234,28473,84724,104835,777732,19383,882567,645152,county,CT
308,09005,09005,"Litchfield County, Connecticut",2000,71551,79267,7716,2107,1837,3894,178299,2201,182193,172154,county,CT
310,09009,09009,"New Haven County, Connecticut",2000,319040,340732,21692,19061,89286,83131,740877,15989,824008,616541,county,CT
1773,34003,34003,"Bergen County, New Jersey",2000,330817,339820,9003,93979,44149,91377,792741,15660,884118,638953,county,INJ
1778,34013,34013,"Essex County, New Jersey",2000,283736,301011,17275,29141,319883,122347,671286,23554,793633,298708,county,INJ
1780,34017,34017,"Hudson County, New Jersey",2000,230546,240618,10072,56370,74040,242123,366852,21226,608975,215216,county,INJ
1781,34019,34019,"Hunterdon County, New Jersey",2000,43678,45032,1354,2332,2638,3371,118618,1175,121989,112473,county,ONJ
1782,34021,34021,"Mercer County, New Jersey",2000,125807,133280,7473,17250,67922,33898,316863,6407,350761,225284,county,ONJ
1783,34023,34023,"Middlesex County, New Jersey",2000,265815,273637,7822,103788,64435,101940,648222,15462,750162,464537,county,INJ
1784,34025,34025,"Monmouth County, New Jersey",2000,224236,240884,16648,24257,47745,38175,577126,9222,615301,495902,county,ONJ
1785,34027,34027,"Morris County, New Jersey",2000,169711,174379,4668,29310,12506,36626,433586,6188,470212,385582,county,INJ
1786,34029,34029,"Ocean County, New Jersey",2000,200402,248711,48309,6426,14431,25638,485278,5247,510916,459174,county,ONJ
1787,34031,34031,"Passaic County, New Jersey",2000,163856,170048,6192,17747,60528,146492,342557,12595,489049,251687,county,INJ
1789,34035,34035,"Somerset County, New Jersey",2000,108984,112023,3039,24870,21571,25811,271679,4654,297490,220584,county,INJ
1790,34037,34037,"Sussex County, New Jersey",2000,50831,56528,5697,1723,1444,4822,139344,1553,144166,134624,county,ONJ
1791,34039,34039,"Union County, New Jersey",2000,186124,192945,6821,19789,104926,103011,419530,11470,522541,283345,county,INJ
1792,34041,34041,"Warren County, New Jersey",2000,38660,41157,2497,1235,1838,3751,98686,1208,102437,94405,county,ONJ
1828,36005,36005,"Bronx County, New York",2000,463212,490659,27447,38558,416338,644705,687945,39398,1332650,193651,county,NYC
1839,36027,36027,"Dutchess County, New York",2000,99536,106103,6567,6990,25059,18060,262090,5128,280150,224913,county,MHV
1849,36047,36047,"Kings County, New York",2000,880727,930866,50139,184291,848583,487878,1977448,90042,2465326,854532,county,NYC
1855,36059,36059,"Nassau County, New York",2000,447387,458151,10764,62744,129860,133282,1201262,21711,1334544,986947,county,LI
1856,36061,36061,"New York County, New York",2000,738644,798144,59500,143291,234698,417816,1119379,37517,1537195,703873,county,NYC
1861,36071,36071,"Orange County, New York",2000,114788,122754,7966,5054,25567,39738,301629,6248,341367,264760,county,MHV
1865,36079,36079,"Putnam County, New York",2000,32703,35030,2327,1157,1437,5976,89769,1202,95745,85973,county,LHV
1866,36081,36081,"Queens County, New York",2000,782664,817250,34586,389303,422831,556605,1672774,127745,2229379,732895,county,NYC
1868,36085,36085,"Richmond County, New York",2000,156341,163993,7652,24786,39704,53550,390178,9372,443728,316316,county,NYC
1869,36087,36087,"Rockland County, New York",2000,92675,94973,2298,15707,30139,29182,257571,6072,286753,205653,county,LHV
1877,36103,36103,"Suffolk County, New York",2000,469299,522323,53024,34355,93262,149411,1269958,23936,1419369,1118405,county,LI
1878,36105,36105,"Sullivan County, New York",2000,27661,44730,17069,810,5897,6839,67127,1195,73966,59225,county,MHV
1881,36111,36111,"Ulster County, New York",2000,67499,77656,10157,2169,9044,10941,166808,3531,177749,152064,county,MHV
1885,36119,36119,"Westchester County, New York",2000,337142,349445,12303,40941,125227,144124,779335,21391,923459,591776,county,LHV
160,09001,09001,"Fairfield County, Connecticut",2010,335545,361221,25676,41801,92705,155025,761804,20582,916829,606716,county,CT
168,09005,09005,"Litchfield County, Connecticut",2010,76640,87550,10910,2877,2206,8535,181392,2906,189927,173403,county,CT
173,09009,09009,"New Haven County, Connecticut",2010,334502,362004,27502,29933,101763,129743,732734,18654,862477,582384,county,CT
493,36047,36047,"Kings County, New York",2010,916856,1000293,83437,260129,799066,496285,2008415,55914,2504700,893306,county,NYC
499,36059,36059,"Nassau County, New York",2010,448528,468346,19818,101558,141305,195355,1144177,24005,1339532,877309,county,LI
500,36061,36061,"New York County, New York",2010,763846,847090,83244,177624,205340,403577,1182296,37839,1585873,761493,county,NYC
501,36079,36079,"Putnam County, New York",2010,35041,38224,3183,1832,2047,11661,88049,1461,99710,82709,county,LHV
505,36071,36071,"Orange County, New York",2010,125925,137025,11100,8685,33895,67185,305628,8789,372813,254259,county,MHV
510,36081,36081,"Queens County, New York",2010,780117,835127,55010,508334,395881,613750,1616972,96030,2230722,616727,county,NYC
512,36085,36085,"Richmond County, New York",2010,165516,176656,11140,34697,44313,81051,387679,8500,468730,300169,county,NYC
513,36087,36087,"Rockland County, New York",2010,99242,104057,4815,19099,34623,48783,262904,5512,311687,203670,county,LHV
521,36103,36103,"Suffolk County, New York",2010,499922,569985,70063,50295,102117,246239,1247111,25971,1493350,1068728,county,LI
522,36105,36105,"Sullivan County, New York",2010,30139,49186,19047,1033,6349,10554,66993,1831,77547,57780,county,MHV
525,36111,36111,"Ulster County, New York",2010,71049,83638,12589,3060,9982,15909,166584,4443,182493,149099,county,MHV
528,36119,36119,"Westchester County, New York",2010,347232,370821,23589,51123,126585,207032,742081,19810,949113,544563,county,LHV
623,34041,34041,"Warren County, New Jersey",2010,41480,44925,3445,2642,3592,7659,101033,1634,108692,93165,county,ONJ
626,34035,34035,"Somerset County, New Jersey",2010,117759,123127,5368,45473,27480,42091,281353,6551,323444,201849,county,INJ
627,34037,34037,"Sussex County, New Jersey",2010,54752,62057,7305,2605,2448,9617,139648,2111,149265,132484,county,ONJ
628,34039,34039,"Union County, New Jersey",2010,188118,199489,11371,24496,111705,146704,389795,10282,536499,243312,county,INJ
667,36005,36005,"Bronx County, New York",2010,483449,511896,28447,47335,416695,741413,643695,28456,1385108,151209,county,NYC
675,36027,36027,"Dutchess County, New York",2010,107965,118638,10673,10330,27395,31267,266221,6684,297488,221812,county,MHV
1807,34021,34021,"Mercer County, New Jersey",2010,133155,143169,10014,32545,71378,55318,311195,7363,366513,199909,county,ONJ
1808,34023,34023,"Middlesex County, New Jersey",2010,281186,294800,13614,172534,71557,148975,660883,18068,809858,398724,county,INJ
1809,34025,34025,"Monmouth County, New Jersey",2010,233983,258410,24427,31018,43931,60939,569441,11057,630380,483435,county,ONJ
1865,34027,34027,"Morris County, New Jersey",2010,180534,189842,9308,43862,14134,56482,435794,8247,492276,369551,county,INJ
1866,34029,34029,"Ocean County, New Jersey",2010,221111,278052,56941,9924,16583,47783,528784,6743,576567,495534,county,ONJ
3152,34003,34003,"Bergen County, New Jersey",2010,335730,352388,16658,130491,46850,145281,759835,16441,905116,566053,county,INJ
3154,34019,34019,"Hunterdon County, New Jersey",2010,47169,49487,2318,4155,3233,6722,121627,1632,128349,112607,county,ONJ
3157,34013,34013,"Essex County, New Jersey",2010,283712,312954,29242,35292,308358,159117,624852,21025,783969,260177,county,INJ
3159,34017,34017,"Hudson County, New Jersey",2010,246437,270335,23898,83825,71315,267853,366413,15763,634266,195510,county,INJ
3160,34031,34031,"Passaic County, New Jersey",2010,166785,175966,9181,24556,55480,185677,315549,8369,501226,227144,county,INJ
0,CT,,Connecticut,2000,714823,759465,44642,49641,175847,191860,1696908,37573,1888768,1433847,subregion,CT
1,CT,,Connecticut,2010,746687,810775,64088,74611,196674,293303,1675930,42142,1969233,1362503,subregion,CT
2,INJ,,Inner New Jersey,2000,1739589,1804481,64892,374994,702038,869727,3946453,110809,4816180,2758612,subregion,INJ
3,INJ,,Inner New Jersey,2010,1800261,1918901,118640,560529,706879,1152180,3834474,104746,4986654,2462320,subregion,INJ
4,LHV,,Lower Hudson Valley,2000,462520,479448,16928,57805,156803,179282,1126675,28665,1305957,883402,subregion,LHV
5,LHV,,Lower Hudson Valley,2010,481515,513102,31587,72054,163255,267476,1093034,26783,1360510,830942,subregion,LHV
6,LI,,Long Island,2000,916686,980474,63788,97099,223122,282693,2471220,45647,2753913,2105352,subregion,LI
7,LI,,Long Island,2010,948450,1038331,89881,151853,243422,441594,2391288,49976,2832882,1946037,subregion,LI
8,MHV,,Mid Hudsonn Valley,2000,309484,351243,41759,15023,65567,75578,797654,16102,873232,700962,subregion,MHV
9,MHV,,Mid Hudsonn Valley,2010,335078,388487,53409,23108,77621,124915,805426,21747,930341,682950,subregion,MHV
10,NYC,,New York City,2000,3021588,3200912,179324,780229,1962154,2160554,5847724,304074,8008278,2801267,subregion,NYC
11,NYC,,New York City,2010,3109784,3371062,261278,1028119,1861295,2336076,5839057,226739,8175133,2722904,subregion,NYC
12,ONJ,,Outer New Jersey,2000,683614,765592,81978,53223,136018,109655,1735915,24812,1845570,1521862,subregion,ONJ
13,ONJ,,Outer New Jersey,2010,731650,836100,104450,82889,141165,188038,1771728,30540,1959766,1517134,subregion,ONJ
1,us,,United States,2000,105480101,115904641,10424540,10123169,33947837,35305818,246116088,7492308,281421906,194552774,nation,
1,us,,United States,2010,116716292,131704730,14988438,14465124,37685848,50477594,258267944,9299420,308745538,196817552,nation,
0,900100000,09001,"County subdivisions not defined, Fairfield County, Connecticut",2000,0,0,0,0,0,0,0,0,0,0,municipality,CT
1,900100000,09001,"County subdivisions not defined, Fairfield County, Connecticut",2010,0,0,0,0,0,0,0,0,0,0,municipality,CT
2,900104720,09001,"Bethel town, Fairfield County, Connecticut",2000,6505,6653,148,631,219,669,17398,311,18067,16237,municipality,CT
3,900104720,09001,"Bethel town, Fairfield County, Connecticut",2010,6938,7310,372,820,315,1419,17165,432,18584,15598,municipality,CT
4,900108070,09001,"Bridgeport town, Fairfield County, Connecticut",2000,50307,54367,4060,4459,40974,44478,95051,6460,139529,43158,municipality,CT
5,900108070,09001,"Bridgeport town, Fairfield County, Connecticut",2010,51255,57012,5757,4781,46472,55100,89129,5082,144229,32794,municipality,CT
6,900108980,09001,"Brookfield town, Fairfield County, Connecticut",2000,5572,5781,209,387,114,372,15292,125,15664,14666,municipality,CT
7,900108980,09001,"Brookfield town, Fairfield County, Connecticut",2010,6129,6562,433,595,161,710,15742,220,16452,14766,municipality,CT
8,900118500,09001,"Danbury town, Fairfield County, Connecticut",2000,27183,28519,1336,4068,4743,11791,63057,3301,74848,50945,municipality,CT
9,900118500,09001,"Danbury town, Fairfield County, Connecticut",2010,28907,31154,2247,5399,5030,20185,60708,3970,80893,46309,municipality,CT
10,900118850,09001,"Darien town, Fairfield County, Connecticut",2000,6592,6792,200,474,83,429,19178,176,19607,18445,municipality,CT
11,900118850,09001,"Darien town, Fairfield County, Connecticut",2010,6698,7074,376,744,98,743,19989,249,20732,18898,municipality,CT
12,900123890,09001,"Easton town, Fairfield County, Connecticut",2000,2465,2511,46,147,15,128,7144,49,7272,6933,municipality,CT
13,900123890,09001,"Easton town, Fairfield County, Connecticut",2010,2577,2715,138,238,46,220,7270,94,7490,6892,municipality,CT
14,900126620,09001,"Fairfield town, Fairfield County, Connecticut",2000,20397,21029,632,1157,598,1340,56000,576,57340,53669,municipality,CT
15,900126620,09001,"Fairfield town, Fairfield County, Connecticut",2010,20457,21648,1191,2177,1015,2999,56405,935,59404,52278,municipality,CT
16,900133620,09001,"Greenwich town, Fairfield County, Connecticut",2000,23230,24511,1281,3161,990,3846,57255,875,61101,52229,municipality,CT
17,900133620,09001,"Greenwich town, Fairfield County, Connecticut",2010,23076,25631,2555,4017,1232,5964,55207,1151,61171,48807,municipality,CT
18,900148620,09001,"Monroe town, Fairfield County, Connecticut",2000,6481,6601,120,291,225,482,18765,168,19247,18081,municipality,CT
19,900148620,09001,"Monroe town, Fairfield County, Connecticut",2010,6735,6918,183,402,259,919,18560,254,19479,17645,municipality,CT
20,900150580,09001,"New Canaan town, Fairfield County, Connecticut",2000,6822,7141,319,443,196,338,19057,198,19395,18220,municipality,CT
21,900150580,09001,"New Canaan town, Fairfield County, Connecticut",2010,7010,7551,541,662,194,570,19168,280,19738,18032,municipality,CT
22,900150860,09001,"New Fairfield town, Fairfield County, Connecticut",2000,4638,5148,510,177,53,393,13560,118,13953,13212,municipality,CT
23,900150860,09001,"New Fairfield town, Fairfield County, Connecticut",2010,4802,5593,791,232,142,611,13270,202,13881,12694,municipality,CT
24,900152980,09001,"Newtown town, Fairfield County, Connecticut",2000,8325,8601,276,346,415,590,24441,239,25031,23441,municipality,CT
25,900152980,09001,"Newtown town, Fairfield County, Connecticut",2010,9459,10061,602,645,433,1033,26527,316,27560,25133,municipality,CT
26,900156060,09001,"Norwalk town, Fairfield County, Connecticut",2000,32711,33753,1042,2672,12231,12966,69985,1758,82951,53324,municipality,CT
27,900156060,09001,"Norwalk town, Fairfield County, Connecticut",2010,33217,35415,2198,4045,11472,20770,64833,1598,85603,47718,municipality,CT
28,900163480,09001,"Redding town, Fairfield County, Connecticut",2000,2918,3086,168,147,61,122,8148,85,8270,7855,municipality,CT
29,900163480,09001,"Redding town, Fairfield County, Connecticut",2010,3470,3811,341,195,60,237,8921,166,9158,8500,municipality,CT
30,900163970,09001,"Ridgefield town, Fairfield County, Connecticut",2000,8433,8877,444,490,133,465,23178,194,23643,22361,municipality,CT
31,900163970,09001,"Ridgefield town, Fairfield County, Connecticut",2010,8801,9420,619,780,174,941,23697,339,24638,22404,municipality,CT
32,900168170,09001,"Shelton town, Fairfield County, Connecticut",2000,14190,14707,517,787,393,1326,36775,492,38101,35103,municipality,CT
33,900168170,09001,"Shelton town, Fairfield County, Connecticut",2010,15325,16146,821,1522,865,2353,37206,486,39559,34333,municipality,CT
34,900168310,09001,"Sherman town, Fairfield County, Connecticut",2000,1434,1606,172,23,19,66,3761,30,3827,3689,municipality,CT
35,900168310,09001,"Sherman town, Fairfield County, Connecticut",2010,1388,1831,443,33,12,76,3505,45,3581,3415,municipality,CT
36,900173070,09001,"Stamford town, Fairfield County, Connecticut",2000,45399,47317,1918,5818,17421,19635,97448,2599,117083,71610,municipality,CT
37,900173070,09001,"Stamford town, Fairfield County, Connecticut",2010,47357,50573,3216,9604,16106,29188,93455,2339,122643,65406,municipality,CT
38,900174190,09001,"Stratford town, Fairfield County, Connecticut",2000,19898,20596,698,695,4765,3399,46577,790,49976,40327,municipality,CT
39,900174190,09001,"Stratford town, Fairfield County, Connecticut",2010,20095,21091,996,1199,6963,7114,44270,1068,51384,35040,municipality,CT
40,900177200,09001,"Trumbull town, Fairfield County, Connecticut",2000,11911,12160,249,813,613,923,33320,345,34243,31549,municipality,CT
41,900177200,09001,"Trumbull town, Fairfield County, Connecticut",2010,12725,13157,432,1559,1070,2068,33950,449,36018,30872,municipality,CT
42,900183430,09001,"Weston town, Fairfield County, Connecticut",2000,3312,3532,220,193,87,206,9831,108,10037,9443,municipality,CT
43,900183430,09001,"Weston town, Fairfield County, Connecticut",2010,3379,3674,295,293,130,336,9843,208,10179,9212,municipality,CT
44,900183500,09001,"Westport town, Fairfield County, Connecticut",2000,9586,10065,479,622,279,602,25147,231,25749,24015,municipality,CT
45,900183500,09001,"Westport town, Fairfield County, Connecticut",2010,9573,10399,826,1038,292,932,25459,414,26391,23715,municipality,CT
46,900186370,09001,"Wilton town, Fairfield County, Connecticut",2000,5923,6113,190,472,97,269,17364,155,17633,16640,municipality,CT
47,900186370,09001,"Wilton town, Fairfield County, Connecticut",2010,6172,6475,303,821,164,537,17525,285,18062,16255,municipality,CT
48,900502760,09005,"Barkhamsted town, Litchfield County, Connecticut",2000,1334,1436,102,14,2,31,3463,30,3494,3417,municipality,CT
49,900502760,09005,"Barkhamsted town, Litchfield County, Connecticut",2010,1452,1589,137,23,10,57,3742,47,3799,3662,municipality,CT
50,900504930,09005,"Bethlehem town, Litchfield County, Connecticut",2000,1246,1388,142,27,9,22,3400,44,3422,3320,municipality,CT
51,900504930,09005,"Bethlehem town, Litchfield County, Connecticut",2010,1411,1575,164,18,16,61,3546,35,3607,3477,municipality,CT
52,900508210,09005,"Bridgewater town, Litchfield County, Connecticut",2000,703,779,76,13,17,9,1815,13,1824,1772,municipality,CT
53,900508210,09005,"Bridgewater town, Litchfield County, Connecticut",2010,735,881,146,15,13,26,1701,12,1727,1661,municipality,CT
54,900510940,09005,"Canaan town, Litchfield County, Connecticut",2000,445,610,165,2,16,4,1077,13,1081,1046,municipality,CT
55,900510940,09005,"Canaan town, Litchfield County, Connecticut",2010,583,779,196,3,8,19,1215,18,1234,1186,municipality,CT
56,900516050,09005,"Colebrook town, Litchfield County, Connecticut",2000,566,656,90,9,10,36,1435,2,1471,1414,municipality,CT
57,900516050,09005,"Colebrook town, Litchfield County, Connecticut",2010,589,722,133,9,4,17,1468,15,1485,1440,municipality,CT
58,900517240,09005,"Cornwall town, Litchfield County, Connecticut",2000,615,873,258,10,2,21,1413,18,1434,1383,municipality,CT
59,900517240,09005,"Cornwall town, Litchfield County, Connecticut",2010,628,1007,379,9,2,34,1386,18,1420,1357,municipality,CT
60,900532290,09005,"Goshen town, Litchfield County, Connecticut",2000,1066,1482,416,20,13,33,2664,13,2697,2618,municipality,CT
61,900532290,09005,"Goshen town, Litchfield County, Connecticut",2010,1192,1664,472,36,9,67,2909,22,2976,2842,municipality,CT
62,900537280,09005,"Harwinton town, Litchfield County, Connecticut",2000,1958,2022,64,27,4,47,5236,34,5283,5171,municipality,CT
63,900537280,09005,"Harwinton town, Litchfield County, Connecticut",2010,2170,2282,112,48,12,80,5562,49,5642,5453,municipality,CT
64,900540290,09005,"Kent town, Litchfield County, Connecticut",2000,1143,1463,320,21,16,72,2786,48,2858,2701,municipality,CT
65,900540290,09005,"Kent town, Litchfield County, Connecticut",2010,1246,1665,419,49,34,94,2885,63,2979,2739,municipality,CT
66,900543370,09005,"Litchfield town, Litchfield County, Connecticut",2000,3310,3629,319,39,55,130,8186,92,8316,8000,municipality,CT
67,900543370,09005,"Litchfield town, Litchfield County, Connecticut",2010,3459,3975,516,76,49,173,8293,143,8466,8025,municipality,CT
68,900549460,09005,"Morris town, Litchfield County, Connecticut",2000,912,1181,269,19,16,20,2281,22,2301,2224,municipality,CT
69,900549460,09005,"Morris town, Litchfield County, Connecticut",2010,958,1314,356,18,11,50,2338,29,2388,2280,municipality,CT
70,900551350,09005,"New Hartford town, Litchfield County, Connecticut",2000,2228,2368,140,45,33,82,6006,37,6088,5891,municipality,CT
71,900551350,09005,"New Hartford town, Litchfield County, Connecticut",2010,2632,2923,291,79,18,124,6846,63,6970,6686,municipality,CT
72,900552630,09005,"New Milford town, Litchfield County, Connecticut",2000,10018,10710,692,515,371,751,26370,446,27121,25038,municipality,CT
73,900552630,09005,"New Milford town, Litchfield County, Connecticut",2010,10618,11731,1113,772,452,1693,26449,516,28142,24709,municipality,CT
74,900553470,09005,"Norfolk town, Litchfield County, Connecticut",2000,676,871,195,9,8,16,1644,25,1660,1602,municipality,CT
75,900553470,09005,"Norfolk town, Litchfield County, Connecticut",2010,720,967,247,11,12,30,1679,19,1709,1637,municipality,CT
76,900554030,09005,"North Canaan town, Litchfield County, Connecticut",2000,1343,1444,101,5,36,79,3271,34,3350,3196,municipality,CT
77,900554030,09005,"North Canaan town, Litchfield County, Connecticut",2010,1400,1587,187,8,39,195,3120,30,3315,3043,municipality,CT
78,900560750,09005,"Plymouth town, Litchfield County, Connecticut",2000,4453,4646,193,48,87,147,11487,137,11634,11215,municipality,CT
79,900560750,09005,"Plymouth town, Litchfield County, Connecticut",2010,4803,5109,306,98,94,370,11873,187,12243,11494,municipality,CT
80,900565930,09005,"Roxbury town, Litchfield County, Connecticut",2000,848,1018,170,20,5,28,2108,27,2136,2056,municipality,CT
81,900565930,09005,"Roxbury town, Litchfield County, Connecticut",2010,936,1167,231,18,13,48,2214,33,2262,2150,municipality,CT
82,900566420,09005,"Salisbury town, Litchfield County, Connecticut",2000,1737,2410,673,38,64,61,3916,48,3977,3766,municipality,CT
83,900566420,09005,"Salisbury town, Litchfield County, Connecticut",2010,1693,2593,900,41,52,107,3634,62,3741,3479,municipality,CT
84,900567960,09005,"Sharon town, Litchfield County, Connecticut",2000,1246,1617,371,17,28,58,2910,32,2968,2833,municipality,CT
85,900567960,09005,"Sharon town, Litchfield County, Connecticut",2010,1250,1775,525,20,44,56,2726,30,2782,2632,municipality,CT
86,900575730,09005,"Thomaston town, Litchfield County, Connecticut",2000,2916,3014,98,37,44,109,7394,45,7503,7268,municipality,CT
87,900575730,09005,"Thomaston town, Litchfield County, Connecticut",2010,3108,3276,168,58,27,202,7685,89,7887,7511,municipality,CT
88,900576570,09005,"Torrington town, Litchfield County, Connecticut",2000,14743,16147,1404,634,694,1162,34040,512,35202,32200,municipality,CT
89,900576570,09005,"Torrington town, Litchfield County, Connecticut",2010,15243,16761,1518,777,776,3193,33190,739,36383,30898,municipality,CT
90,900579510,09005,"Warren town, Litchfield County, Connecticut",2000,497,650,153,10,2,3,1251,13,1254,1226,municipality,CT
91,900579510,09005,"Warren town, Litchfield County, Connecticut",2010,601,811,210,20,8,31,1430,8,1461,1394,municipality,CT
92,900579720,09005,"Washington town, Litchfield County, Connecticut",2000,1416,1764,348,56,21,77,3519,53,3596,3389,municipality,CT
93,900579720,09005,"Washington town, Litchfield County, Connecticut",2010,1512,2124,612,26,20,142,3436,45,3578,3345,municipality,CT
94,900580490,09005,"Watertown town, Litchfield County, Connecticut",2000,8046,8298,252,273,149,406,21255,205,21661,20628,municipality,CT
95,900580490,09005,"Watertown town, Litchfield County, Connecticut",2010,8672,9096,424,376,292,838,21676,301,22514,20707,municipality,CT
96,900586440,09005,"Winchester town, Litchfield County, Connecticut",2000,4371,4922,551,98,89,338,10326,178,10664,9961,municipality,CT
97,900586440,09005,"Winchester town, Litchfield County, Connecticut",2010,4815,5613,798,102,136,583,10659,191,11242,10230,municipality,CT
98,900587910,09005,"Woodbury town, Litchfield County, Connecticut",2000,3715,3869,154,101,46,152,9046,80,9198,8819,municipality,CT
99,900587910,09005,"Woodbury town, Litchfield County, Connecticut",2010,4214,4564,350,167,55,245,9730,142,9975,9366,municipality,CT
100,900900000,09009,"County subdivisions not defined, New Haven County, Connecticut",2000,0,0,0,0,0,0,0,0,0,0,municipality,CT
101,900900000,09009,"County subdivisions not defined, New Haven County, Connecticut",2010,0,0,0,0,0,0,0,0,0,0,municipality,CT
102,900901220,09009,"Ansonia town, New Haven County, Connecticut",2000,7507,7937,430,209,1511,1376,17178,392,18554,15066,municipality,CT
103,900901220,09009,"Ansonia town, New Haven County, Connecticut",2010,7510,8148,638,365,2040,3212,16037,469,19249,13163,municipality,CT
104,900903250,09009,"Beacon Falls town, New Haven County, Connecticut",2000,2032,2104,72,54,34,112,5134,45,5246,5001,municipality,CT
105,900903250,09009,"Beacon Falls town, New Haven County, Connecticut",2010,2360,2509,149,70,87,300,5749,77,6049,5515,municipality,CT
106,900904580,09009,"Bethany town, New Haven County, Connecticut",2000,1755,1792,37,77,92,102,4938,56,5040,4713,municipality,CT
107,900904580,09009,"Bethany town, New Haven County, Connecticut",2010,1971,2044,73,268,102,137,5426,68,5563,4988,municipality,CT
108,900907310,09009,"Branford town, New Haven County, Connecticut",2000,12543,13342,799,778,374,737,27946,370,28683,26424,municipality,CT
109,900907310,09009,"Branford town, New Haven County, Connecticut",2010,12739,13972,1233,1020,507,1149,26877,395,28026,24955,municipality,CT
110,900914160,09009,"Cheshire town, New Haven County, Connecticut",2000,9349,9588,239,743,1270,1097,27446,328,28543,25105,municipality,CT
111,900914160,09009,"Cheshire town, New Haven County, Connecticut",2010,10041,10424,383,1477,1374,1375,27886,398,29261,24637,municipality,CT
112,900919550,09009,"Derby town, New Haven County, Connecticut",2000,5252,5568,316,212,441,950,11441,179,12391,10609,municipality,CT
113,900919550,09009,"Derby town, New Haven County, Connecticut",2010,5388,5849,461,323,891,1830,11072,259,12902,9599,municipality,CT
114,900922910,09009,"East Haven town, New Haven County, Connecticut",2000,11219,11698,479,537,377,1228,26961,293,28189,25754,municipality,CT
115,900922910,09009,"East Haven town, New Haven County, Connecticut",2010,11756,12533,777,954,771,3012,26245,366,29257,24154,municipality,CT
116,900934950,09009,"Guilford town, New Haven County, Connecticut",2000,8151,8724,573,351,192,455,20943,191,21398,20209,municipality,CT
117,900934950,09009,"Guilford town, New Haven County, Connecticut",2010,8715,9596,881,535,160,779,21596,261,22375,20640,municipality,CT
118,900935650,09009,"Hamden town, New Haven County, Connecticut",2000,22408,23464,1056,2000,8642,2425,54488,1034,56913,42812,municipality,CT
119,900935650,09009,"Hamden town, New Haven County, Connecticut",2010,23727,25114,1387,3304,11869,5327,55633,1374,60960,39086,municipality,CT
120,900944560,09009,"Madison town, New Haven County, Connecticut",2000,6515,7386,871,304,70,240,17618,174,17858,17070,municipality,CT
121,900944560,09009,"Madison town, New Haven County, Connecticut",2010,6971,8049,1078,405,100,375,17894,237,18269,17152,municipality,CT
122,900946520,09009,"Meriden town, New Haven County, Connecticut",2000,22951,24631,1680,783,3321,12296,45948,1135,58244,40709,municipality,CT
123,900946520,09009,"Meriden town, New Haven County, Connecticut",2010,23977,25892,1915,1250,4980,17590,43278,1239,60868,35809,municipality,CT
124,900946940,09009,"Middlebury town, New Haven County, Connecticut",2000,2398,2494,96,83,21,79,6372,61,6451,6207,municipality,CT
125,900946940,09009,"Middlebury town, New Haven County, Connecticut",2010,2748,2892,144,286,67,208,7367,89,7575,6925,municipality,CT
126,900947535,09009,"Milford town, New Haven County, Connecticut",2000,20900,21962,1062,1206,951,1750,50555,658,52305,47740,municipality,CT
127,900947535,09009,"Milford town, New Haven County, Connecticut",2010,21708,23074,1366,2801,1238,2756,50003,829,52759,45135,municipality,CT
128,900949950,09009,"Naugatuck town, New Haven County, Connecticut",2000,11829,12341,512,520,842,1386,29603,700,30989,27541,municipality,CT
129,900949950,09009,"Naugatuck town, New Haven County, Connecticut",2010,12339,13061,722,962,1427,2929,28933,777,31862,25767,municipality,CT
130,900952070,09009,"New Haven town, New Haven County, Connecticut",2000,47094,52941,5847,4776,44598,26443,97183,3830,123626,43979,municipality,CT
131,900952070,09009,"New Haven town, New Haven County, Connecticut",2010,48877,54967,6090,5864,43332,35591,94188,3762,129779,41230,municipality,CT
132,900953890,09009,"North Branford town, New Haven County, Connecticut",2000,5132,5246,114,124,163,250,13656,111,13906,13258,municipality,CT
133,900953890,09009,"North Branford town, New Haven County, Connecticut",2010,5441,5629,188,225,187,421,13986,144,14407,13430,municipality,CT
134,900954870,09009,"North Haven town, New Haven County, Connecticut",2000,8597,8773,176,768,502,433,22602,205,23035,21127,municipality,CT
135,900954870,09009,"North Haven town, New Haven County, Connecticut",2010,9135,9491,356,1121,693,929,23164,294,24093,21056,municipality,CT
136,900957600,09009,"Orange town, New Haven County, Connecticut",2000,4739,4870,131,508,100,190,13043,123,13233,12312,municipality,CT
137,900957600,09009,"Orange town, New Haven County, Connecticut",2010,5123,5345,222,1045,198,398,13558,195,13956,12120,municipality,CT
138,900958300,09009,"Oxford town, New Haven County, Connecticut",2000,3343,3420,77,65,50,180,9641,74,9821,9452,municipality,CT
139,900958300,09009,"Oxford town, New Haven County, Connecticut",2010,4504,4746,242,195,134,468,12215,141,12683,11745,municipality,CT
140,900962290,09009,"Prospect town, New Haven County, Connecticut",2000,3020,3094,74,63,122,168,8539,86,8707,8268,municipality,CT
141,900962290,09009,"Prospect town, New Haven County, Connecticut",2010,3357,3474,117,73,175,312,9093,105,9405,8740,municipality,CT
142,900967610,09009,"Seymour town, New Haven County, Connecticut",2000,6155,6356,201,270,204,470,14984,150,15454,14360,municipality,CT
143,900967610,09009,"Seymour town, New Haven County, Connecticut",2010,6654,6968,314,359,395,1064,15476,206,16540,14516,municipality,CT
144,900969640,09009,"Southbury town, New Haven County, Connecticut",2000,7225,7799,574,214,80,296,18271,133,18567,17844,municipality,CT
145,900969640,09009,"Southbury town, New Haven County, Connecticut",2010,8213,9091,878,531,156,523,19381,232,19904,18462,municipality,CT
146,900978740,09009,"Wallingford town, New Haven County, Connecticut",2000,16697,17306,609,749,417,1946,41080,456,43026,39458,municipality,CT
147,900978740,09009,"Wallingford town, New Haven County, Connecticut",2010,18032,18945,913,1526,587,3562,41573,581,45135,38879,municipality,CT
148,900980070,09009,"Waterbury town, New Haven County, Connecticut",2000,42622,46827,4205,1584,16335,23354,83917,3592,107271,62406,municipality,CT
149,900980070,09009,"Waterbury town, New Haven County, Connecticut",2010,42761,47991,5230,1933,19654,34446,75920,4252,110366,50081,municipality,CT
150,900982870,09009,"West Haven town, New Haven County, Connecticut",2000,21090,22336,1246,1512,8257,4757,47603,1313,52360,36521,municipality,CT
151,900982870,09009,"West Haven town, New Haven County, Connecticut",2010,21112,22446,1334,2056,10205,10155,45409,1513,55564,31635,municipality,CT
152,900987560,09009,"Wolcott town, New Haven County, Connecticut",2000,5414,5544,130,113,185,273,14942,158,15215,14486,municipality,CT
153,900987560,09009,"Wolcott town, New Haven County, Connecticut",2010,6007,6276,269,205,261,611,16069,243,16680,15360,municipality,CT
154,900987700,09009,"Woodbridge town, New Haven County, Connecticut",2000,3103,3189,86,458,135,138,8845,142,8983,8110,municipality,CT
155,900987700,09009,"Woodbridge town, New Haven County, Connecticut",2010,3336,3478,142,780,173,284,8706,148,8990,7605,municipality,CT
156,3400300700,34003,"Allendale borough, Bergen County, New Jersey",2000,2110,2143,33,408,26,170,6529,46,6699,6049,municipality,INJ
157,3400300700,34003,"Allendale borough, Bergen County, New Jersey",2010,2236,2388,152,624,29,304,6201,98,6505,5450,municipality,INJ
158,3400301090,34003,"Alpine borough, Bergen County, New Jersey",2000,708,730,22,416,33,55,2128,32,2183,1647,municipality,INJ
159,3400301090,34003,"Alpine borough, Bergen County, New Jersey",2010,611,670,59,482,44,89,1760,37,1849,1197,municipality,INJ
160,3400305170,34003,"Bergenfield borough, Bergen County, New Jersey",2000,8981,9147,166,5327,1665,4474,21773,616,26247,14165,municipality,INJ
161,3400305170,34003,"Bergenfield borough, Bergen County, New Jersey",2010,8852,9200,348,6778,1724,7097,19667,619,26764,10546,municipality,INJ
162,3400306490,34003,"Bogota borough, Bergen County, New Jersey",2000,2874,2915,41,637,393,1759,6490,253,8249,5207,municipality,INJ
163,3400306490,34003,"Bogota borough, Bergen County, New Jersey",2010,2773,2888,115,795,582,3169,5018,230,8187,3411,municipality,INJ
164,3400310480,34003,"Carlstadt borough, Bergen County, New Jersey",2000,2393,2473,80,366,64,473,5444,44,5917,4970,municipality,INJ
165,3400310480,34003,"Carlstadt borough, Bergen County, New Jersey",2010,2378,2495,117,499,122,1104,5023,90,6127,4312,municipality,INJ
166,3400313570,34003,"Cliffside Park borough, Bergen County, New Jersey",2000,10027,10375,348,2755,356,4177,18830,457,23007,15262,municipality,INJ
167,3400313570,34003,"Cliffside Park borough, Bergen County, New Jersey",2010,9948,10665,717,3219,584,6704,16890,653,23594,12434,municipality,INJ
168,3400313810,34003,"Closter borough, Bergen County, New Jersey",2000,2789,2865,76,1800,76,343,8040,105,8383,6059,municipality,INJ
169,3400313810,34003,"Closter borough, Bergen County, New Jersey",2010,2747,2860,113,2649,100,501,7872,104,8373,5019,municipality,INJ
170,3400315820,34003,"Cresskill borough, Bergen County, New Jersey",2000,2630,2702,72,1441,70,309,7437,125,7746,5801,municipality,INJ
171,3400315820,34003,"Cresskill borough, Bergen County, New Jersey",2010,3002,3114,112,2367,57,537,8036,112,8573,5500,municipality,INJ
172,3400317530,34003,"Demarest borough, Bergen County, New Jersey",2000,1601,1634,33,977,23,167,4678,62,4845,3616,municipality,INJ
173,3400317530,34003,"Demarest borough, Bergen County, New Jersey",2010,1597,1659,62,1276,26,216,4665,90,4881,3273,municipality,INJ
174,3400318400,34003,"Dumont borough, Bergen County, New Jersey",2000,6370,6465,95,1915,222,1463,16040,211,17503,13692,municipality,INJ
175,3400318400,34003,"Dumont borough, Bergen County, New Jersey",2010,6364,6542,178,2599,375,2580,14899,284,17479,11641,municipality,INJ
176,3400319510,34003,"East Rutherford borough, Bergen County, New Jersey",2000,3644,3771,127,930,292,928,7788,156,8716,6410,municipality,INJ
177,3400319510,34003,"East Rutherford borough, Bergen County, New Jersey",2010,3792,4018,226,1237,336,1563,7350,161,8913,5616,municipality,INJ
178,3400320020,34003,"Edgewater borough, Bergen County, New Jersey",2000,3836,4277,441,1765,243,802,6875,206,7677,4661,municipality,INJ
179,3400320020,34003,"Edgewater borough, Bergen County, New Jersey",2010,5637,6282,645,4076,519,1278,10235,297,11513,5343,municipality,INJ
180,3400321300,34003,"Elmwood Park borough, Bergen County, New Jersey",2000,7089,7242,153,1474,379,2535,16390,399,18925,14138,municipality,INJ
181,3400321300,34003,"Elmwood Park borough, Bergen County, New Jersey",2010,7032,7385,353,2055,884,4117,15286,390,19403,11957,municipality,INJ
182,3400321450,34003,"Emerson borough, Bergen County, New Jersey",2000,2373,2398,25,568,47,332,6865,41,7197,6209,municipality,INJ
183,3400321450,34003,"Emerson borough, Bergen County, New Jersey",2010,2480,2552,72,629,64,619,6782,103,7401,5986,municipality,INJ
184,3400321480,34003,"Englewood city, Bergen County, New Jersey",2000,9273,9614,341,1356,9887,5703,20500,868,26203,8389,municipality,INJ
185,3400321480,34003,"Englewood city, Bergen County, New Jersey",2010,10057,10695,638,2169,8373,7460,19687,671,27147,8474,municipality,INJ
186,3400321510,34003,"Englewood Cliffs borough, Bergen County, New Jersey",2000,1818,1889,71,1580,72,260,5062,69,5322,3341,municipality,INJ
187,3400321510,34003,"Englewood Cliffs borough, Bergen County, New Jersey",2010,1824,1924,100,2027,93,316,4965,106,5281,2739,municipality,INJ
188,3400322470,34003,"Fair Lawn borough, Bergen County, New Jersey",2000,11806,12006,200,1549,208,1744,29893,399,31637,27737,municipality,INJ
189,3400322470,34003,"Fair Lawn borough, Bergen County, New Jersey",2010,11930,12266,336,3130,464,3296,29161,416,32457,25151,municipality,INJ
190,3400322560,34003,"Fairview borough, Bergen County, New Jersey",2000,4861,4988,127,656,161,4911,8344,655,13255,6872,municipality,INJ
191,3400322560,34003,"Fairview borough, Bergen County, New Jersey",2010,4853,5150,297,612,286,7558,6277,434,13835,4945,municipality,INJ
192,3400324420,34003,"Fort Lee borough, Bergen County, New Jersey",2000,16544,17446,902,11121,555,2791,32670,644,35461,20350,municipality,INJ
193,3400324420,34003,"Fort Lee borough, Bergen County, New Jersey",2010,16371,17818,1447,13552,805,3877,31468,597,35345,16514,municipality,INJ
194,3400324990,34003,"Franklin Lakes borough, Bergen County, New Jersey",2000,3322,3395,73,655,96,286,10136,100,10422,9285,municipality,INJ
195,3400324990,34003,"Franklin Lakes borough, Bergen County, New Jersey",2010,3527,3692,165,777,136,525,10065,135,10590,9017,municipality,INJ
196,3400325770,34003,"Garfield city, Bergen County, New Jersey",2000,11250,11698,448,787,778,5989,23797,672,29786,21560,municipality,INJ
197,3400325770,34003,"Garfield city, Bergen County, New Jersey",2010,11073,11788,715,659,1564,9830,20657,462,30487,17972,municipality,INJ
198,3400326640,34003,"Glen Rock borough, Bergen County, New Jersey",2000,3977,4024,47,748,206,314,11232,115,11546,10163,municipality,INJ
199,3400326640,34003,"Glen Rock borough, Bergen County, New Jersey",2010,3917,4016,99,1050,151,527,11074,182,11601,9691,municipality,INJ
200,3400328680,34003,"Hackensack city, Bergen County, New Jersey",2000,18113,18945,832,3163,10092,11061,31616,1348,42677,17013,municipality,INJ
201,3400328680,34003,"Hackensack city, Bergen County, New Jersey",2010,18142,19375,1233,4372,9693,15186,27824,914,43010,12845,municipality,INJ
202,3400330150,34003,"Harrington Park borough, Bergen County, New Jersey",2000,1563,1583,20,694,29,122,4618,26,4740,3869,municipality,INJ
203,3400330150,34003,"Harrington Park borough, Bergen County, New Jersey",2010,1592,1624,32,812,31,163,4501,66,4664,3592,municipality,INJ
204,3400330420,34003,"Hasbrouck Heights borough, Bergen County, New Jersey",2000,4521,4617,96,771,188,964,10698,128,11662,9611,municipality,INJ
205,3400330420,34003,"Hasbrouck Heights borough, Bergen County, New Jersey",2010,4433,4627,194,1169,293,1760,10082,175,11842,8445,municipality,INJ
206,3400330540,34003,"Haworth borough, Bergen County, New Jersey",2000,1134,1146,12,312,41,92,3298,36,3390,2909,municipality,INJ
207,3400330540,34003,"Haworth borough, Bergen County, New Jersey",2010,1110,1136,26,397,37,148,3234,65,3382,2735,municipality,INJ
208,3400331920,34003,"Hillsdale borough, Bergen County, New Jersey",2000,3502,3547,45,511,86,429,9658,78,10087,8983,municipality,INJ
209,3400331920,34003,"Hillsdale borough, Bergen County, New Jersey",2010,3493,3567,74,638,93,794,9425,104,10219,8590,municipality,INJ
210,3400332310,34003,"Ho-Ho-Kus borough, Bergen County, New Jersey",2000,1433,1465,32,212,20,80,3980,52,4060,3696,municipality,INJ
211,3400332310,34003,"Ho-Ho-Kus borough, Bergen County, New Jersey",2010,1401,1462,61,235,9,168,3910,66,4078,3600,municipality,INJ
212,3400340020,34003,"Leonia borough, Bergen County, New Jersey",2000,3271,3343,72,2317,185,1135,7779,154,8914,5123,municipality,INJ
213,3400340020,34003,"Leonia borough, Bergen County, New Jersey",2010,3284,3428,144,3122,169,1489,7448,216,8937,3941,municipality,INJ
214,3400340680,34003,"Little Ferry borough, Bergen County, New Jersey",2000,4366,4449,83,1842,487,1641,9159,326,10800,6504,municipality,INJ
215,3400340680,34003,"Little Ferry borough, Bergen County, New Jersey",2010,4239,4439,200,2550,366,2442,8184,252,10626,5016,municipality,INJ
216,3400341100,34003,"Lodi borough, Bergen County, New Jersey",2000,9528,9908,380,2111,769,4309,19662,505,23971,16277,municipality,INJ
217,3400341100,34003,"Lodi borough, Bergen County, New Jersey",2010,9471,10127,656,2036,1589,7360,16776,559,24136,12592,municipality,INJ
218,3400342090,34003,"Lyndhurst township, Bergen County, New Jersey",2000,7877,8103,226,1042,98,1744,17639,333,19383,16166,municipality,INJ
219,3400342090,34003,"Lyndhurst township, Bergen County, New Jersey",2010,8337,8787,450,1333,325,3769,16785,418,20554,14709,municipality,INJ
220,3400342750,34003,"Mahwah township, Bergen County, New Jersey",2000,9340,9577,237,1510,510,1028,23034,459,24062,20555,municipality,INJ
221,3400342750,34003,"Mahwah township, Bergen County, New Jersey",2010,9505,9868,363,2014,616,1622,24268,550,25890,21088,municipality,INJ
222,3400344880,34003,"Maywood borough, Bergen County, New Jersey",2000,3710,3777,67,679,247,1115,8408,152,9523,7330,municipality,INJ
223,3400344880,34003,"Maywood borough, Bergen County, New Jersey",2010,3649,3769,120,1042,460,1785,7770,187,9555,6081,municipality,INJ
224,3400346110,34003,"Midland Park borough, Bergen County, New Jersey",2000,2613,2650,37,154,29,256,6691,47,6947,6461,municipality,INJ
225,3400346110,34003,"Midland Park borough, Bergen County, New Jersey",2010,2756,2861,105,192,51,474,6654,109,7128,6302,municipality,INJ
226,3400347610,34003,"Montvale borough, Bergen County, New Jersey",2000,2509,2590,81,373,30,217,6817,56,7034,6358,municipality,INJ
227,3400347610,34003,"Montvale borough, Bergen County, New Jersey",2010,2778,2872,94,861,70,419,7425,99,7844,6395,municipality,INJ
228,3400347700,34003,"Moonachie borough, Bergen County, New Jersey",2000,1041,1074,33,175,22,349,2405,65,2754,2143,municipality,INJ
229,3400347700,34003,"Moonachie borough, Bergen County, New Jersey",2010,1005,1053,48,267,23,660,2048,50,2708,1708,municipality,INJ
230,3400351660,34003,"New Milford borough, Bergen County, New Jersey",2000,6346,6437,91,2402,396,1326,15074,268,16400,12008,municipality,INJ
231,3400351660,34003,"New Milford borough, Bergen County, New Jersey",2010,6141,6362,221,3163,507,2227,14114,284,16341,10160,municipality,INJ
232,3400352320,34003,"North Arlington borough, Bergen County, New Jersey",2000,6392,6529,137,841,58,1605,13576,239,15181,12438,municipality,INJ
233,3400352320,34003,"North Arlington borough, Bergen County, New Jersey",2010,6295,6573,278,1201,148,3211,12181,265,15392,10567,municipality,INJ
234,3400353430,34003,"Northvale borough, Bergen County, New Jersey",2000,1575,1596,21,626,32,211,4249,38,4460,3553,municipality,INJ
235,3400353430,34003,"Northvale borough, Bergen County, New Jersey",2010,1564,1635,71,1110,46,378,4262,67,4640,3039,municipality,INJ
236,3400353610,34003,"Norwood borough, Bergen County, New Jersey",2000,1857,1888,31,1092,48,172,5579,83,5751,4356,municipality,INJ
237,3400353610,34003,"Norwood borough, Bergen County, New Jersey",2010,1927,2007,80,1551,64,260,5451,70,5711,3766,municipality,INJ
238,3400353850,34003,"Oakland borough, Bergen County, New Jersey",2000,4255,4345,90,335,94,483,11983,113,12466,11441,municipality,INJ
239,3400353850,34003,"Oakland borough, Bergen County, New Jersey",2010,4335,4470,135,532,104,681,12073,164,12754,11273,municipality,INJ
240,3400354870,34003,"Old Tappan borough, Bergen County, New Jersey",2000,1778,1804,26,857,30,151,5331,32,5482,4412,municipality,INJ
241,3400354870,34003,"Old Tappan borough, Bergen County, New Jersey",2010,1931,1995,64,1276,40,288,5462,74,5750,4072,municipality,INJ
242,3400354990,34003,"Oradell borough, Bergen County, New Jersey",2000,2789,2833,44,649,34,249,7798,68,8047,7047,municipality,INJ
243,3400354990,34003,"Oradell borough, Bergen County, New Jersey",2010,2749,2831,82,895,46,397,7581,103,7978,6537,municipality,INJ
244,3400355770,34003,"Palisades Park borough, Bergen County, New Jersey",2000,6247,6386,139,7010,176,2813,14260,406,17073,6668,municipality,INJ
245,3400355770,34003,"Palisades Park borough, Bergen County, New Jersey",2010,6934,7362,428,11312,283,3575,16047,239,19622,4213,municipality,INJ
246,3400355950,34003,"Paramus borough, Bergen County, New Jersey",2000,8082,8209,127,4419,278,1253,24484,354,25737,19433,municipality,INJ
247,3400355950,34003,"Paramus borough, Bergen County, New Jersey",2010,8630,8915,285,5850,335,1913,24429,618,26342,17626,municipality,INJ
248,3400356130,34003,"Park Ridge borough, Bergen County, New Jersey",2000,3161,3258,97,336,67,463,8245,64,8708,7778,municipality,INJ
249,3400356130,34003,"Park Ridge borough, Bergen County, New Jersey",2010,3283,3428,145,524,80,669,7976,84,8645,7288,municipality,INJ
250,3400361680,34003,"Ramsey borough, Bergen County, New Jersey",2000,5313,5400,87,833,110,420,13931,142,14351,12846,municipality,INJ
251,3400361680,34003,"Ramsey borough, Bergen County, New Jersey",2010,5363,5550,187,959,90,866,13607,167,14473,12391,municipality,INJ
252,3400362910,34003,"Ridgefield borough, Bergen County, New Jersey",2000,4020,4120,100,1881,71,1494,9336,195,10830,7189,municipality,INJ
253,3400362910,34003,"Ridgefield borough, Bergen County, New Jersey",2010,3905,4145,240,3199,95,2362,8670,161,11032,5215,municipality,INJ
254,3400362940,34003,"Ridgefield Park village, Bergen County, New Jersey",2000,5012,5134,122,1007,446,2863,10010,219,12873,8338,municipality,INJ
255,3400362940,34003,"Ridgefield Park village, Bergen County, New Jersey",2010,4851,5164,313,1447,581,4605,8124,214,12729,5882,municipality,INJ
256,3400363000,34003,"Ridgewood village, Bergen County, New Jersey",2000,8603,8802,199,2155,395,942,23994,280,24936,21164,municipality,INJ
257,3400363000,34003,"Ridgewood village, Bergen County, New Jersey",2010,8456,8743,287,3237,373,1316,23642,471,24958,19561,municipality,INJ
258,3400363360,34003,"River Edge borough, Bergen County, New Jersey",2000,4165,4210,45,1378,108,581,10365,121,10946,8758,municipality,INJ
259,3400363360,34003,"River Edge borough, Bergen County, New Jersey",2010,4134,4261,127,2505,156,869,10471,141,11340,7669,municipality,INJ
260,3400363690,34003,"River Vale township, Bergen County, New Jersey",2000,3275,3312,37,556,50,304,9145,69,9449,8470,municipality,INJ
261,3400363690,34003,"River Vale township, Bergen County, New Jersey",2010,3421,3521,100,809,64,481,9178,119,9659,8186,municipality,INJ
262,3400363990,34003,"Rochelle Park township, Bergen County, New Jersey",2000,2061,2111,50,327,25,474,5054,52,5528,4650,municipality,INJ
263,3400363990,34003,"Rochelle Park township, Bergen County, New Jersey",2010,2087,2170,83,481,147,904,4626,80,5530,3918,municipality,INJ
264,3400364170,34003,"Rockleigh borough, Bergen County, New Jersey",2000,74,80,6,15,13,19,372,8,391,336,municipality,INJ
265,3400364170,34003,"Rockleigh borough, Bergen County, New Jersey",2010,75,86,11,8,10,20,511,6,531,487,municipality,INJ
266,3400365280,34003,"Rutherford borough, Bergen County, New Jersey",2000,7055,7214,159,2054,475,1555,16555,330,18110,13696,municipality,INJ
267,3400365280,34003,"Rutherford borough, Bergen County, New Jersey",2010,6949,7278,329,2340,454,2543,15518,426,18061,12298,municipality,INJ
268,3400365340,34003,"Saddle Brook township, Bergen County, New Jersey",2000,5062,5161,99,611,162,825,12330,157,13155,11400,municipality,INJ
269,3400365340,34003,"Saddle Brook township, Bergen County, New Jersey",2010,5286,5485,199,1102,268,1666,11993,205,13659,10418,municipality,INJ
270,3400365400,34003,"Saddle River borough, Bergen County, New Jersey",2000,1118,1183,65,229,24,82,3119,55,3201,2811,municipality,INJ
271,3400365400,34003,"Saddle River borough, Bergen County, New Jersey",2010,1216,1341,125,291,60,162,2990,69,3152,2570,municipality,INJ
272,3400368970,34003,"South Hackensack township, Bergen County, New Jersey",2000,811,830,19,129,47,339,1910,36,2249,1698,municipality,INJ
273,3400368970,34003,"South Hackensack township, Bergen County, New Jersey",2010,845,879,34,121,98,792,1586,41,2378,1326,municipality,INJ
274,3400372360,34003,"Teaneck township, Bergen County, New Jersey",2000,13418,13719,301,2791,10905,4103,35157,1224,39260,20237,municipality,INJ
275,3400372360,34003,"Teaneck township, Bergen County, New Jersey",2010,13470,14024,554,3574,10266,6575,33201,1015,39776,18346,municipality,INJ
276,3400372420,34003,"Tenafly borough, Bergen County, New Jersey",2000,4774,4897,123,2629,122,642,13164,237,13806,10176,municipality,INJ
277,3400372420,34003,"Tenafly borough, Bergen County, New Jersey",2010,4766,4980,214,3794,123,776,13712,320,14488,9475,municipality,INJ
278,3400372480,34003,"Teterboro borough, Bergen County, New Jersey",2000,7,8,1,0,0,0,18,3,18,15,municipality,INJ
279,3400372480,34003,"Teterboro borough, Bergen County, New Jersey",2010,25,27,2,2,2,24,43,8,67,31,municipality,INJ
280,3400375140,34003,"Upper Saddle River borough, Bergen County, New Jersey",2000,2497,2560,63,484,72,169,7572,80,7741,6936,municipality,INJ
281,3400375140,34003,"Upper Saddle River borough, Bergen County, New Jersey",2010,2639,2776,137,822,108,355,7853,114,8208,6809,municipality,INJ
282,3400376400,34003,"Waldwick borough, Bergen County, New Jersey",2000,3428,3495,67,434,57,511,9111,75,9622,8545,municipality,INJ
283,3400376400,34003,"Waldwick borough, Bergen County, New Jersey",2010,3420,3537,117,478,74,830,8795,121,9625,8122,municipality,INJ
284,3400376490,34003,"Wallington borough, Bergen County, New Jersey",2000,4752,4906,154,574,284,776,10807,216,11583,9733,municipality,INJ
285,3400376490,34003,"Wallington borough, Bergen County, New Jersey",2010,4637,4946,309,610,303,1225,10110,149,11335,9048,municipality,INJ
286,3400377135,34003,"Washington township, Bergen County, New Jersey",2000,3219,3245,26,496,78,299,8639,84,8938,7981,municipality,INJ
287,3400377135,34003,"Washington township, Bergen County, New Jersey",2010,3261,3341,80,581,93,495,8607,94,9102,7839,municipality,INJ
288,3400380270,34003,"Westwood borough, Bergen County, New Jersey",2000,4485,4610,125,482,624,660,10339,122,10999,9111,municipality,INJ
289,3400380270,34003,"Westwood borough, Bergen County, New Jersey",2010,4438,4636,198,802,466,1263,9645,132,10908,8245,municipality,INJ
290,3400382300,34003,"Woodcliff Lake borough, Bergen County, New Jersey",2000,1824,1842,18,257,49,134,5611,31,5745,5274,municipality,INJ
291,3400382300,34003,"Woodcliff Lake borough, Bergen County, New Jersey",2010,1916,1980,64,371,47,310,5420,56,5730,4946,municipality,INJ
292,3400382570,34003,"Wood-Ridge borough, Bergen County, New Jersey",2000,3024,3087,63,382,61,556,7088,83,7644,6562,municipality,INJ
293,3400382570,34003,"Wood-Ridge borough, Bergen County, New Jersey",2010,2939,3051,112,538,95,1000,6626,95,7626,5898,municipality,INJ
294,3400383050,34003,"Wyckoff township, Bergen County, New Jersey",2000,5541,5638,97,611,73,376,16132,136,16508,15312,municipality,INJ
295,3400383050,34003,"Wyckoff township, Bergen County, New Jersey",2010,5646,5827,181,705,81,737,15959,168,16696,15005,municipality,INJ
296,3401304695,34013,"Belleville township, Essex County, New Jersey",2000,13731,14144,413,4024,1708,8507,27421,1020,35928,20669,municipality,INJ
297,3401304695,34013,"Belleville township, Essex County, New Jersey",2010,13395,14327,932,4251,2794,14133,21793,880,35926,13868,municipality,INJ
298,3401306260,34013,"Bloomfield township, Essex County, New Jersey",2000,19017,19508,491,3980,5332,6901,40782,1434,47683,30036,municipality,INJ
299,3401306260,34013,"Bloomfield township, Essex County, New Jersey",2010,18387,19470,1083,3846,8092,11606,35709,1480,47315,22291,municipality,INJ
300,3401309250,34013,"Caldwell borough, Essex County, New Jersey",2000,3311,3396,85,308,165,352,7232,73,7584,6686,municipality,INJ
301,3401309250,34013,"Caldwell borough, Essex County, New Jersey",2010,3359,3510,151,366,233,786,7036,131,7822,6306,municipality,INJ
302,3401311200,34013,"Cedar Grove township, Essex County, New Jersey",2000,4403,4470,67,666,364,393,11907,100,12300,10777,municipality,INJ
303,3401311200,34013,"Cedar Grove township, Essex County, New Jersey",2010,4523,4661,138,800,294,727,11684,115,12411,10475,municipality,INJ
304,3401313045,34013,"City of Orange township, Essex County, New Jersey",2000,11885,12665,780,414,24318,4097,28771,1537,32868,2502,municipality,INJ
305,3401313045,34013,"City of Orange township, Essex County, New Jersey",2010,11202,12222,1020,448,21067,6531,23603,731,30134,1357,municipality,INJ
306,3401319390,34013,"East Orange city, Essex County, New Jersey",2000,26024,28485,2461,294,61604,3284,66540,2768,69824,1874,municipality,INJ
307,3401319390,34013,"East Orange city, Essex County, New Jersey",2010,24945,28803,3858,436,55702,5095,59175,1615,64270,1422,municipality,INJ
308,3401321840,34013,"Essex Fells borough, Essex County, New Jersey",2000,737,761,24,22,10,26,2136,30,2162,2074,municipality,INJ
309,3401321840,34013,"Essex Fells borough, Essex County, New Jersey",2010,728,758,30,43,20,42,2071,32,2113,1976,municipality,INJ
310,3401322385,34013,"Fairfield township, Essex County, New Jersey",2000,2296,2326,30,199,36,244,6819,40,7063,6544,municipality,INJ
311,3401322385,34013,"Fairfield township, Essex County, New Jersey",2010,2645,2723,78,183,46,384,7082,53,7466,6800,municipality,INJ
312,3401326610,34013,"Glen Ridge borough, Essex County, New Jersey",2000,2458,2490,32,241,342,251,7020,102,7271,6335,municipality,INJ
313,3401326610,34013,"Glen Ridge borough, Essex County, New Jersey",2010,2476,2541,65,348,356,377,7150,193,7527,6253,municipality,INJ
314,3401334450,34013,"Irvington township, Essex County, New Jersey",2000,22032,24116,2084,661,48852,5086,55609,2631,60695,3465,municipality,INJ
315,3401334450,34013,"Irvington township, Essex County, New Jersey",2010,20093,23196,3103,462,45285,5716,48210,1034,53926,1429,municipality,INJ
316,3401340890,34013,"Livingston township, Essex County, New Jersey",2000,9300,9457,157,3964,325,695,26696,257,27391,22150,municipality,INJ
317,3401340890,34013,"Livingston township, Essex County, New Jersey",2010,9990,10284,294,5609,632,1192,28174,398,29366,21535,municipality,INJ
318,3401343800,34013,"Maplewood township, Essex County, New Jersey",2000,8452,8615,163,660,7644,1248,22620,934,23868,13382,municipality,INJ
319,3401343800,34013,"Maplewood township, Essex County, New Jersey",2010,8240,8608,368,722,8189,1595,22272,776,23867,12585,municipality,INJ
320,3401346380,34013,"Millburn township, Essex County, New Jersey",2000,7015,7158,143,1658,212,404,19361,229,19765,17262,municipality,INJ
321,3401346380,34013,"Millburn township, Essex County, New Jersey",2010,6813,7106,293,3149,303,703,19446,407,20149,15587,municipality,INJ
322,3401347500,34013,"Montclair township, Essex County, New Jersey",2000,15020,15531,511,1214,12194,1995,36982,1306,38977,22268,municipality,INJ
323,3401347500,34013,"Montclair township, Essex County, New Jersey",2010,15089,15911,822,1416,9902,2810,34859,1621,37669,21920,municipality,INJ
324,3401351000,34013,"Newark city, Essex County, New Jersey",2000,91382,100141,8759,3138,142083,80622,192924,8753,273546,38950,municipality,INJ
325,3401351000,34013,"Newark city, Essex County, New Jersey",2010,94542,109520,14978,4318,138074,93746,183394,8880,277140,32122,municipality,INJ
326,3401352620,34013,"North Caldwell borough, Essex County, New Jersey",2000,2070,2108,38,347,1053,159,7216,62,7375,5754,municipality,INJ
327,3401352620,34013,"North Caldwell borough, Essex County, New Jersey",2010,2092,2134,42,350,41,260,5923,59,6183,5473,municipality,INJ
328,3401353680,34013,"Nutley township, Essex County, New Jersey",2000,10884,11118,234,1934,484,1830,25532,319,27362,22795,municipality,INJ
329,3401353680,34013,"Nutley township, Essex County, New Jersey",2010,11314,11789,475,2789,541,3354,25016,490,28370,21196,municipality,INJ
330,3401364590,34013,"Roseland borough, Essex County, New Jersey",2000,2142,2187,45,250,38,121,5177,42,5298,4847,municipality,INJ
331,3401364590,34013,"Roseland borough, Essex County, New Jersey",2010,2345,2432,87,333,101,262,5557,55,5819,5068,municipality,INJ
332,3401369274,34013,"South Orange Village township, Essex County, New Jersey",2000,5522,5671,149,659,5150,837,16127,447,16964,9871,municipality,INJ
333,3401369274,34013,"South Orange Village township, Essex County, New Jersey",2010,5516,5815,299,829,4484,993,15205,661,16198,9231,municipality,INJ
334,3401375815,34013,"Verona township, Essex County, New Jersey",2000,5585,5719,134,457,197,467,13066,152,13533,12260,municipality,INJ
335,3401375815,34013,"Verona township, Essex County, New Jersey",2010,5315,5523,208,535,239,795,12537,194,13332,11569,municipality,INJ
336,3401378510,34013,"West Caldwell township, Essex County, New Jersey",2000,3990,4044,54,432,100,314,10919,87,11233,10300,municipality,INJ
337,3401378510,34013,"West Caldwell township, Essex County, New Jersey",2010,3913,4009,96,418,122,523,10236,122,10759,9574,municipality,INJ
338,3401379800,34013,"West Orange township, Essex County, New Jersey",2000,16480,16901,421,3619,7672,4514,40429,1231,44943,27907,municipality,INJ
339,3401379800,34013,"West Orange township, Essex County, New Jersey",2010,16790,17612,822,3641,11841,7487,38720,1098,46207,22140,municipality,INJ
340,3401703580,34017,"Bayonne city, Hudson County, New Jersey",2000,25545,26826,1281,2529,3098,11015,50827,1983,61842,43217,municipality,INJ
341,3401703580,34017,"Bayonne city, Hudson County, New Jersey",2010,25237,27799,2562,4803,4730,16251,46773,1419,63024,35821,municipality,INJ
342,3401719360,34017,"East Newark borough, Hudson County, New Jersey",2000,767,799,32,59,22,1130,1247,108,2377,1058,municipality,INJ
343,3401719360,34017,"East Newark borough, Hudson County, New Jersey",2010,759,794,35,188,17,1477,929,56,2406,668,municipality,INJ
344,3401728650,34017,"Guttenberg town, Hudson County, New Jersey",2000,4493,4650,157,779,307,5871,4936,365,10807,3485,municipality,INJ
345,3401728650,34017,"Guttenberg town, Hudson County, New Jersey",2010,4473,4839,366,803,330,7245,3931,176,11176,2622,municipality,INJ
346,3401730210,34017,"Harrison town, Hudson County, New Jersey",2000,5136,5254,118,1700,87,5333,9091,548,14424,6756,municipality,INJ
347,3401730210,34017,"Harrison town, Hudson County, New Jersey",2010,4869,5228,359,2198,173,6017,7603,414,13620,4818,municipality,INJ
348,3401732250,34017,"Hoboken city, Hudson County, New Jersey",2000,19418,19915,497,1648,1299,7783,30794,651,38577,27196,municipality,INJ
349,3401732250,34017,"Hoboken city, Hudson County, New Jersey",2010,25041,26855,1814,3516,1289,7602,42403,991,50005,36607,municipality,INJ
350,3401736000,34017,"Jersey City city, Hudson County, New Jersey",2000,88632,93648,5016,38623,64389,67952,172103,12355,240055,56736,municipality,INJ
351,3401736000,34017,"Jersey City city, Hudson County, New Jersey",2010,96859,108720,11861,58106,59060,68256,179341,8939,247597,53236,municipality,INJ
352,3401736510,34017,"Kearny town, Hudson County, New Jersey",2000,13539,13872,333,2206,1442,11075,29438,1365,40513,24425,municipality,INJ
353,3401736510,34017,"Kearny town, Hudson County, New Jersey",2010,13462,14180,718,1746,1721,16253,24431,1148,40684,19816,municipality,INJ
354,3401752470,34017,"North Bergen township, Hudson County, New Jersey",2000,21236,22009,773,3711,900,33260,24832,1794,58092,18427,municipality,INJ
355,3401752470,34017,"North Bergen township, Hudson County, New Jersey",2010,22062,23912,1850,3835,1065,41569,19204,934,60773,13370,municipality,INJ
356,3401766570,34017,"Secaucus town, Hudson County, New Jersey",2000,6214,6385,171,1874,651,1953,13978,281,15931,11172,municipality,INJ
357,3401766570,34017,"Secaucus town, Hudson County, New Jersey",2010,6297,6846,549,3269,575,3025,13239,304,16264,9091,municipality,INJ
358,3401774630,34017,"Union City city, Hudson County, New Jersey",2000,22872,23741,869,1333,875,55226,11862,764,67088,8890,municipality,INJ
359,3401774630,34017,"Union City city, Hudson County, New Jersey",2010,22814,24931,2117,1447,1070,56291,10164,607,66455,7040,municipality,INJ
360,3401777930,34017,"Weehawken township, Hudson County, New Jersey",2000,5975,6159,184,616,312,5487,8014,320,13501,6766,municipality,INJ
361,3401777930,34017,"Weehawken township, Hudson County, New Jersey",2010,5712,6213,501,1010,412,5055,7499,227,12554,5850,municipality,INJ
362,3401779610,34017,"West New York town, Hudson County, New Jersey",2000,16719,17360,641,1292,658,36038,9730,692,45768,7088,municipality,INJ
363,3401779610,34017,"West New York town, Hudson County, New Jersey",2010,18852,20018,1166,2904,873,38812,10896,548,49708,6571,municipality,INJ
364,3401900550,34019,"Alexandria township, Hunterdon County, New Jersey",2000,1535,1598,63,34,36,81,4617,38,4698,4509,municipality,ONJ
365,3401900550,34019,"Alexandria township, Hunterdon County, New Jersey",2010,1758,1865,107,90,98,159,4779,41,4938,4550,municipality,ONJ
366,3401905650,34019,"Bethlehem township, Hunterdon County, New Jersey",2000,1266,1303,37,39,31,62,3758,18,3820,3670,municipality,ONJ
367,3401905650,34019,"Bethlehem township, Hunterdon County, New Jersey",2010,1344,1386,42,75,39,160,3819,35,3979,3670,municipality,ONJ
368,3401906370,34019,"Bloomsbury borough, Hunterdon County, New Jersey",2000,322,342,20,3,3,13,873,6,886,861,municipality,ONJ
369,3401906370,34019,"Bloomsbury borough, Hunterdon County, New Jersey",2010,337,358,21,16,9,35,835,11,870,799,municipality,ONJ
370,3401909280,34019,"Califon borough, Hunterdon County, New Jersey",2000,401,410,9,8,0,5,1050,6,1055,1036,municipality,ONJ
371,3401909280,34019,"Califon borough, Hunterdon County, New Jersey",2010,394,419,25,9,3,14,1062,27,1076,1023,municipality,ONJ
372,3401913720,34019,"Clinton town, Hunterdon County, New Jersey",2000,1068,1095,27,98,35,108,2524,36,2632,2355,municipality,ONJ
373,3401913720,34019,"Clinton town, Hunterdon County, New Jersey",2010,1057,1098,41,181,36,169,2550,34,2719,2299,municipality,ONJ
374,3401913750,34019,"Clinton township, Hunterdon County, New Jersey",2000,4129,4234,105,303,858,507,12450,149,12957,11140,municipality,ONJ
375,3401913750,34019,"Clinton township, Hunterdon County, New Jersey",2010,4568,4737,169,523,734,755,12723,227,13478,11239,municipality,ONJ
376,3401917170,34019,"Delaware township, Hunterdon County, New Jersey",2000,1643,1701,58,46,18,51,4427,21,4478,4342,municipality,ONJ
377,3401917170,34019,"Delaware township, Hunterdon County, New Jersey",2010,1788,1927,139,41,26,112,4451,60,4563,4324,municipality,ONJ
378,3401918820,34019,"East Amwell township, Hunterdon County, New Jersey",2000,1581,1624,43,41,32,68,4387,36,4455,4278,municipality,ONJ
379,3401918820,34019,"East Amwell township, Hunterdon County, New Jersey",2010,1518,1580,62,57,50,113,3900,33,4013,3760,municipality,ONJ
380,3401923700,34019,"Flemington borough, Hunterdon County, New Jersey",2000,1804,1876,72,131,127,461,3739,73,4200,3408,municipality,ONJ
381,3401923700,34019,"Flemington borough, Hunterdon County, New Jersey",2010,1815,1926,111,257,159,1198,3383,104,4581,2863,municipality,ONJ
382,3401924870,34019,"Franklin township, Hunterdon County, New Jersey",2000,1091,1125,34,23,12,67,2923,21,2990,2867,municipality,ONJ
383,3401924870,34019,"Franklin township, Hunterdon County, New Jersey",2010,1137,1204,67,37,18,110,3085,22,3195,3008,municipality,ONJ
384,3401925350,34019,"Frenchtown borough, Hunterdon County, New Jersey",2000,613,630,17,18,6,39,1449,12,1488,1413,municipality,ONJ
385,3401925350,34019,"Frenchtown borough, Hunterdon County, New Jersey",2010,596,656,60,13,10,70,1303,12,1373,1268,municipality,ONJ
386,3401926550,34019,"Glen Gardner borough, Hunterdon County, New Jersey",2000,805,829,24,28,17,65,1837,23,1902,1769,municipality,ONJ
387,3401926550,34019,"Glen Gardner borough, Hunterdon County, New Jersey",2010,768,825,57,31,28,90,1614,21,1704,1534,municipality,ONJ
388,3401929460,34019,"Hampton borough, Hunterdon County, New Jersey",2000,559,574,15,15,73,44,1502,29,1546,1385,municipality,ONJ
389,3401929460,34019,"Hampton borough, Hunterdon County, New Jersey",2010,570,612,42,26,32,75,1326,21,1401,1247,municipality,ONJ
390,3401931320,34019,"High Bridge borough, Hunterdon County, New Jersey",2000,1428,1478,50,54,29,80,3696,34,3776,3579,municipality,ONJ
391,3401931320,34019,"High Bridge borough, Hunterdon County, New Jersey",2010,1418,1481,63,114,47,219,3429,41,3648,3227,municipality,ONJ
392,3401932460,34019,"Holland township, Hunterdon County, New Jersey",2000,1881,1942,61,22,22,87,5037,35,5124,4958,municipality,ONJ
393,3401932460,34019,"Holland township, Hunterdon County, New Jersey",2010,1972,2066,94,41,29,142,5149,33,5291,5046,municipality,ONJ
394,3401937065,34019,"Kingwood township, Hunterdon County, New Jersey",2000,1340,1422,82,29,23,70,3712,25,3782,3635,municipality,ONJ
395,3401937065,34019,"Kingwood township, Hunterdon County, New Jersey",2010,1446,1569,123,41,23,92,3753,48,3845,3641,municipality,ONJ
396,3401938610,34019,"Lambertville city, Hunterdon County, New Jersey",2000,1860,1961,101,32,74,120,3748,47,3868,3595,municipality,ONJ
397,3401938610,34019,"Lambertville city, Hunterdon County, New Jersey",2010,1958,2075,117,51,70,381,3525,35,3906,3369,municipality,ONJ
398,3401939630,34019,"Lebanon borough, Hunterdon County, New Jersey",2000,458,477,19,33,7,22,1043,5,1065,998,municipality,ONJ
399,3401939630,34019,"Lebanon borough, Hunterdon County, New Jersey",2010,602,664,62,71,22,68,1290,26,1358,1171,municipality,ONJ
400,3401939660,34019,"Lebanon township, Hunterdon County, New Jersey",2000,1963,2020,57,53,45,100,5716,43,5816,5575,municipality,ONJ
401,3401939660,34019,"Lebanon township, Hunterdon County, New Jersey",2010,2296,2439,143,97,107,205,6383,83,6588,6096,municipality,ONJ
402,3401946260,34019,"Milford borough, Hunterdon County, New Jersey",2000,469,484,15,5,2,24,1171,7,1195,1157,municipality,ONJ
403,3401946260,34019,"Milford borough, Hunterdon County, New Jersey",2010,520,552,32,12,3,27,1206,14,1233,1177,municipality,ONJ
404,3401961920,34019,"Raritan township, Hunterdon County, New Jersey",2000,6939,7094,155,692,237,552,19257,243,19809,18085,municipality,ONJ
405,3401961920,34019,"Raritan township, Hunterdon County, New Jersey",2010,8056,8288,232,1315,438,1138,21047,301,22185,18993,municipality,ONJ
406,3401962250,34019,"Readington township, Hunterdon County, New Jersey",2000,5676,5794,118,405,118,324,15479,149,15803,14807,municipality,ONJ
407,3401962250,34019,"Readington township, Hunterdon County, New Jersey",2010,5971,6191,220,578,205,633,15493,180,16126,14530,municipality,ONJ
408,3401970980,34019,"Stockton borough, Hunterdon County, New Jersey",2000,246,258,12,5,0,3,557,1,560,551,municipality,ONJ
409,3401970980,34019,"Stockton borough, Hunterdon County, New Jersey",2010,237,259,22,5,0,3,535,3,538,527,municipality,ONJ
410,3401972510,34019,"Tewksbury township, Hunterdon County, New Jersey",2000,1986,2052,66,102,27,85,5456,32,5541,5295,municipality,ONJ
411,3401972510,34019,"Tewksbury township, Hunterdon County, New Jersey",2010,2189,2323,134,175,48,209,5784,78,5993,5483,municipality,ONJ
412,3401974420,34019,"Union township, Hunterdon County, New Jersey",2000,1666,1725,59,97,791,316,5844,73,6160,4883,municipality,ONJ
413,3401974420,34019,"Union township, Hunterdon County, New Jersey",2010,1752,1830,78,244,502,359,5549,97,5908,4706,municipality,ONJ
414,3401978230,34019,"West Amwell township, Hunterdon County, New Jersey",2000,949,984,35,16,15,17,2366,13,2383,2322,municipality,ONJ
415,3401978230,34019,"West Amwell township, Hunterdon County, New Jersey",2010,1102,1157,55,55,497,186,3654,45,3840,3057,municipality,ONJ
416,3402119780,34021,"East Windsor township, Mercer County, New Jersey",2000,9448,9880,432,2365,2122,3559,21360,440,24919,16433,municipality,ONJ
417,3402119780,34021,"East Windsor township, Mercer County, New Jersey",2010,10224,10851,627,4786,2220,5340,21850,543,27190,14301,municipality,ONJ
418,3402122185,34021,"Ewing township, Mercer County, New Jersey",2000,12551,12924,373,805,8707,1586,34121,641,35707,23968,municipality,ONJ
419,3402122185,34021,"Ewing township, Mercer County, New Jersey",2010,13171,13926,755,1520,9586,2727,33063,769,35790,21188,municipality,ONJ
420,3402129310,34021,"Hamilton township, Mercer County, New Jersey",2000,33523,34535,1012,2226,6907,4471,82638,1387,87109,72118,municipality,ONJ
421,3402129310,34021,"Hamilton township, Mercer County, New Jersey",2010,34534,36170,1636,2890,10042,9613,78851,1389,88464,64530,municipality,ONJ
422,3402131620,34021,"Hightstown borough, Mercer County, New Jersey",2000,2001,2081,80,119,423,1046,4170,111,5216,3517,municipality,ONJ
423,3402131620,34021,"Hightstown borough, Mercer County, New Jersey",2010,1976,2108,132,218,413,1664,3830,111,5494,3088,municipality,ONJ
424,3402133150,34021,"Hopewell borough, Mercer County, New Jersey",2000,813,836,23,20,22,47,1988,26,2035,1920,municipality,ONJ
425,3402133150,34021,"Hopewell borough, Mercer County, New Jersey",2010,778,817,39,13,29,71,1851,23,1922,1786,municipality,ONJ
426,3402133180,34021,"Hopewell township, Mercer County, New Jersey",2000,5498,5629,131,639,905,395,15710,188,16105,13978,municipality,ONJ
427,3402133180,34021,"Hopewell township, Mercer County, New Jersey",2010,6282,6551,269,1532,354,573,16731,294,17304,14551,municipality,ONJ
428,3402139510,34021,"Lawrence township, Mercer County, New Jersey",2000,10797,11180,383,2297,2669,1344,27815,524,29159,22325,municipality,ONJ
429,3402139510,34021,"Lawrence township, Mercer County, New Jersey",2010,12524,13239,715,4711,3493,2503,30969,762,33472,22003,municipality,ONJ
430,3402157600,34021,"Pennington borough, Mercer County, New Jersey",2000,1013,1040,27,27,71,32,2664,20,2696,2546,municipality,ONJ
431,3402157600,34021,"Pennington borough, Mercer County, New Jersey",2010,1031,1083,52,46,45,37,2548,25,2585,2432,municipality,ONJ
432,3402160900,34021,"Princeton borough, Mercer County, New Jersey",2000,9370,9719,349,2654,1719,1856,28374,765,30230,23236,municipality,ONJ
433,3402160900,34021,"Princeton borough, Mercer County, New Jersey",2010,9521,10302,781,3955,1547,2392,26180,884,28572,19794,municipality,ONJ
434,3402163850,34021,"Robbinsville township, Mercer County, New Jersey",2000,4074,4163,89,440,293,279,9996,126,10275,9137,municipality,ONJ
435,3402163850,34021,"Robbinsville township, Mercer County, New Jersey",2010,5087,5277,190,1728,407,564,13078,235,13642,10708,municipality,ONJ
436,3402174000,34021,"Trenton city, Mercer County, New Jersey",2000,29437,33843,4406,684,43497,18391,67012,1809,85403,21022,municipality,ONJ
437,3402174000,34021,"Trenton city, Mercer County, New Jersey",2010,28578,33035,4457,923,42286,28621,56292,1641,84913,11442,municipality,ONJ
438,3402180240,34021,"West Windsor township, Mercer County, New Jersey",2000,7282,7450,168,4974,587,892,21015,370,21907,15084,municipality,ONJ
439,3402180240,34021,"West Windsor township, Mercer County, New Jersey",2010,9449,9810,361,10223,956,1213,25952,687,27165,14086,municipality,ONJ
440,3402310750,34023,"Carteret borough, Middlesex County, New Jersey",2000,7039,7320,281,1705,1856,4839,15870,454,20709,11855,municipality,INJ
441,3402310750,34023,"Carteret borough, Middlesex County, New Jersey",2010,7591,8148,557,4308,3056,7066,15778,602,22844,7812,municipality,INJ
442,3402315550,34023,"Cranbury township, Middlesex County, New Jersey",2000,1091,1121,30,239,72,55,3172,40,3227,2821,municipality,INJ
443,3402315550,34023,"Cranbury township, Middlesex County, New Jersey",2010,1320,1371,51,530,130,99,3758,67,3857,3031,municipality,INJ
444,3402318490,34023,"Dunellen borough, Middlesex County, New Jersey",2000,2451,2520,69,242,241,1010,5813,103,6823,5227,municipality,INJ
445,3402318490,34023,"Dunellen borough, Middlesex County, New Jersey",2010,2566,2683,117,323,549,1933,5294,131,7227,4291,municipality,INJ
446,3402319000,34023,"East Brunswick township, Middlesex County, New Jersey",2000,16372,16640,268,7584,1282,1957,44799,929,46756,35004,municipality,INJ
447,3402319000,34023,"East Brunswick township, Middlesex County, New Jersey",2010,16810,17367,557,10812,1741,3184,44328,888,47512,30887,municipality,INJ
448,3402320230,34023,"Edison township, Middlesex County, New Jersey",2000,35136,36018,882,28541,6458,6226,91461,2001,97687,54461,municipality,INJ
449,3402320230,34023,"Edison township, Middlesex County, New Jersey",2010,34972,36302,1330,43092,6631,8112,91855,2555,99967,39577,municipality,INJ
450,3402330840,34023,"Helmetta borough, Middlesex County, New Jersey",2000,746,769,23,44,40,97,1728,13,1825,1631,municipality,INJ
451,3402330840,34023,"Helmetta borough, Middlesex County, New Jersey",2010,891,920,29,102,72,164,2014,30,2178,1810,municipality,INJ
452,3402331470,34023,"Highland Park borough, Middlesex County, New Jersey",2000,5899,6071,172,1903,1067,1145,12854,367,13999,9517,municipality,INJ
453,3402331470,34023,"Highland Park borough, Middlesex County, New Jersey",2010,5875,6203,328,2494,1018,1252,12730,332,13982,8886,municipality,INJ
454,3402334890,34023,"Jamesburg borough, Middlesex County, New Jersey",2000,2176,2240,64,133,515,606,5419,107,6025,4664,municipality,INJ
455,3402334890,34023,"Jamesburg borough, Middlesex County, New Jersey",2010,2172,2267,95,264,488,1324,4591,122,5915,3717,municipality,INJ
456,3402345690,34023,"Metuchen borough, Middlesex County, New Jersey",2000,4992,5104,112,922,668,508,12332,259,12840,10483,municipality,INJ
457,3402345690,34023,"Metuchen borough, Middlesex County, New Jersey",2010,5243,5440,197,1744,617,935,12639,326,13574,9952,municipality,INJ
458,3402345900,34023,"Middlesex borough, Middlesex County, New Jersey",2000,5048,5130,82,562,440,1235,12482,181,13717,11299,municipality,INJ
459,3402345900,34023,"Middlesex borough, Middlesex County, New Jersey",2010,4984,5148,164,804,645,2246,11389,192,13635,9748,municipality,INJ
460,3402346620,34023,"Milltown borough, Middlesex County, New Jersey",2000,2627,2670,43,215,45,261,6739,72,7000,6407,municipality,INJ
461,3402346620,34023,"Milltown borough, Middlesex County, New Jersey",2010,2599,2698,99,227,77,445,6448,70,6893,6074,municipality,INJ
462,3402347280,34023,"Monroe township, Middlesex County, New Jersey",2000,12536,13259,723,648,792,666,27333,200,27999,25693,municipality,INJ
463,3402347280,34023,"Monroe township, Middlesex County, New Jersey",2010,16497,18002,1505,4911,1486,1673,37459,486,39132,30576,municipality,INJ
464,3402351210,34023,"New Brunswick city, Middlesex County, New Jersey",2000,13057,13893,836,2544,10043,18947,29626,1075,48573,15964,municipality,INJ
465,3402351210,34023,"New Brunswick city, Middlesex County, New Jersey",2010,14119,15053,934,4122,7743,27553,27628,1002,55181,14761,municipality,INJ
466,3402352560,34023,"North Brunswick township, Middlesex County, New Jersey",2000,13635,13932,297,5142,5370,3775,32512,944,36287,21056,municipality,INJ
467,3402352560,34023,"North Brunswick township, Middlesex County, New Jersey",2010,14551,15045,494,9865,6625,7223,33519,1083,40742,15946,municipality,INJ
468,3402354705,34023,"Old Bridge township, Middlesex County, New Jersey",2000,21438,21896,458,6520,3052,4578,55878,1278,60456,45028,municipality,INJ
469,3402354705,34023,"Old Bridge township, Middlesex County, New Jersey",2010,23777,24638,861,9319,3770,7064,58311,1440,65375,43782,municipality,INJ
470,3402358200,34023,"Perth Amboy city, Middlesex County, New Jersey",2000,14562,15236,674,669,3790,33033,14270,892,47303,8919,municipality,INJ
471,3402358200,34023,"Perth Amboy city, Middlesex County, New Jersey",2010,15419,16556,1137,806,3742,39685,11129,477,50814,6104,municipality,INJ
472,3402359010,34023,"Piscataway township, Middlesex County, New Jersey",2000,16500,16946,446,12472,9985,4002,46480,1341,50482,22682,municipality,INJ
473,3402359010,34023,"Piscataway township, Middlesex County, New Jersey",2010,17050,17777,727,18654,11053,6289,49755,1777,56044,18271,municipality,INJ
474,3402359280,34023,"Plainsboro township, Middlesex County, New Jersey",2000,8742,9133,391,6143,1490,937,19278,433,20215,11212,municipality,INJ
475,3402359280,34023,"Plainsboro township, Middlesex County, New Jersey",2010,9402,10089,687,10608,1749,1429,21570,598,22999,8615,municipality,INJ
476,3402365790,34023,"Sayreville borough, Middlesex County, New Jersey",2000,14955,15235,280,4247,3334,2942,37435,786,40377,29068,municipality,INJ
477,3402365790,34023,"Sayreville borough, Middlesex County, New Jersey",2010,15636,16393,757,6841,4287,5258,37446,968,42704,25350,municipality,INJ
478,3402368550,34023,"South Amboy city, Middlesex County, New Jersey",2000,2967,3110,143,108,57,534,7379,93,7913,7121,municipality,INJ
479,3402368550,34023,"South Amboy city, Middlesex County, New Jersey",2010,3372,3576,204,345,347,1158,7473,143,8631,6638,municipality,INJ
480,3402368790,34023,"South Brunswick township, Middlesex County, New Jersey",2000,13428,13862,434,6799,2886,1918,35816,739,37734,25392,municipality,INJ
481,3402368790,34023,"South Brunswick township, Middlesex County, New Jersey",2010,15069,15708,639,15571,3172,2624,40793,1072,43417,20978,municipality,INJ
482,3402369390,34023,"South Plainfield borough, Middlesex County, New Jersey",2000,7151,7307,156,1632,1798,1888,19922,590,21810,15902,municipality,INJ
483,3402369390,34023,"South Plainfield borough, Middlesex County, New Jersey",2010,7876,8093,217,3422,2266,3097,20288,750,23385,13850,municipality,INJ
484,3402369420,34023,"South River borough, Middlesex County, New Jersey",2000,5606,5769,163,537,892,1480,13842,418,15322,11995,municipality,INJ
485,3402369420,34023,"South River borough, Middlesex County, New Jersey",2010,5652,5957,305,758,1028,2913,13095,572,16008,10737,municipality,INJ
486,3402369810,34023,"Spotswood borough, Middlesex County, New Jersey",2000,3099,3158,59,230,108,345,7535,60,7880,7137,municipality,INJ
487,3402369810,34023,"Spotswood borough, Middlesex County, New Jersey",2010,3128,3242,114,419,227,687,7570,124,8257,6800,municipality,INJ
488,3402382000,34023,"Woodbridge township, Middlesex County, New Jersey",2000,34562,35298,736,14007,8154,8956,88247,2087,97203,63999,municipality,INJ
489,3402382000,34023,"Woodbridge township, Middlesex County, New Jersey",2010,34615,36124,1509,22193,9038,15562,84023,2261,99585,50531,municipality,INJ
490,3402500000,34025,"County subdivisions not defined, Monmouth County, New Jersey",2000,0,0,0,0,0,0,0,0,0,0,municipality,ONJ
491,3402500000,34025,"County subdivisions not defined, Monmouth County, New Jersey",2010,0,0,0,0,0,0,0,0,0,0,municipality,ONJ
492,3402500070,34025,"Aberdeen township, Monmouth County, New Jersey",2000,6421,6558,137,953,2040,1225,16229,293,17454,12943,municipality,ONJ
493,3402500070,34025,"Aberdeen township, Monmouth County, New Jersey",2010,6876,7102,226,1162,2041,1900,16310,350,18210,12757,municipality,ONJ
494,3402500730,34025,"Allenhurst borough, Monmouth County, New Jersey",2000,285,370,85,3,6,18,700,6,718,685,municipality,ONJ
495,3402500730,34025,"Allenhurst borough, Monmouth County, New Jersey",2010,217,365,148,5,5,22,474,3,496,461,municipality,ONJ
496,3402500760,34025,"Allentown borough, Monmouth County, New Jersey",2000,708,718,10,12,120,36,1846,33,1882,1681,municipality,ONJ
497,3402500760,34025,"Allentown borough, Monmouth County, New Jersey",2010,704,735,31,27,76,65,1763,31,1828,1629,municipality,ONJ
498,3402501960,34025,"Asbury Park city, Monmouth County, New Jersey",2000,6754,7744,990,118,10236,2637,14293,792,16930,3147,municipality,ONJ
499,3402501960,34025,"Asbury Park city, Monmouth County, New Jersey",2010,6725,8076,1351,72,7955,4115,12001,463,16116,3511,municipality,ONJ
500,3402502110,34025,"Atlantic Highlands borough, Monmouth County, New Jersey",2000,1969,2056,87,57,105,165,4540,46,4705,4332,municipality,ONJ
501,3402502110,34025,"Atlantic Highlands borough, Monmouth County, New Jersey",2010,1870,2002,132,91,62,225,4160,70,4385,3937,municipality,ONJ
502,3402502440,34025,"Avon-by-the-Sea borough, Monmouth County, New Jersey",2000,1043,1387,344,20,8,54,2190,13,2244,2149,municipality,ONJ
503,3402502440,34025,"Avon-by-the-Sea borough, Monmouth County, New Jersey",2010,901,1321,420,12,6,71,1830,18,1901,1794,municipality,ONJ
504,3402504930,34025,"Belmar borough, Monmouth County, New Jersey",2000,2946,3996,1050,61,200,414,5631,96,6045,5274,municipality,ONJ
505,3402504930,34025,"Belmar borough, Monmouth County, New Jersey",2010,2695,3931,1236,52,184,971,4823,67,5794,4520,municipality,ONJ
506,3402506970,34025,"Bradley Beach borough, Monmouth County, New Jersey",2000,2297,3132,835,69,167,615,4178,91,4793,3851,municipality,ONJ
507,3402506970,34025,"Bradley Beach borough, Monmouth County, New Jersey",2010,2098,3180,1082,78,189,840,3458,77,4298,3114,municipality,ONJ
508,3402507750,34025,"Brielle borough, Monmouth County, New Jersey",2000,1938,2123,185,33,170,162,4731,54,4893,4474,municipality,ONJ
509,3402507750,34025,"Brielle borough, Monmouth County, New Jersey",2010,1805,2034,229,43,121,152,4622,62,4774,4396,municipality,ONJ
510,3402514560,34025,"Colts Neck township, Monmouth County, New Jersey",2000,3513,3614,101,445,916,520,11811,161,12331,10289,municipality,ONJ
511,3402514560,34025,"Colts Neck township, Monmouth County, New Jersey",2010,3277,3735,458,463,163,359,9783,115,10142,9042,municipality,ONJ
512,3402516660,34025,"Deal borough, Monmouth County, New Jersey",2000,434,953,519,3,12,54,1016,16,1070,985,municipality,ONJ
513,3402516660,34025,"Deal borough, Monmouth County, New Jersey",2010,333,926,593,26,11,55,695,9,750,649,municipality,ONJ
514,3402519840,34025,"Eatontown borough, Monmouth County, New Jersey",2000,5780,6341,561,1301,1572,928,13080,401,14008,9806,municipality,ONJ
515,3402519840,34025,"Eatontown borough, Monmouth County, New Jersey",2010,5319,5723,404,1097,1475,1571,11138,437,12709,8129,municipality,ONJ
516,3402521570,34025,"Englishtown borough, Monmouth County, New Jersey",2000,643,680,37,77,67,110,1654,17,1764,1493,municipality,ONJ
517,3402521570,34025,"Englishtown borough, Monmouth County, New Jersey",2010,621,647,26,121,43,148,1699,22,1847,1513,municipality,ONJ
518,3402522440,34025,"Fair Haven borough, Monmouth County, New Jersey",2000,1998,2037,39,56,240,79,5858,51,5937,5511,municipality,ONJ
519,3402522440,34025,"Fair Haven borough, Monmouth County, New Jersey",2010,1970,2065,95,66,151,165,5956,78,6121,5661,municipality,ONJ
520,3402522950,34025,"Farmingdale borough, Monmouth County, New Jersey",2000,625,638,13,37,18,61,1526,13,1587,1458,municipality,ONJ
521,3402522950,34025,"Farmingdale borough, Monmouth County, New Jersey",2010,547,578,31,42,35,92,1237,28,1329,1132,municipality,ONJ
522,3402525200,34025,"Freehold borough, Monmouth County, New Jersey",2000,3695,3821,126,268,1635,3081,7895,139,10976,5853,municipality,ONJ
523,3402525200,34025,"Freehold borough, Monmouth County, New Jersey",2010,4006,4249,243,342,1391,5167,6885,195,12052,4957,municipality,ONJ
524,3402525230,34025,"Freehold township, Monmouth County, New Jersey",2000,10814,11032,218,1612,1550,1637,29900,367,31537,26371,municipality,ONJ
525,3402525230,34025,"Freehold township, Monmouth County, New Jersey",2010,12577,13140,563,2530,1860,2808,33376,559,36184,28427,municipality,ONJ
526,3402530690,34025,"Hazlet township, Monmouth County, New Jersey",2000,7244,7406,162,719,210,1254,20124,206,21378,18989,municipality,ONJ
527,3402530690,34025,"Hazlet township, Monmouth County, New Jersey",2010,7140,7417,277,675,279,1601,18733,229,20334,17550,municipality,ONJ
528,3402531500,34025,"Highlands borough, Monmouth County, New Jersey",2000,2450,2820,370,50,52,207,4890,72,5097,4716,municipality,ONJ
529,3402531500,34025,"Highlands borough, Monmouth County, New Jersey",2010,2623,3146,523,64,70,324,4681,86,5005,4461,municipality,ONJ
530,3402532640,34025,"Holmdel township, Monmouth County, New Jersey",2000,4947,5137,190,2748,101,387,15394,203,15781,12342,municipality,ONJ
531,3402532640,34025,"Holmdel township, Monmouth County, New Jersey",2010,5584,5792,208,3201,135,621,16152,318,16773,12498,municipality,ONJ
532,3402533300,34025,"Howell township, Monmouth County, New Jersey",2000,16063,16572,509,1735,1669,2610,46293,626,48903,42263,municipality,ONJ
533,3402533300,34025,"Howell township, Monmouth County, New Jersey",2010,17260,17979,719,2283,1767,4153,46922,784,51075,42088,municipality,ONJ
534,3402534200,34025,"Interlaken borough, Monmouth County, New Jersey",2000,386,397,11,2,0,10,890,7,900,881,municipality,ONJ
535,3402534200,34025,"Interlaken borough, Monmouth County, New Jersey",2010,361,393,32,4,0,14,806,5,820,797,municipality,ONJ
536,3402536480,34025,"Keansburg borough, Monmouth County, New Jersey",2000,3872,4269,397,131,207,853,9879,138,10732,9403,municipality,ONJ
537,3402536480,34025,"Keansburg borough, Monmouth County, New Jersey",2010,3805,4318,513,169,582,1493,8612,245,10105,7616,municipality,ONJ
538,3402536810,34025,"Keyport borough, Monmouth County, New Jersey",2000,3264,3400,136,162,501,839,6729,133,7568,5933,municipality,ONJ
539,3402536810,34025,"Keyport borough, Monmouth County, New Jersey",2010,3067,3272,205,171,479,1322,5918,126,7240,5142,municipality,ONJ
540,3402537560,34025,"Lake Como borough, Monmouth County, New Jersey",2000,824,1107,283,23,134,183,1623,40,1806,1426,municipality,ONJ
541,3402537560,34025,"Lake Como borough, Monmouth County, New Jersey",2010,785,1115,330,21,106,322,1437,33,1759,1277,municipality,ONJ
542,3402540770,34025,"Little Silver borough, Monmouth County, New Jersey",2000,2232,2288,56,93,19,81,6089,53,6170,5924,municipality,ONJ
543,3402540770,34025,"Little Silver borough, Monmouth County, New Jersey",2010,2146,2278,132,102,14,179,5771,78,5950,5577,municipality,ONJ
544,3402541010,34025,"Loch Arbour village, Monmouth County, New Jersey",2000,120,156,36,2,6,2,278,5,280,265,municipality,ONJ
545,3402541010,34025,"Loch Arbour village, Monmouth County, New Jersey",2010,82,159,77,3,3,7,187,3,194,178,municipality,ONJ
546,3402541310,34025,"Long Branch city, Monmouth County, New Jersey",2000,12594,13983,1389,504,5471,6477,24863,1057,31340,17831,municipality,ONJ
547,3402541310,34025,"Long Branch city, Monmouth County, New Jersey",2010,11753,14170,2417,633,3946,8624,22095,1577,30719,15939,municipality,ONJ
548,3402542990,34025,"Manalapan township, Monmouth County, New Jersey",2000,10781,11066,285,1503,641,1183,32240,333,33423,29763,municipality,ONJ
549,3402542990,34025,"Manalapan township, Monmouth County, New Jersey",2010,13263,13735,472,2670,872,2202,36670,443,38872,32685,municipality,ONJ
550,3402543050,34025,"Manasquan borough, Monmouth County, New Jersey",2000,2600,3531,931,28,25,283,6027,31,6310,5943,municipality,ONJ
551,3402543050,34025,"Manasquan borough, Monmouth County, New Jersey",2010,2374,3500,1126,36,14,414,5483,28,5897,5405,municipality,ONJ
552,3402544070,34025,"Marlboro township, Monmouth County, New Jersey",2000,11478,11896,418,4602,721,1051,35347,353,36398,29671,municipality,ONJ
553,3402544070,34025,"Marlboro township, Monmouth County, New Jersey",2010,13001,13436,435,6921,814,1619,38572,475,40191,30362,municipality,ONJ
554,3402544520,34025,"Matawan borough, Monmouth County, New Jersey",2000,3531,3640,109,708,553,575,8335,152,8910,6922,municipality,ONJ
555,3402544520,34025,"Matawan borough, Monmouth County, New Jersey",2010,3358,3606,248,557,576,949,7861,204,8810,6524,municipality,ONJ
556,3402545990,34025,"Middletown township, Monmouth County, New Jersey",2000,23236,23841,605,1703,769,2265,64062,523,66327,61067,municipality,ONJ
557,3402545990,34025,"Middletown township, Monmouth County, New Jersey",2010,23962,24959,997,1717,814,3569,62953,720,66522,59702,municipality,ONJ
558,3402546560,34025,"Millstone township, Monmouth County, New Jersey",2000,2708,2797,89,304,269,315,8655,85,8970,7997,municipality,ONJ
559,3402546560,34025,"Millstone township, Monmouth County, New Jersey",2010,3301,3434,133,472,363,579,9987,159,10566,8993,municipality,ONJ
560,3402547130,34025,"Monmouth Beach borough, Monmouth County, New Jersey",2000,1633,1969,336,31,19,68,3527,16,3595,3461,municipality,ONJ
561,3402547130,34025,"Monmouth Beach borough, Monmouth County, New Jersey",2010,1494,1981,487,24,11,62,3217,33,3279,3149,municipality,ONJ
562,3402549890,34025,"Neptune township, Monmouth County, New Jersey",2000,10907,12217,1310,322,10310,1537,26153,662,27690,14859,municipality,ONJ
563,3402549890,34025,"Neptune township, Monmouth County, New Jersey",2010,11201,12991,1790,628,10377,2607,25328,745,27935,13578,municipality,ONJ
564,3402549920,34025,"Neptune City borough, Monmouth County, New Jersey",2000,2221,2342,121,141,481,277,4941,107,5218,4212,municipality,ONJ
565,3402549920,34025,"Neptune City borough, Monmouth County, New Jersey",2010,2133,2312,179,213,490,491,4378,104,4869,3571,municipality,ONJ
566,3402554270,34025,"Ocean township, Monmouth County, New Jersey",2000,10254,10756,502,1683,1466,1215,25744,543,26959,22052,municipality,ONJ
567,3402554270,34025,"Ocean township, Monmouth County, New Jersey",2010,10611,11541,930,1775,2038,2453,24838,578,27291,20447,municipality,ONJ
568,3402554570,34025,"Oceanport borough, Monmouth County, New Jersey",2000,2043,2114,71,46,110,120,5687,50,5807,5481,municipality,ONJ
569,3402554570,34025,"Oceanport borough, Monmouth County, New Jersey",2010,2227,2390,163,88,161,236,5596,71,5832,5276,municipality,ONJ
570,3402562430,34025,"Red Bank borough, Monmouth County, New Jersey",2000,5201,5450,249,259,2287,2027,9817,208,11844,7063,municipality,ONJ
571,3402562430,34025,"Red Bank borough, Monmouth County, New Jersey",2010,4929,5381,452,223,1408,4198,8008,230,12206,6147,municipality,ONJ
572,3402564410,34025,"Roosevelt borough, Monmouth County, New Jersey",2000,337,351,14,19,23,42,891,44,933,805,municipality,ONJ
573,3402564410,34025,"Roosevelt borough, Monmouth County, New Jersey",2010,314,327,13,28,8,52,830,18,882,776,municipality,ONJ
574,3402565130,34025,"Rumson borough, Monmouth County, New Jersey",2000,2452,2610,158,76,17,99,7038,36,7137,6909,municipality,ONJ
575,3402565130,34025,"Rumson borough, Monmouth County, New Jersey",2010,2344,2585,241,88,18,173,6949,72,7122,6771,municipality,ONJ
576,3402566240,34025,"Sea Bright borough, Monmouth County, New Jersey",2000,1003,1202,199,41,31,82,1736,13,1818,1651,municipality,ONJ
577,3402566240,34025,"Sea Bright borough, Monmouth County, New Jersey",2010,792,1211,419,32,11,78,1334,12,1412,1279,municipality,ONJ
578,3402566330,34025,"Sea Girt borough, Monmouth County, New Jersey",2000,942,1285,343,2,2,30,2118,7,2148,2107,municipality,ONJ
579,3402566330,34025,"Sea Girt borough, Monmouth County, New Jersey",2010,823,1291,468,4,0,30,1798,8,1828,1786,municipality,ONJ
580,3402567350,34025,"Shrewsbury borough, Monmouth County, New Jersey",2000,1207,1223,16,59,11,69,3521,32,3590,3419,municipality,ONJ
581,3402567350,34025,"Shrewsbury borough, Monmouth County, New Jersey",2010,1261,1310,49,79,24,95,3714,38,3809,3573,municipality,ONJ
582,3402567365,34025,"Shrewsbury township, Monmouth County, New Jersey",2000,521,546,25,109,176,73,1025,43,1098,697,municipality,ONJ
583,3402567365,34025,"Shrewsbury township, Monmouth County, New Jersey",2010,583,648,65,75,147,161,980,31,1141,727,municipality,ONJ
584,3402570110,34025,"Spring Lake borough, Monmouth County, New Jersey",2000,1463,1930,467,10,12,26,3541,17,3567,3502,municipality,ONJ
585,3402570110,34025,"Spring Lake borough, Monmouth County, New Jersey",2010,1253,2048,795,30,8,57,2936,23,2993,2875,municipality,ONJ
586,3402570140,34025,"Spring Lake Heights borough, Monmouth County, New Jersey",2000,2511,2950,439,19,57,111,5116,27,5227,5013,municipality,ONJ
587,3402570140,34025,"Spring Lake Heights borough, Monmouth County, New Jersey",2010,2316,2972,656,51,25,155,4558,35,4713,4447,municipality,ONJ
588,3402573020,34025,"Tinton Falls borough, Monmouth County, New Jersey",2000,5883,6211,328,740,1916,707,14346,294,15053,11396,municipality,ONJ
589,3402573020,34025,"Tinton Falls borough, Monmouth County, New Jersey",2010,8355,8766,411,829,1610,1118,16774,332,17892,14003,municipality,ONJ
590,3402574540,34025,"Union Beach borough, Monmouth County, New Jersey",2000,2143,2229,86,80,52,538,6111,108,6649,5871,municipality,ONJ
591,3402574540,34025,"Union Beach borough, Monmouth County, New Jersey",2010,2143,2269,126,108,85,686,5559,139,6245,5227,municipality,ONJ
592,3402574900,34025,"Upper Freehold township, Monmouth County, New Jersey",2000,1437,1501,64,60,45,151,4131,80,4282,3946,municipality,ONJ
593,3402574900,34025,"Upper Freehold township, Monmouth County, New Jersey",2010,2363,2458,95,300,134,254,6648,98,6902,6116,municipality,ONJ
594,3402576460,34025,"Wall township, Monmouth County, New Jersey",2000,9437,9957,520,318,149,391,24870,177,25261,24226,municipality,ONJ
595,3402576460,34025,"Wall township, Monmouth County, New Jersey",2010,10051,10883,832,420,611,908,25256,300,26164,23925,municipality,ONJ
596,3402579310,34025,"West Long Branch borough, Monmouth County, New Jersey",2000,2448,2535,87,100,171,241,8017,152,8258,7594,municipality,ONJ
597,3402579310,34025,"West Long Branch borough, Monmouth County, New Jersey",2010,2384,2528,144,95,163,407,7690,93,8097,7339,municipality,ONJ
598,3402706610,34027,"Boonton town, Morris County, New Jersey",2000,3272,3352,80,655,321,582,7914,245,8496,6693,municipality,INJ
599,3402706610,34027,"Boonton town, Morris County, New Jersey",2010,3235,3398,163,838,363,920,7427,258,8347,5968,municipality,INJ
600,3402706640,34027,"Boonton township, Morris County, New Jersey",2000,1476,1510,34,175,51,92,4195,48,4287,3921,municipality,INJ
601,3402706640,34027,"Boonton township, Morris County, New Jersey",2010,1575,1647,72,170,63,178,4085,54,4263,3798,municipality,INJ
602,3402709040,34027,"Butler borough, Morris County, New Jersey",2000,2868,2923,55,137,42,379,7041,70,7420,6792,municipality,INJ
603,3402709040,34027,"Butler borough, Morris County, New Jersey",2010,3031,3169,138,228,78,860,6679,107,7539,6266,municipality,INJ
604,3402712100,34027,"Chatham borough, Morris County, New Jersey",2000,3159,3232,73,238,11,223,8237,69,8460,7919,municipality,INJ
605,3402712100,34027,"Chatham borough, Morris County, New Jersey",2010,3073,3210,137,433,85,457,8505,162,8962,7825,municipality,INJ
606,3402712130,34027,"Chatham township, Morris County, New Jersey",2000,3920,4019,99,483,41,197,9889,83,10086,9282,municipality,INJ
607,3402712130,34027,"Chatham township, Morris County, New Jersey",2010,3915,4128,213,657,69,349,10103,180,10452,9197,municipality,INJ
608,3402712580,34027,"Chester borough, Morris County, New Jersey",2000,609,627,18,28,5,112,1523,13,1635,1477,municipality,INJ
609,3402712580,34027,"Chester borough, Morris County, New Jersey",2010,615,647,32,38,13,222,1427,32,1649,1344,municipality,INJ
610,3402712610,34027,"Chester township, Morris County, New Jersey",2000,2323,2377,54,171,72,188,7094,72,7282,6779,municipality,INJ
611,3402712610,34027,"Chester township, Morris County, New Jersey",2010,2592,2697,105,268,77,341,7497,118,7838,7034,municipality,INJ
612,3402717650,34027,"Denville township, Morris County, New Jersey",2000,5990,6178,188,734,169,418,15406,176,15824,14327,municipality,INJ
613,3402717650,34027,"Denville township, Morris County, New Jersey",2010,6432,6734,302,1081,220,883,15752,265,16635,14186,municipality,INJ
614,3402718070,34027,"Dover town, Morris County, New Jersey",2000,5436,5568,132,446,1035,10539,7649,231,18188,5937,municipality,INJ
615,3402718070,34027,"Dover town, Morris County, New Jersey",2010,5562,5783,221,447,845,12598,5559,196,18157,4071,municipality,INJ
616,3402719210,34027,"East Hanover township, Morris County, New Jersey",2000,3843,3895,52,1257,64,312,11081,92,11393,9668,municipality,INJ
617,3402719210,34027,"East Hanover township, Morris County, New Jersey",2010,3893,3976,83,1322,90,600,10557,103,11157,9042,municipality,INJ
618,3402723910,34027,"Florham Park borough, Morris County, New Jersey",2000,3239,3342,103,343,88,190,8667,54,8857,8182,municipality,INJ
619,3402723910,34027,"Florham Park borough, Morris County, New Jersey",2010,4003,4201,198,743,488,594,11102,207,11696,9664,municipality,INJ
620,3402729550,34027,"Hanover township, Morris County, New Jersey",2000,4745,4818,73,1123,127,452,12446,83,12898,11113,municipality,INJ
621,3402729550,34027,"Hanover township, Morris County, New Jersey",2010,5308,5526,218,1480,134,630,13082,171,13712,11297,municipality,INJ
622,3402729700,34027,"Harding township, Morris County, New Jersey",2000,1180,1243,63,34,13,57,3123,38,3180,3038,municipality,INJ
623,3402729700,34027,"Harding township, Morris County, New Jersey",2010,1474,1610,136,102,35,134,3704,64,3838,3503,municipality,INJ
624,3402734980,34027,"Jefferson township, Morris County, New Jersey",2000,7131,7527,396,209,153,672,19045,239,19717,18444,municipality,INJ
625,3402734980,34027,"Jefferson township, Morris County, New Jersey",2010,7830,8597,767,977,305,1382,19932,277,21314,18373,municipality,INJ
626,3402737110,34027,"Kinnelon borough, Morris County, New Jersey",2000,3062,3123,61,263,44,218,9147,65,9365,8775,municipality,INJ
627,3402737110,34027,"Kinnelon borough, Morris County, New Jersey",2010,3472,3600,128,433,86,418,9830,107,10248,9204,municipality,INJ
628,3402740290,34027,"Lincoln Park borough, Morris County, New Jersey",2000,4026,4110,84,575,177,633,10297,147,10930,9398,municipality,INJ
629,3402740290,34027,"Lincoln Park borough, Morris County, New Jersey",2010,4001,4145,144,775,165,1009,9512,173,10521,8399,municipality,INJ
630,3402741362,34027,"Long Hill township, Morris County, New Jersey",2000,3139,3206,67,420,31,303,8474,107,8777,7916,municipality,INJ
631,3402741362,34027,"Long Hill township, Morris County, New Jersey",2010,3105,3226,121,520,48,614,8088,135,8702,7385,municipality,INJ
632,3402742510,34027,"Madison borough, Morris County, New Jersey",2000,5520,5641,121,616,481,987,15543,274,16530,14172,municipality,INJ
633,3402742510,34027,"Madison borough, Morris County, New Jersey",2010,5485,5775,290,869,441,1406,14439,289,15845,12840,municipality,INJ
634,3402745330,34027,"Mendham borough, Morris County, New Jersey",2000,1781,1828,47,72,22,125,4972,32,5097,4846,municipality,INJ
635,3402745330,34027,"Mendham borough, Morris County, New Jersey",2010,1722,1798,76,101,51,135,4846,53,4981,4641,municipality,INJ
636,3402745360,34027,"Mendham township, Morris County, New Jersey",2000,1788,1849,61,109,48,82,5318,46,5400,5115,municipality,INJ
637,3402745360,34027,"Mendham township, Morris County, New Jersey",2010,1952,2062,110,199,76,211,5658,83,5869,5300,municipality,INJ
638,3402746860,34027,"Mine Hill township, Morris County, New Jersey",2000,1365,1388,23,89,118,319,3360,52,3679,3101,municipality,INJ
639,3402746860,34027,"Mine Hill township, Morris County, New Jersey",2010,1329,1380,51,177,148,840,2811,73,3651,2413,municipality,INJ
640,3402747670,34027,"Montville township, Morris County, New Jersey",2000,7380,7541,161,2612,188,531,20308,234,20839,17274,municipality,INJ
641,3402747670,34027,"Montville township, Morris County, New Jersey",2010,7485,7823,338,3885,252,900,20628,357,21528,16134,municipality,INJ
642,3402748090,34027,"Morris township, Morris County, New Jersey",2000,8116,8298,182,847,1154,830,20966,223,21796,18742,municipality,INJ
643,3402748090,34027,"Morris township, Morris County, New Jersey",2010,8128,8502,374,1136,1216,1683,20623,378,22306,17893,municipality,INJ
644,3402748210,34027,"Morris Plains borough, Morris County, New Jersey",2000,1955,1994,39,225,70,141,5095,53,5236,4747,municipality,INJ
645,3402748210,34027,"Morris Plains borough, Morris County, New Jersey",2010,2131,2197,66,275,135,314,5218,77,5532,4731,municipality,INJ
646,3402748300,34027,"Morristown town, Morris County, New Jersey",2000,7252,7615,363,694,3066,5034,13510,348,18544,9402,municipality,INJ
647,3402748300,34027,"Morristown town, Morris County, New Jersey",2010,7417,8172,755,794,2479,6277,12134,300,18411,8561,municipality,INJ
648,3402748480,34027,"Mountain Lakes borough, Morris County, New Jersey",2000,1330,1357,27,219,15,72,4184,42,4256,3908,municipality,INJ
649,3402748480,34027,"Mountain Lakes borough, Morris County, New Jersey",2010,1313,1363,50,318,15,106,4054,83,4160,3638,municipality,INJ
650,3402748690,34027,"Mount Arlington borough, Morris County, New Jersey",2000,1918,2039,121,173,84,212,4451,73,4663,4121,municipality,INJ
651,3402748690,34027,"Mount Arlington borough, Morris County, New Jersey",2010,2283,2545,262,179,115,415,4635,74,5050,4267,municipality,INJ
652,3402749080,34027,"Mount Olive township, Morris County, New Jersey",2000,9068,9311,243,1446,895,1445,22748,418,24193,19989,municipality,INJ
653,3402749080,34027,"Mount Olive township, Morris County, New Jersey",2010,10690,11244,554,2297,1514,3237,24880,547,28117,20522,municipality,INJ
654,3402750130,34027,"Netcong borough, Morris County, New Jersey",2000,1008,1043,35,43,31,184,2396,32,2580,2290,municipality,INJ
655,3402750130,34027,"Netcong borough, Morris County, New Jersey",2010,1381,1449,68,89,119,572,2660,42,3232,2410,municipality,INJ
656,3402756460,34027,"Parsippany-Troy Hills township, Morris County, New Jersey",2000,19624,20066,442,9124,1510,3535,47114,1197,50649,35283,municipality,INJ
657,3402756460,34027,"Parsippany-Troy Hills township, Morris County, New Jersey",2010,20279,21274,995,15443,1741,4430,48808,1410,53238,30214,municipality,INJ
658,3402758110,34027,"Pequannock township, Morris County, New Jersey",2000,5026,5097,71,265,39,408,13480,77,13888,13099,municipality,INJ
659,3402758110,34027,"Pequannock township, Morris County, New Jersey",2010,6471,6794,323,291,72,703,14837,132,15540,14342,municipality,INJ
660,3402761890,34027,"Randolph township, Morris County, New Jersey",2000,8679,8903,224,2265,555,1208,23639,362,24847,20457,municipality,INJ
661,3402761890,34027,"Randolph township, Morris County, New Jersey",2010,9013,9343,330,2674,638,2616,23118,430,25734,19376,municipality,INJ
662,3402763300,34027,"Riverdale borough, Morris County, New Jersey",2000,919,940,21,68,27,110,2388,28,2498,2265,municipality,INJ
663,3402763300,34027,"Riverdale borough, Morris County, New Jersey",2010,1547,1657,110,187,42,256,3303,60,3559,3014,municipality,INJ
664,3402764050,34027,"Rockaway borough, Morris County, New Jersey",2000,2445,2491,46,411,84,608,5865,57,6473,5313,municipality,INJ
665,3402764050,34027,"Rockaway borough, Morris County, New Jersey",2010,2443,2521,78,491,192,970,5468,82,6438,4703,municipality,INJ
666,3402764080,34027,"Rockaway township, Morris County, New Jersey",2000,8108,8506,398,1287,538,1440,21490,272,22930,19393,municipality,INJ
667,3402764080,34027,"Rockaway township, Morris County, New Jersey",2010,8983,9587,604,1605,552,2705,21451,375,24156,18919,municipality,INJ
668,3402764980,34027,"Roxbury township, Morris County, New Jersey",2000,8364,8550,186,847,432,1154,22729,239,23883,21211,municipality,INJ
669,3402764980,34027,"Roxbury township, Morris County, New Jersey",2010,8292,8582,290,1330,496,2083,21241,374,23324,19041,municipality,INJ
670,3402775890,34027,"Victory Gardens borough, Morris County, New Jersey",2000,564,588,24,84,318,783,763,31,1546,330,municipality,INJ
671,3402775890,34027,"Victory Gardens borough, Morris County, New Jersey",2010,533,566,33,35,210,957,563,30,1520,288,municipality,INJ
672,3402777240,34027,"Washington township, Morris County, New Jersey",2000,5755,5890,135,325,143,389,17203,125,17592,16610,municipality,INJ
673,3402777240,34027,"Washington township, Morris County, New Jersey",2010,6237,6488,251,607,239,847,17686,250,18533,16590,municipality,INJ
674,3402780390,34027,"Wharton borough, Morris County, New Jersey",2000,2328,2394,66,198,244,1462,4836,141,6298,4253,municipality,INJ
675,3402780390,34027,"Wharton borough, Morris County, New Jersey",2010,2304,2426,122,368,227,2630,3892,139,6522,3158,municipality,INJ
676,3402900000,34029,"County subdivisions not defined, Ocean County, New Jersey",2000,0,0,0,0,0,0,0,0,0,0,municipality,ONJ
677,3402900000,34029,"County subdivisions not defined, Ocean County, New Jersey",2010,0,0,0,0,0,0,0,0,0,0,municipality,ONJ
678,3402903050,34029,"Barnegat township, Ocean County, New Jersey",2000,5493,6066,573,152,320,590,14680,158,15270,14050,municipality,ONJ
679,3402903050,34029,"Barnegat township, Ocean County, New Jersey",2010,8128,9085,957,360,607,1420,19516,334,20936,18215,municipality,ONJ
680,3402903130,34029,"Barnegat Light borough, Ocean County, New Jersey",2000,371,1207,836,2,3,6,758,4,764,749,municipality,ONJ
681,3402903130,34029,"Barnegat Light borough, Ocean County, New Jersey",2010,274,1282,1008,0,6,11,563,2,574,555,municipality,ONJ
682,3402903520,34029,"Bay Head borough, Ocean County, New Jersey",2000,584,1053,469,7,2,16,1222,10,1238,1203,municipality,ONJ
683,3402903520,34029,"Bay Head borough, Ocean County, New Jersey",2010,459,1023,564,7,5,10,958,2,968,944,municipality,ONJ
684,3402903940,34029,"Beach Haven borough, Ocean County, New Jersey",2000,586,2555,1969,7,1,60,1218,6,1278,1204,municipality,ONJ
685,3402903940,34029,"Beach Haven borough, Ocean County, New Jersey",2010,531,2667,2136,9,1,116,1054,4,1170,1040,municipality,ONJ
686,3402904180,34029,"Beachwood borough, Ocean County, New Jersey",2000,3475,3623,148,114,95,438,9937,93,10375,9635,municipality,ONJ
687,3402904180,34029,"Beachwood borough, Ocean County, New Jersey",2010,3682,3826,144,166,185,898,10147,117,11045,9679,municipality,ONJ
688,3402905305,34029,"Berkeley township, Ocean County, New Jersey",2000,19828,22288,2460,176,482,932,39059,248,39991,38153,municipality,ONJ
689,3402905305,34029,"Berkeley township, Ocean County, New Jersey",2010,20349,23818,3469,458,681,2028,39227,365,41255,37723,municipality,ONJ
690,3402907420,34029,"Brick township, Ocean County, New Jersey",2000,29511,32689,3178,883,705,2930,73189,741,76119,70860,municipality,ONJ
691,3402907420,34029,"Brick township, Ocean County, New Jersey",2010,29842,33677,3835,1144,1374,5301,69771,881,75072,66372,municipality,ONJ
692,3402918670,34029,"Eagleswood township, Ocean County, New Jersey",2000,546,693,147,3,1,16,1425,11,1441,1410,municipality,ONJ
693,3402918670,34029,"Eagleswood township, Ocean County, New Jersey",2010,621,760,139,10,13,54,1549,16,1603,1510,municipality,ONJ
694,3402930390,34029,"Harvey Cedars borough, Ocean County, New Jersey",2000,167,1205,1038,1,2,13,346,1,359,342,municipality,ONJ
695,3402930390,34029,"Harvey Cedars borough, Ocean County, New Jersey",2010,169,1214,1045,1,2,3,334,0,337,331,municipality,ONJ
696,3402934530,34029,"Island Heights borough, Ocean County, New Jersey",2000,705,807,102,11,2,24,1727,25,1751,1689,municipality,ONJ
697,3402934530,34029,"Island Heights borough, Ocean County, New Jersey",2010,683,831,148,23,2,40,1633,32,1673,1576,municipality,ONJ
698,3402934680,34029,"Jackson township, Ocean County, New Jersey",2000,14176,14640,464,858,1569,2474,40342,567,42816,37348,municipality,ONJ
699,3402934680,34029,"Jackson township, Ocean County, New Jersey",2010,19417,20342,925,1592,2460,4295,50561,877,54856,45632,municipality,ONJ
700,3402937380,34029,"Lacey township, Ocean County, New Jersey",2000,9336,10580,1244,135,89,545,24801,184,25346,24393,municipality,ONJ
701,3402937380,34029,"Lacey township, Ocean County, New Jersey",2010,10183,11573,1390,221,150,1310,26334,304,27644,25659,municipality,ONJ
702,3402937770,34029,"Lakehurst borough, Ocean County, New Jersey",2000,870,961,91,59,183,201,2321,49,2522,2030,municipality,ONJ
703,3402937770,34029,"Lakehurst borough, Ocean County, New Jersey",2010,881,943,62,56,264,347,2307,107,2654,1880,municipality,ONJ
704,3402938550,34029,"Lakewood township, Ocean County, New Jersey",2000,19876,21214,1338,799,6878,8935,51417,924,60352,42816,municipality,ONJ
705,3402938550,34029,"Lakewood township, Ocean County, New Jersey",2010,24283,26337,2054,737,5346,16062,76781,693,92843,70005,municipality,ONJ
706,3402939390,34029,"Lavallette borough, Ocean County, New Jersey",2000,1208,3210,2002,4,7,43,2622,20,2665,2591,municipality,ONJ
707,3402939390,34029,"Lavallette borough, Ocean County, New Jersey",2010,945,3207,2262,10,2,56,1819,7,1875,1800,municipality,ONJ
708,3402940560,34029,"Little Egg Harbor township, Ocean County, New Jersey",2000,6179,7931,1752,96,117,520,15425,182,15945,15030,municipality,ONJ
709,3402940560,34029,"Little Egg Harbor township, Ocean County, New Jersey",2010,8060,10324,2264,249,259,1047,19018,238,20065,18272,municipality,ONJ
710,3402941250,34029,"Long Beach township, Ocean County, New Jersey",2000,1664,9023,7359,12,5,70,3259,14,3329,3228,municipality,ONJ
711,3402941250,34029,"Long Beach township, Ocean County, New Jersey",2010,1539,9216,7677,15,7,126,2925,18,3051,2885,municipality,ONJ
712,3402943140,34029,"Manchester township, Ocean County, New Jersey",2000,20688,22681,1993,328,1153,1024,37904,352,38928,36071,municipality,ONJ
713,3402943140,34029,"Manchester township, Ocean County, New Jersey",2010,22840,25886,3046,754,1572,2062,41008,467,43070,38215,municipality,ONJ
714,3402943380,34029,"Mantoloking borough, Ocean County, New Jersey",2000,207,522,315,2,7,3,420,0,423,411,municipality,ONJ
715,3402943380,34029,"Mantoloking borough, Ocean County, New Jersey",2010,162,535,373,1,5,7,289,4,296,279,municipality,ONJ
716,3402954300,34029,"Ocean township, Ocean County, New Jersey",2000,2446,2981,535,27,38,200,6250,62,6450,6123,municipality,ONJ
717,3402954300,34029,"Ocean township, Ocean County, New Jersey",2010,3483,4291,808,89,49,230,8102,85,8332,7879,municipality,ONJ
718,3402954450,34029,"Ocean Gate borough, Ocean County, New Jersey",2000,832,1152,320,20,20,49,2027,24,2076,1963,municipality,ONJ
719,3402954450,34029,"Ocean Gate borough, Ocean County, New Jersey",2010,832,1203,371,4,26,128,1883,17,2011,1836,municipality,ONJ
720,3402958590,34029,"Pine Beach borough, Ocean County, New Jersey",2000,767,872,105,12,4,46,1904,6,1950,1882,municipality,ONJ
721,3402958590,34029,"Pine Beach borough, Ocean County, New Jersey",2010,818,903,85,30,7,79,2048,16,2127,1995,municipality,ONJ
722,3402959790,34029,"Plumsted township, Ocean County, New Jersey",2000,2510,2628,118,53,156,280,6995,96,7275,6690,municipality,ONJ
723,3402959790,34029,"Plumsted township, Ocean County, New Jersey",2010,2936,3067,131,73,131,498,7923,128,8421,7591,municipality,ONJ
724,3402959880,34029,"Point Pleasant borough, Ocean County, New Jersey",2000,7560,8350,790,103,47,465,18841,135,19306,18556,municipality,ONJ
725,3402959880,34029,"Point Pleasant borough, Ocean County, New Jersey",2010,7273,8331,1058,129,56,935,17457,139,18392,17133,municipality,ONJ
726,3402959910,34029,"Point Pleasant Beach borough, Ocean County, New Jersey",2000,2317,3558,1241,54,27,234,5080,39,5314,4960,municipality,ONJ
727,3402959910,34029,"Point Pleasant Beach borough, Ocean County, New Jersey",2010,1985,3373,1388,39,27,421,4244,46,4665,4132,municipality,ONJ
728,3402966450,34029,"Seaside Heights borough, Ocean County, New Jersey",2000,1408,2840,1432,19,114,306,2849,87,3155,2629,municipality,ONJ
729,3402966450,34029,"Seaside Heights borough, Ocean County, New Jersey",2010,1376,3003,1627,44,181,516,2371,84,2887,2062,municipality,ONJ
730,3402966480,34029,"Seaside Park borough, Ocean County, New Jersey",2000,1127,2811,1684,13,6,52,2211,16,2263,2176,municipality,ONJ
731,3402966480,34029,"Seaside Park borough, Ocean County, New Jersey",2010,833,2703,1870,6,15,54,1525,12,1579,1492,municipality,ONJ
732,3402967110,34029,"Ship Bottom borough, Ocean County, New Jersey",2000,664,2218,1554,12,4,80,1304,6,1384,1282,municipality,ONJ
733,3402967110,34029,"Ship Bottom borough, Ocean County, New Jersey",2010,555,2066,1511,5,6,106,1050,7,1156,1032,municipality,ONJ
734,3402969510,34029,"South Toms River borough, Ocean County, New Jersey",2000,1073,1123,50,25,731,337,3297,84,3634,2457,municipality,ONJ
735,3402969510,34029,"South Toms River borough, Ocean County, New Jersey",2010,1098,1160,62,23,649,718,2966,120,3684,2174,municipality,ONJ
736,3402970320,34029,"Stafford township, Ocean County, New Jersey",2000,8535,11522,2987,217,157,542,21990,205,22532,21411,municipality,ONJ
737,3402970320,34029,"Stafford township, Ocean County, New Jersey",2010,10096,13604,3508,393,243,1410,25125,261,26535,24228,municipality,ONJ
738,3402971640,34029,"Surf City borough, Ocean County, New Jersey",2000,706,2621,1915,5,2,28,1414,10,1442,1397,municipality,ONJ
739,3402971640,34029,"Surf City borough, Ocean County, New Jersey",2010,622,2566,1944,6,16,61,1144,9,1205,1113,municipality,ONJ
740,3402973125,34029,"Toms River township, Ocean County, New Jersey",2000,33510,41116,7606,2198,1490,4070,85636,855,89706,81093,municipality,ONJ
741,3402973125,34029,"Toms River township, Ocean County, New Jersey",2010,34760,43334,8574,3237,2213,7231,84008,1317,91239,77241,municipality,ONJ
742,3402974210,34029,"Tuckerton borough, Ocean County, New Jersey",2000,1477,1971,494,19,14,109,3408,33,3517,3342,municipality,ONJ
743,3402974210,34029,"Tuckerton borough, Ocean County, New Jersey",2010,1396,1902,506,33,23,203,3144,34,3347,3054,municipality,ONJ
744,3403106340,34031,"Bloomingdale borough, Passaic County, New Jersey",2000,2847,2940,93,164,27,332,7278,77,7610,7010,municipality,INJ
745,3403106340,34031,"Bloomingdale borough, Passaic County, New Jersey",2010,2935,3089,154,188,82,714,6942,84,7656,6588,municipality,INJ
746,3403113690,34031,"Clifton city, Passaic County, New Jersey",2000,30244,31060,816,5028,2002,15608,63064,2828,78672,53206,municipality,INJ
747,3403113690,34031,"Clifton city, Passaic County, New Jersey",2010,30661,31946,1285,7401,3235,26854,57282,1776,84136,44870,municipality,INJ
748,3403129070,34031,"Haledon borough, Passaic County, New Jersey",2000,2820,2906,86,371,524,1865,6387,269,8252,5223,municipality,INJ
749,3403129070,34031,"Haledon borough, Passaic County, New Jersey",2010,2778,2932,154,505,806,3460,4858,154,8318,3393,municipality,INJ
750,3403130570,34031,"Hawthorne borough, Passaic County, New Jersey",2000,7260,7419,159,339,130,1354,16864,254,18218,16141,municipality,INJ
751,3403130570,34031,"Hawthorne borough, Passaic County, New Jersey",2010,7454,7756,302,524,355,2897,15894,223,18791,14792,municipality,INJ
752,3403140620,34031,"Little Falls township, Passaic County, New Jersey",2000,4687,4797,110,450,71,579,10276,162,10855,9593,municipality,INJ
753,3403140620,34031,"Little Falls township, Passaic County, New Jersey",2010,4740,4925,185,652,549,1428,13004,273,14432,11530,municipality,INJ
754,3403153040,34031,"North Haledon borough, Passaic County, New Jersey",2000,2626,2675,49,79,97,308,7612,91,7920,7345,municipality,INJ
755,3403153040,34031,"North Haledon borough, Passaic County, New Jersey",2010,3123,3213,90,318,136,628,7789,87,8417,7248,municipality,INJ
756,3403156550,34031,"Passaic city, Passaic County, New Jersey",2000,19458,20194,736,3617,8042,42387,25474,1410,67861,12405,municipality,INJ
757,3403156550,34031,"Passaic city, Passaic County, New Jersey",2010,19411,20432,1021,2924,5221,49557,20224,838,69781,11241,municipality,INJ
758,3403157000,34031,"Paterson city, Passaic County, New Jersey",2000,44710,47169,2459,2728,46882,74774,74448,5073,149222,19765,municipality,INJ
759,3403157000,34031,"Paterson city, Passaic County, New Jersey",2010,44329,47946,3617,4663,41431,84254,61945,2425,146199,13426,municipality,INJ
760,3403160090,34031,"Pompton Lakes borough, Passaic County, New Jersey",2000,3949,4024,75,316,127,611,10029,109,10640,9477,municipality,INJ
761,3403160090,34031,"Pompton Lakes borough, Passaic County, New Jersey",2010,4190,4341,151,595,127,1209,9888,147,11097,9019,municipality,INJ
762,3403161170,34031,"Prospect Park borough, Passaic County, New Jersey",2000,1822,1889,67,180,703,2211,3568,292,5779,2393,municipality,INJ
763,3403161170,34031,"Prospect Park borough, Passaic County, New Jersey",2010,1797,1931,134,176,1016,3055,2810,139,5865,1479,municipality,INJ
764,3403163150,34031,"Ringwood borough, Passaic County, New Jersey",2000,4108,4221,113,147,183,527,11869,283,12396,11256,municipality,INJ
765,3403163150,34031,"Ringwood borough, Passaic County, New Jersey",2010,4182,4331,149,209,148,707,11521,364,12228,10800,municipality,INJ
766,3403173140,34031,"Totowa borough, Passaic County, New Jersey",2000,3539,3630,91,223,109,630,9262,108,9892,8822,municipality,INJ
767,3403173140,34031,"Totowa borough, Passaic County, New Jersey",2010,3783,3918,135,639,220,1550,9254,146,10804,8249,municipality,INJ
768,3403176730,34031,"Wanaque borough, Passaic County, New Jersey",2000,3444,3500,56,368,147,554,9712,200,10266,8997,municipality,INJ
769,3403176730,34031,"Wanaque borough, Passaic County, New Jersey",2010,4018,4184,166,508,305,1075,10041,214,11116,9014,municipality,INJ
770,3403177840,34031,"Wayne township, Passaic County, New Jersey",2000,18755,19218,463,3056,843,2754,51315,650,54069,46766,municipality,INJ
771,3403177840,34031,"Wayne township, Passaic County, New Jersey",2010,19127,19768,641,4441,1124,4335,50382,787,54717,44030,municipality,INJ
772,3403179460,34031,"West Milford township, Passaic County, New Jersey",2000,9190,9909,719,262,314,893,25517,467,26410,24474,municipality,INJ
773,3403179460,34031,"West Milford township, Passaic County, New Jersey",2010,9625,10419,794,319,327,1512,24338,460,25850,23232,municipality,INJ
774,3403182423,34031,"Woodland Park borough, Passaic County, New Jersey",2000,4397,4497,100,419,327,1105,9882,322,10987,8814,municipality,INJ
775,3403182423,34031,"Woodland Park borough, Passaic County, New Jersey",2010,4632,4835,203,494,398,2442,9377,252,11819,8233,municipality,INJ
776,3403504450,34035,"Bedminster township, Somerset County, New Jersey",2000,4235,4467,232,531,143,319,7983,91,8302,7218,municipality,INJ
777,3403504450,34035,"Bedminster township, Somerset County, New Jersey",2010,4100,4349,249,707,157,519,7646,136,8165,6646,municipality,INJ
778,3403505560,34035,"Bernards township, Somerset County, New Jersey",2000,9242,9485,243,1928,341,646,23929,262,24575,21398,municipality,INJ
779,3403505560,34035,"Bernards township, Somerset County, New Jersey",2010,9783,10103,320,3670,478,1054,25598,504,26652,20946,municipality,INJ
780,3403505590,34035,"Bernardsville borough, Somerset County, New Jersey",2000,2723,2807,84,194,18,439,6906,84,7345,6610,municipality,INJ
781,3403505590,34035,"Bernardsville borough, Somerset County, New Jersey",2010,2685,2871,186,248,58,903,6804,96,7707,6402,municipality,INJ
782,3403506790,34035,"Bound Brook borough, Somerset County, New Jersey",2000,3615,3802,187,282,222,3541,6614,146,10155,5964,municipality,INJ
783,3403506790,34035,"Bound Brook borough, Somerset County, New Jersey",2010,3586,3816,230,264,522,5062,5340,171,10402,4383,municipality,INJ
784,3403507180,34035,"Branchburg township, Somerset County, New Jersey",2000,5272,5405,133,890,273,392,14174,155,14566,12856,municipality,INJ
785,3403507180,34035,"Branchburg township, Somerset County, New Jersey",2010,5271,5419,148,1210,313,643,13816,257,14459,12036,municipality,INJ
786,3403507720,34035,"Bridgewater township, Somerset County, New Jersey",2000,15561,15879,318,4509,899,2056,40884,481,42940,34995,municipality,INJ
787,3403507720,34035,"Bridgewater township, Somerset County, New Jersey",2010,16111,16657,546,7901,978,3004,41460,729,44464,31852,municipality,INJ
788,3403522890,34035,"Far Hills borough, Somerset County, New Jersey",2000,368,386,18,18,7,31,828,8,859,795,municipality,INJ
789,3403522890,34035,"Far Hills borough, Somerset County, New Jersey",2010,376,418,42,17,6,88,831,9,919,799,municipality,INJ
790,3403524900,34035,"Franklin township, Somerset County, New Jersey",2000,19355,19789,434,6475,12888,4127,46776,1187,50903,26226,municipality,INJ
791,3403524900,34035,"Franklin township, Somerset County, New Jersey",2010,23301,24426,1125,12410,15888,8050,54250,1754,62300,24198,municipality,INJ
792,3403527510,34035,"Green Brook township, Somerset County, New Jersey",2000,1893,1916,23,452,93,231,5423,60,5654,4818,municipality,INJ
793,3403527510,34035,"Green Brook township, Somerset County, New Jersey",2010,2375,2448,73,1453,238,494,6709,101,7203,4917,municipality,INJ
794,3403531890,34035,"Hillsborough township, Somerset County, New Jersey",2000,12649,12854,205,2672,1325,1740,34894,535,36634,30362,municipality,INJ
795,3403531890,34035,"Hillsborough township, Somerset County, New Jersey",2010,13573,14030,457,4723,1674,2893,35410,644,38303,28369,municipality,INJ
796,3403543620,34035,"Manville borough, Somerset County, New Jersey",2000,4115,4296,181,135,45,559,9784,80,10343,9524,municipality,INJ
797,3403543620,34035,"Manville borough, Somerset County, New Jersey",2010,4016,4277,261,205,259,1963,8381,162,10344,7755,municipality,INJ
798,3403546590,34035,"Millstone borough, Somerset County, New Jersey",2000,169,173,4,4,4,13,397,2,410,387,municipality,INJ
799,3403546590,34035,"Millstone borough, Somerset County, New Jersey",2010,162,167,5,7,5,15,403,4,418,387,municipality,INJ
800,3403547580,34035,"Montgomery township, Somerset County, New Jersey",2000,5803,6130,327,2010,350,387,17094,227,17481,14507,municipality,INJ
801,3403547580,34035,"Montgomery township, Somerset County, New Jersey",2010,7635,7902,267,5689,586,1017,21237,526,22254,14436,municipality,INJ
802,3403553280,34035,"North Plainfield borough, Somerset County, New Jersey",2000,7202,7393,191,1053,2580,6916,14187,531,21103,10023,municipality,INJ
803,3403553280,34035,"North Plainfield borough, Somerset County, New Jersey",2010,7448,7848,400,1260,3848,9699,12237,394,21936,6735,municipality,INJ
804,3403557300,34035,"Peapack and Gladstone borough, Somerset County, New Jersey",2000,840,871,31,30,76,92,2341,14,2433,2221,municipality,INJ
805,3403557300,34035,"Peapack and Gladstone borough, Somerset County, New Jersey",2010,887,949,62,47,99,281,2301,31,2582,2124,municipality,INJ
806,3403561980,34035,"Raritan borough, Somerset County, New Jersey",2000,2556,2644,88,518,47,533,5805,79,6338,5161,municipality,INJ
807,3403561980,34035,"Raritan borough, Somerset County, New Jersey",2010,2673,2847,174,975,128,1128,5753,143,6881,4507,municipality,INJ
808,3403564320,34035,"Rocky Hill borough, Somerset County, New Jersey",2000,284,295,11,3,9,26,636,16,662,608,municipality,INJ
809,3403564320,34035,"Rocky Hill borough, Somerset County, New Jersey",2010,280,292,12,16,10,33,649,23,682,600,municipality,INJ
810,3403568460,34035,"Somerville borough, Somerset County, New Jersey",2000,4743,4882,139,909,1548,2112,10311,322,12423,7532,municipality,INJ
811,3403568460,34035,"Somerville borough, Somerset County, New Jersey",2010,4591,4951,360,1359,1389,2873,9225,325,12098,6152,municipality,INJ
812,3403568730,34035,"South Bound Brook borough, Somerset County, New Jersey",2000,1632,1676,44,184,345,1028,3464,89,4492,2846,municipality,INJ
813,3403568730,34035,"South Bound Brook borough, Somerset County, New Jersey",2010,1733,1865,132,275,429,1245,3318,140,4563,2474,municipality,INJ
814,3403576940,34035,"Warren township, Somerset County, New Jersey",2000,4629,4718,89,1520,169,455,13804,197,14259,11918,municipality,INJ
815,3403576940,34035,"Warren township, Somerset County, New Jersey",2010,5059,5258,199,2304,225,820,14491,258,15311,11704,municipality,INJ
816,3403577600,34035,"Watchung borough, Somerset County, New Jersey",2000,2098,2155,57,553,189,168,5445,88,5613,4615,municipality,INJ
817,3403577600,34035,"Watchung borough, Somerset County, New Jersey",2010,2114,2234,120,733,190,307,5494,144,5801,4427,municipality,INJ
818,3403701330,34037,"Andover borough, Sussex County, New Jersey",2000,261,273,12,15,13,17,641,12,658,601,municipality,ONJ
819,3403701330,34037,"Andover borough, Sussex County, New Jersey",2010,241,263,22,8,5,46,560,13,606,534,municipality,ONJ
820,3403701360,34037,"Andover township, Sussex County, New Jersey",2000,1889,1968,79,137,111,136,5897,46,6033,5603,municipality,ONJ
821,3403701360,34037,"Andover township, Sussex County, New Jersey",2010,2070,2181,111,164,202,325,5994,81,6319,5547,municipality,ONJ
822,3403707300,34037,"Branchville borough, Sussex County, New Jersey",2000,354,377,23,3,0,11,834,5,845,826,municipality,ONJ
823,3403707300,34037,"Branchville borough, Sussex County, New Jersey",2010,364,386,22,9,2,33,808,9,841,788,municipality,ONJ
824,3403709160,34037,"Byram township, Sussex County, New Jersey",2000,2833,3078,245,116,79,243,8011,94,8254,7722,municipality,ONJ
825,3403709160,34037,"Byram township, Sussex County, New Jersey",2010,2926,3207,281,173,113,417,7933,94,8350,7553,municipality,ONJ
826,3403724810,34037,"Frankford township, Sussex County, New Jersey",2000,1839,2295,456,21,21,96,5324,27,5420,5255,municipality,ONJ
827,3403724810,34037,"Frankford township, Sussex County, New Jersey",2010,2046,2520,474,46,53,176,5389,66,5565,5224,municipality,ONJ
828,3403724930,34037,"Franklin borough, Sussex County, New Jersey",2000,1898,1997,99,76,30,228,4932,71,5160,4755,municipality,ONJ
829,3403724930,34037,"Franklin borough, Sussex County, New Jersey",2010,1936,2136,200,88,95,395,4650,105,5045,4362,municipality,ONJ
830,3403725140,34037,"Fredon township, Sussex County, New Jersey",2000,982,1019,37,24,15,62,2798,19,2860,2740,municipality,ONJ
831,3403725140,34037,"Fredon township, Sussex County, New Jersey",2010,1207,1289,82,58,17,127,3310,32,3437,3203,municipality,ONJ
832,3403727420,34037,"Green township, Sussex County, New Jersey",2000,1046,1069,23,31,26,103,3117,29,3220,3031,municipality,ONJ
833,3403727420,34037,"Green township, Sussex County, New Jersey",2010,1181,1251,70,60,42,173,3428,39,3601,3287,municipality,ONJ
834,3403729220,34037,"Hamburg borough, Sussex County, New Jersey",2000,1173,1233,60,71,21,131,2974,63,3105,2819,municipality,ONJ
835,3403729220,34037,"Hamburg borough, Sussex County, New Jersey",2010,1364,1476,112,66,57,225,3052,74,3277,2855,municipality,ONJ
836,3403729490,34037,"Hampton township, Sussex County, New Jersey",2000,1857,2026,169,33,46,94,4849,37,4943,4733,municipality,ONJ
837,3403729490,34037,"Hampton township, Sussex County, New Jersey",2010,2021,2200,179,62,41,200,4996,46,5196,4847,municipality,ONJ
838,3403729850,34037,"Hardyston township, Sussex County, New Jersey",2000,2319,2690,371,95,51,199,5972,78,6171,5748,municipality,ONJ
839,3403729850,34037,"Hardyston township, Sussex County, New Jersey",2010,3255,3783,528,243,200,457,7756,114,8213,7199,municipality,ONJ
840,3403732910,34037,"Hopatcong borough, Sussex County, New Jersey",2000,5656,6190,534,282,296,952,14936,214,15888,14144,municipality,ONJ
841,3403732910,34037,"Hopatcong borough, Sussex County, New Jersey",2010,5653,6296,643,334,401,1714,13433,208,15147,12490,municipality,ONJ
842,3403737440,34037,"Lafayette township, Sussex County, New Jersey",2000,771,799,28,18,24,54,2246,16,2300,2188,municipality,ONJ
843,3403737440,34037,"Lafayette township, Sussex County, New Jersey",2010,875,919,44,19,36,129,2409,34,2538,2320,municipality,ONJ
844,3403747430,34037,"Montague township, Sussex County, New Jersey",2000,1286,1588,302,23,61,112,3300,44,3412,3172,municipality,ONJ
845,3403747430,34037,"Montague township, Sussex County, New Jersey",2010,1535,1802,267,39,83,246,3601,87,3847,3392,municipality,ONJ
846,3403751930,34037,"Newton town, Sussex County, New Jersey",2000,3258,3425,167,161,272,313,7931,107,8244,7391,municipality,ONJ
847,3403751930,34037,"Newton town, Sussex County, New Jersey",2010,3170,3479,309,233,361,987,7010,159,7997,6257,municipality,ONJ
848,3403754660,34037,"Ogdensburg borough, Sussex County, New Jersey",2000,881,903,22,19,4,110,2528,24,2638,2481,municipality,ONJ
849,3403754660,34037,"Ogdensburg borough, Sussex County, New Jersey",2010,864,905,41,44,8,151,2259,23,2410,2184,municipality,ONJ
850,3403765700,34037,"Sandyston township, Sussex County, New Jersey",2000,693,907,214,8,6,24,1801,18,1825,1769,municipality,ONJ
851,3403765700,34037,"Sandyston township, Sussex County, New Jersey",2010,788,988,200,11,8,68,1930,26,1998,1885,municipality,ONJ
852,3403769690,34037,"Sparta township, Sussex County, New Jersey",2000,6225,6590,365,251,50,459,17621,185,18080,17135,municipality,ONJ
853,3403769690,34037,"Sparta township, Sussex County, New Jersey",2010,6868,7423,555,490,187,1054,18668,276,19722,17715,municipality,ONJ
854,3403770380,34037,"Stanhope borough, Sussex County, New Jersey",2000,1384,1419,35,54,45,145,3439,85,3584,3255,municipality,ONJ
855,3403770380,34037,"Stanhope borough, Sussex County, New Jersey",2010,1396,1472,76,83,53,307,3303,60,3610,3107,municipality,ONJ
856,3403770890,34037,"Stillwater township, Sussex County, New Jersey",2000,1494,2030,536,18,7,89,4178,36,4267,4117,municipality,ONJ
857,3403770890,34037,"Stillwater township, Sussex County, New Jersey",2010,1553,1930,377,29,27,90,4009,50,4099,3903,municipality,ONJ
858,3403771670,34037,"Sussex borough, Sussex County, New Jersey",2000,903,961,58,26,22,55,2090,15,2145,2027,municipality,ONJ
859,3403771670,34037,"Sussex borough, Sussex County, New Jersey",2010,899,1005,106,49,39,169,1961,48,2130,1825,municipality,ONJ
860,3403775740,34037,"Vernon township, Sussex County, New Jersey",2000,8368,9994,1626,171,178,889,23797,234,24686,23214,municipality,ONJ
861,3403775740,34037,"Vernon township, Sussex County, New Jersey",2010,8622,10958,2336,185,292,1534,22409,308,23943,21624,municipality,ONJ
862,3403776640,34037,"Walpack township, Sussex County, New Jersey",2000,20,34,14,0,0,0,41,0,41,41,municipality,ONJ
863,3403776640,34037,"Walpack township, Sussex County, New Jersey",2010,8,15,7,0,0,0,16,1,16,15,municipality,ONJ
864,3403776790,34037,"Wantage township, Sussex County, New Jersey",2000,3441,3663,222,70,66,300,10087,94,10387,9857,municipality,ONJ
865,3403776790,34037,"Wantage township, Sussex County, New Jersey",2010,3910,4173,263,112,126,594,10764,158,11358,10368,municipality,ONJ
866,3403905320,34039,"Berkeley Heights township, Union County, New Jersey",2000,4479,4562,83,1055,143,494,12913,104,13407,11611,municipality,INJ
867,3403905320,34039,"Berkeley Heights township, Union County, New Jersey",2010,4470,4596,126,1372,186,675,12508,190,13183,10760,municipality,INJ
868,3403913150,34039,"Clark township, Union County, New Jersey",2000,5637,5709,72,402,35,535,14062,91,14597,13534,municipality,INJ
869,3403913150,34039,"Clark township, Union County, New Jersey",2010,5562,5751,189,527,116,1107,13649,132,14756,12874,municipality,INJ
870,3403915640,34039,"Cranford township, Union County, New Jersey",2000,8397,8560,163,484,579,879,21699,172,22578,20464,municipality,INJ
871,3403915640,34039,"Cranford township, Union County, New Jersey",2010,8583,8816,233,635,563,1474,21151,318,22625,19635,municipality,INJ
872,3403921000,34039,"Elizabeth city, Union County, New Jersey",2000,40482,42838,2356,2745,22329,59627,60941,3529,120568,32338,municipality,INJ
873,3403921000,34039,"Elizabeth city, Union County, New Jersey",2010,41596,45516,3920,2521,23072,74353,50616,2318,124969,22705,municipality,INJ
874,3403922860,34039,"Fanwood borough, Union County, New Jersey",2000,2574,2615,41,315,364,268,6906,95,7174,6132,municipality,INJ
875,3403922860,34039,"Fanwood borough, Union County, New Jersey",2010,2627,2686,59,490,374,458,6860,143,7318,5853,municipality,INJ
876,3403925800,34039,"Garwood borough, Union County, New Jersey",2000,1731,1782,51,55,15,207,3946,25,4153,3851,municipality,INJ
877,3403925800,34039,"Garwood borough, Union County, New Jersey",2010,1778,1870,92,86,42,373,3853,59,4226,3666,municipality,INJ
878,3403931980,34039,"Hillside township, Union County, New Jersey",2000,7161,7388,227,744,9961,3153,18594,898,21747,6991,municipality,INJ
879,3403931980,34039,"Hillside township, Union County, New Jersey",2010,7112,7536,424,571,11091,3774,17630,594,21404,5374,municipality,INJ
880,3403936690,34039,"Kenilworth borough, Union County, New Jersey",2000,2854,2926,72,220,183,663,7012,70,7675,6539,municipality,INJ
881,3403936690,34039,"Kenilworth borough, Union County, New Jersey",2010,2841,2924,83,303,213,1228,6686,123,7914,6047,municipality,INJ
882,3403940350,34039,"Linden city, Union County, New Jersey",2000,15052,15567,515,914,8782,5674,33720,1197,39394,22827,municipality,INJ
883,3403940350,34039,"Linden city, Union County, New Jersey",2010,14909,15872,963,1066,10403,10095,30404,846,40499,18089,municipality,INJ
884,3403948510,34039,"Mountainside borough, Union County, New Jersey",2000,2434,2478,44,180,61,199,6403,51,6602,6111,municipality,INJ
885,3403948510,34039,"Mountainside borough, Union County, New Jersey",2010,2468,2558,90,323,121,407,6278,80,6685,5754,municipality,INJ
886,3403951810,34039,"New Providence borough, Union County, New Jersey",2000,4404,4485,81,903,104,417,11490,124,11907,10359,municipality,INJ
887,3403951810,34039,"New Providence borough, Union County, New Jersey",2010,4408,4537,129,1187,153,783,11388,178,12171,9870,municipality,INJ
888,3403959190,34039,"Plainfield city, Union County, New Jersey",2000,15137,16180,1043,428,28698,12033,35796,1162,47829,5508,municipality,INJ
889,3403959190,34039,"Plainfield city, Union County, New Jersey",2010,15180,16621,1441,439,24069,20105,29703,1056,49808,4139,municipality,INJ
890,3403961530,34039,"Rahway city, Union County, New Jersey",2000,10028,10381,353,925,7058,3675,22825,743,26500,14099,municipality,INJ
891,3403961530,34039,"Rahway city, Union County, New Jersey",2010,10533,11300,767,1148,8104,6433,20913,648,27346,11013,municipality,INJ
892,3403964620,34039,"Roselle borough, Union County, New Jersey",2000,7520,7870,350,573,10669,3641,17633,717,21274,5674,municipality,INJ
893,3403964620,34039,"Roselle borough, Union County, New Jersey",2010,7407,7939,532,464,11148,5644,15441,440,21085,3389,municipality,INJ
894,3403964650,34039,"Roselle Park borough, Union County, New Jersey",2000,5137,5258,121,1199,298,2170,11111,217,13281,9397,municipality,INJ
895,3403964650,34039,"Roselle Park borough, Union County, New Jersey",2010,5002,5231,229,1337,697,3809,9488,193,13297,7261,municipality,INJ
896,3403966060,34039,"Scotch Plains township, Union County, New Jersey",2000,8349,8479,130,1638,2532,895,21837,332,22732,17335,municipality,INJ
897,3403966060,34039,"Scotch Plains township, Union County, New Jersey",2010,8595,8896,301,1795,2519,1582,21928,493,23510,17121,municipality,INJ
898,3403970020,34039,"Springfield township, Union County, New Jersey",2000,6001,6204,203,675,536,597,13832,130,14429,12491,municipality,INJ
899,3403970020,34039,"Springfield township, Union County, New Jersey",2010,6511,6736,225,1196,968,1502,14315,229,15817,11922,municipality,INJ
900,3403971430,34039,"Summit city, Union County, New Jersey",2000,7897,8146,249,935,877,2150,18981,243,21131,16926,municipality,INJ
901,3403971430,34039,"Summit city, Union County, New Jersey",2010,7708,8190,482,1367,933,2851,18606,409,21457,15897,municipality,INJ
902,3403974480,34039,"Union township, Union County, New Jersey",2000,19534,20001,467,4191,10563,4861,49544,1129,54405,33661,municipality,INJ
903,3403974480,34039,"Union township, Union County, New Jersey",2010,19556,20250,694,5959,15979,8465,48177,1266,56642,24973,municipality,INJ
904,3403979040,34039,"Westfield town, Union County, New Jersey",2000,10622,10819,197,1206,1137,836,28808,418,29644,26047,municipality,INJ
905,3403979040,34039,"Westfield town, Union County, New Jersey",2010,10566,10950,384,1708,940,1492,28824,547,30316,25629,municipality,INJ
906,3403981650,34039,"Winfield township, Union County, New Jersey",2000,694,697,3,2,2,37,1477,23,1514,1450,municipality,INJ
907,3403981650,34039,"Winfield township, Union County, New Jersey",2010,706,714,8,2,14,94,1377,20,1471,1341,municipality,INJ
908,3404100670,34041,"Allamuchy township, Warren County, New Jersey",2000,1692,1774,82,72,36,104,3773,33,3877,3632,municipality,ONJ
909,3404100670,34041,"Allamuchy township, Warren County, New Jersey",2010,1953,2096,143,118,75,194,4129,56,4323,3880,municipality,ONJ
910,3404101030,34041,"Alpha borough, Warren County, New Jersey",2000,989,1034,45,30,5,47,2435,26,2482,2374,municipality,ONJ
911,3404101030,34041,"Alpha borough, Warren County, New Jersey",2010,964,1032,68,36,55,125,2244,38,2369,2115,municipality,ONJ
912,3404104990,34041,"Belvidere town, Warren County, New Jersey",2000,1088,1165,77,14,14,64,2707,24,2771,2655,municipality,ONJ
913,3404104990,34041,"Belvidere town, Warren County, New Jersey",2010,1054,1140,86,21,38,97,2584,31,2681,2494,municipality,ONJ
914,3404106160,34041,"Blairstown township, Warren County, New Jersey",2000,2040,2136,96,32,15,114,5633,36,5747,5550,municipality,ONJ
915,3404106160,34041,"Blairstown township, Warren County, New Jersey",2010,2124,2272,148,68,63,226,5741,52,5967,5558,municipality,ONJ
916,3404124960,34041,"Franklin township, Warren County, New Jersey",2000,972,1019,47,24,22,55,2713,26,2768,2641,municipality,ONJ
917,3404124960,34041,"Franklin township, Warren County, New Jersey",2010,1122,1219,97,74,47,122,3054,46,3176,2887,municipality,ONJ
918,3404125320,34041,"Frelinghuysen township, Warren County, New Jersey",2000,722,755,33,8,7,55,2028,19,2083,1994,municipality,ONJ
919,3404125320,34041,"Frelinghuysen township, Warren County, New Jersey",2010,760,826,66,12,14,57,2173,22,2230,2125,municipality,ONJ
920,3404128260,34041,"Greenwich township, Warren County, New Jersey",2000,1421,1477,56,97,106,166,4199,40,4365,3956,municipality,ONJ
921,3404128260,34041,"Greenwich township, Warren County, New Jersey",2010,1808,1870,62,343,355,364,5348,94,5712,4556,municipality,ONJ
922,3404128710,34041,"Hackettstown town, Warren County, New Jersey",2000,4134,4347,213,301,221,833,9570,234,10403,8814,municipality,ONJ
923,3404128710,34041,"Hackettstown town, Warren County, New Jersey",2010,3575,3755,180,478,210,1474,8250,155,9724,7407,municipality,ONJ
924,3404129820,34041,"Hardwick township, Warren County, New Jersey",2000,502,530,28,6,8,34,1430,10,1464,1406,municipality,ONJ
925,3404129820,34041,"Hardwick township, Warren County, New Jersey",2010,573,619,46,11,14,67,1629,9,1696,1595,municipality,ONJ
926,3404130090,34041,"Harmony township, Warren County, New Jersey",2000,1010,1076,66,11,19,35,2694,21,2729,2643,municipality,ONJ
927,3404130090,34041,"Harmony township, Warren County, New Jersey",2010,1017,1109,92,5,18,35,2632,19,2667,2590,municipality,ONJ
928,3404133060,34041,"Hope township, Warren County, New Jersey",2000,697,747,50,8,8,28,1863,14,1891,1833,municipality,ONJ
929,3404133060,34041,"Hope township, Warren County, New Jersey",2010,741,809,68,31,23,80,1872,12,1952,1806,municipality,ONJ
930,3404133930,34041,"Independence township, Warren County, New Jersey",2000,2146,2210,64,94,65,211,5392,67,5603,5166,municipality,ONJ
931,3404133930,34041,"Independence township, Warren County, New Jersey",2010,2234,2325,91,126,64,307,5355,78,5662,5087,municipality,ONJ
932,3404137320,34041,"Knowlton township, Warren County, New Jersey",2000,1028,1135,107,19,11,55,2922,29,2977,2863,municipality,ONJ
933,3404137320,34041,"Knowlton township, Warren County, New Jersey",2010,1097,1212,115,28,27,111,2944,43,3055,2846,municipality,ONJ
934,3404140110,34041,"Liberty township, Warren County, New Jersey",2000,980,1088,108,16,10,74,2691,28,2765,2637,municipality,ONJ
935,3404140110,34041,"Liberty township, Warren County, New Jersey",2010,1047,1151,104,41,30,122,2820,34,2942,2715,municipality,ONJ
936,3404141490,34041,"Lopatcong township, Warren County, New Jersey",2000,2143,2429,286,94,62,115,5650,30,5765,5464,municipality,ONJ
937,3404141490,34041,"Lopatcong township, Warren County, New Jersey",2010,3136,3420,284,334,458,480,7534,112,8014,6630,municipality,ONJ
938,3404143320,34041,"Mansfield township, Warren County, New Jersey",2000,2334,2415,81,81,281,291,6362,126,6653,5874,municipality,ONJ
939,3404143320,34041,"Mansfield township, Warren County, New Jersey",2010,2972,3316,344,248,355,845,6880,139,7725,6138,municipality,ONJ
940,3404155530,34041,"Oxford township, Warren County, New Jersey",2000,886,938,52,12,27,80,2227,12,2307,2176,municipality,ONJ
941,3404155530,34041,"Oxford township, Warren County, New Jersey",2010,950,1033,83,38,40,95,2419,25,2514,2316,municipality,ONJ
942,3404158350,34041,"Phillipsburg town, Warren County, New Jersey",2000,6044,6651,607,126,502,816,14350,227,15166,13495,municipality,ONJ
943,3404158350,34041,"Phillipsburg town, Warren County, New Jersey",2010,5925,6607,682,222,1037,1767,13183,369,14950,11555,municipality,ONJ
944,3404159820,34041,"Pohatcong township, Warren County, New Jersey",2000,1341,1411,70,10,15,69,3347,20,3416,3302,municipality,ONJ
945,3404159820,34041,"Pohatcong township, Warren County, New Jersey",2010,1310,1420,110,30,53,116,3223,41,3339,3099,municipality,ONJ
946,3404177270,34041,"Washington borough, Warren County, New Jersey",2000,2724,2876,152,96,250,280,6432,89,6712,5997,municipality,ONJ
947,3404177270,34041,"Washington borough, Warren County, New Jersey",2010,2623,2897,274,217,372,549,5912,129,6461,5194,municipality,ONJ
948,3404177300,34041,"Washington township, Warren County, New Jersey",2000,2099,2174,75,59,103,135,6113,41,6248,5910,municipality,ONJ
949,3404177300,34041,"Washington township, Warren County, New Jersey",2010,2380,2493,113,126,152,292,6359,78,6651,6003,municipality,ONJ
950,3404180570,34041,"White township, Warren County, New Jersey",2000,1668,1770,102,25,51,90,4155,56,4245,4023,municipality,ONJ
951,3404180570,34041,"White township, Warren County, New Jersey",2010,2115,2304,189,35,92,134,4748,52,4882,4569,municipality,ONJ
952,3600508510,36005,"Bronx borough, Bronx County, New York",2000,463212,490659,27447,38558,416338,644705,687945,39398,1332650,193651,municipality,NYC
953,3600508510,36005,"Bronx borough, Bronx County, New York",2010,483449,511896,28447,47335,416695,741413,643695,28456,1385108,151209,municipality,NYC
954,3602701693,36027,"Amenia town, Dutchess County, New York",2000,1625,1814,189,19,117,136,3912,88,4048,3688,municipality,MHV
955,3602701693,36027,"Amenia town, Dutchess County, New York",2010,1741,2045,304,61,172,376,4060,107,4436,3720,municipality,MHV
956,3602705100,36027,"Beacon city, Dutchess County, New York",2000,5091,5406,315,175,2556,2334,11474,366,13808,8377,municipality,MHV
957,3602705100,36027,"Beacon city, Dutchess County, New York",2010,5347,5715,368,250,3232,3219,12322,507,15541,8333,municipality,MHV
958,3602705452,36027,"Beekman town, Dutchess County, New York",2000,3751,4180,429,194,264,616,10836,167,11452,10211,municipality,MHV
959,3602705452,36027,"Beekman town, Dutchess County, New York",2010,4251,4797,546,387,1559,1332,13289,276,14621,11067,municipality,MHV
960,3602716408,36027,"Clinton town, Dutchess County, New York",2000,1502,1734,232,40,58,70,3940,43,4010,3799,municipality,MHV
961,3602716408,36027,"Clinton town, Dutchess County, New York",2010,1602,1915,313,50,97,161,4151,74,4312,3930,municipality,MHV
962,3602720819,36027,"Dover town, Dutchess County, New York",2000,3034,3266,232,84,440,484,8081,180,8565,7377,municipality,MHV
963,3602720819,36027,"Dover town, Dutchess County, New York",2010,3259,3637,378,115,379,1199,7500,178,8699,6828,municipality,MHV
964,3602721996,36027,"East Fishkill town, Dutchess County, New York",2000,8233,8495,262,713,563,1035,24554,333,25589,22945,municipality,MHV
965,3602721996,36027,"East Fishkill town, Dutchess County, New York",2010,9512,10039,527,1162,918,2224,26805,430,29029,24295,municipality,MHV
966,3602725978,36027,"Fishkill town, Dutchess County, New York",2000,6856,7040,184,600,2734,2121,18137,207,20258,14596,municipality,MHV
967,3602725978,36027,"Fishkill town, Dutchess County, New York",2010,8642,9246,604,1695,2083,2420,19687,430,22107,15479,municipality,MHV
968,3602737209,36027,"Hyde Park town, Dutchess County, New York",2000,7395,7704,309,288,846,674,20177,415,20851,18628,municipality,MHV
969,3602737209,36027,"Hyde Park town, Dutchess County, New York",2010,7829,8416,587,526,1210,1204,20367,488,21571,18143,municipality,MHV
970,3602740299,36027,"La Grange town, Dutchess County, New York",2000,5085,5240,155,434,340,636,14292,218,14928,13300,municipality,MHV
971,3602740299,36027,"La Grange town, Dutchess County, New York",2010,5440,5668,228,630,545,1116,14614,251,15730,13188,municipality,MHV
972,3602747207,36027,"Milan town, Dutchess County, New York",2000,882,1090,208,34,1186,715,3844,64,4559,2560,municipality,MHV
973,3602747207,36027,"Milan town, Dutchess County, New York",2010,964,1279,315,12,35,105,2265,29,2370,2189,municipality,MHV
974,3602751891,36027,"North East town, Dutchess County, New York",2000,1146,1366,220,17,63,98,2904,31,3002,2793,municipality,MHV
975,3602751891,36027,"North East town, Dutchess County, New York",2010,1259,1627,368,32,74,275,2756,56,3031,2594,municipality,MHV
976,3602756825,36027,"Pawling town, Dutchess County, New York",2000,2823,3101,278,95,101,365,7156,83,7521,6877,municipality,MHV
977,3602756825,36027,"Pawling town, Dutchess County, New York",2010,3093,3593,500,183,211,865,7598,102,8463,7102,municipality,MHV
978,3602758156,36027,"Pine Plains town, Dutchess County, New York",2000,988,1161,173,17,23,35,2534,48,2569,2446,municipality,MHV
979,3602758156,36027,"Pine Plains town, Dutchess County, New York",2010,1007,1284,277,26,29,172,2301,38,2473,2208,municipality,MHV
980,3602758695,36027,"Pleasant Valley town, Dutchess County, New York",2000,3467,3614,147,58,166,240,8826,108,9066,8494,municipality,MHV
981,3602758695,36027,"Pleasant Valley town, Dutchess County, New York",2010,3765,4049,284,109,264,452,9220,210,9672,8637,municipality,MHV
982,3602759641,36027,"Poughkeepsie city, Dutchess County, New York",2000,12014,13153,1139,480,10354,3177,26694,1154,29871,14706,municipality,MHV
983,3602759641,36027,"Poughkeepsie city, Dutchess County, New York",2010,12400,13984,1584,521,10407,6384,26352,1172,32736,14252,municipality,MHV
984,3602759652,36027,"Poughkeepsie town, Dutchess County, New York",2000,14605,15132,527,2177,3326,2254,40523,789,42777,34231,municipality,MHV
985,3602759652,36027,"Poughkeepsie town, Dutchess County, New York",2010,15276,16116,840,2614,3983,4233,39108,1257,43341,31254,municipality,MHV
986,3602760905,36027,"Red Hook town, Dutchess County, New York",2000,3574,3840,266,215,135,276,10132,172,10408,9610,municipality,MHV
987,3602760905,36027,"Red Hook town, Dutchess County, New York",2010,3942,4384,442,272,190,555,10764,213,11319,10089,municipality,MHV
988,3602761357,36027,"Rhinebeck town, Dutchess County, New York",2000,3001,3255,254,106,267,306,7456,88,7762,6995,municipality,MHV
989,3602761357,36027,"Rhinebeck town, Dutchess County, New York",2010,3158,3653,495,132,185,387,7161,106,7548,6738,municipality,MHV
990,3602770662,36027,"Stanford town, Dutchess County, New York",2000,1398,1712,314,39,54,94,3450,58,3544,3299,municipality,MHV
991,3602770662,36027,"Stanford town, Dutchess County, New York",2010,1496,1913,417,39,64,219,3604,78,3823,3423,municipality,MHV
992,3602776166,36027,"Union Vale town, Dutchess County, New York",2000,1359,1464,105,54,107,156,4390,50,4546,4179,municipality,MHV
993,3602776166,36027,"Union Vale town, Dutchess County, New York",2010,1708,1911,203,110,74,227,4650,60,4877,4406,municipality,MHV
994,3602778157,36027,"Wappinger town, Dutchess County, New York",2000,9793,10144,351,1120,1235,2068,24206,419,26274,21432,municipality,MHV
995,3602778157,36027,"Wappinger town, Dutchess County, New York",2010,10318,10908,590,1341,1564,3860,23188,542,27048,19741,municipality,MHV
996,3602778388,36027,"Washington town, Dutchess County, New York",2000,1914,2192,278,31,124,170,4572,47,4742,4370,municipality,MHV
997,3602778388,36027,"Washington town, Dutchess County, New York",2010,1956,2459,503,63,120,282,4459,80,4741,4196,municipality,MHV
998,3604710022,36047,"Brooklyn borough, Kings County, New York",2000,880727,930866,50139,184291,848583,487878,1977448,90042,2465326,854532,municipality,NYC
999,3604710022,36047,"Brooklyn borough, Kings County, New York",2010,916856,1000293,83437,260129,799066,496285,2008415,55914,2504700,893306,municipality,NYC
1000,3601011,36059,"Albertson CDP, New York",2010,1789,1850,61,1256,12,377,4805,152,5182,3385,municipality,LI
1001,3602968,36059,"Atlantic Beach village, New York",2010,857,1091,234,18,12,74,1817,11,1891,1776,municipality,LI
1002,3604143,36059,"Baldwin CDP, New York",2010,10447,10783,336,1371,9941,5821,26314,998,32135,14004,municipality,LI
1003,3604550,36059,"Barnum Island CDP, New York",2010,843,889,46,64,22,377,2037,37,2414,1914,municipality,LI
1004,3604803,36059,"Baxter Estates village, New York",2010,382,411,29,60,12,168,831,16,999,743,municipality,LI
1005,3604891,36059,"Bay Park CDP, New York",2010,867,903,36,37,6,141,2071,14,2212,2014,municipality,LI
1006,3605034,36059,"Bayville village, New York",2010,2471,2651,180,112,18,433,6236,93,6669,6013,municipality,LI
1007,3605639,36059,"Bellerose village, New York",2010,375,378,3,52,35,113,1080,29,1193,964,municipality,LI
1008,3605661,36059,"Bellerose Terrace CDP, New York",2010,633,665,32,611,168,568,1630,87,2198,764,municipality,LI
1009,3605738,36059,"Bellmore CDP, New York",2010,5669,5807,138,477,158,922,15296,183,16218,14478,municipality,LI
1010,3606387,36059,"Bethpage CDP, New York",2010,5875,6051,176,895,90,1152,15277,197,16429,14095,municipality,LI
1011,3610132,36059,"Brookville village, New York",2010,612,663,51,351,372,219,3246,38,3465,2485,municipality,LI
1012,3612419,36059,"Carle Place CDP, New York",2010,1863,1932,69,391,90,552,4429,67,4981,3881,municipality,LI
1013,3613233,36059,"Cedarhurst village, New York",2010,2242,2375,133,236,134,705,5887,94,6592,5423,municipality,LI
1014,3613618,36059,"Centre Island village, New York",2010,168,232,64,15,0,30,380,3,410,362,municipality,LI
1015,3618597,36059,"Cove Neck village, New York",2010,104,148,44,4,1,14,272,3,286,264,municipality,LI
1016,3621578,36059,"East Atlantic Beach CDP, New York",2010,849,972,123,22,12,109,1940,17,2049,1889,municipality,LI
1017,3622260,36059,"East Hills village, New York",2010,2252,2301,49,513,66,156,6799,80,6955,6140,municipality,LI
1018,3622480,36059,"East Massapequa CDP, New York",2010,6599,6796,197,404,2298,1929,17140,340,19069,14098,municipality,LI
1019,3622502,36059,"East Meadow CDP, New York",2010,12410,12863,453,4400,1867,4653,33479,584,38132,26628,municipality,LI
1020,3622623,36059,"East Norwich CDP, New York",2010,943,966,23,92,19,118,2591,27,2709,2453,municipality,LI
1021,3622876,36059,"East Rockaway village, New York",2010,3825,3997,172,200,127,788,9030,86,9818,8617,municipality,LI
1022,3623217,36059,"East Williston village, New York",2010,842,864,22,99,8,110,2446,23,2556,2316,municipality,LI
1023,3624273,36059,"Elmont CDP, New York",2010,9847,10279,432,3609,14587,7236,25962,1272,33198,6494,municipality,LI
1024,3625384,36059,"Farmingdale village, New York",2010,3326,3482,156,445,199,1122,7067,108,8189,6315,municipality,LI
1025,3626264,36059,"Floral Park village, New York",2010,5680,5909,229,1086,198,1391,14472,250,15863,12938,municipality,LI
1026,3626352,36059,"Flower Hill village, New York",2010,1473,1523,50,591,34,271,4394,99,4665,3670,municipality,LI
1027,3627309,36059,"Franklin Square CDP, New York",2010,9941,10313,372,2100,845,3885,25435,478,29320,22012,municipality,LI
1028,3627485,36059,"Freeport village, New York",2010,13279,13865,586,669,13226,17858,25002,994,42860,10113,municipality,LI
1029,3628178,36059,"Garden City village, New York",2010,7366,7647,281,792,294,1003,21368,248,22371,20034,municipality,LI
1030,3628189,36059,"Garden City Park CDP, New York",2010,2533,2603,70,2578,282,942,6864,214,7806,3790,municipality,LI
1031,3628200,36059,"Garden City South CDP, New York",2010,1384,1429,45,229,33,317,3707,31,4024,3414,municipality,LI
1032,3629113,36059,"Glen Cove city, New York",2010,9764,10352,588,1235,1728,7513,19451,475,26964,16013,municipality,LI
1033,3629245,36059,"Glen Head CDP, New York",2010,1718,1784,66,158,36,380,4317,73,4697,4050,municipality,LI
1034,3629421,36059,"Glenwood Landing CDP, New York",2010,1336,1400,64,140,29,232,3547,45,3779,3333,municipality,LI
1035,3630169,36059,"Great Neck village, New York",2010,3473,3645,172,721,176,1015,8974,328,9989,7749,municipality,LI
1036,3630191,36059,"Great Neck Estates village, New York",2010,902,937,35,281,21,80,2681,43,2761,2336,municipality,LI
1037,3630202,36059,"Great Neck Gardens CDP, New York",2010,393,401,8,143,9,20,1166,46,1186,968,municipality,LI
1038,3630213,36059,"Great Neck Plaza village, New York",2010,3690,4052,362,769,88,526,6181,119,6707,5205,municipality,LI
1039,3630598,36059,"Greenvale CDP, New York",2010,358,373,15,206,20,149,945,32,1094,687,municipality,LI
1040,3632094,36059,"Harbor Hills CDP, New York",2010,180,190,10,30,0,11,564,4,575,530,municipality,LI
1041,3632105,36059,"Harbor Isle CDP, New York",2010,470,495,25,21,4,77,1224,21,1301,1178,municipality,LI
1042,3633139,36059,"Hempstead village, New York",2010,15234,16034,800,704,24724,23823,30068,1092,53891,3548,municipality,LI
1043,3634198,36059,"Herricks CDP, New York",2010,1343,1378,35,1854,19,169,4126,116,4295,2137,municipality,LI
1044,3634286,36059,"Hewlett CDP, New York",2010,2547,2708,161,480,152,727,6092,97,6819,5363,municipality,LI
1045,3634297,36059,"Hewlett Bay Park village, New York",2010,131,145,14,23,0,22,382,3,404,356,municipality,LI
1046,3634308,36059,"Hewlett Harbor village, New York",2010,418,442,24,49,10,30,1233,14,1263,1160,municipality,LI
1047,3634319,36059,"Hewlett Neck village, New York",2010,145,159,14,9,17,9,436,3,445,407,municipality,LI
1048,3634374,36059,"Hicksville CDP, New York",2010,13412,13761,349,8139,836,6043,35504,926,41547,25603,municipality,LI
1049,3637583,36059,"Inwood CDP, New York",2010,2964,3153,189,322,2258,4190,5602,236,9792,2786,municipality,LI
1050,3637847,36059,"Island Park village, New York",2010,1603,1715,112,115,64,1234,3421,72,4655,3170,municipality,LI
1051,3638539,36059,"Jericho CDP, New York",2010,4628,4782,154,3442,247,401,13166,180,13567,9297,municipality,LI
1052,3639309,36059,"Kensington village, New York",2010,411,448,37,101,8,26,1135,38,1161,988,municipality,LI
1053,3639694,36059,"Kings Point village, New York",2010,1293,1386,93,167,40,84,4921,199,5005,4515,municipality,LI
1054,3640937,36059,"Lake Success village, New York",2010,799,826,27,791,96,81,2853,46,2934,1920,municipality,LI
1055,3641003,36059,"Lakeview CDP, New York",2010,1487,1552,65,44,4399,853,4762,191,5615,128,municipality,LI
1056,3641432,36059,"Lattingtown village, New York",2010,614,707,93,47,8,41,1698,27,1739,1616,municipality,LI
1057,3641487,36059,"Laurel Hollow village, New York",2010,602,635,33,149,29,45,1907,21,1952,1708,municipality,LI
1058,3641553,36059,"Lawrence village, New York",2010,2045,2280,235,108,86,185,6298,29,6483,6075,municipality,LI
1059,3642081,36059,"Levittown CDP, New York",2010,16973,17287,314,2937,403,5979,45902,748,51881,41814,municipality,LI
1060,3642279,36059,"Lido Beach CDP, New York",2010,1192,1403,211,51,18,105,2792,33,2897,2690,municipality,LI
1061,3643192,36059,"Locust Valley CDP, New York",2010,1208,1281,73,82,99,600,2806,37,3406,2588,municipality,LI
1062,3643335,36059,"Long Beach city, New York",2010,14809,16450,1641,881,1958,4691,28584,628,33275,25117,municipality,LI
1063,3643874,36059,"Lynbrook village, New York",2010,7513,7921,408,867,648,2534,16893,288,19427,15090,municipality,LI
1064,3644787,36059,"Malverne village, New York",2010,3076,3146,70,354,260,736,7778,98,8514,7066,municipality,LI
1065,3644792,36059,"Malverne Park Oaks CDP, New York",2010,183,189,6,19,27,44,461,11,505,404,municipality,LI
1066,3644897,36059,"Manhasset CDP, New York",2010,2790,2893,103,877,744,711,7369,119,8080,5629,municipality,LI
1067,3644908,36059,"Manhasset Hills CDP, New York",2010,1184,1241,57,1412,22,210,3382,80,3592,1868,municipality,LI
1068,3645106,36059,"Manorhaven village, New York",2010,2442,2597,155,1150,90,1775,4781,94,6556,3447,municipality,LI
1069,3645986,36059,"Massapequa CDP, New York",2010,7226,7407,181,350,70,900,20785,167,21685,20198,municipality,LI
1070,3645997,36059,"Massapequa Park village, New York",2010,5731,5844,113,255,52,757,16251,86,17008,15858,municipality,LI
1071,3646107,36059,"Matinecock village, New York",2010,272,323,51,16,14,50,760,3,810,727,municipality,LI
1072,3646668,36059,"Merrick CDP, New York",2010,7448,7622,174,619,246,1301,20796,239,22097,19692,municipality,LI
1073,3647405,36059,"Mill Neck village, New York",2010,379,440,61,61,12,57,940,18,997,849,municipality,LI
1074,3647636,36059,"Mineola village, New York",2010,7396,7701,305,1579,321,3090,15709,367,18799,13442,municipality,LI
1075,3649231,36059,"Munsey Park village, New York",2010,819,840,21,173,11,87,2606,42,2693,2380,municipality,LI
1076,3649330,36059,"Muttontown village, New York",2010,1071,1125,54,794,54,119,3378,45,3497,2485,municipality,LI
1077,3650067,36059,"New Cassel CDP, New York",2010,2974,3174,200,174,5225,7577,6482,242,14059,841,municipality,LI
1078,3650397,36059,"New Hyde Park village, New York",2010,3271,3371,100,2521,104,1184,8528,261,9712,5642,municipality,LI
1079,3651517,36059,"North Bellmore CDP, New York",2010,6650,6818,168,904,492,1539,18402,302,19941,16704,municipality,LI
1080,3653022,36059,"North Hills village, New York",2010,2259,2438,179,1283,54,112,4963,96,5075,3530,municipality,LI
1081,3653231,36059,"North Lynbrook CDP, New York",2010,231,231,0,41,26,119,674,21,793,586,municipality,LI
1082,3653253,36059,"North Massapequa CDP, New York",2010,6084,6212,128,315,46,968,16918,127,17886,16430,municipality,LI
1083,3653264,36059,"North Merrick CDP, New York",2010,4044,4125,81,567,169,869,11403,130,12272,10537,municipality,LI
1084,3653275,36059,"North New Hyde Park CDP, New York",2010,4888,5016,128,4329,90,1078,13821,343,14899,9059,municipality,LI
1085,3653748,36059,"North Valley Stream CDP, New York",2010,5113,5548,435,2132,7720,2411,14217,600,16628,3765,municipality,LI
1086,3653792,36059,"North Wantagh CDP, New York",2010,4230,4321,91,294,77,897,11063,95,11960,10597,municipality,LI
1087,3654441,36059,"Oceanside CDP, New York",2010,11249,11604,355,879,356,2970,29139,308,32109,27596,municipality,LI
1088,3654551,36059,"Old Bethpage CDP, New York",2010,1894,1927,33,342,11,189,5334,55,5523,4926,municipality,LI
1089,3654562,36059,"Old Brookville village, New York",2010,669,720,51,238,42,122,2012,37,2134,1695,municipality,LI
1090,3654705,36059,"Old Westbury village, New York",2010,1073,1172,99,574,708,316,4355,123,4671,2950,municipality,LI
1091,3655992,36059,"Oyster Bay CDP, New York",2010,2758,2947,189,195,199,1119,5588,112,6707,5082,municipality,LI
1092,3656011,36059,"Oyster Bay Cove village, New York",2010,708,758,50,187,33,48,2149,19,2197,1910,municipality,LI
1093,3658409,36059,"Plainedge CDP, New York",2010,2875,2936,61,399,64,684,8133,86,8817,7584,municipality,LI
1094,3658442,36059,"Plainview CDP, New York",2010,9070,9281,211,2799,110,1046,25171,381,26217,21881,municipality,LI
1095,3658475,36059,"Plandome village, New York",2010,416,431,15,49,11,30,1319,7,1349,1252,municipality,LI
1096,3658486,36059,"Plandome Heights village, New York",2010,323,330,7,86,2,45,960,17,1005,855,municipality,LI
1097,3658497,36059,"Plandome Manor village, New York",2010,280,295,15,53,1,22,850,19,872,777,municipality,LI
1098,3658849,36059,"Point Lookout CDP, New York",2010,500,666,166,12,5,39,1180,4,1219,1159,municipality,LI
1099,3659520,36059,"Port Washington CDP, New York",2010,5698,6234,536,1273,346,2116,13730,267,15846,11844,municipality,LI
1100,3659531,36059,"Port Washington North village, New York",2010,1298,1395,97,263,44,200,2954,42,3154,2605,municipality,LI
1101,3663264,36059,"Rockville Centre village, New York",2010,9258,9679,421,498,1039,2169,21854,302,24023,20015,municipality,LI
1102,3663506,36059,"Roosevelt CDP, New York",2010,4031,4356,325,85,9873,5548,10710,426,16258,326,municipality,LI
1103,3663770,36059,"Roslyn village, New York",2010,1193,1288,95,243,58,311,2459,53,2770,2105,municipality,LI
1104,3663792,36059,"Roslyn Estates village, New York",2010,415,428,13,103,4,17,1234,12,1251,1115,municipality,LI
1105,3663803,36059,"Roslyn Harbor village, New York",2010,361,382,21,124,15,56,995,18,1051,838,municipality,LI
1106,3663814,36059,"Roslyn Heights CDP, New York",2010,2157,2263,106,1357,397,556,6021,209,6577,4058,municipality,LI
1107,3664232,36059,"Russell Gardens village, New York",2010,343,359,16,194,2,37,908,21,945,691,municipality,LI
1108,3664430,36059,"Saddle Rock village, New York",2010,267,280,13,54,3,14,816,25,830,734,municipality,LI
1109,3664441,36059,"Saddle Rock Estates CDP, New York",2010,140,142,2,11,0,2,464,11,466,442,municipality,LI
1110,3664842,36059,"Salisbury CDP, New York",2010,4004,4098,94,1521,211,1780,10313,205,12093,8376,municipality,LI
1111,3665035,36059,"Sands Point village, New York",2010,872,934,62,219,20,125,2550,46,2675,2265,municipality,LI
1112,3666047,36059,"Sea Cliff village, New York",2010,1960,2049,89,94,113,341,4654,53,4995,4394,municipality,LI
1113,3666058,36059,"Seaford CDP, New York",2010,5266,5395,129,334,70,761,14533,143,15294,13986,municipality,LI
1114,3666102,36059,"Searingtown CDP, New York",2010,1563,1604,41,1907,48,178,4737,115,4915,2667,municipality,LI
1115,3669001,36059,"South Farmingdale CDP, New York",2010,4784,4888,104,644,186,1454,13032,177,14486,12025,municipality,LI
1116,3669023,36059,"South Floral Park village, New York",2010,530,569,39,137,971,316,1448,95,1764,245,municipality,LI
1117,3669188,36059,"South Hempstead CDP, New York",2010,1047,1076,29,78,410,601,2642,58,3243,2096,municipality,LI
1118,3669892,36059,"South Valley Stream CDP, New York",2010,1969,2043,74,1079,1311,584,5378,210,5962,2778,municipality,LI
1119,3671267,36059,"Stewart Manor village, New York",2010,699,711,12,91,45,94,1802,20,1896,1646,municipality,LI
1120,3672554,36059,"Syosset CDP, New York",2010,6188,6339,151,4162,137,775,18054,297,18829,13458,municipality,LI
1121,3673605,36059,"Thomaston village, New York",2010,958,1004,46,731,25,137,2480,57,2617,1667,municipality,LI
1122,3676089,36059,"Uniondale CDP, New York",2010,7296,7652,356,774,12618,10173,20794,729,30967,6673,municipality,LI
1123,3676287,36059,"University Gardens CDP, New York",2010,1645,1695,50,1246,71,318,3908,87,4226,2504,municipality,LI
1124,3676331,36059,"Upper Brookville village, New York",2010,569,611,42,161,16,80,1618,36,1698,1405,municipality,LI
1125,3676705,36059,"Valley Stream village, New York",2010,12189,12625,436,4237,6544,8344,29167,1145,37511,17241,municipality,LI
1126,3678146,36059,"Wantagh CDP, New York",2010,6126,6250,124,372,51,889,17982,179,18871,17380,municipality,LI
1127,3679444,36059,"Westbury village, New York",2010,5078,5271,193,898,3127,4128,11018,348,15146,6645,municipality,LI
1128,3680225,36059,"West Hempstead CDP, New York",2010,5939,6130,191,1129,1807,3098,15764,404,18862,12424,municipality,LI
1129,3682117,36059,"Williston Park village, New York",2010,2668,2743,75,852,55,442,6845,121,7287,5817,municipality,LI
1130,3682744,36059,"Woodbury CDP, New York",2010,3054,3178,124,912,114,199,8708,96,8907,7586,municipality,LI
1131,3682942,36059,"Woodmere CDP, New York",2010,5336,5570,234,786,687,790,16331,120,17121,14738,municipality,LI
1132,3682986,36059,"Woodsburgh village, New York",2010,267,300,33,22,7,23,755,11,778,715,municipality,LI
1133,3605929113,36059,"Glen Cove city, Nassau County, New York",2000,9461,9734,273,1082,1614,5336,21286,446,26622,18144,municipality,LI
1134,3605929113,36059,"Glen Cove city, Nassau County, New York",2010,9764,10352,588,1235,1728,7513,19451,475,26964,16013,municipality,LI
1135,3605934000,36059,"Hempstead town, Nassau County, New York",2000,246828,252286,5458,26427,107929,86657,669267,13559,755924,521352,municipality,LI
1136,3605934000,36059,"Hempstead town, Nassau County, New York",2010,246456,256734,10278,39084,119480,132154,627603,14156,759757,454883,municipality,LI
1137,3605943335,36059,"Long Beach city, Nassau County, New York",2000,14923,16128,1205,814,2071,4540,30922,709,35462,27328,municipality,LI
1138,3605943335,36059,"Long Beach city, Nassau County, New York",2010,14809,16450,1641,881,1958,4691,28584,628,33275,25117,municipality,LI
1139,3605953000,36059,"North Hempstead town, Nassau County, New York",2000,76820,78927,2107,20209,13651,21872,200739,4117,222611,162762,municipality,LI
1140,3605953000,36059,"North Hempstead town, Nassau County, New York",2010,78080,81961,3881,33747,11971,29074,197248,4770,226322,146760,municipality,LI
1141,3605956000,36059,"Oyster Bay town, Nassau County, New York",2000,99355,101076,1721,14212,4595,14877,279048,2880,293925,257361,municipality,LI
1142,3605956000,36059,"Oyster Bay town, Nassau County, New York",2010,99419,102849,3430,26611,6168,21923,271291,3976,293214,234536,municipality,LI
1143,3606144919,36061,"Manhattan borough, New York County, New York",2000,738644,798144,59500,143291,234698,417816,1119379,37517,1537195,703873,municipality,NYC
1144,3606144919,36061,"Manhattan borough, New York County, New York",2010,763846,847090,83244,177624,205340,403577,1182296,37839,1585873,761493,municipality,NYC
1145,3607107003,36071,"Blooming Grove town, Orange County, New York",2000,5836,6559,723,235,599,1556,15795,315,17351,14646,municipality,MHV
1146,3607107003,36071,"Blooming Grove town, Orange County, New York",2010,6284,6954,670,392,953,2709,15319,397,18028,13577,municipality,MHV
1147,3607115308,36071,"Chester town, Orange County, New York",2000,3848,3984,136,319,768,1231,10909,153,12140,9669,municipality,MHV
1148,3607115308,36071,"Chester town, Orange County, New York",2010,4135,4372,237,490,812,1669,10312,315,11981,8695,municipality,MHV
1149,3607118300,36071,"Cornwall town, Orange County, New York",2000,4625,4852,227,150,144,629,11678,158,12307,11226,municipality,MHV
1150,3607118300,36071,"Cornwall town, Orange County, New York",2010,4742,5136,394,212,221,1046,11600,251,12646,10916,municipality,MHV
1151,3607118916,36071,"Crawford town, Orange County, New York",2000,2707,2851,144,57,89,404,7471,85,7875,7240,municipality,MHV
1152,3607118916,36071,"Crawford town, Orange County, New York",2010,3279,3475,196,139,303,924,8392,214,9316,7736,municipality,MHV
1153,3607119961,36071,"Deerpark town, Orange County, New York",2000,2906,3332,426,45,117,300,7558,99,7858,7297,municipality,MHV
1154,3607119961,36071,"Deerpark town, Orange County, New York",2010,2988,3484,496,89,174,547,7354,192,7901,6899,municipality,MHV
1155,3607129553,36071,"Goshen town, Orange County, New York",2000,4074,4320,246,219,801,950,11963,105,12913,10838,municipality,MHV
1156,3607129553,36071,"Goshen town, Orange County, New York",2010,4536,4921,385,347,888,1867,11820,268,13687,10317,municipality,MHV
1157,3607130631,36071,"Greenville town, Orange County, New York",2000,1243,1365,122,40,47,170,3630,36,3800,3507,municipality,MHV
1158,3607130631,36071,"Greenville town, Orange County, New York",2010,1504,1653,149,66,113,425,4191,93,4616,3919,municipality,MHV
1159,3607131907,36071,"Hamptonburgh town, Orange County, New York",2000,1467,1532,65,69,88,207,4479,77,4686,4245,municipality,MHV
1160,3607131907,36071,"Hamptonburgh town, Orange County, New York",2010,1739,1819,80,167,202,484,5077,113,5561,4595,municipality,MHV
1161,3607134550,36071,"Highlands town, Orange County, New York",2000,3230,3418,188,324,1064,962,11522,373,12484,9761,municipality,MHV
1162,3607134550,36071,"Highlands town, Orange County, New York",2010,3026,3487,461,416,934,1585,10907,537,12492,9020,municipality,MHV
1163,3607147042,36071,"Middletown city, Orange County, New York",2000,9466,10124,658,423,3350,6375,19013,817,25388,14423,municipality,MHV
1164,3607147042,36071,"Middletown city, Orange County, New York",2010,9976,10866,890,503,5075,11158,16928,930,28086,10420,municipality,MHV
1165,3607147713,36071,"Minisink town, Orange County, New York",2000,1182,1245,63,21,37,165,3420,21,3585,3341,municipality,MHV
1166,3607147713,36071,"Minisink town, Orange County, New York",2010,1485,1561,76,49,105,410,4080,74,4490,3852,municipality,MHV
1167,3607147999,36071,"Monroe town, Orange County, New York",2000,8228,8517,289,425,369,1543,29864,322,31407,28748,municipality,MHV
1168,3607147999,36071,"Monroe town, Orange County, New York",2010,10312,11144,832,980,772,3365,36547,455,39912,34340,municipality,MHV
1169,3607148153,36071,"Montgomery town, Orange County, New York",2000,7273,7643,370,137,694,1620,19271,302,20891,18138,municipality,MHV
1170,3607148153,36071,"Montgomery town, Orange County, New York",2010,8000,8523,523,318,1378,3167,19439,493,22606,17250,municipality,MHV
1171,3607148857,36071,"Mount Hope town, Orange County, New York",2000,1582,1714,132,97,989,970,5669,69,6639,4514,municipality,MHV
1172,3607148857,36071,"Mount Hope town, Orange County, New York",2010,1770,1955,185,109,1025,1121,5897,135,7018,4628,municipality,MHV
1173,3607150034,36071,"Newburgh city, Orange County, New York",2000,9144,10476,1332,202,8961,10257,18002,870,28259,7969,municipality,MHV
1174,3607150034,36071,"Newburgh city, Orange County, New York",2010,9030,10505,1475,257,8071,13814,15052,844,28866,5880,municipality,MHV
1175,3607150045,36071,"Newburgh town, Orange County, New York",2000,9765,10122,357,557,1873,2644,24924,449,27568,22045,municipality,MHV
1176,3607150045,36071,"Newburgh town, Orange County, New York",2010,10762,11313,551,865,3289,4664,25137,653,29801,20330,municipality,MHV
1177,3607150848,36071,"New Windsor town, Orange County, New York",2000,8396,8759,363,389,1446,2538,20328,446,22866,18047,municipality,MHV
1178,3607150848,36071,"New Windsor town, Orange County, New York",2010,9291,9862,571,840,2599,4920,20324,581,25244,16304,municipality,MHV
1179,3607159388,36071,"Port Jervis city, Orange County, New York",2000,3533,3851,318,57,333,660,8200,221,8860,7589,municipality,MHV
1180,3607159388,36071,"Port Jervis city, Orange County, New York",2010,3570,3957,387,108,565,1054,7774,366,8828,6735,municipality,MHV
1181,3607175781,36071,"Tuxedo town, Orange County, New York",2000,1337,1457,120,103,39,142,3192,57,3334,2993,municipality,MHV
1182,3607175781,36071,"Tuxedo town, Orange County, New York",2010,1457,1691,234,190,73,258,3366,74,3624,3029,municipality,MHV
1183,3607177992,36071,"Wallkill town, Orange County, New York",2000,8866,9283,417,584,2145,3304,21355,606,24659,18020,municipality,MHV
1184,3607177992,36071,"Wallkill town, Orange County, New York",2010,10133,10777,644,855,3939,6162,21264,824,27426,15646,municipality,MHV
1185,3607178366,36071,"Warwick town, Orange County, New York",2000,10868,11818,950,259,1234,1991,28773,455,30764,26825,municipality,MHV
1186,3607178366,36071,"Warwick town, Orange County, New York",2010,11835,12982,1147,463,1425,3279,28786,590,32065,26308,municipality,MHV
1187,3607178839,36071,"Wawayanda town, Orange County, New York",2000,2095,2174,79,101,107,369,5904,90,6273,5606,municipality,MHV
1188,3607178839,36071,"Wawayanda town, Orange County, New York",2010,2444,2630,186,139,331,883,6383,125,7266,5788,municipality,MHV
1189,3607182755,36071,"Woodbury town, Orange County, New York",2000,3117,3358,241,241,273,751,8709,122,9460,8073,municipality,MHV
1190,3607182755,36071,"Woodbury town, Orange County, New York",2010,3627,3958,331,691,648,1674,9679,265,11353,8075,municipality,MHV
1191,3607912529,36079,"Carmel town, Putnam County, New York",2000,10847,11283,436,386,325,1955,31051,402,33006,29938,municipality,LHV
1192,3607912529,36079,"Carmel town, Putnam County, New York",2010,11672,12348,676,588,545,3469,30836,400,34305,29303,municipality,LHV
1193,3607939331,36079,"Kent town, Putnam County, New York",2000,4868,5353,485,166,193,808,13201,199,14009,12643,municipality,LHV
1194,3607939331,36079,"Kent town, Putnam County, New York",2010,4888,5508,620,245,308,1755,11752,220,13507,10979,municipality,LHV
1195,3607956748,36079,"Patterson town, Putnam County, New York",2000,3529,3746,217,140,380,792,10514,188,11306,9806,municipality,LHV
1196,3607956748,36079,"Patterson town, Putnam County, New York",2010,3905,4272,367,209,480,1555,10468,225,12023,9554,municipality,LHV
1197,3607957584,36079,"Philipstown town, Putnam County, New York",2000,3599,3983,384,98,86,357,9065,102,9422,8779,municipality,LHV
1198,3607957584,36079,"Philipstown town, Putnam County, New York",2010,3685,4164,479,134,148,671,8991,187,9662,8522,municipality,LHV
1199,3607960147,36079,"Putnam Valley town, Putnam County, New York",2000,3676,4253,577,84,149,671,10015,169,10686,9613,municipality,LHV
1200,3607960147,36079,"Putnam Valley town, Putnam County, New York",2010,4216,4837,621,207,239,1159,10650,207,11809,9997,municipality,LHV
1201,3607968924,36079,"Southeast town, Putnam County, New York",2000,6184,6412,228,283,304,1393,15923,142,17316,15194,municipality,LHV
1202,3607968924,36079,"Southeast town, Putnam County, New York",2010,6675,7095,420,449,327,3052,15352,222,18404,14354,municipality,LHV
1203,3608160323,36081,"Queens borough, Queens County, New York",2000,782664,817250,34586,389303,422831,556605,1672774,127745,2229379,732895,municipality,NYC
1204,3608160323,36081,"Queens borough, Queens County, New York",2010,780117,835127,55010,508334,395881,613750,1616972,96030,2230722,616727,municipality,NYC
1205,3608570915,36085,"Staten Island borough, Richmond County, New York",2000,156341,163993,7652,24786,39704,53550,390178,9372,443728,316316,municipality,NYC
1206,3608570915,36085,"Staten Island borough, Richmond County, New York",2010,165516,176656,11140,34697,44313,81051,387679,8500,468730,300169,municipality,NYC
1207,3608715968,36087,"Clarkstown town, Rockland County, New York",2000,27697,28220,523,6442,6178,5683,76399,1428,82082,62351,municipality,LHV
1208,3608715968,36087,"Clarkstown town, Rockland County, New York",2010,29234,30314,1080,8748,7598,9831,74356,1641,84187,56369,municipality,LHV
1209,3608732765,36087,"Haverstraw town, Rockland County, New York",2000,11255,11553,298,1062,3146,10729,23082,741,33811,18133,municipality,LHV
1210,3608732765,36087,"Haverstraw town, Rockland County, New York",2010,12170,12809,639,1559,4627,15012,21622,730,36634,14706,municipality,LHV
1211,3608755211,36087,"Orangetown town, Rockland County, New York",2000,17330,17827,497,3056,2687,2873,44838,881,47711,38214,municipality,LHV
1212,3608755211,36087,"Orangetown town, Rockland County, New York",2010,17826,18611,785,3386,2742,4782,44430,812,49212,37490,municipality,LHV
1213,3608760510,36087,"Ramapo town, Rockland County, New York",2000,31561,32422,861,4964,17965,8923,99982,2854,108905,74199,municipality,LHV
1214,3608760510,36087,"Ramapo town, Rockland County, New York",2010,34731,36754,2023,5013,19173,17223,109372,2092,126595,83094,municipality,LHV
1215,3608771674,36087,"Stony Point town, Rockland County, New York",2000,4832,4951,119,183,163,974,13270,168,14244,12756,municipality,LHV
1216,3608771674,36087,"Stony Point town, Rockland County, New York",2010,5281,5569,288,393,483,1935,13124,237,15059,12011,municipality,LHV
1217,3601594,36103,"Amagansett CDP, New York",2010,513,1790,1277,22,13,119,1046,7,1165,1004,municipality,LI
1218,3602044,36103,"Amityville village, New York",2010,3690,3997,307,166,874,1249,8274,138,9523,7096,municipality,LI
1219,3602374,36103,"Aquebogue CDP, New York",2010,932,1127,195,5,102,290,2148,14,2438,2027,municipality,LI
1220,3602737,36103,"Asharoken village, New York",2010,255,302,47,13,0,20,634,9,654,612,municipality,LI
1221,3603408,36103,"Babylon village, New York",2010,4585,4768,183,263,221,817,11349,207,12166,10658,municipality,LI
1222,3604055,36103,"Baiting Hollow CDP, New York",2010,719,1208,489,12,15,98,1544,8,1642,1509,municipality,LI
1223,3604913,36103,"Bayport CDP, New York",2010,3346,3515,169,151,115,470,8426,88,8896,8072,municipality,LI
1224,3604935,36103,"Bay Shore CDP, New York",2010,9064,9663,599,845,4590,8101,18236,746,26337,12055,municipality,LI
1225,3605039,36103,"Baywood CDP, New York",2010,2162,2272,110,288,976,2548,4802,166,7350,3372,municipality,LI
1226,3605672,36103,"Belle Terre village, New York",2010,286,308,22,26,10,31,761,11,792,714,municipality,LI
1227,3605771,36103,"Bellport village, New York",2010,921,1170,249,27,32,87,1997,42,2084,1896,municipality,LI
1228,3607069,36103,"Blue Point CDP, New York",2010,1680,1747,67,78,36,200,4573,57,4773,4402,municipality,LI
1229,3607157,36103,"Bohemia CDP, New York",2010,3606,3731,125,232,91,723,9457,73,10180,9061,municipality,LI
1230,3608026,36103,"Brentwood CDP, New York",2010,13654,14202,548,1101,8344,41529,19135,1136,60664,8554,municipality,LI
1231,3608136,36103,"Bridgehampton CDP, New York",2010,748,2431,1683,21,232,256,1500,26,1756,1221,municipality,LI
1232,3608323,36103,"Brightwaters village, New York",2010,1126,1156,30,48,38,159,2944,48,3103,2810,municipality,LI
1233,3609000,36103,"Brookhaven CDP, New York",2010,1176,1268,92,24,214,212,3239,39,3451,2962,municipality,LI
1234,3611781,36103,"Calverton CDP, New York",2010,2965,3224,259,57,493,453,6057,89,6510,5418,municipality,LI
1235,3613376,36103,"Centereach CDP, New York",2010,10026,10408,382,1950,834,3575,28003,470,31578,24749,municipality,LI
1236,3613420,36103,"Center Moriches CDP, New York",2010,2597,2818,221,105,248,776,6804,138,7580,6313,municipality,LI
1237,3613442,36103,"Centerport CDP, New York",2010,2032,2120,88,102,26,194,5314,59,5508,5127,municipality,LI
1238,3613552,36103,"Central Islip CDP, New York",2010,9365,9961,596,1112,7740,17938,16512,977,34450,6683,municipality,LI
1239,3616958,36103,"Cold Spring Harbor CDP, New York",2010,1749,1809,60,113,34,194,4876,46,5070,4683,municipality,LI
1240,3617530,36103,"Commack CDP, New York",2010,11907,12138,231,1951,297,1722,34402,404,36124,31750,municipality,LI
1241,3618146,36103,"Copiague CDP, New York",2010,7535,7919,384,464,1455,7523,15470,384,22993,13167,municipality,LI
1242,3618157,36103,"Coram CDP, New York",2010,14632,15437,805,1952,3842,5307,33806,939,39113,27073,municipality,LI
1243,3619466,36103,"Cutchogue CDP, New York",2010,1347,2062,715,27,47,242,3107,20,3349,3013,municipality,LI
1244,3619972,36103,"Deer Park CDP, New York",2010,9383,9715,332,1871,3182,3364,24381,573,27745,18755,municipality,LI
1245,3620379,36103,"Dering Harbor village, New York",2010,5,35,30,0,0,0,11,0,11,11,municipality,LI
1246,3620687,36103,"Dix Hills CDP, New York",2010,8319,8529,210,2990,1385,1533,25359,551,26892,20433,municipality,LI
1247,3621985,36103,"East Farmingdale CDP, New York",2010,2002,2114,112,332,775,1353,5131,149,6484,3875,municipality,LI
1248,3622183,36103,"East Hampton village, New York",2010,533,1836,1303,12,8,128,955,4,1083,931,municipality,LI
1249,3622200,36103,"East Hampton North CDP, New York",2010,1536,2545,1009,44,244,1594,2548,81,4142,2179,municipality,LI
1250,3622315,36103,"East Islip CDP, New York",2010,4803,4942,139,223,143,903,13572,153,14475,13053,municipality,LI
1251,3622447,36103,"East Marion CDP, New York",2010,409,953,544,8,7,62,864,17,926,832,municipality,LI
1252,3622546,36103,"East Moriches CDP, New York",2010,1896,2163,267,46,75,312,4937,74,5249,4742,municipality,LI
1253,3622612,36103,"East Northport CDP, New York",2010,7114,7288,174,564,158,1354,18863,253,20217,17888,municipality,LI
1254,3622733,36103,"East Patchogue CDP, New York",2010,8294,8685,391,518,903,3951,18518,384,22469,16713,municipality,LI
1255,3622810,36103,"Eastport CDP, New York",2010,702,865,163,11,23,160,1671,17,1831,1620,municipality,LI
1256,3622832,36103,"East Quogue CDP, New York",2010,1832,3069,1237,61,63,425,4332,52,4757,4156,municipality,LI
1257,3622980,36103,"East Shoreham CDP, New York",2010,2047,2104,57,155,86,364,6302,56,6666,6005,municipality,LI
1258,3623316,36103,"Eatons Neck CDP, New York",2010,519,575,56,13,2,36,1370,19,1406,1336,municipality,LI
1259,3624405,36103,"Elwood CDP, New York",2010,3512,3585,73,887,674,918,10259,154,11177,8544,municipality,LI
1260,3625417,36103,"Farmingville CDP, New York",2010,4707,4884,177,571,339,1942,13539,265,15481,12364,municipality,LI
1261,3625839,36103,"Fire Island CDP, New York",2010,131,3395,3264,1,12,23,269,3,292,253,municipality,LI
1262,3625923,36103,"Fishers Island CDP, New York",2010,120,660,540,2,2,2,234,5,236,225,municipality,LI
1263,3626121,36103,"Flanders CDP, New York",2010,1345,1684,339,46,597,1677,2795,132,4472,2020,municipality,LI
1264,3626946,36103,"Fort Salonga CDP, New York",2010,3370,3484,114,216,84,388,9620,106,10008,9214,municipality,LI
1265,3628997,36103,"Gilgo-Oak Beach-Captree CDP, New York",2010,182,376,194,3,1,26,391,3,417,384,municipality,LI
1266,3629509,36103,"Gordon Heights CDP, New York",2010,1070,1182,112,75,1971,1012,3030,201,4042,783,municipality,LI
1267,3630235,36103,"Great River CDP, New York",2010,503,517,14,23,8,62,1427,7,1489,1389,municipality,LI
1268,3630543,36103,"Greenlawn CDP, New York",2010,4560,4722,162,555,1841,1724,12018,284,13742,9338,municipality,LI
1269,3630576,36103,"Greenport village, New York",2010,820,1191,371,11,219,746,1451,44,2197,1177,municipality,LI
1270,3630581,36103,"Greenport West CDP, New York",2010,960,1651,691,16,100,328,1796,34,2124,1646,municipality,LI
1271,3631445,36103,"Halesite CDP, New York",2010,1008,1070,62,38,17,106,2392,25,2498,2312,municipality,LI
1272,3631896,36103,"Hampton Bays CDP, New York",2010,5079,7873,2794,108,161,3895,9708,165,13603,9274,municipality,LI
1273,3632732,36103,"Hauppauge CDP, New York",2010,7333,7566,233,1226,389,1479,19403,240,20882,17548,municipality,LI
1274,3632963,36103,"Head of the Harbor village, New York",2010,511,551,40,38,10,46,1426,15,1472,1363,municipality,LI
1275,3635056,36103,"Holbrook CDP, New York",2010,9550,9820,270,1008,401,2311,24884,293,27195,23182,municipality,LI
1276,3635254,36103,"Holtsville CDP, New York",2010,6725,6929,204,859,326,1990,17724,230,19714,16309,municipality,LI
1277,3636233,36103,"Huntington CDP, New York",2010,7170,7482,312,390,382,906,17140,226,18046,16142,municipality,LI
1278,3637022,36103,"Huntington Bay village, New York",2010,534,578,44,26,6,49,1376,15,1425,1329,municipality,LI
1279,3637044,36103,"Huntington Station CDP, New York",2010,10067,10523,456,1154,3299,12109,20920,745,33029,15722,municipality,LI
1280,3637840,36103,"Islandia village, New York",2010,1026,1088,62,204,429,944,2391,68,3335,1690,municipality,LI
1281,3637869,36103,"Islip CDP, New York",2010,6437,6664,227,461,760,2580,16109,318,18689,14570,municipality,LI
1282,3638022,36103,"Islip Terrace CDP, New York",2010,1703,1764,61,124,90,478,4911,70,5389,4627,municipality,LI
1283,3638253,36103,"Jamesport CDP, New York",2010,715,1169,454,7,18,142,1568,13,1710,1530,municipality,LI
1284,3639672,36103,"Kings Park CDP, New York",2010,6212,6469,257,406,183,915,16367,197,17282,15581,municipality,LI
1285,3640530,36103,"Lake Grove village, New York",2010,3814,3956,142,737,215,866,10297,140,11163,9205,municipality,LI
1286,3640838,36103,"Lake Ronkonkoma CDP, New York",2010,6932,7199,267,904,423,2008,18147,309,20155,16511,municipality,LI
1287,3641465,36103,"Laurel CDP, New York",2010,524,810,286,6,24,124,1270,23,1394,1217,municipality,LI
1288,3642554,36103,"Lindenhurst village, New York",2010,9316,9665,349,518,341,2656,24597,357,27253,23381,municipality,LI
1289,3643005,36103,"Lloyd Harbor village, New York",2010,1162,1262,100,80,34,120,3540,48,3660,3378,municipality,LI
1290,3645139,36103,"Manorville CDP, New York",2010,5000,5303,303,249,222,938,13376,162,14314,12743,municipality,LI
1291,3646074,36103,"Mastic CDP, New York",2010,4526,4847,321,323,1247,3378,12103,471,15481,10062,municipality,LI
1292,3646085,36103,"Mastic Beach CDP, New York",2010,4231,4889,658,186,1120,2019,10911,354,12930,9251,municipality,LI
1293,3646140,36103,"Mattituck CDP, New York",2010,1693,2495,802,37,54,288,3931,66,4219,3774,municipality,LI
1294,3646404,36103,"Medford CDP, New York",2010,7821,8171,350,620,1328,4306,19836,417,24142,17471,municipality,LI
1295,3646514,36103,"Melville CDP, New York",2010,6908,7194,286,1372,607,955,18030,317,18985,15734,municipality,LI
1296,3646976,36103,"Middle Island CDP, New York",2010,4217,4479,262,361,786,974,9509,228,10483,8134,municipality,LI
1297,3647306,36103,"Miller Place CDP, New York",2010,4000,4141,141,359,191,621,11718,133,12339,11035,municipality,LI
1298,3648054,36103,"Montauk CDP, New York",2010,1422,4666,3244,30,74,537,2789,41,3326,2644,municipality,LI
1299,3648450,36103,"Moriches CDP, New York",2010,1322,1475,153,79,72,247,2591,40,2838,2400,municipality,LI
1300,3649066,36103,"Mount Sinai CDP, New York",2010,4080,4285,205,486,165,706,11412,141,12118,10620,municipality,LI
1301,3649424,36103,"Napeague CDP, New York",2010,107,762,655,3,1,6,194,3,200,187,municipality,LI
1302,3649825,36103,"Nesconset CDP, New York",2010,4564,4711,147,651,159,825,12562,112,13387,11640,municipality,LI
1303,3650727,36103,"New Suffolk CDP, New York",2010,177,307,130,0,1,22,327,1,349,325,municipality,LI
1304,3651286,36103,"Nissequogue village, New York",2010,573,646,73,87,11,60,1689,21,1749,1570,municipality,LI
1305,3651396,36103,"North Amityville CDP, New York",2010,5333,5636,303,167,10076,5093,12769,619,17862,1907,municipality,LI
1306,3651418,36103,"Northampton CDP, New York",2010,191,239,48,2,157,112,458,14,570,285,municipality,LI
1307,3651440,36103,"North Babylon CDP, New York",2010,6136,6378,242,696,1009,2221,15288,273,17509,13310,municipality,LI
1308,3651495,36103,"North Bay Shore CDP, New York",2010,4395,4627,232,697,2894,12310,6634,458,18944,2585,municipality,LI
1309,3651528,36103,"North Bellport CDP, New York",2010,3362,3652,290,288,2868,3382,8163,572,11545,4435,municipality,LI
1310,3652078,36103,"North Great River CDP, New York",2010,1264,1367,103,82,109,470,3531,36,4001,3304,municipality,LI
1311,3652188,36103,"North Haven village, New York",2010,332,739,407,12,1,24,809,4,833,792,municipality,LI
1312,3653198,36103,"North Lindenhurst CDP, New York",2010,3787,3898,111,362,564,2246,9406,194,11652,8286,municipality,LI
1313,3653319,36103,"North Patchogue CDP, New York",2010,2300,2432,132,127,155,1491,5755,90,7246,5383,municipality,LI
1314,3653396,36103,"Northport village, New York",2010,2921,3066,145,121,40,267,7134,57,7401,6916,municipality,LI
1315,3653561,36103,"North Sea CDP, New York",2010,1771,3477,1706,69,40,748,3710,65,4458,3536,municipality,LI
1316,3653775,36103,"Northville CDP, New York",2010,531,772,241,10,14,78,1262,16,1340,1222,municipality,LI
1317,3653852,36103,"Northwest Harbor CDP, New York",2010,1313,3394,2081,56,83,605,2712,47,3317,2526,municipality,LI
1318,3654056,36103,"Noyack CDP, New York",2010,1510,2881,1371,52,43,334,3234,40,3568,3099,municipality,LI
1319,3654144,36103,"Oakdale CDP, New York",2010,3116,3280,164,102,81,314,7660,50,7974,7427,municipality,LI
1320,3654430,36103,"Ocean Beach village, New York",2010,39,607,568,0,0,1,78,0,79,78,municipality,LI
1321,3654617,36103,"Old Field village, New York",2010,325,369,44,58,8,26,892,27,918,799,municipality,LI
1322,3655321,36103,"Orient CDP, New York",2010,353,772,419,6,8,16,727,9,743,704,municipality,LI
1323,3656660,36103,"Patchogue village, New York",2010,4694,5023,329,185,620,3488,8310,209,11798,7296,municipality,LI
1324,3656968,36103,"Peconic CDP, New York",2010,273,479,206,1,22,70,613,3,683,587,municipality,LI
1325,3659157,36103,"Poquott village, New York",2010,353,380,27,63,18,40,913,21,953,811,municipality,LI
1326,3659355,36103,"Port Jefferson village, New York",2010,3090,3270,180,470,117,500,7250,107,7750,6556,municipality,LI
1327,3659377,36103,"Port Jefferson Station CDP, New York",2010,2812,2949,137,416,183,1158,6680,83,7838,5998,municipality,LI
1328,3660408,36103,"Quiogue CDP, New York",2010,307,583,276,17,67,155,661,36,816,541,municipality,LI
1329,3660422,36103,"Quogue village, New York",2010,424,1623,1199,10,17,58,909,23,967,859,municipality,LI
1330,3661142,36103,"Remsenburg-Speonk CDP, New York",2010,984,1624,640,19,33,209,2433,33,2642,2348,municipality,LI
1331,3661665,36103,"Ridge CDP, New York",2010,5714,6235,521,241,601,749,12587,175,13336,11570,municipality,LI
1332,3661973,36103,"Riverhead CDP, New York",2010,4827,5295,468,220,2033,3369,9930,352,13299,7325,municipality,LI
1333,3662066,36103,"Riverside CDP, New York",2010,716,840,124,7,706,872,2039,90,2911,1236,municipality,LI
1334,3663319,36103,"Rocky Point CDP, New York",2010,4820,5366,546,222,187,978,13036,196,14014,12431,municipality,LI
1335,3663473,36103,"Ronkonkoma CDP, New York",2010,6512,6724,212,882,342,1944,17138,279,19082,15635,municipality,LI
1336,3664452,36103,"Sagaponack village, New York",2010,146,676,530,2,4,7,306,5,313,295,municipality,LI
1337,3664485,36103,"Sag Harbor village, New York",2010,1000,1941,941,31,157,285,1884,42,2169,1654,municipality,LI
1338,3664584,36103,"St. James CDP, New York",2010,4535,4741,206,261,65,750,12588,129,13338,12133,municipality,LI
1339,3664881,36103,"Saltaire village, New York",2010,15,459,444,0,0,0,37,0,37,37,municipality,LI
1340,3665409,36103,"Sayville CDP, New York",2010,5983,6220,237,307,161,814,16039,156,16853,15415,municipality,LI
1341,3666212,36103,"Selden CDP, New York",2010,6446,6739,293,866,568,2750,17101,324,19851,15343,municipality,LI
1342,3666481,36103,"Setauket-East Setauket CDP, New York",2010,5391,5589,198,1137,156,807,14670,249,15477,13128,municipality,LI
1343,3666828,36103,"Shelter Island CDP, New York",2010,598,1136,538,6,12,75,1258,18,1333,1222,municipality,LI
1344,3666850,36103,"Shelter Island Heights CDP, New York",2010,525,1583,1058,4,13,41,1007,24,1048,966,municipality,LI
1345,3667048,36103,"Shinnecock Hills CDP, New York",2010,744,1500,756,23,40,655,1533,34,2188,1436,municipality,LI
1346,3667070,36103,"Shirley CDP, New York",2010,8353,9022,669,701,1768,4781,23073,638,27854,19966,municipality,LI
1347,3667191,36103,"Shoreham village, New York",2010,192,229,37,16,7,15,516,3,531,490,municipality,LI
1348,3667851,36103,"Smithtown CDP, New York",2010,8773,9031,258,754,272,1361,25109,258,26470,23825,municipality,LI
1349,3668374,36103,"Sound Beach CDP, New York",2010,2729,3001,272,134,89,475,7137,133,7612,6781,municipality,LI
1350,3668462,36103,"Southampton village, New York",2010,1263,3314,2051,51,297,503,2606,71,3109,2187,municipality,LI
1351,3669254,36103,"South Huntington CDP, New York",2010,3378,3500,122,549,212,756,8666,164,9422,7741,municipality,LI
1352,3669452,36103,"Southold CDP, New York",2010,2414,3996,1582,47,43,482,5266,53,5748,5123,municipality,LI
1353,3670387,36103,"Springs CDP, New York",2010,2318,4340,2022,97,94,2410,4182,46,6592,3945,municipality,LI
1354,3671608,36103,"Stony Brook CDP, New York",2010,4846,5042,196,1029,215,603,13137,175,13740,11718,municipality,LI
1355,3671620,36103,"Stony Brook University CDP, New York",2010,26,26,0,1883,1247,612,8604,170,9216,5304,municipality,LI
1356,3673352,36103,"Terryville CDP, New York",2010,3827,3971,144,364,266,1831,10018,152,11849,9236,municipality,LI
1357,3675572,36103,"Tuckahoe CDP, New York",2010,480,865,385,18,128,366,1007,45,1373,816,municipality,LI
1358,3677519,36103,"Village of the Branch village, New York",2010,625,645,20,39,21,51,1756,25,1807,1671,municipality,LI
1359,3677772,36103,"Wading River CDP, New York",2010,2716,3090,374,71,150,349,7370,118,7719,7031,municipality,LI
1360,3677805,36103,"Wainscott CDP, New York",2010,264,876,612,3,15,93,557,19,650,520,municipality,LI
1361,3678575,36103,"Water Mill CDP, New York",2010,652,2085,1433,22,15,109,1450,17,1559,1396,municipality,LI
1362,3679246,36103,"West Babylon CDP, New York",2010,14537,15091,554,1163,4622,5262,37951,844,43213,31322,municipality,LI
1363,3679301,36103,"West Bay Shore CDP, New York",2010,1720,1818,98,101,100,343,4305,77,4648,4027,municipality,LI
1364,3680170,36103,"Westhampton CDP, New York",2010,1045,2120,1075,35,109,380,2699,51,3079,2504,municipality,LI
1365,3680181,36103,"Westhampton Beach village, New York",2010,691,2376,1685,17,46,340,1381,19,1721,1299,municipality,LI
1366,3680186,36103,"West Hampton Dunes village, New York",2010,24,272,248,1,0,2,53,0,55,52,municipality,LI
1367,3680258,36103,"West Hills CDP, New York",2010,1974,2037,63,300,60,304,5288,78,5592,4850,municipality,LI
1368,3680302,36103,"West Islip CDP, New York",2010,9040,9266,226,477,166,1557,26778,266,28335,25869,municipality,LI
1369,3680885,36103,"West Sayville CDP, New York",2010,1771,2124,353,55,35,183,4828,45,5011,4693,municipality,LI
1370,3681419,36103,"Wheatley Heights CDP, New York",2010,1480,1517,37,285,2701,692,4438,215,5130,1237,municipality,LI
1371,3683294,36103,"Wyandanch CDP, New York",2010,2926,3157,231,121,7326,3286,8361,335,11647,579,municipality,LI
1372,3683426,36103,"Yaphank CDP, New York",2010,1872,1961,89,105,389,677,5268,67,5945,4707,municipality,LI
1373,3610304000,36103,"Babylon town, Suffolk County, New York",2000,69048,71186,2138,3975,31945,21275,190517,4417,211792,150180,municipality,LI
1374,3610304000,36103,"Babylon town, Suffolk County, New York",2010,70894,74233,3339,6411,33147,35793,177810,4291,213603,133961,municipality,LI
1375,3610310000,36103,"Brookhaven town, Suffolk County, New York",2000,146828,155406,8578,12912,18196,36041,412207,7227,448248,373872,municipality,LI
1376,3610310000,36103,"Brookhaven town, Suffolk County, New York",2010,162884,175026,12142,18880,24428,60270,425770,8680,486040,373782,municipality,LI
1377,3610322194,36103,"East Hampton town, Suffolk County, New York",2000,8101,19640,11539,236,681,2914,16805,441,19719,15447,municipality,LI
1378,3610322194,36103,"East Hampton town, Suffolk County, New York",2010,8410,21038,12628,278,678,5660,15797,277,21457,14564,municipality,LI
1379,3610337000,36103,"Huntington town, Suffolk County, New York",2000,65917,67708,1791,6812,7934,12844,182445,2672,195289,165027,municipality,LI
1380,3610337000,36103,"Huntington town, Suffolk County, New York",2010,69311,71948,2637,10009,8933,22362,180902,3270,203264,158690,municipality,LI
1381,3610338000,36103,"Islip town, Suffolk County, New York",2000,98936,104278,5342,6872,26827,65031,257581,6079,322612,217803,municipality,LI
1382,3610338000,36103,"Islip town, Suffolk County, New York",2010,103631,110665,7034,9358,27898,97371,238172,5633,335543,195283,municipality,LI
1383,3610359106,36103,"Poospatuck Reservation, Suffolk County, New York",2000,93,100,7,0,35,13,258,219,271,4,municipality,LI
1384,3610359106,36103,"Poospatuck Reservation, Suffolk County, New York",2010,110,124,14,3,53,27,297,201,324,40,municipality,LI
1385,3610361984,36103,"Riverhead town, Suffolk County, New York",2000,10749,12479,1730,249,2862,1678,26002,398,27680,22493,municipality,LI
1386,3610361984,36103,"Riverhead town, Suffolk County, New York",2010,12990,15424,2434,367,2501,4649,28857,568,33506,25421,municipality,LI
1387,3610366839,36103,"Shelter Island town, Suffolk County, New York",2000,996,2370,1374,11,11,53,2175,30,2228,2123,municipality,LI
1388,3610366839,36103,"Shelter Island town, Suffolk County, New York",2010,1128,2754,1626,10,25,116,2276,42,2392,2199,municipality,LI
1389,3610367059,36103,"Shinnecock Reservation, Suffolk County, New York",2000,179,194,15,1,12,25,479,446,504,20,municipality,LI
1390,3610367059,36103,"Shinnecock Reservation, Suffolk County, New York",2010,226,256,30,3,29,42,620,555,662,33,municipality,LI
1391,3610368000,36103,"Smithtown town, Suffolk County, New York",2000,38487,39357,870,2743,689,3855,111860,891,115715,107537,municipality,LI
1392,3610368000,36103,"Smithtown town, Suffolk County, New York",2010,40055,41381,1326,4197,1122,6272,111529,1234,117801,104976,municipality,LI
1393,3610368473,36103,"Southampton town, Suffolk County, New York",2000,21504,35836,14332,454,3491,4700,50012,855,54712,45212,municipality,LI
1394,3610368473,36103,"Southampton town, Suffolk County, New York",2010,21193,41759,20566,618,2776,11295,45495,945,56790,41156,municipality,LI
1395,3610369463,36103,"Southold town, Suffolk County, New York",2000,8461,13769,5308,90,579,982,19617,261,20599,18687,municipality,LI
1396,3610369463,36103,"Southold town, Suffolk County, New York",2010,9090,15377,6287,161,527,2382,19586,275,21968,18623,municipality,LI
1397,3610506310,36105,"Bethel town, Sullivan County, New York",2000,1649,3641,1992,22,189,492,3870,49,4362,3610,municipality,MHV
1398,3610506310,36105,"Bethel town, Sullivan County, New York",2010,1733,3954,2221,36,139,485,3770,89,4255,3506,municipality,MHV
1399,3610511759,36105,"Callicoon town, Sullivan County, New York",2000,1222,1797,575,21,18,139,2913,35,3052,2839,municipality,MHV
1400,3610511759,36105,"Callicoon town, Sullivan County, New York",2010,1288,2003,715,51,34,126,2931,43,3057,2803,municipality,MHV
1401,3610516661,36105,"Cochecton town, Sullivan County, New York",2000,555,955,400,8,12,22,1306,18,1328,1268,municipality,MHV
1402,3610516661,36105,"Cochecton town, Sullivan County, New York",2010,604,1114,510,10,29,57,1315,10,1372,1266,municipality,MHV
1403,3610520104,36105,"Delaware town, Sullivan County, New York",2000,956,1337,381,22,253,172,2547,25,2719,2247,municipality,MHV
1404,3610520104,36105,"Delaware town, Sullivan County, New York",2010,996,1535,539,11,313,185,2485,31,2670,2130,municipality,MHV
1405,3610525241,36105,"Fallsburg town, Sullivan County, New York",2000,3761,6661,2900,139,1780,1777,10457,238,12234,8300,municipality,MHV
1406,3610525241,36105,"Fallsburg town, Sullivan County, New York",2010,4225,8497,4272,176,1654,2823,10047,353,12870,7864,municipality,MHV
1407,3610526528,36105,"Forestburgh town, Sullivan County, New York",2000,327,500,173,0,17,40,793,3,833,773,municipality,MHV
1408,3610526528,36105,"Forestburgh town, Sullivan County, New York",2010,355,550,195,7,35,36,783,22,819,719,municipality,MHV
1409,3610527573,36105,"Fremont town, Sullivan County, New York",2000,563,1182,619,13,22,17,1374,29,1391,1310,municipality,MHV
1410,3610527573,36105,"Fremont town, Sullivan County, New York",2010,607,1323,716,12,31,48,1333,34,1381,1256,municipality,MHV
1411,3610534473,36105,"Highland town, Sullivan County, New York",2000,951,1558,607,10,73,95,2309,31,2404,2195,municipality,MHV
1412,3610534473,36105,"Highland town, Sullivan County, New York",2010,1049,1766,717,22,81,148,2382,43,2530,2236,municipality,MHV
1413,3610542235,36105,"Liberty town, Sullivan County, New York",2000,3711,5350,1639,133,825,1050,8582,146,9632,7478,municipality,MHV
1414,3610542235,36105,"Liberty town, Sullivan County, New York",2010,3883,5495,1612,146,817,1862,8023,245,9885,6815,municipality,MHV
1415,3610543786,36105,"Lumberland town, Sullivan County, New York",2000,781,1419,638,16,4,37,1902,29,1939,1853,municipality,MHV
1416,3610543786,36105,"Lumberland town, Sullivan County, New York",2010,967,1630,663,23,34,126,2342,45,2468,2240,municipality,MHV
1417,3610544809,36105,"Mamakating town, Sullivan County, New York",2000,4153,5629,1476,112,215,525,10477,195,11002,9955,municipality,MHV
1418,3610544809,36105,"Mamakating town, Sullivan County, New York",2010,4738,6251,1513,135,390,1027,11058,272,12085,10261,municipality,MHV
1419,3610549847,36105,"Neversink town, Sullivan County, New York",2000,1346,1960,614,8,20,78,3475,56,3553,3391,municipality,MHV
1420,3610549847,36105,"Neversink town, Sullivan County, New York",2010,1464,2045,581,21,45,129,3428,56,3557,3306,municipality,MHV
1421,3610563176,36105,"Rockland town, Sullivan County, New York",2000,1560,2475,915,35,107,278,3635,52,3913,3441,municipality,MHV
1422,3610563176,36105,"Rockland town, Sullivan County, New York",2010,1596,2755,1159,50,92,322,3453,76,3775,3235,municipality,MHV
1423,3610573627,36105,"Thompson town, Sullivan County, New York",2000,5543,9258,3715,260,2268,2066,12123,262,14189,9333,municipality,MHV
1424,3610573627,36105,"Thompson town, Sullivan County, New York",2010,5982,9130,3148,319,2590,3102,12206,471,15308,8826,municipality,MHV
1425,3610575759,36105,"Tusten town, Sullivan County, New York",2000,583,1008,425,11,94,51,1364,27,1415,1232,municipality,MHV
1426,3610575759,36105,"Tusten town, Sullivan County, New York",2010,652,1138,486,14,65,78,1437,41,1515,1317,municipality,MHV
1427,3611120247,36111,"Denning town, Ulster County, New York",2000,215,517,302,1,0,8,508,20,516,487,municipality,MHV
1428,3611120247,36111,"Denning town, Ulster County, New York",2010,234,531,297,1,6,7,544,19,551,518,municipality,MHV
1429,3611124691,36111,"Esopus town, Ulster County, New York",2000,3439,3724,285,88,195,178,9153,148,9331,8722,municipality,MHV
1430,3611124691,36111,"Esopus town, Ulster County, New York",2010,3492,3969,477,125,395,487,8554,240,9041,7794,municipality,MHV
1431,3611128255,36111,"Gardiner town, Ulster County, New York",2000,1997,2255,258,39,81,240,4998,94,5238,4784,municipality,MHV
1432,3611128255,36111,"Gardiner town, Ulster County, New York",2010,2229,2610,381,60,78,381,5332,92,5713,5102,municipality,MHV
1433,3611132116,36111,"Hardenburgh town, Ulster County, New York",2000,95,275,180,5,1,2,206,2,208,198,municipality,MHV
1434,3611132116,36111,"Hardenburgh town, Ulster County, New York",2010,112,344,232,5,0,7,231,13,238,213,municipality,MHV
1435,3611137143,36111,"Hurley town, Ulster County, New York",2000,2694,2946,252,80,87,125,6439,72,6564,6200,municipality,MHV
1436,3611137143,36111,"Hurley town, Ulster County, New York",2010,2693,3069,376,91,96,181,6133,112,6314,5834,municipality,MHV
1437,3611139727,36111,"Kingston city, Ulster County, New York",2000,9871,10637,766,356,2820,1516,21940,688,23456,18076,municipality,MHV
1438,3611139727,36111,"Kingston city, Ulster County, New York",2010,10217,11147,930,426,3214,3203,20690,985,23893,16065,municipality,MHV
1439,3611139738,36111,"Kingston town, Ulster County, New York",2000,356,398,42,4,16,15,893,17,908,856,municipality,MHV
1440,3611139738,36111,"Kingston town, Ulster County, New York",2010,380,432,52,11,27,28,861,10,889,813,municipality,MHV
1441,3611142994,36111,"Lloyd town, Ulster County, New York",2000,3626,3818,192,117,484,504,9437,173,9941,8663,municipality,MHV
1442,3611142994,36111,"Lloyd town, Ulster County, New York",2010,4112,4419,307,309,658,793,10070,237,10863,8866,municipality,MHV
1443,3611145458,36111,"Marbletown town, Ulster County, New York",2000,2386,2846,460,41,75,121,5733,111,5854,5506,municipality,MHV
1444,3611145458,36111,"Marbletown town, Ulster County, New York",2010,2400,2989,589,68,81,155,5452,107,5607,5196,municipality,MHV
1445,3611145722,36111,"Marlborough town, Ulster County, New York",2000,3020,3176,156,27,224,329,7934,104,8263,7579,municipality,MHV
1446,3611145722,36111,"Marlborough town, Ulster County, New York",2010,3335,3644,309,77,334,769,8039,153,8808,7475,municipality,MHV
1447,3611150562,36111,"New Paltz town, Ulster County, New York",2000,4455,4679,224,514,709,1054,11776,407,12830,10146,municipality,MHV
1448,3611150562,36111,"New Paltz town, Ulster County, New York",2010,4515,4877,362,605,612,1233,12770,353,14003,11200,municipality,MHV
1449,3611154749,36111,"Olive town, Ulster County, New York",2000,1869,2306,437,42,24,115,4464,73,4579,4325,municipality,MHV
1450,3611154749,36111,"Olive town, Ulster County, New York",2010,1960,2498,538,57,53,139,4280,106,4419,4064,municipality,MHV
1451,3611158552,36111,"Plattekill town, Ulster County, New York",2000,3649,3888,239,62,406,1583,8309,194,9892,7647,municipality,MHV
1452,3611158552,36111,"Plattekill town, Ulster County, New York",2010,3861,4242,381,84,534,1934,8565,174,10499,7773,municipality,MHV
1453,3611163011,36111,"Rochester town, Ulster County, New York",2000,2688,3750,1062,32,152,339,6679,147,7018,6348,municipality,MHV
1454,3611163011,36111,"Rochester town, Ulster County, New York",2010,2936,4019,1083,64,151,410,6903,184,7313,6504,municipality,MHV
1455,3611163737,36111,"Rosendale town, Ulster County, New York",2000,2587,2857,270,28,111,167,6185,104,6352,5942,municipality,MHV
1456,3611163737,36111,"Rosendale town, Ulster County, New York",2010,2572,2897,325,46,100,304,5771,125,6075,5500,municipality,MHV
1457,3611165299,36111,"Saugerties town, Ulster County, New York",2000,7478,8257,779,152,771,916,18952,265,19868,17764,municipality,MHV
1458,3611165299,36111,"Saugerties town, Ulster County, New York",2010,8163,9106,943,198,309,979,18503,384,19482,17612,municipality,MHV
1459,3611166597,36111,"Shandaken town, Ulster County, New York",2000,1463,2666,1203,38,33,99,3136,80,3235,2985,municipality,MHV
1460,3611166597,36111,"Shandaken town, Ulster County, New York",2010,1505,2776,1271,47,28,153,2932,77,3085,2780,municipality,MHV
1461,3611166674,36111,"Shawangunk town, Ulster County, New York",2000,3433,3754,321,107,945,837,11185,158,12022,9975,municipality,MHV
1462,3611166674,36111,"Shawangunk town, Ulster County, New York",2010,3887,4333,446,222,1078,1310,13022,200,14332,11522,municipality,MHV
1463,3611175935,36111,"Ulster town, Ulster County, New York",2000,4850,5239,389,192,349,307,12237,202,12544,11494,municipality,MHV
1464,3611175935,36111,"Ulster town, Ulster County, New York",2010,4961,5368,407,269,359,662,11665,298,12327,10739,municipality,MHV
1465,3611178828,36111,"Wawarsing town, Ulster County, New York",2000,4382,5821,1439,147,1483,2326,10563,331,12889,8602,municipality,MHV
1466,3611178828,36111,"Wawarsing town, Ulster County, New York",2010,4509,6211,1702,180,1784,2538,10619,426,13157,8229,municipality,MHV
1467,3611183052,36111,"Woodstock town, Ulster County, New York",2000,2946,3847,901,97,78,160,6081,141,6241,5765,municipality,MHV
1468,3611183052,36111,"Woodstock town, Ulster County, New York",2010,2976,4157,1181,115,85,236,5648,148,5884,5300,municipality,MHV
1469,3611905320,36119,"Bedford town, Westchester County, New York",2000,5731,6020,289,358,1167,1372,16761,178,18133,15058,municipality,LHV
1470,3611905320,36119,"Bedford town, Westchester County, New York",2010,5765,6326,561,507,855,2104,15231,252,17335,13617,municipality,LHV
1471,3611918410,36119,"Cortlandt town, Westchester County, New York",2000,13517,14065,548,978,1672,2766,35701,581,38467,32470,municipality,LHV
1472,3611918410,36119,"Cortlandt town, Westchester County, New York",2010,14987,15962,975,1479,1994,5324,36268,819,41592,31976,municipality,LHV
1473,3611921820,36119,"Eastchester town, Westchester County, New York",2000,12626,13035,409,2135,825,1402,29916,455,31318,26501,municipality,LHV
1474,3611921820,36119,"Eastchester town, Westchester County, New York",2010,12946,13747,801,2355,967,2335,30028,540,32363,26166,municipality,LHV
1475,3611930367,36119,"Greenburgh town, Westchester County, New York",2000,33043,34084,1041,7587,10993,7825,78939,1909,86764,58450,municipality,LHV
1476,3611930367,36119,"Greenburgh town, Westchester County, New York",2010,33495,35452,1957,9155,10377,12366,76034,1963,88400,54539,municipality,LHV
1477,3611932413,36119,"Harrison town, Westchester County, New York",2000,8394,8680,286,1309,308,1618,22536,335,24154,20584,municipality,LHV
1478,3611932413,36119,"Harrison town, Westchester County, New York",2010,8375,8956,581,2062,563,3202,24270,512,27472,21133,municipality,LHV
1479,3611942136,36119,"Lewisboro town, Westchester County, New York",2000,4218,4465,247,257,144,306,12018,136,12324,11481,municipality,LHV
1480,3611942136,36119,"Lewisboro town, Westchester County, New York",2010,4453,4854,401,294,153,552,11859,225,12411,11187,municipality,LHV
1481,3611944842,36119,"Mamaroneck town, Westchester County, New York",2000,10929,11255,326,896,751,3164,25803,412,28967,23744,municipality,LHV
1482,3611944842,36119,"Mamaroneck town, Westchester County, New York",2010,10849,11562,713,1131,775,4524,24632,555,29156,22171,municipality,LHV
1483,3611948895,36119,"Mount Kisco town, Westchester County, New York",2000,3993,4103,110,421,551,2450,7533,174,9983,6387,municipality,LHV
1484,3611948895,36119,"Mount Kisco town, Westchester County, New York",2010,4102,4289,187,515,500,3818,7059,182,10877,5862,municipality,LHV
1485,3611949011,36119,"Mount Pleasant town, Westchester County, New York",2000,13737,13985,248,1401,1962,6057,37164,421,43221,33380,municipality,LHV
1486,3611949011,36119,"Mount Pleasant town, Westchester County, New York",2010,14306,14826,520,2093,2076,7859,35865,622,43724,31074,municipality,LHV
1487,3611949121,36119,"Mount Vernon city, Westchester County, New York",2000,25729,27048,1319,1433,39889,7083,61298,3299,68381,16677,municipality,LHV
1488,3611949121,36119,"Mount Vernon city, Westchester County, New York",2010,26260,28990,2730,1206,41226,9592,57700,2819,67292,12449,municipality,LHV
1489,3611950078,36119,"New Castle town, Westchester County, New York",2000,5732,5843,111,969,231,487,17004,179,17491,15625,municipality,LHV
1490,3611950078,36119,"New Castle town, Westchester County, New York",2010,5786,6037,251,1282,263,710,16859,301,17569,15013,municipality,LHV
1491,3611950617,36119,"New Rochelle city, Westchester County, New York",2000,26189,26995,806,2304,13389,14492,57690,1725,72182,40272,municipality,LHV
1492,3611950617,36119,"New Rochelle city, Westchester County, New York",2010,27953,29586,1633,3212,13956,21452,55610,1494,77062,36948,municipality,LHV
1493,3611951693,36119,"North Castle town, Westchester County, New York",2000,3583,3706,123,430,182,449,10400,106,10849,9682,municipality,LHV
1494,3611951693,36119,"North Castle town, Westchester County, New York",2010,3913,4135,222,586,179,906,10935,176,11841,9994,municipality,LHV
1495,3611953517,36119,"North Salem town, Westchester County, New York",2000,1764,1979,215,50,37,189,4984,101,5173,4796,municipality,LHV
1496,3611953517,36119,"North Salem town, Westchester County, New York",2010,1811,2082,271,84,60,382,4722,67,5104,4511,municipality,LHV
1497,3611955541,36119,"Ossining town, Westchester County, New York",2000,12355,12733,378,1637,4969,7282,29252,614,36534,22032,municipality,LHV
1498,3611955541,36119,"Ossining town, Westchester County, New York",2010,12706,13386,680,1834,4345,11403,26271,634,37674,19458,municipality,LHV
1499,3611956979,36119,"Peekskill city, Westchester County, New York",2000,8696,9053,357,529,5483,4920,17521,733,22441,10776,municipality,LHV
1500,3611956979,36119,"Peekskill city, Westchester County, New York",2010,9060,9709,649,682,5052,8713,14870,697,23583,8439,municipality,LHV
1501,3611957012,36119,"Pelham town, Westchester County, New York",2000,4149,4246,97,468,519,714,11152,253,11866,9912,municipality,LHV
1502,3611957012,36119,"Pelham town, Westchester County, New York",2010,4247,4483,236,642,729,1243,11153,325,12396,9457,municipality,LHV
1503,3611959685,36119,"Pound Ridge town, Westchester County, New York",2000,1699,1868,169,78,53,116,4610,56,4726,4423,municipality,LHV
1504,3611959685,36119,"Pound Ridge town, Westchester County, New York",2010,1844,2108,264,96,64,233,4871,96,5104,4615,municipality,LHV
1505,3611964309,36119,"Rye city, Westchester County, New York",2000,5377,5559,182,964,181,718,14237,185,14955,12907,municipality,LHV
1506,3611964309,36119,"Rye city, Westchester County, New York",2010,5520,5957,437,932,207,1014,14706,238,15720,13329,municipality,LHV
1507,3611964320,36119,"Rye town, Westchester County, New York",2000,15389,15813,424,1252,2069,14264,29616,891,43880,25404,municipality,LHV
1508,3611964320,36119,"Rye town, Westchester County, New York",2010,15469,16556,1087,1470,1884,19477,26451,803,45928,22294,municipality,LHV
1509,3611965442,36119,"Scarsdale town, Westchester County, New York",2000,5662,5795,133,2241,263,467,17356,258,17823,14594,municipality,LHV
1510,3611965442,36119,"Scarsdale town, Westchester County, New York",2010,5418,5647,229,2220,242,671,16495,385,17166,13648,municipality,LHV
1511,3611968308,36119,"Somers town, Westchester County, New York",2000,6802,7098,296,341,293,543,17803,163,18346,17006,municipality,LHV
1512,3611968308,36119,"Somers town, Westchester County, New York",2010,7623,7982,359,640,304,1010,19424,252,20434,18228,municipality,LHV
1513,3611981677,36119,"White Plains city, Westchester County, New York",2000,20921,21576,655,2371,8138,12476,40601,1349,53077,28743,municipality,LHV
1514,3611981677,36119,"White Plains city, Westchester County, New York",2010,22910,24382,1472,3587,7502,16839,40014,1120,56853,27805,municipality,LHV
1515,3611984000,36119,"Yonkers city, Westchester County, New York",2000,74351,77589,3238,9290,30164,50852,145234,6434,196086,99346,municipality,LHV
1516,3611984000,36119,"Yonkers city, Westchester County, New York",2010,74550,80389,5839,11370,31297,67927,128049,4219,195976,81163,municipality,LHV
1517,3611984077,36119,"Yorktown town, Westchester County, New York",2000,12556,12852,296,1242,994,2112,34206,444,36318,31526,municipality,LHV
1518,3611984077,36119,"Yorktown town, Westchester County, New York",2010,12884,13418,534,1689,1015,3376,32705,514,36081,29487,municipality,LHV
0,36005CS,36005,BX Central and South,2000,148853,158913,10060,15078,119031,236419,202201,13699,438620,54393,municipality,NYC
1,36005CS,36005,BX Central and South,2010,156721,165740,9019,22186,122382,265843,195443,10563,461286,40312,municipality,NYC
2,36005NE,36005,BX North and East,2000,94854,99908,5054,4473,117431,50118,198037,7796,248155,68337,municipality,NYC
3,36005NE,36005,BX North and East,2010,96791,102562,5771,5609,121515,68901,184473,6455,253374,50894,municipality,NYC
4,36005W,36005,BX West,2000,219505,231838,12333,19007,179876,358168,287707,17903,645875,70921,municipality,NYC
5,36005W,36005,BX West,2010,229937,243594,13657,19540,172798,406669,263779,11438,670448,60003,municipality,NYC
6,36047C,36047,BK Central,2000,201610,213139,11529,11348,413337,44928,530958,18242,575886,88031,municipality,NYC
7,36047C,36047,BK Central,2010,204464,218751,14287,13366,394809,49672,509846,13398,559518,88273,municipality,NYC
8,36047E,36047,BK East,2000,85177,92283,7106,6441,155780,81201,182446,10676,263647,9549,municipality,NYC
9,36047E,36047,BK East,2010,92886,100608,7722,9622,164346,84875,189244,8111,274119,7165,municipality,NYC
10,36047N,36047,BK North,2000,128716,140487,11771,9929,124682,153255,230607,14684,383862,81312,municipality,NYC
11,36047N,36047,BK North,2010,150039,165611,15572,15963,112659,147533,263514,7967,411047,126925,municipality,NYC
12,36047S,36047,BK Southern,2000,324145,336444,12299,116417,90150,94095,787906,32673,882001,548666,municipality,NYC
13,36047S,36047,BK Southern,2010,323559,357209,33650,160096,79237,114375,773686,15884,888061,518469,municipality,NYC
14,36047W,36047,BK West,2000,141079,148513,7434,40156,64634,114399,245531,13767,359930,126974,municipality,NYC
15,36047W,36047,BK West,2010,145908,158114,12206,61082,48015,99830,272125,10554,371955,152474,municipality,NYC
16,36061E,36061,MN East Side,2000,212494,232127,19633,29113,12356,23002,337502,7312,360504,288721,municipality,NYC
17,36061E,36061,MN East Side,2010,206971,234068,27097,40137,12266,26956,343974,8344,370930,283227,municipality,NYC
18,36061L,36061,MN Lower,2000,138123,146707,8584,76240,16247,52259,239687,8080,291946,139120,municipality,NYC
19,36061L,36061,MN Lower,2010,152412,166325,13913,78234,15539,50634,263637,8387,314271,161477,municipality,NYC
20,36061U,36061,MN Upper,2000,210107,226337,16230,15198,181739,294053,276238,13586,570291,65715,municipality,NYC
21,36061U,36061,MN Upper,2010,216933,233344,16411,23354,155467,278755,283361,12391,562116,92149,municipality,NYC
22,36061WM,36061,MN West Side and Midtown,2000,177920,192973,15053,22740,24356,48502,265952,8539,314454,210317,municipality,NYC
23,36061WM,36061,MN West Side and Midtown,2010,187530,213353,25823,35899,22068,47232,291324,8717,338556,224640,municipality,NYC
24,36081NE,36081,QN Northeast,2000,188358,194808,6450,154038,30795,75682,433469,19890,509151,228746,municipality,NYC
25,36081NE,36081,QN Northeast,2010,188278,199124,10846,216089,28051,79640,439557,14036,519197,181381,municipality,NYC
26,36081NW,36081,QN Northwest,2000,338979,350623,11644,164231,49575,334561,592309,39389,926870,339114,municipality,NYC
27,36081NW,36081,QN Northwest,2010,337909,362407,24498,189619,39603,362648,557243,21646,919891,306375,municipality,NYC
28,36081SE,36081,QN Southeast,2000,168275,180465,12190,31621,311244,68892,453267,29846,522159,80556,municipality,NYC
29,36081SE,36081,QN Southeast,2010,169682,183794,14112,49124,295216,84386,440799,27720,525185,68739,municipality,NYC
30,36081SW,36081,QN Southwest,2000,87052,91354,4302,39413,31217,77470,193729,38620,271199,84479,municipality,NYC
31,36081SW,36081,QN Southwest,2010,84248,89802,5554,53502,33011,87076,179373,32628,266449,60232,municipality,NYC
32,36085C,36085,SI Central,2000,45882,47705,1823,11286,3198,12406,115771,2522,128177,98765,municipality,NYC
33,36085C,36085,SI Central,2010,47772,50814,3042,14989,4027,17665,115456,2386,133121,94054,municipality,NYC
34,36085N,36085,SI North,2000,57306,60986,3680,8496,35189,32192,130417,5468,162609,81264,municipality,NYC
35,36085N,36085,SI North,2010,60652,65422,4770,13111,38620,50055,125701,4445,175756,69525,municipality,NYC
36,36085S,36085,SI South,2000,53153,55302,2149,5004,1317,8952,143990,1382,152942,136287,municipality,NYC
37,36085S,36085,SI South,2010,57092,60420,3328,6597,1666,13331,146522,1669,159853,136590,municipality,NYC
