,STATE,COUNTY,GEOCODE,SUMLEV,POP100,HU100,P0010001,P0020001,P0020002,P0020003,P0020004,P0020005,P0020006,P0020007,P0020008,P0020009,P0020010,P0020011,H0010001,H0010002,H0010003,NAME
10,9,1.0,0900104720,60,20358,7980,20358,20358,2622,17736,16613,14409,565,19,1213,1,406,1123,7980,7653,327,Bethel town
11,9,1.0,0900108070,60,148654,58874,148654,148654,62853,85801,80315,24404,48690,228,4024,31,2938,5486,58874,54261,4613,Bridgeport town
12,9,1.0,0900108980,60,17528,7116,17528,17528,1470,16058,15223,13785,299,11,946,3,179,835,7116,6695,421,Brookfield town
13,9,1.0,0900118500,60,86518,33562,86518,86518,28690,57828,52007,37963,5630,70,5339,25,2980,5821,33562,31762,1800,Danbury town
14,9,1.0,0900118850,60,21499,7265,21499,21499,1234,20265,19470,18016,148,17,1197,4,88,795,7265,6814,451,Darien town
15,9,1.0,0900123890,60,7605,2756,7605,7605,444,7161,6883,6408,106,6,328,1,34,278,2756,2605,151,Easton town
16,9,1.0,0900126620,60,61512,21982,61512,61512,4806,56706,54497,50035,1110,23,2906,5,418,2209,21982,20820,1162,Fairfield town
17,9,1.0,0900133620,60,63518,25677,63518,63518,8135,55383,52414,45877,1157,33,4726,15,606,2969,25677,23316,2361,Greenwich town
18,9,1.0,0900148620,60,18825,6918,18825,18825,1470,17355,16717,15548,400,20,660,0,89,638,6918,6690,228,Monroe town
19,9,1.0,0900150580,60,20622,7502,20622,20622,1121,19501,18670,17169,244,6,1159,4,88,831,7502,6923,579,New Canaan town
20,9,1.0,0900150860,60,13579,5635,13579,13579,1201,12378,11933,11438,153,11,230,3,98,445,5635,4948,687,New Fairfield town
21,9,1.0,0900152980,60,27173,10322,27173,27173,1757,25416,24434,22950,592,12,734,10,136,982,10322,9766,556,Newtown town
22,9,1.0,0900156060,60,91184,38152,91184,91184,27629,63555,60928,44314,11074,102,4772,14,652,2627,38152,36078,2074,Norwalk town
23,9,1.0,0900163480,60,8765,3664,8765,8765,465,8300,7970,7580,75,11,243,2,59,330,3664,3356,308,Redding town
24,9,1.0,0900163970,60,25033,9506,25033,25033,1506,23527,22612,20956,214,22,1261,3,156,915,9506,8968,538,Ridgefield town
25,9,1.0,0900168170,60,40869,17174,40869,40869,4080,36789,35641,31701,1812,30,1800,11,287,1148,17174,16356,818,Shelton town
26,9,1.0,0900168310,60,3527,1834,3527,3527,159,3368,3232,3149,25,1,51,0,6,136,1834,1425,409,Sherman town
27,9,1.0,0900173070,60,135470,56953,135470,135470,37958,97512,93710,64876,16201,140,11453,22,1018,3802,56953,53241,3712,Stamford town
28,9,1.0,0900174190,60,52355,21643,52355,52355,11107,41248,39329,28407,9136,53,1310,11,412,1919,21643,20435,1208,Stratford town
29,9,1.0,0900177200,60,36827,13159,36827,36827,3505,33322,32103,27652,1642,22,2509,1,277,1219,13159,12622,537,Trumbull town
30,9,1.0,0900183430,60,10354,3671,10354,10354,631,9723,9242,8443,143,3,575,3,75,481,3671,3420,251,Weston town
31,9,1.0,0900183500,60,27141,10567,27141,27141,1592,25549,24414,22169,375,15,1703,0,152,1135,10567,9720,847,Westport town
32,9,1.0,0900186370,60,18503,6567,18503,18503,916,17587,16774,14876,201,3,1612,4,78,813,6567,6210,357,Wilton town
62,9,5.0,0900502760,60,3647,1566,3647,3647,84,3563,3436,3382,11,1,26,0,16,127,1566,1457,109,Barkhamsted town
63,9,5.0,0900504930,60,3385,1605,3385,3385,104,3281,3173,3104,31,4,22,0,12,108,1605,1398,207,Bethlehem town
64,9,5.0,0900508210,60,1662,863,1662,1662,41,1621,1553,1520,14,1,10,0,8,68,863,728,135,Bridgewater town
65,9,5.0,0900510940,60,1080,639,1080,1080,56,1024,1001,975,15,3,1,0,7,23,639,480,159,Canaan town
66,9,5.0,0900516050,60,1361,694,1361,1361,31,1330,1275,1257,5,1,4,0,8,55,694,584,110,Colebrook town
67,9,5.0,0900517240,60,1567,1002,1567,1567,61,1506,1467,1433,4,1,24,0,5,39,1002,732,270,Cornwall town
68,9,5.0,0900532290,60,3150,1708,3150,3150,120,3030,2924,2869,16,2,32,0,5,106,1708,1285,423,Goshen town
69,9,5.0,0900537280,60,5484,2313,5484,5484,172,5312,5132,5045,35,8,31,0,13,180,2313,2179,134,Harwinton town
70,9,5.0,0900540290,60,3019,1687,3019,3019,156,2863,2733,2586,31,21,85,0,10,130,1687,1285,402,Kent town
71,9,5.0,0900543370,60,8192,3966,8192,8192,276,7916,7653,7463,51,13,114,0,12,263,3966,3467,499,Litchfield town
72,9,5.0,0900549460,60,2256,1253,2256,2256,67,2189,2125,2093,12,0,14,0,6,64,1253,933,320,Morris town
73,9,5.0,0900551350,60,6658,2968,6658,6658,177,6481,6238,6105,18,6,75,3,31,243,2968,2681,287,New Hartford town
74,9,5.0,0900552630,60,28115,11928,28115,28115,3241,24874,23432,21515,639,32,958,6,282,1442,11928,10994,934,New Milford town
75,9,5.0,0900553470,60,1588,932,1588,1588,48,1540,1481,1449,8,4,18,0,2,59,932,715,217,Norfolk town
76,9,5.0,0900554030,60,3211,1582,3211,3211,266,2945,2814,2747,36,6,15,0,10,131,1582,1399,183,North Canaan town
77,9,5.0,0900560750,60,11671,5151,11671,11671,739,10932,10388,10057,141,16,145,9,20,544,5151,4856,295,Plymouth town
78,9,5.0,0900565930,60,2260,1163,2260,2260,70,2190,2102,2053,9,2,29,0,9,88,1163,979,184,Roxbury town
79,9,5.0,0900566420,60,4194,2519,4194,4194,197,3997,3845,3643,80,8,78,1,35,152,2519,1717,802,Salisbury town
80,9,5.0,0900567960,60,2680,1724,2680,2680,98,2582,2499,2390,35,1,44,0,29,83,1724,1238,486,Sharon town
81,9,5.0,0900575730,60,7442,3340,7442,7442,340,7102,6826,6637,58,9,91,1,30,276,3340,3145,195,Thomaston town
82,9,5.0,0900576570,60,35515,17040,35515,35515,5433,30082,28485,26308,1060,64,891,15,147,1597,17040,15490,1550,Torrington town
83,9,5.0,0900579510,60,1351,790,1351,1351,56,1295,1238,1211,1,6,14,0,6,57,790,580,210,Warren town
84,9,5.0,0900579720,60,3646,2056,3646,3646,219,3427,3319,3217,24,5,49,0,24,108,2056,1526,530,Washington town
85,9,5.0,0900580490,60,22105,9137,22105,22105,1390,20715,20064,19121,399,21,399,10,114,651,9137,8742,395,Watertown town
86,9,5.0,0900586440,60,10224,5405,10224,10224,684,9540,9117,8812,116,15,124,12,38,423,5405,4661,744,Winchester town
87,9,5.0,0900587910,60,9723,4584,9723,9723,454,9269,8934,8609,108,18,141,6,52,335,4584,4251,333,Woodbury town
104,9,9.0,0900900000,60,0,0,0,0,0,0,0,0,0,0,0,0,0,0,0,0,0,County subdivisions not defined
105,9,9.0,0900901220,60,18918,8104,18918,18918,4493,14425,13685,10688,2474,27,382,1,113,740,8104,7570,534,Ansonia town
106,9,9.0,0900903250,60,6000,2618,6000,6000,413,5587,5386,5126,124,9,84,0,43,201,2618,2485,133,Beacon Falls town
107,9,9.0,0900904580,60,5297,2039,5297,5297,182,5115,4938,4561,101,3,248,0,25,177,2039,1948,91,Bethany town
108,9,9.0,0900907310,60,28273,14180,28273,28273,1862,26411,25564,23427,654,25,1311,10,137,847,14180,13069,1111,Branford town
109,9,9.0,0900914160,60,28733,10401,28733,28733,1818,26915,26015,22882,1226,16,1788,2,101,900,10401,10041,360,Cheshire town
110,9,9.0,0900919550,60,12325,5759,12325,12325,2544,9781,9391,7595,1373,20,336,3,64,390,5759,5408,351,Derby town
111,9,9.0,0900922910,60,27923,12394,27923,27923,5054,22869,22125,19656,1262,26,1066,3,112,744,12394,11635,759,East Haven town
112,9,9.0,0900934950,60,22073,9693,22073,22073,1135,20938,20142,19085,202,10,781,2,62,796,9693,8813,880,Guilford town
113,9,9.0,0900935650,60,61169,25984,61169,61169,7836,53333,51170,32384,14834,178,3447,25,302,2163,25984,23988,1996,Hamden town
114,9,9.0,0900944560,60,17691,8060,17691,17691,641,17050,16477,15705,127,20,562,0,63,573,8060,6987,1073,Madison town
115,9,9.0,0900946520,60,60850,26177,60850,60850,22295,38555,36384,29104,5565,67,1311,25,312,2171,26177,24346,1831,Meriden town
116,9,9.0,0900946940,60,7574,3047,7574,7574,332,7242,7038,6560,67,0,377,3,31,204,3047,2859,188,Middlebury town
117,9,9.0,0900947535,60,52044,23749,52044,52044,4111,47933,46122,41417,1531,51,2840,17,266,1811,23749,22338,1411,Milford town
118,9,9.0,0900949950,60,31519,13239,31519,31519,4871,26648,24909,21366,2195,31,749,7,561,1739,13239,12432,807,Naugatuck town
119,9,9.0,0900952070,60,134023,57525,134023,134023,41068,92955,88115,37010,40788,339,9044,61,873,4840,57525,52263,5262,New Haven town
120,9,9.0,0900953890,60,13544,5633,13544,13544,670,12874,12556,12137,145,7,234,0,33,318,5633,5323,310,North Branford town
121,9,9.0,0900954870,60,24253,9981,24253,24253,1490,22763,22124,19631,889,23,1468,8,105,639,9981,9546,435,North Haven town
122,9,9.0,0900957600,60,14280,5480,14280,14280,715,13565,13112,11326,259,11,1458,1,57,453,5480,5282,198,Orange town
123,9,9.0,0900958300,60,12706,5022,12706,12706,681,12025,11657,11254,128,7,218,4,46,368,5022,4774,248,Oxford town
124,9,9.0,0900962290,60,9401,3762,9401,9401,426,8975,8676,8331,206,10,94,2,33,299,3762,3627,135,Prospect town
125,9,9.0,0900967610,60,16748,7112,16748,16748,1752,14996,14479,13298,668,13,421,5,74,517,7112,6779,333,Seymour town
126,9,9.0,0900969640,60,19879,9270,19879,19879,830,19049,18477,17625,200,6,556,2,88,572,9270,8587,683,Southbury town
127,9,9.0,0900978740,60,44396,18938,44396,44396,4770,39626,38283,35397,842,57,1809,18,160,1343,18938,18104,834,Wallingford town
128,9,9.0,0900980070,60,114403,48392,114403,114403,45281,69122,64515,37760,22269,307,2349,32,1798,4607,48392,44425,3967,Waterbury town
129,9,9.0,0900982870,60,55584,22735,55584,55584,13177,42407,40531,25960,11485,118,2609,10,349,1876,22735,21409,1326,West Haven town
130,9,9.0,0900987560,60,16142,6408,16142,16142,1087,15055,14525,13778,395,27,250,3,72,530,6408,6141,267,Wolcott town
131,9,9.0,0900987700,60,9087,3476,9087,9087,547,8540,8173,6625,264,5,1203,3,73,367,3476,3258,218,Woodbridge town
106,36,5.0,3600508510,60,1472654,547030,1472654,1472654,806463,666191,637821,130796,419393,3087,67766,457,16322,28370,547030,522450,24580,Bronx borough
321,36,27.0,3602701693,60,3769,1962,3769,3769,425,3344,3164,2974,87,16,70,0,17,180,1962,1622,340,Amenia town
322,36,27.0,3602705100,60,13769,6262,13769,13769,2686,11083,10396,8204,1741,12,290,11,138,687,6262,5780,482,Beacon city
323,36,27.0,3602705452,60,14172,4874,14172,14172,1881,12291,11860,9952,1485,17,356,3,47,431,4874,4409,465,Beekman town
324,36,27.0,3602716408,60,4037,1901,4037,4037,196,3841,3666,3521,75,3,56,1,10,175,1901,1593,308,Clinton town
325,36,27.0,3602720819,60,8415,3505,8415,8415,1638,6777,6418,5736,372,8,266,0,36,359,3505,3182,323,Dover town
326,36,27.0,3602721996,60,29707,10829,29707,29707,3679,26028,25002,22403,1130,29,1254,2,184,1026,10829,10206,623,East Fishkill town
327,36,27.0,3602725978,60,24226,9521,24226,24226,3822,20404,19655,15138,3160,46,1180,5,126,749,9521,9039,482,Fishkill town
328,36,27.0,3602737209,60,21021,8433,21021,21021,1989,19032,17957,15405,1594,35,810,1,112,1075,8433,7921,512,Hyde Park town
329,36,27.0,3602740299,60,15975,5897,15975,15975,1783,14192,13522,11852,842,16,707,4,101,670,5897,5617,280,LaGrange town
330,36,27.0,3602747207,60,2245,1202,2245,2245,131,2114,1994,1912,32,6,30,0,14,120,1202,957,245,Milan town
331,36,27.0,3602751891,60,2971,1543,2971,2971,419,2552,2431,2318,48,2,53,1,9,121,1543,1223,320,North East town
332,36,27.0,3602756825,60,8012,3518,8012,8012,1178,6834,6588,6196,201,12,133,3,43,246,3518,3117,401,Pawling town
333,36,27.0,3602758156,60,2218,1175,2218,2218,126,2092,1980,1921,18,4,30,1,6,112,1175,946,229,Pine Plains town
334,36,27.0,3602758695,60,9799,4151,9799,9799,866,8933,8474,7817,384,6,184,3,80,459,4151,3921,230,Pleasant Valley town
335,36,27.0,3602759641,60,31577,14604,31577,31577,7105,24472,22813,10853,11165,64,505,12,214,1659,14604,13139,1465,Poughkeepsie city
336,36,27.0,3602759652,60,45471,16878,45471,45471,6794,38677,36864,28406,5115,41,2802,7,493,1813,16878,15857,1021,Poughkeepsie town
337,36,27.0,3602760905,60,9953,4415,9953,9953,733,9220,8872,8381,148,10,299,2,32,348,4415,3926,489,Red Hook town
338,36,27.0,3602761357,60,7596,3787,7596,7596,506,7090,6806,6510,97,5,154,0,40,284,3787,3320,467,Rhinebeck town
339,36,27.0,3602770662,60,3682,1859,3682,3682,277,3405,3276,3073,135,5,43,0,20,129,1859,1494,365,Stanford town
340,36,27.0,3602776166,60,4558,1766,4558,4558,312,4246,4104,3926,74,3,78,2,21,142,1766,1587,179,Union Vale town
341,36,27.0,3602778157,60,28216,11657,28216,28216,5228,22988,21965,18331,2120,39,1270,9,196,1023,11657,11183,474,Wappinger town
342,36,27.0,3602778388,60,4522,2270,4522,4522,450,4072,3859,3666,103,8,65,0,17,213,2270,1888,382,Washington town
506,36,47.0,3604710022,60,2736074,1077654,2736074,2736074,516426,2219648,2106478,968427,729696,3964,370776,718,32897,113170,1077654,1009804,67850,Brooklyn borough
590,36,59.0,3605929113,60,28365,10793,28365,28365,9752,18613,18055,14775,1595,58,1449,2,176,558,10793,10099,694,Glen Cove city
591,36,59.0,3605934000,60,793409,260524,793409,793409,174883,618526,597414,402466,125839,1139,59525,172,8273,21112,260524,250261,10263,Hempstead town
592,36,59.0,3605943335,60,35029,16771,35029,35029,5370,29659,28794,25531,1820,42,1107,21,273,865,16771,15360,1411,Long Beach city
593,36,59.0,3605953000,60,237639,83729,237639,237639,35083,202556,196132,128168,11312,253,54700,50,1649,6424,83729,79546,4183,North Hempstead town
594,36,59.0,3605956000,60,301332,104915,301332,301332,31337,269995,263226,208514,6650,222,46384,47,1409,6769,104915,100216,4699,Oyster Bay town
595,36,61.0,3606144919,60,1694251,913926,1694251,1694251,402640,1291611,1228622,793294,199592,1895,219624,882,13335,62989,913926,817782,96144,Manhattan borough
681,36,71.0,3607107003,60,18811,6944,18811,18811,3913,14898,14228,11981,1387,73,401,4,382,670,6944,6253,691,Blooming Grove town
682,36,71.0,3607115308,60,12646,4590,12646,12646,2446,10200,9743,8065,1058,15,498,2,105,457,4590,4356,234,Chester town
683,36,71.0,3607118300,60,12884,5240,12884,12884,1664,11220,10699,9761,414,17,408,3,96,521,5240,4923,317,Cornwall town
684,36,71.0,3607118916,60,9130,3549,9130,9130,1370,7760,7402,6847,346,11,138,1,59,358,3549,3339,210,Crawford town
685,36,71.0,3607119961,60,7509,3319,7509,7509,657,6852,6457,5851,211,22,328,3,42,395,3319,2954,365,Deerpark town
686,36,71.0,3607129553,60,14571,5226,14571,14571,3133,11438,11061,9604,888,29,473,1,66,377,5226,4832,394,Goshen town
687,36,71.0,3607130631,60,4689,1725,4689,4689,626,4063,3903,3652,144,7,54,0,46,160,1725,1613,112,Greenville town
688,36,71.0,3607131907,60,5489,1877,5489,5489,797,4692,4503,4086,175,4,203,0,35,189,1877,1778,99,Hamptonburgh town
689,36,71.0,3607134550,60,12939,3554,12939,12939,2066,10873,10319,8235,1333,59,598,28,66,554,3554,3156,398,Highlands town
690,36,71.0,3607147042,60,30345,11980,30345,30345,13243,17102,16019,8236,6304,73,1130,3,273,1083,11980,11011,969,Middletown city
691,36,71.0,3607147713,60,4621,1659,4621,4621,618,4003,3866,3657,127,5,45,0,32,137,1659,1579,80,Minisink town
692,36,71.0,3607147999,60,21387,7421,21387,21387,5342,16045,15358,12274,1531,12,1186,4,351,687,7421,7016,405,Monroe town
693,36,71.0,3607148153,60,23322,8920,23322,23322,4320,19002,18032,15797,1663,37,389,5,141,970,8920,8367,553,Montgomery town
694,36,71.0,3607148857,60,6537,2059,6537,6537,1143,5394,5208,4079,756,17,298,0,58,186,2059,1869,190,Mount Hope town
695,36,71.0,3607150034,60,28856,11099,28856,28856,15085,13771,12885,4833,7545,55,246,8,198,886,11099,9771,1328,Newburgh city
696,36,71.0,3607150045,60,31985,12406,31985,31985,7066,24919,23734,18410,4095,55,929,3,242,1185,12406,11745,661,Newburgh town
697,36,71.0,3607150848,60,27805,11156,27805,27805,7100,20705,19735,14468,3969,40,1059,15,184,970,11156,10500,656,New Windsor town
698,36,71.0,3607156185,60,32954,6207,32954,32954,465,32489,31817,23184,57,17,13,12,8534,672,6207,5837,370,Palm Tree town
699,36,71.0,3607159388,60,8775,3992,8775,8775,1311,7464,6914,5843,727,33,181,1,129,550,3992,3542,450,Port Jervis city
700,36,71.0,3607175781,60,3811,1660,3811,3811,466,3345,3230,2831,182,0,191,0,26,115,1660,1441,219,Tuxedo town
701,36,71.0,3607177992,60,30486,12047,30486,30486,8492,21994,20870,13464,5709,101,1289,8,299,1124,12047,11371,676,Wallkill town
702,36,71.0,3607178366,60,32027,13315,32027,32027,4429,27598,26561,24413,1268,56,622,3,199,1037,13315,12115,1200,Warwick town
703,36,71.0,3607178839,60,7534,2758,7534,7534,1335,6199,5968,5272,451,6,190,0,49,231,2758,2593,165,Wawayanda town
704,36,71.0,3607182755,60,12197,4176,12197,12197,2657,9540,9212,7005,1001,10,796,0,400,328,4176,3785,391,Woodbury town
766,36,79.0,3607912529,60,33576,12578,33576,33576,5301,28275,27480,25831,752,20,698,0,179,795,12578,11897,681,Carmel town
767,36,79.0,3607939331,60,12900,5429,12900,12900,2818,10082,9692,8963,359,18,270,0,82,390,5429,4866,563,Kent town
768,36,79.0,3607956748,60,11541,4101,11541,11541,2557,8984,8645,7872,447,13,253,2,58,339,4101,3786,315,Patterson town
769,36,79.0,3607957584,60,9831,4325,9831,9831,916,8915,8505,8087,150,7,208,1,52,410,4325,3847,478,Philipstown town
770,36,79.0,3607960147,60,11762,4817,11762,11762,1852,9910,9488,8859,292,10,251,5,71,422,4817,4237,580,Putnam Valley town
771,36,79.0,3607968924,60,18058,7058,18058,18058,4316,13742,13356,12330,425,12,466,4,119,386,7058,6696,362,Southeast town
772,36,81.0,3608160323,60,2405464,896333,2405464,2405464,667861,1737603,1653491,549358,381375,9576,656583,1110,55489,84112,896333,847210,49123,Queens borough
789,36,85.0,3608570915,60,495747,183692,495747,495747,96960,398787,387469,277981,46835,624,58753,135,3141,11318,183692,173202,10490,Staten Island borough
790,36,87.0,3608715968,60,86855,30629,86855,86855,16275,70580,68409,49281,8298,66,10152,10,602,2171,30629,29489,1140,Clarkstown town
791,36,87.0,3608732765,60,39087,13178,39087,39087,18556,20531,19790,12340,5434,37,1713,7,259,741,13178,12646,532,Haverstraw town
792,36,87.0,3608755211,60,48655,18986,48655,48655,6428,42227,40830,34462,2577,27,3480,4,280,1397,18986,17945,1041,Orangetown town
793,36,87.0,3608760510,60,148919,39869,148919,148919,21984,126935,123940,100337,16555,245,4563,19,2221,2995,39869,37722,2147,Ramapo town
794,36,87.0,3608771674,60,14813,5406,14813,14813,3208,11605,11209,9693,911,15,505,2,83,396,5406,5146,260,Stony Point town
924,36,103.0,3610304000,60,218223,75270,218223,218223,52142,166081,160237,114931,33874,428,9329,20,1655,5844,75270,71907,3363,Babylon town
925,36,103.0,3610310000,60,485773,178581,485773,485773,83528,402245,386917,329999,30287,814,23108,97,2612,15328,178581,167187,11394,Brookhaven town
926,36,103.0,3610322194,60,28385,21163,28385,28385,7531,20854,20106,18607,770,57,474,12,186,748,21163,11118,10045,East Hampton town
927,36,103.0,3610337000,60,204127,73073,204127,204127,31403,172724,167499,143950,8667,147,13598,27,1110,5225,73073,70014,3059,Huntington town
928,36,103.0,3610338000,60,339938,111346,339938,339938,118903,221035,213728,172617,26931,455,11001,58,2666,7307,111346,105002,6344,Islip town
929,36,103.0,3610359106,60,436,159,436,436,87,349,304,34,55,215,0,0,0,45,159,150,9,Poospatuck Reservation
930,36,103.0,3610361984,60,35902,16310,35902,35902,8262,27640,26742,23881,2193,53,436,5,174,898,16310,13879,2431,Riverhead town
931,36,103.0,3610366839,60,3253,2731,3253,3253,289,2964,2849,2777,21,0,46,0,5,115,2731,1481,1250,Shelter Island town
932,36,103.0,3610367059,60,819,349,819,819,47,772,744,28,30,684,2,0,0,28,349,300,49,Shinnecock Reservation
933,36,103.0,3610368000,60,116296,41415,116296,116296,9979,106317,103561,95702,1662,58,5585,6,548,2756,41415,40018,1397,Smithtown town
934,36,103.0,3610368473,60,69036,42770,69036,69036,17178,51858,50186,46104,2293,170,1185,9,425,1672,42770,25806,16964,Southampton town
935,36,103.0,3610369463,60,23732,15773,23732,23732,3610,20122,19566,18700,485,21,255,7,98,556,15773,10010,5763,Southold town
936,36,105.0,3610506310,60,3959,3703,3959,3959,503,3456,3312,3152,94,4,32,3,27,144,3703,1766,1937,Bethel town
937,36,105.0,3610511759,60,2989,1852,2989,2989,232,2757,2642,2534,31,6,63,0,8,115,1852,1280,572,Callicoon town
938,36,105.0,3610516661,60,1448,1042,1448,1448,80,1368,1310,1272,22,0,9,0,7,58,1042,653,389,Cochecton town
939,36,105.0,3610520104,60,2203,1458,2203,2203,171,2032,1956,1779,140,1,22,0,14,76,1458,927,531,Delaware town
940,36,105.0,3610525241,60,14192,8830,14192,14192,3845,10347,9887,7586,1811,25,306,2,157,460,8830,4148,4682,Fallsburg town
941,36,105.0,3610526528,60,808,552,808,808,38,770,740,695,18,0,23,1,3,30,552,347,205,Forestburgh town
942,36,105.0,3610527573,60,1161,1197,1161,1161,72,1089,1057,1014,20,10,10,0,3,32,1197,537,660,Fremont town
943,36,105.0,3610534473,60,2196,1722,2196,2196,144,2052,1974,1918,27,4,17,0,8,78,1722,1004,718,Highland town
944,36,105.0,3610542235,60,10159,5450,10159,10159,2789,7370,6853,5912,685,32,173,0,51,517,5450,3916,1534,Liberty town
945,36,105.0,3610543786,60,2243,1547,2243,2243,201,2042,1924,1844,32,10,31,0,7,118,1547,911,636,Lumberland town
946,36,105.0,3610544809,60,12655,6157,12655,12655,1573,11082,10374,9633,428,33,189,1,90,708,6157,4731,1426,Mamakating town
947,36,105.0,3610549847,60,3366,2020,3366,3366,222,3144,3027,2927,43,5,41,0,11,117,2020,1411,609,Neversink town
948,36,105.0,3610563176,60,3290,2432,3290,3290,322,2968,2809,2683,49,5,54,0,18,159,2432,1420,1012,Rockland town
949,36,105.0,3610573627,60,16550,10023,16550,16550,3719,12831,11987,8545,2638,36,572,3,193,844,10023,6478,3545,Thompson town
950,36,105.0,3610575759,60,1405,1140,1405,1405,96,1309,1263,1197,31,3,27,0,5,46,1140,654,486,Tusten town
970,36,111.0,3611120247,60,493,501,493,493,30,463,423,400,12,6,3,0,2,40,501,219,282,Denning town
971,36,111.0,3611124691,60,9548,4089,9548,9548,603,8945,8472,7914,401,3,111,0,43,473,4089,3668,421,Esopus town
972,36,111.0,3611128255,60,5610,2672,5610,5610,452,5158,4875,4657,83,3,96,0,36,283,2672,2302,370,Gardiner town
973,36,111.0,3611132116,60,221,301,221,221,14,207,206,192,1,0,13,0,0,1,301,101,200,Hardenburgh town
974,36,111.0,3611137143,60,6178,3079,6178,6178,356,5822,5565,5287,107,37,114,1,19,257,3079,2718,361,Hurley town
975,36,111.0,3611139727,60,24069,11571,24069,24069,4107,19962,18402,14623,2956,34,630,3,156,1560,11571,10407,1164,Kingston city
976,36,111.0,3611139738,60,933,477,933,933,64,869,824,796,10,2,9,0,7,45,477,422,55,Kingston town
977,36,111.0,3611142994,60,11133,4785,11133,11133,1157,9976,9523,8429,681,14,324,11,64,453,4785,4438,347,Lloyd town
978,36,111.0,3611145458,60,5658,3080,5658,5658,310,5348,5093,4871,66,9,112,0,35,255,3080,2503,577,Marbletown town
979,36,111.0,3611145722,60,8712,3794,8712,8712,1022,7690,7392,6764,494,4,99,0,31,298,3794,3426,368,Marlborough town
980,36,111.0,3611150562,60,14407,5358,14407,14407,1835,12572,12030,10246,751,20,775,9,229,542,5358,4906,452,New Paltz town
981,36,111.0,3611154749,60,4226,2564,4226,4226,248,3978,3786,3640,47,6,59,1,33,192,2564,1923,641,Olive town
982,36,111.0,3611158552,60,10424,4412,10424,10424,2055,8369,7879,7167,521,16,87,5,83,490,4412,4032,380,Plattekill town
983,36,111.0,3611163011,60,7272,4062,7272,7272,495,6777,6415,6118,130,10,107,2,48,362,4062,3046,1016,Rochester town
984,36,111.0,3611163737,60,5782,2931,5782,5782,361,5421,5146,4913,111,0,72,4,46,275,2931,2570,361,Rosendale town
985,36,111.0,3611165299,60,19038,9370,19038,19038,1468,17570,16672,15912,386,19,280,2,73,898,9370,8300,1070,Saugerties town
986,36,111.0,3611166597,60,2866,2482,2866,2866,230,2636,2492,2356,36,5,51,1,43,144,2482,1419,1063,Shandaken town
987,36,111.0,3611166674,60,13563,4418,13563,13563,1863,11700,11272,9937,1082,23,165,2,63,428,4418,4053,365,Shawangunk town
988,36,111.0,3611175935,60,12660,5714,12660,12660,1176,11484,10862,9847,592,26,320,2,75,622,5714,5229,485,Ulster town
989,36,111.0,3611178828,60,12771,5943,12771,12771,2925,9846,9207,7301,1569,53,193,2,89,639,5943,4504,1439,Wawarsing town
990,36,111.0,3611183052,60,6287,4250,6287,6287,348,5939,5658,5325,116,16,158,0,43,281,4250,3135,1115,Woodstock town
1036,36,119.0,3611905320,60,17309,6314,17309,17309,2910,14399,13866,12424,726,19,589,0,108,533,6314,5758,556,Bedford town
1037,36,119.0,3611918410,60,42545,16229,42545,42545,8547,33998,32436,27941,2494,45,1679,4,273,1562,16229,15288,941,Cortlandt town
1038,36,119.0,3611921820,60,34641,14410,34641,34641,3117,31524,30302,25852,1036,6,3200,2,206,1222,14410,13595,815,Eastchester town
1039,36,119.0,3611930367,60,95397,37565,95397,95397,16821,78576,74906,52300,10141,83,11602,9,771,3670,37565,35776,1789,Greenburgh town
1040,36,119.0,3611932413,60,28218,9274,28218,28218,4402,23816,22952,18780,745,10,3231,4,182,864,9274,8747,527,Harrison town
1041,36,119.0,3611942136,60,12265,4867,12265,12265,969,11296,10812,10107,191,8,435,0,71,484,4867,4495,372,Lewisboro town
1042,36,119.0,3611944842,60,31758,11969,31758,31758,5671,26087,24838,22090,921,12,1544,5,266,1249,11969,11423,546,Mamaroneck town
1043,36,119.0,3611948895,60,10959,4465,10959,10959,4569,6390,6116,5076,439,20,513,1,67,274,4465,4271,194,Mount Kisco town
1044,36,119.0,3611949011,60,44436,15221,44436,44436,9259,35177,33961,29930,1260,30,2501,2,238,1216,15221,14595,626,Mount Pleasant town
1045,36,119.0,3611949121,60,73893,30350,73893,73893,14003,59890,56750,9077,44655,140,1398,21,1459,3140,30350,28286,2064,Mount Vernon city
1046,36,119.0,3611950078,60,18311,6160,18311,18311,1243,17068,16367,13824,267,3,2144,3,126,701,6160,5918,242,New Castle town
1047,36,119.0,3611950617,60,79726,30531,79726,79726,26257,53469,51194,32009,14324,95,3859,20,887,2275,30531,28702,1829,New Rochelle city
1048,36,119.0,3611951693,60,12408,4310,12408,12408,1448,10960,10560,9511,196,0,793,1,59,400,4310,4098,212,North Castle town
1049,36,119.0,3611953517,60,5243,2126,5243,5243,594,4649,4503,4270,83,4,120,0,26,146,2126,1887,239,North Salem town
1050,36,119.0,3611955541,60,40061,14975,40061,40061,14493,25568,24507,17932,4096,53,2195,5,226,1061,14975,14077,898,Ossining town
1051,36,119.0,3611956979,60,25431,10464,25431,25431,11160,14271,13410,7720,4693,32,725,5,235,861,10464,9813,651,Peekskill city
1052,36,119.0,3611957012,60,13078,4490,13078,13078,1656,11422,10779,9030,717,11,844,10,167,643,4490,4323,167,Pelham town
1053,36,119.0,3611959685,60,5082,2076,5082,5082,344,4738,4516,4264,65,3,165,0,19,222,2076,1860,216,Pound Ridge town
1054,36,119.0,3611964309,60,16592,6038,16592,16592,1388,15204,14499,13052,189,12,1185,4,57,705,6038,5654,384,Rye city
1055,36,119.0,3611964320,60,49613,17678,49613,49613,23918,25695,24428,20216,1757,27,1961,0,467,1267,17678,16909,769,Rye town
1056,36,119.0,3611965442,60,18253,5747,18253,18253,922,17331,16419,12249,220,7,3816,0,127,912,5747,5510,237,Scarsdale town
1057,36,119.0,3611968308,60,21541,9010,21541,21541,1907,19634,19037,17912,278,4,776,4,63,597,9010,8457,553,Somers town
1058,36,119.0,3611981677,60,59559,25494,59559,59559,19426,40133,38324,26242,6746,33,4747,13,543,1809,25494,24162,1332,White Plains city
1059,36,119.0,3611984000,60,211569,85528,211569,211569,89065,122504,117591,68970,33509,330,12915,34,1833,4913,85528,80548,4980,Yonkers city
1060,36,119.0,3611984077,60,36569,13672,36569,36569,5245,31324,30346,26906,1262,30,1970,3,175,978,13672,13144,528,Yorktown town
23888,36,,3601011,160,5220,1857,5220,5220,468,4752,4638,2867,25,6,1700,1,39,114,1857,1795,62,Albertson CDP
23899,36,,3601594,160,1824,1776,1824,1824,186,1638,1599,1522,35,0,18,2,22,39,1776,770,1006,Amagansett CDP
23902,36,,3602044,160,9500,4015,9500,9500,1761,7739,7514,6403,876,18,163,0,54,225,4015,3846,169,Amityville village
23911,36,,3602374,160,2547,1164,2547,2547,476,2071,2005,1919,52,2,26,0,6,66,1164,969,195,Aquebogue CDP
23918,36,,3602737,160,592,296,592,592,31,561,550,532,2,0,6,0,10,11,296,231,65,Asharoken village
23920,36,,3602968,160,1707,1046,1707,1707,83,1624,1580,1533,3,0,28,0,16,44,1046,763,283,Atlantic Beach village
23928,36,,3603408,160,12188,4732,12188,12188,1067,11121,10773,10221,199,6,294,1,52,348,4732,4544,188,Babylon village
23930,36,,3604055,160,2763,1656,2763,2763,309,2454,2396,2290,67,7,21,1,10,58,1656,1081,575,Baiting Hollow CDP
23931,36,,3604143,160,33919,11092,33919,33919,7588,26331,24994,9831,12989,55,1576,8,535,1337,11092,10702,390,Baldwin CDP
23939,36,,3604550,160,2590,1062,2590,2590,504,2086,2025,1762,69,4,156,0,34,61,1062,1026,36,Barnum Island CDP
23944,36,,3604803,160,991,425,991,991,173,818,785,700,7,0,74,0,4,33,425,394,31,Baxter Estates village
23945,36,,3604891,160,2117,888,2117,2117,228,1889,1848,1766,42,2,28,0,10,41,888,845,43,Bay Park CDP
23946,36,,3604913,160,8609,3506,8609,8609,754,7855,7644,7301,161,4,142,2,34,211,3506,3245,261,Bayport CDP
23947,36,,3604935,160,29244,10126,29244,29244,11127,18117,17322,10660,5044,82,1236,5,295,795,10126,9667,459,Bay Shore CDP
23948,36,,3605034,160,6748,2691,6748,6748,704,6044,5888,5691,32,3,140,1,21,156,2691,2518,173,Bayville village
23949,36,,3605039,160,7726,2266,7726,7726,3470,4256,3992,2561,1019,5,301,1,105,264,2266,2210,56,Baywood CDP
23955,36,,3605639,160,1173,388,1173,1173,121,1052,1009,896,36,1,62,1,13,43,388,384,4,Bellerose village
23956,36,,3605661,160,2329,692,2329,2329,655,1674,1597,601,151,15,782,1,47,77,692,670,22,Bellerose Terrace CDP
23957,36,,3605672,160,808,312,808,808,54,754,727,672,8,0,42,0,5,27,312,287,25,Belle Terre village
23959,36,,3605738,160,16297,5776,16297,16297,1570,14727,14273,13237,242,2,737,0,55,454,5776,5572,204,Bellmore CDP
23960,36,,3605771,160,2203,1170,2203,2203,118,2085,2013,1924,46,5,34,0,4,72,1170,938,232,Bellport village
23964,36,,3606387,160,16658,6072,16658,16658,1735,14923,14587,12292,151,7,2066,4,67,336,6072,5810,262,Bethpage CDP
23977,36,,3607069,160,5156,2132,5156,5156,287,4869,4754,4599,42,3,87,0,23,115,2132,2029,103,Blue Point CDP
23978,36,,3607157,160,9852,3720,9852,9852,1040,8812,8610,8074,170,2,349,0,15,202,3720,3581,139,Bohemia CDP
23984,36,,3608026,160,62387,14127,62387,62387,47072,15315,14520,5816,6766,91,1134,6,707,795,14127,13658,469,Brentwood CDP
23990,36,,3608136,160,2953,2632,2953,2953,417,2536,2446,2160,199,3,71,0,13,90,2632,1136,1496,Bridgehampton CDP
23995,36,,3608323,160,3181,1160,3181,3181,250,2931,2849,2718,82,0,46,0,3,82,1160,1135,25,Brightwaters village
24001,36,,3609000,160,3330,1177,3330,3330,303,3027,2933,2686,190,10,34,0,13,94,1177,1097,80,Brookhaven CDP
24003,36,,3610132,160,2939,661,2939,2939,152,2787,2718,2273,45,2,390,0,8,69,661,625,36,Brookville village
24018,36,,3611781,160,5934,3016,5934,5934,1095,4839,4698,4203,414,7,47,0,27,141,3016,2779,237,Calverton CDP
24031,36,,3612402,160,48,35,48,48,4,44,43,43,0,0,0,0,0,1,35,25,10,Captree CDP
24032,36,,3612419,160,5005,1908,5005,5005,740,4265,4120,3434,148,6,488,0,44,145,1908,1825,83,Carle Place CDP
24046,36,,3613233,160,7374,2413,7374,7374,1040,6334,6217,5803,151,0,189,0,74,117,2413,2265,148,Cedarhurst village
24049,36,,3613376,160,30980,10405,30980,30980,5147,25833,24974,21175,964,41,2658,8,128,859,10405,10008,397,Centereach CDP
24050,36,,3613420,160,8046,2960,8046,8046,1129,6917,6690,6308,243,8,109,0,22,227,2960,2770,190,Center Moriches CDP
24051,36,,3613442,160,5822,2272,5822,5822,306,5516,5347,5181,20,2,108,1,35,169,2272,2171,101,Centerport CDP
24053,36,,3613552,160,36714,10344,36714,36714,21856,14858,14077,5414,7005,98,1085,11,464,781,10344,9870,474,Central Islip CDP
24055,36,,3613618,160,407,229,407,407,31,376,373,351,2,0,19,1,0,3,229,160,69,Centre Island village
24093,36,,3616958,160,3064,1020,3064,3064,203,2861,2763,2621,10,1,119,0,12,98,1020,975,45,Cold Spring Harbor CDP
24096,36,,3617530,160,36536,12312,36536,36536,2914,33622,32857,29468,632,28,2536,4,189,765,12312,12009,303,Commack CDP
24108,36,,3618146,160,23429,8024,23429,23429,9634,13795,13308,10743,1836,18,524,1,186,487,8024,7684,340,Copiague CDP
24109,36,,3618157,160,40220,16060,40220,40220,7454,32766,31371,24163,4703,51,2197,9,248,1395,16060,15234,826,Coram CDP
24117,36,,3618597,160,293,138,293,293,18,275,266,264,0,1,0,0,1,9,138,125,13,Cove Neck village
24131,36,,3619466,160,3437,2121,3437,3437,417,3020,2962,2886,36,1,28,1,10,58,2121,1400,721,Cutchogue CDP
24138,36,,3619972,160,28837,9839,28837,28837,5206,23631,22845,15200,3982,74,3322,1,266,786,9839,9510,329,Deer Park CDP
24147,36,,3620379,160,50,34,50,50,16,34,29,24,0,0,4,0,1,5,34,17,17,Dering Harbor village
24151,36,,3620687,160,26180,8315,26180,26180,2224,23956,23178,17099,1410,28,4397,8,236,778,8315,8016,299,Dix Hills CDP
24165,36,,3621578,160,2101,994,2101,2101,128,1973,1933,1898,8,0,18,0,9,40,994,860,134,East Atlantic Beach CDP
24170,36,,3621985,160,6617,2275,6617,6617,1706,4911,4750,3384,785,5,528,2,46,161,2275,2177,98,East Farmingdale CDP
24174,36,,3622183,160,1517,1774,1517,1517,177,1340,1308,1253,24,0,24,0,7,32,1774,668,1106,East Hampton village
24175,36,,3622200,160,5377,2856,5377,5377,2396,2981,2864,2524,219,8,75,0,38,117,2856,1889,967,East Hampton North CDP
24177,36,,3622260,160,7284,2294,7284,7284,303,6981,6815,5808,85,1,888,0,33,166,2294,2218,76,East Hills village
24178,36,,3622315,160,13931,4918,13931,13931,1454,12477,12149,11567,209,9,302,0,62,328,4918,4769,149,East Islip CDP
24181,36,,3622447,160,1048,946,1048,1048,109,939,912,881,11,2,11,1,6,27,946,494,452,East Marion CDP
24182,36,,3622480,160,19854,7112,19854,19854,2775,17079,16531,13474,2415,14,486,2,140,548,7112,6884,228,East Massapequa CDP
24183,36,,3622502,160,37796,12951,37796,37796,6048,31748,30832,22039,1668,39,6758,11,317,916,12951,12361,590,East Meadow CDP
24184,36,,3622546,160,5946,2349,5946,5946,571,5375,5235,5001,112,6,84,0,32,140,2349,2120,229,East Moriches CDP
24186,36,,3622612,160,20048,7246,20048,20048,2120,17928,17428,16539,205,13,591,1,79,500,7246,6996,250,East Northport CDP
24187,36,,3622623,160,2792,998,2792,2792,222,2570,2507,2362,26,0,111,0,8,63,998,968,30,East Norwich CDP
24188,36,,3622733,160,21580,8612,21580,21580,4975,16605,15945,14297,982,45,522,7,92,660,8612,8221,391,East Patchogue CDP
24189,36,,3622810,160,2219,1015,2219,2219,300,1919,1851,1786,32,1,19,2,11,68,1015,907,108,Eastport CDP
24190,36,,3622832,160,5557,3104,5557,5557,1029,4528,4408,4268,36,3,77,0,24,120,3104,2152,952,East Quogue CDP
24193,36,,3622876,160,10159,4000,10159,10159,1451,8708,8459,7789,296,4,327,0,43,249,4000,3814,186,East Rockaway village
24194,36,,3622964,160,10998,4038,10998,10998,799,10199,9877,8484,110,12,1216,1,54,322,4038,3891,147,East Setauket CDP
24195,36,,3622980,160,6841,2248,6841,6841,647,6194,5962,5620,121,5,183,0,33,232,2248,2181,67,East Shoreham CDP
24197,36,,3623217,160,2645,864,2645,2645,150,2495,2412,2060,5,0,340,0,7,83,864,828,36,East Williston village
24199,36,,3623316,160,1334,570,1334,1334,60,1274,1249,1217,5,0,22,0,5,25,570,507,63,Eatons Neck CDP
24214,36,,3624273,160,35265,10270,35265,35265,8024,27241,25933,4282,15460,102,5290,15,784,1308,10270,9896,374,Elmont CDP
24216,36,,3624405,160,11426,3846,11426,11426,1387,10039,9725,8190,535,1,941,0,58,314,3846,3730,116,Elwood CDP
24230,36,,3625384,160,8466,3868,8466,8466,1291,7175,6987,6019,280,9,618,0,61,188,3868,3627,241,Farmingdale village
24231,36,,3625417,160,14983,4845,14983,14983,2659,12324,11852,10520,510,5,709,2,106,472,4845,4706,139,Farmingville CDP
24236,36,,3625839,160,777,3357,777,777,99,678,650,585,29,10,17,0,9,28,3357,393,2964,Fire Island CDP
24238,36,,3625923,160,424,609,424,424,32,392,370,352,3,0,11,2,2,22,609,180,429,Fishers Island CDP
24241,36,,3626121,160,5098,1714,5098,5098,2764,2334,2209,1707,421,5,37,0,39,125,1714,1492,222,Flanders CDP
24243,36,,3626264,160,16172,5961,16172,16172,2067,14105,13745,11495,262,14,1889,3,82,360,5961,5746,215,Floral Park village
24245,36,,3626352,160,4794,1529,4794,4794,280,4514,4395,3423,32,7,904,0,29,119,1529,1473,56,Flower Hill village
24257,36,,3626946,160,9652,3430,9652,9652,619,9033,8783,8450,75,6,227,1,24,250,3430,3299,131,Fort Salonga CDP
24261,36,,3627309,160,30903,10231,30903,30903,5979,24924,24277,18604,1385,40,3947,8,293,647,10231,9903,328,Franklin Square CDP
24265,36,,3627485,160,44472,14137,44472,44472,21312,23160,21903,7632,12830,89,792,15,545,1257,14137,13501,636,Freeport village
24276,36,,3628178,160,23272,7715,23272,23272,1486,21786,21274,19344,212,12,1589,7,110,512,7715,7513,202,Garden City village
24277,36,,3628189,160,7985,2592,7985,7985,999,6986,6762,2702,223,19,3742,2,74,224,2592,2499,93,Garden City Park CDP
24278,36,,3628200,160,4119,1454,4119,4119,475,3644,3567,3160,42,7,348,0,10,77,1454,1401,53,Garden City South CDP
24289,36,,3628990,160,185,137,185,185,2,183,179,173,2,0,2,0,2,4,137,86,51,Gilgo CDP
24292,36,,3629113,160,28365,10793,28365,28365,9752,18613,18055,14775,1595,58,1449,2,176,558,10793,10099,694,Glen Cove city
24293,36,,3629245,160,4837,1787,4837,4837,546,4291,4176,3786,32,2,330,0,26,115,1787,1718,69,Glen Head CDP
24297,36,,3629421,160,3948,1422,3948,3948,355,3593,3501,3212,25,3,236,1,24,92,1422,1375,47,Glenwood Landing CDP
24300,36,,3629509,160,3981,1131,3981,3981,1479,2502,2319,649,1478,55,91,0,46,183,1131,1059,72,Gordon Heights CDP
24310,36,,3630169,160,11145,3883,11145,11145,1204,9941,9512,7767,145,5,1497,1,97,429,3883,3620,263,Great Neck village
24311,36,,3630191,160,2990,937,2990,2990,122,2868,2770,2159,16,2,563,0,30,98,937,879,58,Great Neck Estates village
24312,36,,3630202,160,1268,397,1268,1268,30,1238,1210,812,3,0,390,0,5,28,397,380,17,Great Neck Gardens CDP
24313,36,,3630213,160,7482,3954,7482,7482,626,6856,6661,4523,135,5,1960,0,38,195,3954,3702,252,Great Neck Plaza village
24314,36,,3630235,160,2005,842,2005,2005,155,1850,1818,1752,29,1,36,0,0,32,842,798,44,Great River CDP
24318,36,,3630543,160,13661,4669,13661,13661,2420,11241,10854,8329,1660,14,773,0,78,387,4669,4524,145,Greenlawn CDP
24319,36,,3630576,160,2583,1277,2583,2583,957,1626,1542,1300,197,4,25,0,16,84,1277,950,327,Greenport village
24320,36,,3630581,160,2282,1658,2282,2282,388,1894,1854,1729,85,0,29,0,11,40,1658,1056,602,Greenport West CDP
24321,36,,3630598,160,1069,373,1069,1069,118,951,912,622,8,0,270,0,12,39,373,344,29,Greenvale CDP
24334,36,,3631445,160,2527,1099,2527,2527,176,2351,2288,2169,41,0,60,0,18,63,1099,1034,65,Halesite CDP
24342,36,,3631896,160,15228,7879,15228,15228,5715,9513,9239,8759,167,25,177,1,110,274,7879,5669,2210,Hampton Bays CDP
24348,36,,3632094,160,562,188,562,562,5,557,536,488,0,0,45,0,3,21,188,177,11,Harbor Hills CDP
24349,36,,3632105,160,1436,497,1436,1436,145,1291,1256,1201,26,2,22,0,5,35,497,473,24,Harbor Isle CDP
24357,36,,3632732,160,20083,7384,20083,20083,2080,18003,17535,15440,503,11,1481,1,99,468,7384,7180,204,Hauppauge CDP
24361,36,,3632963,160,1520,537,1520,1520,177,1343,1287,1212,4,1,59,0,11,56,537,475,62,Head of the Harbor village
24363,36,,3633139,160,59169,16954,59169,59169,29640,29529,28135,3067,23041,147,1242,17,621,1394,16954,16299,655,Hempstead village
24368,36,,3634198,160,4398,1380,4398,4398,196,4202,4093,1487,27,18,2522,3,36,109,1380,1330,50,Herricks CDP
24371,36,,3634286,160,7262,2698,7262,7262,1086,6176,5983,4989,303,4,630,1,56,193,2698,2532,166,Hewlett CDP
24372,36,,3634297,160,494,144,494,494,20,474,451,400,7,2,40,0,2,23,144,140,4,Hewlett Bay Park village
24373,36,,3634308,160,1290,442,1290,1290,59,1231,1201,1124,13,3,59,0,2,30,442,418,24,Hewlett Harbor village
24374,36,,3634319,160,569,161,569,569,30,539,533,491,12,5,22,0,3,6,161,149,12,Hewlett Neck village
24375,36,,3634374,160,43869,13889,43869,43869,8003,35866,34788,19073,1129,75,14178,7,326,1078,13889,13477,412,Hicksville CDP
24386,36,,3635056,160,26487,9714,26487,26487,3166,23321,22774,20723,701,19,1194,3,134,547,9714,9439,275,Holbrook CDP
24390,36,,3635254,160,18937,6646,18937,18937,2728,16209,15730,14130,455,16,1040,3,86,479,6646,6448,198,Holtsville CDP
24405,36,,3636233,160,19645,8341,19645,19645,1458,18187,17651,16612,368,10,568,5,88,536,8341,7920,421,Huntington CDP
24406,36,,3637022,160,1446,593,1446,1446,56,1390,1351,1301,5,1,29,0,15,39,593,552,41,Huntington Bay village
24407,36,,3637044,160,34878,10943,34878,34878,15793,19085,18277,13388,3012,38,1588,8,243,808,10943,10517,426,Huntington Station CDP
24413,36,,3637583,160,11340,3355,11340,11340,5997,5343,5158,2680,1920,9,431,4,114,185,3355,3180,175,Inwood CDP
24416,36,,3637840,160,3567,1087,3567,3567,1135,2432,2340,1651,437,5,219,0,28,92,1087,1044,43,Islandia village
24417,36,,3637847,160,4928,1851,4928,4928,1645,3283,3158,2729,149,9,203,8,60,125,1851,1725,126,Island Park village
24418,36,,3637869,160,18418,6605,18418,18418,3574,14844,14371,12703,889,23,635,2,119,473,6605,6407,198,Islip CDP
24419,36,,3638022,160,5323,1774,5323,5323,836,4487,4364,4023,146,13,147,1,34,123,1774,1698,76,Islip Terrace CDP
24422,36,,3638253,160,1609,1126,1609,1609,177,1432,1411,1381,22,0,7,1,0,21,1126,689,437,Jamesport CDP
24429,36,,3638539,160,14808,4818,14808,14808,595,14213,13925,6369,301,7,7168,3,77,288,4818,4597,221,Jericho CDP
24439,36,,3639309,160,1226,457,1226,1226,15,1211,1173,877,4,1,282,1,8,38,457,430,27,Kensington village
24444,36,,3639672,160,17085,6564,17085,17085,1414,15671,15306,14499,179,4,554,0,70,365,6564,6311,253,Kings Park CDP
24445,36,,3639694,160,5619,1416,5619,5619,214,5405,5102,4680,88,0,307,4,23,303,1416,1293,123,Kings Point village
24456,36,,3640530,160,11072,4078,11072,11072,1252,9820,9532,8299,277,9,920,0,27,288,4078,3910,168,Lake Grove village
24463,36,,3640838,160,18619,7223,18619,18619,2588,16031,15494,13560,687,21,1086,3,137,537,7223,6645,578,Lake Ronkonkoma CDP
24464,36,,3640937,160,2828,858,2828,2828,103,2725,2658,1039,12,1,1587,0,19,67,858,820,38,Lake Success village
24465,36,,3641003,160,6077,1625,6077,6077,1123,4954,4701,152,4249,17,157,0,126,253,1625,1567,58,Lakeview CDP
24472,36,,3641432,160,1881,708,1881,1881,117,1764,1708,1613,5,0,81,1,8,56,708,614,94,Lattingtown village
24473,36,,3641465,160,1495,800,1495,1495,249,1246,1217,1182,6,4,15,0,10,29,800,550,250,Laurel CDP
24474,36,,3641487,160,1940,630,1940,1940,92,1848,1793,1603,15,0,168,0,7,55,630,594,36,Laurel Hollow village
24476,36,,3641553,160,6809,2432,6809,6809,308,6501,6389,6095,85,0,93,0,116,112,2432,2185,247,Lawrence village
24480,36,,3642081,160,51758,17123,51758,51758,8617,43141,41782,34853,675,65,5900,6,283,1359,17123,16634,489,Levittown CDP
24483,36,,3642279,160,2719,1302,2719,2719,148,2571,2520,2454,10,0,52,0,4,51,1302,1161,141,Lido Beach CDP
24489,36,,3642554,160,27148,9712,27148,27148,4458,22690,22053,20548,629,23,729,0,124,637,9712,9260,452,Lindenhurst village
24498,36,,3643005,160,3571,1246,3571,3571,206,3365,3262,3100,9,0,136,0,17,103,1246,1150,96,Lloyd Harbor village
24501,36,,3643192,160,3571,1339,3571,3571,861,2710,2645,2408,90,0,124,0,23,65,1339,1268,71,Locust Valley CDP
24503,36,,3643335,160,35029,16771,35029,35029,5370,29659,28794,25531,1820,42,1107,21,273,865,16771,15360,1411,Long Beach city
24509,36,,3643874,160,20438,7798,20438,20438,3847,16591,16002,13210,1345,22,1270,1,154,589,7798,7459,339,Lynbrook village
24525,36,,3644787,160,8560,3159,8560,8560,1116,7444,7235,6163,464,11,488,0,109,209,3159,3068,91,Malverne village
24526,36,,3644792,160,538,194,538,538,63,475,457,334,60,0,47,0,16,18,194,186,8,Malverne Park Oaks CDP
24529,36,,3644897,160,8176,2947,8176,8176,868,7308,7094,4606,597,8,1863,0,20,214,2947,2790,157,Manhasset CDP
24530,36,,3644908,160,3649,1154,3649,3649,237,3412,3341,1287,32,6,1974,0,42,71,1154,1119,35,Manhasset Hills CDP
24533,36,,3645106,160,6956,2699,6956,6956,2487,4469,4338,3195,106,4,995,2,36,131,2699,2534,165,Manorhaven village
24534,36,,3645139,160,14317,5364,14317,14317,1428,12889,12456,11814,326,12,253,0,51,433,5364,5159,205,Manorville CDP
24543,36,,3645986,160,21355,7375,21355,21355,1586,19769,19264,18661,112,9,432,3,47,505,7375,7152,223,Massapequa CDP
24544,36,,3645997,160,17109,5913,17109,17109,1235,15874,15563,15105,78,12,306,0,62,311,5913,5759,154,Massapequa Park village
24546,36,,3646074,160,15404,4792,15404,15404,4605,10799,10198,8191,1440,43,390,10,124,601,4792,4557,235,Mastic CDP
24547,36,,3646085,160,14199,5198,14199,14199,3160,11039,10334,8194,1771,64,208,4,93,705,5198,4677,521,Mastic Beach CDP
24548,36,,3646107,160,847,323,847,847,77,770,757,710,1,0,46,0,0,13,323,284,39,Matinecock village
24549,36,,3646140,160,4322,2527,4322,4322,516,3806,3706,3586,65,3,39,1,12,100,2527,1805,722,Mattituck CDP
24556,36,,3646404,160,24247,8416,24247,24247,5973,18274,17554,15080,1545,31,758,8,132,720,8416,8095,321,Medford CDP
24559,36,,3646514,160,19284,7777,19284,19284,1288,17996,17538,14654,794,12,1997,3,78,458,7777,7368,409,Melville CDP
24562,36,,3646668,160,22040,7672,22040,22040,2066,19974,19480,18074,339,8,928,0,131,494,7672,7436,236,Merrick CDP
24566,36,,3646976,160,10546,4588,10546,10546,1290,9256,8919,7226,1308,33,282,7,63,337,4588,4375,213,Middle Island CDP
24572,36,,3647306,160,11723,4157,11723,11723,882,10841,10566,9991,178,10,348,7,32,275,4157,4001,156,Miller Place CDP
24574,36,,3647405,160,1054,414,1054,1054,132,922,890,802,20,0,67,0,1,32,414,349,65,Mill Neck village
24579,36,,3647636,160,20800,8776,20800,20800,4071,16729,16104,12500,528,13,2860,3,200,625,8776,8311,465,Mineola village
24587,36,,3648054,160,4318,4487,4318,4318,804,3514,3384,3195,86,5,62,2,34,130,4487,1804,2683,Montauk CDP
24595,36,,3648450,160,3026,1460,3026,3026,390,2636,2505,2101,321,7,54,0,22,131,1460,1361,99,Moriches CDP
24605,36,,3649066,160,11623,4339,11623,11623,984,10639,10372,9556,157,18,599,0,42,267,4339,4131,208,Mount Sinai CDP
24609,36,,3649231,160,2809,842,2809,2809,149,2660,2558,2141,29,1,378,1,8,102,842,821,21,Munsey Park village
24611,36,,3649330,160,3512,1141,3512,3512,159,3353,3286,2027,54,1,1189,5,10,67,1141,1057,84,Muttontown village
24615,36,,3649424,160,368,480,368,368,29,339,329,307,7,0,11,0,4,10,480,179,301,Napeague CDP
24625,36,,3649825,160,13207,4707,13207,13207,1186,12021,11709,10575,208,8,838,0,80,312,4707,4560,147,Nesconset CDP
24631,36,,3650067,160,14199,3402,14199,14199,7917,6282,6083,667,4895,18,422,1,80,199,3402,3185,217,New Cassel CDP
24639,36,,3650397,160,10257,3376,10257,10257,1413,8844,8610,4253,176,29,4063,4,85,234,3376,3260,116,New Hyde Park village
24644,36,,3650727,160,403,316,403,403,38,365,360,354,1,0,2,2,1,5,316,187,129,New Suffolk CDP
24652,36,,3651286,160,1564,625,1564,1564,78,1486,1451,1392,6,5,40,2,6,35,625,578,47,Nissequogue village
24655,36,,3651396,160,18643,5628,18643,18643,6899,11744,11148,1678,8834,123,280,10,223,596,5628,5304,324,North Amityville CDP
24656,36,,3651418,160,763,246,763,763,324,439,424,262,141,9,10,0,2,15,246,227,19,Northampton CDP
24657,36,,3651440,160,17927,6430,17927,17927,3381,14546,14058,11154,1732,21,1007,1,143,488,6430,6229,201,North Babylon CDP
24660,36,,3651495,160,19619,4742,19619,19619,13376,6243,5898,2032,2663,39,940,10,214,345,4742,4579,163,North Bay Shore CDP
24661,36,,3651517,160,20583,6866,20583,20583,2374,18209,17691,15443,645,5,1470,3,125,518,6866,6723,143,North Bellmore CDP
24662,36,,3651528,160,11900,3670,11900,11900,4451,7449,6934,3883,2532,108,322,1,88,515,3670,3484,186,North Bellport CDP
24670,36,,3652078,160,4266,1535,4266,4266,728,3538,3451,3197,137,7,94,0,16,87,1535,1505,30,North Great River CDP
24671,36,,3652188,160,1162,732,1162,1162,47,1115,1095,1062,8,2,18,0,5,20,732,464,268,North Haven village
24672,36,,3653022,160,5464,2500,5464,5464,151,5313,5203,3245,53,0,1878,3,24,110,2500,2290,210,North Hills village
24674,36,,3653198,160,12000,4016,12000,12000,3390,8610,8309,7040,719,14,445,0,91,301,4016,3861,155,North Lindenhurst CDP
24675,36,,3653231,160,747,234,747,747,113,634,610,468,70,0,68,0,4,24,234,233,1,North Lynbrook CDP
24676,36,,3653253,160,17829,6103,17829,17829,1541,16288,15983,15369,107,4,459,0,44,305,6103,5963,140,North Massapequa CDP
24677,36,,3653264,160,12238,4137,12238,12238,1332,10906,10627,9566,305,5,668,2,81,279,4137,4023,114,North Merrick CDP
24678,36,,3653275,160,15657,5024,15657,15657,1230,14427,14138,6588,108,37,7238,8,159,289,5024,4887,137,North New Hyde Park CDP
24679,36,,3653319,160,6751,2421,6751,6751,1792,4959,4808,4447,179,7,131,2,42,151,2421,2314,107,North Patchogue CDP
24680,36,,3653396,160,7347,3128,7347,7347,401,6946,6787,6563,53,4,146,0,21,159,3128,2983,145,Northport village
24682,36,,3653561,160,5461,3587,5461,5461,1080,4381,4210,3946,60,26,125,3,50,171,3587,2158,1429,North Sea CDP
24685,36,,3653748,160,18197,5638,18197,18197,2677,15520,14753,2635,8111,74,3515,6,412,767,5638,5447,191,North Valley Stream CDP
24687,36,,3653775,160,1566,813,1566,1566,224,1342,1309,1270,19,0,18,0,2,33,813,620,193,Northville CDP
24688,36,,3653792,160,11931,4282,11931,11931,1416,10515,10260,9673,138,3,375,0,71,255,4282,4174,108,North Wantagh CDP
24689,36,,3653852,160,4637,3512,4637,4637,863,3774,3641,3378,83,26,110,7,37,133,3512,1912,1600,Northwest Harbor CDP
24693,36,,3654056,160,4325,2832,4325,4325,578,3747,3636,3481,60,5,76,0,14,111,2832,1797,1035,Noyack CDP
24696,36,,3654111,160,268,233,268,268,20,248,248,225,5,0,18,0,0,0,233,113,120,Oak Beach CDP
24697,36,,3654144,160,7430,3240,7430,7430,517,6913,6760,6550,86,6,103,2,13,153,3240,3109,131,Oakdale CDP
24699,36,,3654430,160,153,591,153,153,10,143,138,133,2,1,0,0,2,5,591,76,515,Ocean Beach village
24700,36,,3654441,160,32637,11552,32637,32637,4529,28108,27335,25259,658,19,1181,1,217,773,11552,11212,340,Oceanside CDP
24704,36,,3654551,160,6403,2836,6403,6403,340,6063,5924,5293,17,0,597,0,17,139,2836,2390,446,Old Bethpage CDP
24705,36,,3654562,160,2020,718,2020,2020,120,1900,1866,1558,31,3,260,0,14,34,718,692,26,Old Brookville village
24706,36,,3654617,160,893,365,893,893,42,851,827,738,2,0,74,1,12,24,365,334,31,Old Field village
24708,36,,3654705,160,4289,1209,4289,4289,318,3971,3823,2234,586,3,977,0,23,148,1209,1080,129,Old Westbury village
24717,36,,3655321,160,999,800,999,999,41,958,939,920,2,4,10,0,3,19,800,470,330,Orient CDP
24729,36,,3655992,160,7049,2964,7049,7049,1396,5653,5486,4993,228,8,236,0,21,167,2964,2831,133,Oyster Bay CDP
24730,36,,3656011,160,2265,759,2265,2265,113,2152,2082,1774,22,0,270,0,16,70,759,695,64,Oyster Bay Cove village
24740,36,,3656660,160,12408,5776,12408,12408,3520,8888,8576,7604,662,19,242,1,48,312,5776,5456,320,Patchogue village
24746,36,,3656968,160,692,495,692,692,83,609,593,568,13,0,6,0,6,16,495,300,195,Peconic CDP
24768,36,,3658409,160,9517,2941,9517,9517,1093,8424,8230,7177,172,3,815,15,48,194,2941,2863,78,Plainedge CDP
24769,36,,3658442,160,27100,9207,27100,27100,1598,25502,24941,19134,131,21,5548,1,106,561,9207,8861,346,Plainview CDP
24770,36,,3658475,160,1448,445,1448,1448,67,1381,1350,1169,9,2,165,1,4,31,445,411,34,Plandome village
24771,36,,3658486,160,1009,333,1009,1009,71,938,914,718,0,2,185,1,8,24,333,327,6,Plandome Heights village
24772,36,,3658497,160,793,272,793,793,50,743,736,638,2,0,91,0,5,7,272,252,20,Plandome Manor village
24780,36,,3658849,160,1527,855,1527,1527,62,1465,1437,1407,8,0,18,0,4,28,855,668,187,Point Lookout CDP
24783,36,,3659157,160,903,374,903,903,43,860,843,743,8,0,91,0,1,17,374,364,10,Poquott village
24790,36,,3659355,160,7962,3471,7962,7962,712,7250,6957,6258,109,2,537,2,49,293,3471,3291,180,Port Jefferson village
24791,36,,3659377,160,7950,2985,7950,7950,1570,6380,6132,5277,302,4,512,0,37,248,2985,2859,126,Port Jefferson Station CDP
24796,36,,3659520,160,16753,6269,16753,16753,2524,14229,13637,11747,312,11,1502,4,61,592,6269,5925,344,Port Washington CDP
24797,36,,3659531,160,3160,1377,3160,3160,297,2863,2786,2435,28,0,296,1,26,77,1377,1324,53,Port Washington North village
24808,36,,3660408,160,1013,625,1013,1013,279,734,702,629,40,7,20,0,6,32,625,364,261,Quiogue CDP
24809,36,,3660422,160,1662,1613,1662,1662,134,1528,1490,1368,41,16,58,0,7,38,1613,688,925,Quogue village
24821,36,,3661142,160,3110,1644,3110,3110,351,2759,2679,2599,36,0,35,0,9,80,1644,1200,444,Remsenburg-Speonk CDP
24831,36,,3661665,160,13271,6336,13271,13271,1145,12126,11775,10661,723,12,333,2,44,351,6336,5877,459,Ridge CDP
24834,36,,3661973,160,14993,5763,14993,14993,5674,9319,8933,6853,1716,37,225,3,99,386,5763,5365,398,Riverhead CDP
24836,36,,3662066,160,2882,910,2882,2882,1176,1706,1655,1054,539,16,26,3,17,51,910,838,72,Riverside CDP
24840,36,,3663264,160,26016,9991,26016,26016,3029,22987,22379,20319,1314,19,617,0,110,608,9991,9669,322,Rockville Centre village
24841,36,,3663319,160,13633,5285,13633,13633,1651,11982,11532,11073,171,13,239,3,33,450,5285,4826,459,Rocky Point CDP
24846,36,,3663473,160,18955,6701,18955,18955,2814,16141,15595,13641,548,15,1166,8,217,546,6701,6496,205,Ronkonkoma CDP
24847,36,,3663506,160,18066,4441,18066,18066,8406,9660,9247,343,8519,32,169,11,173,413,4441,4242,199,Roosevelt CDP
24850,36,,3663770,160,2988,1441,2988,2988,513,2475,2401,1872,44,4,465,3,13,74,1441,1309,132,Roslyn village
24851,36,,3663792,160,1318,407,1318,1318,42,1276,1248,1062,10,0,169,0,7,28,407,391,16,Roslyn Estates village
24852,36,,3663803,160,1067,379,1067,1067,63,1004,959,756,4,0,196,0,3,45,379,330,49,Roslyn Harbor village
24853,36,,3663814,160,6747,2218,6747,6747,700,6047,5878,3203,375,10,2239,0,51,169,2218,2108,110,Roslyn Heights CDP
24861,36,,3664232,160,978,339,978,978,30,948,924,492,3,0,418,1,10,24,339,314,25,Russell Gardens village
24865,36,,3664430,160,989,293,989,989,18,971,944,840,1,0,94,0,9,27,293,281,12,Saddle Rock village
24866,36,,3664441,160,428,139,428,428,1,427,410,355,3,0,41,0,11,17,139,130,9,Saddle Rock Estates CDP
24867,36,,3664452,160,770,718,770,770,60,710,680,624,9,8,28,0,11,30,718,305,413,Sagaponack village
24868,36,,3664485,160,2772,2013,2772,2772,301,2471,2370,2100,206,12,35,0,17,101,2013,1202,811,Sag Harbor village
24870,36,,3664584,160,13487,4921,13487,13487,1037,12450,12164,11500,117,7,513,0,27,286,4921,4729,192,St. James CDP
24876,36,,3664842,160,12618,4106,12618,12618,2484,10134,9794,6994,321,7,2383,1,88,340,4106,3989,117,Salisbury CDP
24879,36,,3664881,160,113,432,113,113,3,110,107,105,0,0,2,0,0,3,432,31,401,Saltaire village
24883,36,,3665035,160,2712,947,2712,2712,117,2595,2551,2249,32,0,261,0,9,44,947,878,69,Sands Point village
24891,36,,3665409,160,16569,6228,16569,16569,1148,15421,15029,14489,186,10,283,4,57,392,6228,5935,293,Sayville CDP
24906,36,,3666047,160,5062,2086,5062,5062,475,4587,4407,4160,82,2,148,1,14,180,2086,1954,132,Sea Cliff village
24907,36,,3666058,160,15251,5475,15251,15251,1239,14012,13658,13051,111,2,428,0,66,354,5475,5293,182,Seaford CDP
24908,36,,3666102,160,5044,1607,5044,5044,197,4847,4726,1986,58,6,2647,0,29,121,1607,1556,51,Searingtown CDP
24909,36,,3666212,160,21262,7167,21262,21262,4129,17133,16550,14013,885,28,1495,3,126,583,7167,6838,329,Selden CDP
24912,36,,3666465,160,3986,1531,3986,3986,257,3729,3576,3148,67,0,346,2,13,153,1531,1413,118,Setauket CDP
24914,36,,3666828,160,1602,1145,1602,1602,181,1421,1362,1329,13,0,18,0,2,59,1145,703,442,Shelter Island CDP
24915,36,,3666850,160,1601,1552,1601,1601,92,1509,1458,1424,8,0,24,0,2,51,1552,761,791,Shelter Island Heights CDP
24920,36,,3667048,160,2282,1537,2282,2282,702,1580,1516,1404,45,7,51,0,9,64,1537,845,692,Shinnecock Hills CDP
24921,36,,3667070,160,26360,8782,26360,26360,6200,20160,19167,16268,1907,70,724,2,196,993,8782,8262,520,Shirley CDP
24923,36,,3667191,160,561,232,561,561,45,516,492,467,11,0,13,0,1,24,232,188,44,Shoreham village
24939,36,,3667851,160,25629,8800,25629,25629,2484,23145,22455,20966,351,7,1007,0,124,690,8800,8495,305,Smithtown CDP
24945,36,,3668374,160,7416,2943,7416,7416,758,6658,6412,6111,125,13,136,5,22,246,2943,2728,215,Sound Beach CDP
24946,36,,3668462,160,4550,3438,4550,4550,792,3758,3636,3218,236,19,129,0,34,122,3438,1701,1737,Southampton village
24953,36,,3669001,160,14345,4902,14345,14345,2078,12267,11961,10822,284,11,773,0,71,306,4902,4765,137,South Farmingdale CDP
24954,36,,3669023,160,1741,534,1741,1741,384,1357,1267,158,834,8,240,0,27,90,534,507,27,South Floral Park village
24956,36,,3669188,160,3406,1074,3406,3406,836,2570,2482,1852,506,10,79,2,33,88,1074,1029,45,South Hempstead CDP
24958,36,,3669254,160,9561,3418,9561,9561,1428,8133,7886,6864,210,5,773,0,34,247,3418,3290,128,South Huntington CDP
24964,36,,3669452,160,6040,4222,6040,6040,779,5261,5109,4941,66,3,78,0,21,152,4222,2617,1605,Southold CDP
24966,36,,3669892,160,6386,2063,6386,6386,793,5593,5356,2125,1674,20,1376,2,159,237,2063,1995,68,South Valley Stream CDP
24974,36,,3670387,160,8086,4482,8086,8086,2728,5358,5159,4883,112,7,128,1,28,199,4482,2973,1509,Springs CDP
24982,36,,3671267,160,1992,709,1992,1992,256,1736,1680,1480,39,3,149,0,9,56,709,691,18,Stewart Manor village
24986,36,,3671608,160,13467,5033,13467,13467,826,12641,12262,10310,217,2,1667,2,64,379,5033,4831,202,Stony Brook CDP
24987,36,,3671620,160,10409,115,10409,10409,1748,8661,8121,2658,3516,3,1829,0,115,540,115,72,43,Stony Brook University CDP
24996,36,,3672554,160,19259,6293,19259,19259,971,18288,17802,10645,118,19,6944,2,74,486,6293,6033,260,Syosset CDP
25002,36,,3673352,160,11472,4006,11472,11472,2411,9061,8798,7890,392,15,430,1,70,263,4006,3853,153,Terryville CDP
25006,36,,3673605,160,2759,1024,2759,2759,121,2638,2575,1245,37,4,1265,1,23,63,1024,984,40,Thomaston village
25021,36,,3675572,160,1505,995,1505,1505,342,1163,1126,987,83,8,35,0,13,37,995,628,367,Tuckahoe CDP
25030,36,,3676089,160,32473,8255,32473,32473,12934,19539,18682,5644,11543,76,1119,12,288,857,8255,7850,405,Uniondale CDP
25034,36,,3676287,160,4358,1706,4358,4358,323,4035,3905,1702,60,0,2119,0,24,130,1706,1642,64,University Gardens CDP
25035,36,,3676331,160,1786,612,1786,1786,87,1699,1645,1323,31,0,278,0,13,54,612,557,55,Upper Brookville village
25044,36,,3676705,160,40634,12925,40634,40634,10672,29962,28415,11450,9343,120,6503,21,978,1547,12925,12494,431,Valley Stream village
25054,36,,3677519,160,1735,573,1735,1735,92,1643,1600,1521,23,0,49,0,7,43,573,563,10,Village of the Branch village
25059,36,,3677772,160,7731,3223,7731,7731,690,7041,6809,6512,160,0,102,0,35,232,3223,2789,434,Wading River CDP
25061,36,,3677805,160,904,916,904,904,142,762,738,688,17,1,23,0,9,24,916,386,530,Wainscott CDP
25070,36,,3678146,160,18613,6228,18613,18613,1399,17214,16836,16211,59,7,495,0,64,378,6228,6062,166,Wantagh CDP
25082,36,,3678575,160,2506,2125,2506,2506,189,2317,2218,2079,28,4,93,1,13,99,2125,958,1167,Water Mill CDP
25097,36,,3679246,160,43213,15139,43213,43213,8202,35011,33804,26727,5291,79,1455,4,248,1207,15139,14523,616,West Babylon CDP
25098,36,,3679301,160,4625,1809,4625,4625,495,4130,3970,3680,133,2,137,0,18,160,1809,1742,67,West Bay Shore CDP
25099,36,,3679444,160,15864,5265,15864,15864,5143,10721,10275,5875,2741,28,1481,4,146,446,5265,5083,182,Westbury village
25109,36,,3680170,160,3621,2206,3621,3621,654,2967,2890,2737,80,4,45,0,24,77,2206,1291,915,Westhampton CDP
25110,36,,3680181,160,2150,2455,2150,2150,319,1831,1787,1694,33,1,49,0,10,44,2455,858,1597,Westhampton Beach village
25111,36,,3680186,160,126,271,126,126,5,121,121,119,0,0,2,0,0,0,271,28,243,West Hampton Dunes village
25113,36,,3680225,160,19835,6315,19835,19835,3956,15879,15317,11322,2249,33,1438,0,275,562,6315,6093,222,West Hempstead CDP
25114,36,,3680258,160,5385,2024,5385,5385,530,4855,4738,4231,108,3,377,0,19,117,2024,1968,56,West Hills CDP
25116,36,,3680302,160,27048,9021,27048,27048,2659,24389,23832,23078,166,6,528,2,52,557,9021,8763,258,West Islip CDP
25125,36,,3680885,160,4872,2109,4872,4872,342,4530,4412,4282,45,2,72,0,11,118,2109,1765,344,West Sayville CDP
25130,36,,3681419,160,5140,1493,5140,5140,878,4262,4012,919,2619,5,395,0,74,250,1493,1442,51,Wheatley Heights CDP
25139,36,,3682117,160,7591,2787,7591,7591,753,6838,6619,5025,81,4,1448,1,60,219,2787,2691,96,Williston Park village
25151,36,,3682744,160,9335,3402,9335,9335,532,8803,8664,6881,127,2,1611,0,43,139,3402,3155,247,Woodbury CDP
25153,36,,3682942,160,18669,5485,18669,18669,960,17709,17418,15791,757,0,586,4,280,291,5485,5199,286,Woodmere CDP
25155,36,,3682986,160,897,306,897,897,28,869,859,811,3,1,33,0,11,10,306,293,13,Woodsburgh village
25161,36,,3683294,160,12990,3548,12990,12990,5487,7503,7153,451,6352,42,163,0,145,350,3548,3290,258,Wyandanch CDP
25164,36,,3683426,160,5974,2480,5974,5974,793,5181,4960,4475,278,8,145,0,54,221,2480,2280,200,Yaphank CDP
46,34,3.0,3400300700,60,6848,2450,6848,6848,456,6392,6165,5261,42,1,837,2,22,227,2450,2327,123,Allendale borough
47,34,3.0,3400301090,60,1762,676,1762,1762,121,1641,1601,949,54,0,593,0,5,40,676,587,89,Alpine borough
48,34,3.0,3400305170,60,28321,9387,28321,28321,9121,19200,18668,9278,1894,30,7222,0,244,532,9387,9097,290,Bergenfield borough
49,34,3.0,3400306490,60,8778,3026,8778,8778,4506,4272,4057,2614,585,15,748,2,93,215,3026,2939,87,Bogota borough
50,34,3.0,3400310480,60,6372,2563,6372,6372,1582,4790,4646,3855,132,10,608,0,41,144,2563,2429,134,Carlstadt borough
51,34,3.0,3400313570,60,25693,11435,25693,25693,8954,16739,16007,11185,656,23,3784,5,354,732,11435,10735,700,Cliffside Park borough
52,34,3.0,3400313810,60,8594,2891,8594,8594,725,7869,7620,4496,83,2,3009,0,30,249,2891,2762,129,Closter borough
53,34,3.0,3400315820,60,9155,3157,9155,9155,630,8525,8301,5305,90,3,2865,1,37,224,3157,3015,142,Cresskill borough
54,34,3.0,3400317530,60,4981,1680,4981,4981,270,4711,4570,2941,41,1,1562,1,24,141,1680,1598,82,Demarest borough
55,34,3.0,3400318400,60,17863,6572,17863,17863,3883,13980,13538,9847,503,12,3081,2,93,442,6572,6408,164,Dumont borough
56,34,3.0,3400319510,60,10022,4585,10022,10022,2556,7466,7225,5028,456,28,1612,2,99,241,4585,4306,279,East Rutherford borough
57,34,3.0,3400320020,60,14336,7315,14336,14336,1959,12377,11878,5934,772,13,5071,1,87,499,7315,6742,573,Edgewater borough
58,34,3.0,3400321300,60,21422,7949,21422,21422,5898,15524,15052,10928,1494,25,2367,0,238,472,7949,7652,297,Elmwood Park borough
59,34,3.0,3400321450,60,7290,2600,7290,7290,948,6342,6164,5328,108,4,709,0,15,178,2600,2482,118,Emerson borough
60,34,3.0,3400321480,60,29308,11563,29308,29308,9639,19669,18909,8497,7180,46,2863,8,315,760,11563,10909,654,Englewood city
61,34,3.0,3400321510,60,5342,1961,5342,5342,341,5001,4863,2201,107,0,2534,0,21,138,1961,1846,115,Englewood Cliffs borough
62,34,3.0,3400322470,60,34927,12649,34927,34927,5369,29558,28781,23305,784,24,4468,10,190,777,12649,12243,406,Fair Lawn borough
63,34,3.0,3400322560,60,15025,5291,15025,15025,10018,5007,4712,3513,240,27,694,0,238,295,5291,5021,270,Fairview borough
64,34,3.0,3400324420,60,40191,19861,40191,40191,5376,34815,33895,15488,1192,21,16949,9,236,920,19861,18451,1410,Fort Lee borough
65,34,3.0,3400324990,60,11079,4051,11079,11079,786,10293,10031,8755,172,2,1051,3,48,262,4051,3722,329,Franklin Lakes borough
66,34,3.0,3400325770,60,32655,12407,32655,32655,12781,19874,19343,16398,1684,48,985,3,225,531,12407,11773,634,Garfield city
67,34,3.0,3400326640,60,12133,4041,12133,12133,848,11285,10843,9037,163,0,1617,1,25,442,4041,3934,107,Glen Rock borough
68,34,3.0,3400328680,60,46030,20290,46030,46030,19220,26810,25849,11053,9558,62,4734,7,435,961,20290,19132,1158,Hackensack city
69,34,3.0,3400330150,60,4741,1643,4741,4741,299,4442,4333,3235,35,0,1049,0,14,109,1643,1594,49,Harrington Park borough
70,34,3.0,3400330420,60,12125,4715,12125,12125,2551,9574,9301,7466,333,7,1421,1,73,273,4715,4535,180,Hasbrouck Heights borough
71,34,3.0,3400330540,60,3343,1148,3343,3343,191,3152,3024,2416,51,0,545,0,12,128,1148,1104,44,Haworth borough
72,34,3.0,3400331920,60,10143,3635,10143,10143,1138,9005,8769,7861,115,3,742,1,47,236,3635,3502,133,Hillsdale borough
73,34,3.0,3400332310,60,4258,1473,4258,4258,302,3956,3842,3475,26,1,321,0,19,114,1473,1416,57,Ho-Ho-Kus borough
74,34,3.0,3400340020,60,9304,3476,9304,9304,1669,7635,7368,3256,202,2,3876,0,32,267,3476,3359,117,Leonia borough
75,34,3.0,3400340680,60,10987,4527,10987,10987,3468,7519,7298,4012,469,6,2717,3,91,221,4527,4351,176,Little Ferry borough
76,34,3.0,3400341100,60,26206,10414,26206,26206,10838,15368,14842,10413,2020,12,2194,0,203,526,10414,9971,443,Lodi borough
77,34,3.0,3400342090,60,22519,9516,22519,22519,6081,16438,15895,13388,688,9,1587,0,223,543,9516,9069,447,Lyndhurst township
78,34,3.0,3400342750,60,25487,10109,25487,25487,2204,23283,22554,18840,686,93,2830,2,103,729,10109,9727,382,Mahwah township
79,34,3.0,3400344880,60,10080,3829,10080,10080,2567,7513,7286,5143,605,32,1442,1,63,227,3829,3717,112,Maywood borough
80,34,3.0,3400346110,60,7014,2887,7014,7014,734,6280,6100,5749,70,6,241,0,34,180,2887,2750,137,Midland Park borough
81,34,3.0,3400347610,60,8436,3115,8436,8436,683,7753,7532,6069,121,0,1324,1,17,221,3115,3016,99,Montvale borough
82,34,3.0,3400347700,60,3133,1149,3133,3133,1292,1841,1789,1391,20,0,351,0,27,52,1149,1120,29,Moonachie borough
83,34,3.0,3400351660,60,16923,6432,16923,16923,3304,13619,13191,8830,796,6,3420,0,139,428,6432,6276,156,New Milford borough
84,34,3.0,3400352320,60,16457,6749,16457,16457,5109,11348,10850,9245,257,7,1173,2,166,498,6749,6525,224,North Arlington borough
85,34,3.0,3400353430,60,4761,1700,4761,4761,569,4192,4060,2714,55,0,1278,0,13,132,1700,1641,59,Northvale borough
86,34,3.0,3400353610,60,5641,2032,5641,5641,418,5223,5091,3196,74,4,1809,0,8,132,2032,1943,89,Norwood borough
87,34,3.0,3400353850,60,12748,4561,12748,12748,1210,11538,11137,10370,119,12,605,1,30,401,4561,4356,205,Oakland borough
88,34,3.0,3400354870,60,5888,2083,5888,5888,380,5508,5350,3673,59,3,1600,0,15,158,2083,1982,101,Old Tappan borough
89,34,3.0,3400354990,60,8244,2850,8244,8244,734,7510,7285,5889,73,7,1277,0,39,225,2850,2782,68,Oradell borough
90,34,3.0,3400355770,60,20292,7668,20292,20292,4862,15430,15174,2903,262,10,11900,6,93,256,7668,7314,354,Palisades Park borough
91,34,3.0,3400355950,60,26698,8786,26698,26698,2810,23888,23119,15556,459,3,6966,0,135,769,8786,8448,338,Paramus borough
92,34,3.0,3400356130,60,8883,3435,8883,8883,936,7947,7729,6972,91,2,631,0,33,218,3435,3310,125,Park Ridge borough
93,34,3.0,3400361680,60,14798,5670,14798,14798,1374,13424,13041,11711,127,4,1134,1,64,383,5670,5488,182,Ramsey borough
94,34,3.0,3400362910,60,11501,4237,11501,11501,3343,8158,7921,4281,200,10,3319,4,107,237,4237,4050,187,Ridgefield borough
95,34,3.0,3400362940,60,13224,5269,13224,13224,6189,7035,6688,4477,649,8,1460,1,93,347,5269,4986,283,Ridgefield Park village
96,34,3.0,3400363000,60,25979,8814,25979,25979,2069,23910,22813,17786,353,7,4556,0,111,1097,8814,8490,324,Ridgewood village
97,34,3.0,3400363360,60,12049,4337,12049,12049,1339,10710,10424,6649,283,8,3434,0,50,286,4337,4191,146,River Edge borough
98,34,3.0,3400363690,60,9909,3644,9909,9909,731,9178,8905,7756,117,8,993,1,30,273,3644,3536,108,River Vale township
99,34,3.0,3400363990,60,5814,2227,5814,5814,1575,4239,4095,3254,208,3,602,0,28,144,2227,2151,76,Rochelle Park township
100,34,3.0,3400364170,60,407,81,407,407,33,374,365,327,10,0,27,0,1,9,81,69,12,Rockleigh borough
101,34,3.0,3400365280,60,18834,7370,18834,18834,3395,15439,14718,11242,631,27,2688,6,124,721,7370,7061,309,Rutherford borough
102,34,3.0,3400365340,60,14294,5618,14294,14294,2748,11546,11285,9554,442,6,1219,2,62,261,5618,5378,240,Saddle Brook township
103,34,3.0,3400365400,60,3372,1458,3372,3372,181,3191,3093,2550,65,11,451,2,14,98,1458,1246,212,Saddle River borough
104,34,3.0,3400368970,60,2701,950,2701,2701,1256,1445,1394,1068,135,1,172,1,17,51,950,922,28,South Hackensack township
105,34,3.0,3400372360,60,41246,14430,41246,41246,8848,32398,31047,16845,9180,46,4378,8,590,1351,14430,13784,646,Teaneck township
106,34,3.0,3400372420,60,15409,5184,15409,15409,1137,14272,13777,8719,240,8,4711,12,87,495,5184,4913,271,Tenafly borough
107,34,3.0,3400372480,60,61,26,61,61,25,36,34,26,7,0,1,0,0,2,26,25,1,Teterboro borough
108,34,3.0,3400375140,60,8353,2785,8353,8353,579,7774,7524,6120,129,1,1240,1,33,250,2785,2658,127,Upper Saddle River borough
109,34,3.0,3400376400,60,10058,3691,10058,10058,1315,8743,8504,7701,126,6,640,0,31,239,3691,3577,114,Waldwick borough
110,34,3.0,3400376490,60,11868,5108,11868,11868,2299,9569,9408,8286,320,11,694,6,91,161,5108,4825,283,Wallington borough
111,34,3.0,3400377135,60,9285,3375,9285,9285,800,8485,8273,7585,87,8,566,0,27,212,3375,3278,97,Washington township
112,34,3.0,3400380270,60,11282,4716,11282,11282,1651,9631,9282,7861,448,6,928,6,33,349,4716,4515,201,Westwood borough
113,34,3.0,3400382300,60,6128,2235,6128,6128,407,5721,5568,4955,46,2,536,1,28,153,2235,2114,121,Woodcliff Lake borough
114,34,3.0,3400382570,60,10137,4057,10137,10137,1738,8399,8175,6141,337,4,1617,0,76,224,4057,3920,137,Wood-Ridge borough
115,34,3.0,3400383050,60,16585,5769,16585,16585,1315,15270,14762,13767,93,4,872,3,23,508,5769,5569,200,Wyckoff township
225,34,13.0,3401304695,60,38222,14970,38222,38222,19181,19041,18188,10310,3092,50,4201,18,517,853,14970,14282,688,Belleville township
226,34,13.0,3401306260,60,53105,21714,53105,53105,16197,36908,34905,19668,9941,84,4495,4,713,2003,21714,20810,904,Bloomfield township
227,34,13.0,3401309250,60,9027,3669,9027,9027,1313,7714,7498,6471,419,4,545,4,55,216,3669,3538,131,Caldwell borough
228,34,13.0,3401311200,60,12980,5042,12980,12980,1465,11515,11160,9754,305,18,1016,2,65,355,5042,4754,288,Cedar Grove township
229,34,13.0,3401313045,60,34447,13590,34447,34447,9983,24464,23316,1073,21627,44,262,7,303,1148,13590,12788,802,City of Orange township
230,34,13.0,3401319390,60,69612,30357,69612,69612,9032,60580,57318,1388,54689,164,501,6,570,3262,30357,27410,2947,East Orange city
231,34,13.0,3401321840,60,2244,806,2244,2244,137,2107,2021,1889,24,2,104,0,2,86,806,750,56,Essex Fells borough
232,34,13.0,3401322385,60,7872,2826,7872,7872,733,7139,6980,6562,38,0,355,1,24,159,2826,2747,79,Fairfield township
233,34,13.0,3401326610,60,7802,2592,7802,7802,558,7244,6749,5825,289,0,587,0,48,495,2592,2529,63,Glen Ridge borough
234,34,13.0,3401334450,60,61176,24984,61176,61176,8985,52191,50124,983,48208,84,413,7,429,2067,24984,22638,2346,Irvington township
235,34,13.0,3401340890,60,31330,10719,31330,31330,1583,29747,28972,18812,953,12,9014,4,177,775,10719,10337,382,Livingston township
236,34,13.0,3401343800,60,25684,9269,25684,25684,2182,23502,22061,13170,7740,30,951,4,166,1441,9269,8866,403,Maplewood township
237,34,13.0,3401346380,60,21710,7241,21710,21710,973,20737,19891,12147,458,15,7123,2,146,846,7241,6908,333,Millburn township
238,34,13.0,3401347500,60,40921,16304,40921,40921,4304,36617,34137,22593,9008,36,2045,11,444,2480,16304,15555,749,Montclair township
239,34,13.0,3401351000,60,311549,118163,311549,311549,113374,198175,185706,24916,147905,572,4871,63,7379,12469,118163,108789,9374,Newark city
240,34,13.0,3401352620,60,6694,2364,6694,6694,405,6289,6092,5476,85,3,518,0,10,197,2364,2258,106,North Caldwell borough
241,34,13.0,3401353680,60,30143,12340,30143,30143,5858,24285,23539,18864,928,38,3518,13,178,746,12340,11887,453,Nutley township
242,34,13.0,3401364590,60,6299,2607,6299,6299,437,5862,5677,4904,192,7,551,1,22,185,2607,2523,84,Roseland borough
243,34,13.0,3401369274,60,18484,6306,18484,18484,1604,16880,15836,10510,3803,11,1228,2,282,1044,6306,5940,366,South Orange Village township
244,34,13.0,3401375815,60,14572,6150,14572,14572,1431,13141,12675,11591,323,11,696,2,52,466,6150,5862,288,Verona township
245,34,13.0,3401378510,60,11012,4137,11012,11012,971,10041,9702,9064,138,0,440,0,60,339,4137,4004,133,West Caldwell township
246,34,13.0,3401379800,60,48843,18746,48843,48843,9647,39196,37101,19155,13916,53,3523,18,436,2095,18746,17738,1008,West Orange township
271,34,17.0,3401703580,60,71686,29727,71686,71686,22101,49585,47559,32697,7116,80,7011,17,638,2026,29727,27867,1860,Bayonne city
272,34,17.0,3401719360,60,2594,920,2594,2594,1619,975,906,511,54,2,257,0,82,69,920,889,31,East Newark borough
273,34,17.0,3401728650,60,12017,5142,12017,12017,7868,4149,3965,2426,343,7,1064,3,122,184,5142,4920,222,Guttenberg town
274,34,17.0,3401730210,60,19450,8594,19450,19450,7759,11691,10905,4690,722,18,4946,0,529,786,8594,8111,483,Harrison town
275,34,17.0,3401732250,60,60419,30202,60419,60419,8542,51877,49797,40657,2106,29,6518,50,437,2080,30202,28175,2027,Hoboken city
276,34,17.0,3401736000,60,292449,130992,292449,292449,72777,219672,210191,69624,54199,638,81425,101,4204,9481,130992,119517,11475,Jersey City city
277,34,17.0,3401736510,60,41999,15392,41999,41999,20465,21534,19514,14889,1246,37,2034,23,1285,2020,15392,14639,753,Kearny town
278,34,17.0,3401752470,60,63361,25079,63361,63361,44900,18461,17603,11235,1403,70,4269,14,612,858,25079,23426,1653,North Bergen township
279,34,17.0,3401766570,60,22181,9316,22181,22181,4700,17481,16997,8760,922,23,7167,3,122,484,9316,8840,476,Secaucus town
280,34,17.0,3401774630,60,68589,26455,68589,68589,56509,12080,11310,6855,1355,99,2394,7,600,770,26455,24511,1944,Union City city
281,34,17.0,3401777930,60,17197,9089,17197,17197,5665,11532,10970,7537,685,15,2594,7,132,562,9089,7969,1120,Weehawken township
282,34,17.0,3401779610,60,52912,21798,52912,52912,40114,12798,12134,6649,1234,51,3745,8,447,664,21798,20544,1254,West New York town
283,34,19.0,3401900550,60,4809,1857,4809,4809,287,4522,4370,4168,65,9,105,1,22,152,1857,1751,106,Alexandria township
284,34,19.0,3401905650,60,3745,1406,3745,3745,209,3536,3413,3267,40,2,92,0,12,123,1406,1347,59,Bethlehem township
285,34,19.0,3401906370,60,792,371,792,792,54,738,714,671,25,0,13,0,5,24,371,340,31,Bloomsbury borough
286,34,19.0,3401909280,60,1005,429,1005,1005,41,964,923,901,1,1,15,0,5,41,429,404,25,Califon borough
287,34,19.0,3401913720,60,2773,1157,2773,2773,281,2492,2414,2115,50,7,235,0,7,78,1157,1114,43,Clinton town
288,34,19.0,3401913750,60,13505,4888,13505,13505,1071,12434,11991,10391,757,8,768,1,66,443,4888,4658,230,Clinton township
289,34,19.0,3401917170,60,4560,1952,4560,4560,264,4296,4132,4006,39,4,64,0,19,164,1952,1795,157,Delaware township
290,34,19.0,3401918820,60,3917,1628,3917,3917,217,3700,3597,3467,35,12,64,0,19,103,1628,1548,80,East Amwell township
291,34,19.0,3401923700,60,4876,1974,4876,4876,1928,2948,2839,2350,133,7,317,1,31,109,1974,1853,121,Flemington borough
292,34,19.0,3401924870,60,3267,1257,3267,3267,214,3053,2935,2828,28,1,58,0,20,118,1257,1172,85,Franklin township
293,34,19.0,3401925350,60,1370,677,1370,1370,104,1266,1209,1156,16,1,23,0,13,57,677,629,48,Frenchtown borough
294,34,19.0,3401926550,60,1682,835,1682,1682,141,1541,1495,1398,62,0,18,1,16,46,835,785,50,Glen Gardner borough
295,34,19.0,3401929460,60,1438,650,1438,1438,126,1312,1259,1186,31,0,34,0,8,53,650,612,38,Hampton borough
296,34,19.0,3401931320,60,3546,1517,3546,3546,340,3206,3100,2928,51,1,113,0,7,106,1517,1424,93,High Bridge borough
297,34,19.0,3401932460,60,5177,2099,5177,5177,220,4957,4780,4694,31,2,44,0,9,177,2099,2001,98,Holland township
298,34,19.0,3401937065,60,3802,1606,3802,3802,143,3659,3531,3436,42,3,40,0,10,128,1606,1476,130,Kingwood township
299,34,19.0,3401938610,60,4139,2265,4139,4139,525,3614,3499,3337,75,3,62,1,21,115,2265,2093,172,Lambertville city
300,34,19.0,3401939630,60,1665,828,1665,1665,144,1521,1471,1328,70,0,70,0,3,50,828,795,33,Lebanon borough
301,34,19.0,3401939660,60,6195,2505,6195,6195,356,5839,5639,5422,64,4,123,0,26,200,2505,2368,137,Lebanon township
302,34,19.0,3401946260,60,1232,556,1232,1232,83,1149,1117,1082,17,2,12,0,4,32,556,524,32,Milford borough
303,34,19.0,3401961920,60,23447,8911,23447,23447,1899,21548,20798,17989,588,16,2104,2,99,750,8911,8613,298,Raritan township
304,34,19.0,3401962250,60,16128,6552,16128,16128,1217,14911,14456,13443,213,8,744,0,48,455,6552,6271,281,Readington township
305,34,19.0,3401970980,60,495,255,495,495,10,485,472,463,0,0,8,0,1,13,255,233,22,Stockton borough
306,34,19.0,3401972510,60,5870,2386,5870,5870,332,5538,5340,5019,54,0,232,0,35,198,2386,2185,201,Tewksbury township
307,34,19.0,3401974420,60,6507,1917,6507,6507,543,5964,5790,5026,481,1,258,1,23,174,1917,1840,77,Union township
308,34,19.0,3401978230,60,3005,1209,3005,3005,180,2825,2725,2596,62,0,61,0,6,100,1209,1147,62,West Amwell township
309,34,21.0,3402119780,60,30045,11690,30045,30045,7750,22295,21572,11910,2653,43,6780,11,175,723,11690,11158,532,East Windsor township
310,34,21.0,3402122185,60,37264,15637,37264,37264,4868,32396,31179,17587,11364,52,1938,16,222,1217,15637,13889,1748,Ewing township
311,34,21.0,3402129310,60,92297,37716,92297,92297,18279,74018,71473,55199,11724,67,4121,14,348,2545,37716,36125,1591,Hamilton township
312,34,21.0,3402131620,60,5900,2216,5900,5900,2166,3734,3521,2739,402,6,333,4,37,213,2216,2097,119,Hightstown borough
313,34,21.0,3402133150,60,1918,828,1918,1918,84,1834,1752,1685,32,4,27,1,3,82,828,787,41,Hopewell borough
314,34,21.0,3402133180,60,17491,6748,17491,17491,1039,16452,15834,13108,586,9,2035,7,89,618,6748,6367,381,Hopewell township
315,34,21.0,3402139510,60,33077,13268,33077,33077,3687,29390,28200,18370,3755,27,5883,8,157,1190,13268,12550,718,Lawrence township
316,34,21.0,3402157600,60,2802,1088,2802,2802,88,2714,2604,2466,45,4,83,0,6,110,1088,1028,60,Pennington borough
317,34,21.0,3402160900,60,30681,10380,30681,30681,3014,27667,26141,17446,1742,17,6732,9,195,1526,10380,9373,1007,Princeton
318,34,21.0,3402163850,60,15476,5687,15476,15476,790,14686,14206,9336,469,21,4307,0,73,480,5687,5479,208,Robbinsville township
319,34,21.0,3402174000,60,90871,34322,90871,90871,40905,49966,48096,8510,38386,144,592,24,440,1870,34322,30139,4183,Trenton city
320,34,21.0,3402180240,60,29518,10862,29518,29518,1507,28011,27108,10224,1206,33,15499,12,134,903,10862,10369,493,West Windsor township
321,34,23.0,3402310750,60,25326,8809,25326,25326,9340,15986,15430,5586,3820,43,5756,6,219,556,8809,8387,422,Carteret borough
322,34,23.0,3402315550,60,3842,1388,3842,3842,183,3659,3543,2612,108,0,803,0,20,116,1388,1323,65,Cranbury township
323,34,23.0,3402318490,60,7637,2727,7637,7637,2820,4817,4587,3390,669,2,430,4,92,230,2727,2620,107,Dunellen borough
324,34,23.0,3402319000,60,49715,18088,49715,49715,4758,44957,43548,27185,2113,41,13894,7,308,1409,18088,17302,786,East Brunswick township
325,34,23.0,3402320230,60,107588,38493,107588,107588,10771,96817,94630,28304,7764,219,57687,27,629,2187,38493,36852,1641,Edison township
326,34,23.0,3402330840,60,2455,1091,2455,2455,282,2173,2081,1846,99,1,119,4,12,92,1091,1052,39,Helmetta borough
327,34,23.0,3402331470,60,15072,6669,15072,15072,2251,12821,12302,8212,1258,12,2643,5,172,519,6669,6320,349,Highland Park borough
328,34,23.0,3402334890,60,5783,2228,5783,5783,1843,3940,3755,3043,401,9,267,1,34,185,2228,2115,113,Jamesburg borough
329,34,23.0,3402345690,60,15049,6053,15049,15049,1510,13539,12830,9259,645,16,2825,2,83,709,6053,5822,231,Metuchen borough
330,34,23.0,3402345900,60,14636,5472,14636,14636,3751,10885,10471,8331,902,14,1159,0,65,414,5472,5302,170,Middlesex borough
331,34,23.0,3402346620,60,7037,2707,7037,7037,810,6227,6013,5555,178,5,246,0,29,214,2707,2613,94,Milltown borough
332,34,23.0,3402347280,60,48594,21504,48594,48594,2746,45848,44992,30185,1655,42,12892,4,214,856,21504,20289,1215,Monroe township
333,34,23.0,3402351210,60,55266,17509,55266,55266,31376,23890,23136,10322,6278,34,5722,30,750,754,17509,15387,2122,New Brunswick city
334,34,23.0,3402352560,60,43905,15585,43905,43905,10676,33229,32086,12614,7737,75,11212,1,447,1143,15585,15025,560,North Brunswick township
335,34,23.0,3402354705,60,66876,26067,66876,66876,9276,57600,55695,40394,4671,71,10119,17,423,1905,26067,25059,1008,Old Bridge township
336,34,23.0,3402358200,60,55436,17855,55436,55436,46149,9287,8747,4153,3483,38,610,12,451,540,17855,17136,719,Perth Amboy city
337,34,23.0,3402359010,60,60804,18904,60804,60804,8276,52528,50980,14251,11771,130,23973,21,834,1548,18904,18071,833,Piscataway township
338,34,23.0,3402359280,60,24084,10281,24084,24084,1449,22635,22029,6696,1579,49,13578,7,120,606,10281,9720,561,Plainsboro township
339,34,23.0,3402365790,60,45345,17695,45345,45345,7868,37477,36187,22366,5743,66,7611,5,396,1290,17695,16910,785,Sayreville borough
340,34,23.0,3402368550,60,9411,3906,9411,9411,2093,7318,7006,5948,529,8,470,1,50,312,3906,3740,166,South Amboy city
341,34,23.0,3402368790,60,47043,16647,47043,47043,3510,43533,42393,16098,3405,85,22604,7,194,1140,16647,16014,633,South Brunswick township
342,34,23.0,3402369390,60,24338,8432,24338,24338,4555,19783,19008,11588,2496,51,4579,5,289,775,8432,8217,215,South Plainfield borough
343,34,23.0,3402369420,60,16118,5977,16118,16118,4198,11920,11075,8804,1000,4,826,2,439,845,5977,5694,283,South River borough
344,34,23.0,3402369810,60,8163,3297,8163,8163,917,7246,6968,6144,272,3,523,0,26,278,3297,3196,101,Spotswood borough
345,34,23.0,3402382000,60,103639,38137,103639,103639,22279,81360,78786,40272,10143,165,27425,24,757,2574,38137,36381,1756,Woodbridge township
346,34,25.0,3402500000,60,0,0,0,0,0,0,0,0,0,0,0,0,0,0,0,0,0,County subdivisions not defined
347,34,25.0,3402500070,60,19329,7967,19329,19329,2642,16687,15955,12820,1883,25,1116,3,108,732,7967,7697,270,Aberdeen township
348,34,25.0,3402500730,60,472,369,472,472,19,453,442,435,4,0,3,0,0,11,369,199,170,Allenhurst borough
349,34,25.0,3402500760,60,1734,724,1734,1734,92,1642,1582,1477,64,3,28,2,8,60,724,694,30,Allentown borough
350,34,25.0,3402501960,60,15188,8274,15188,15188,4079,11109,10602,5284,5059,14,162,4,79,507,8274,7087,1187,Asbury Park city
351,34,25.0,3402502110,60,4414,2092,4414,4414,363,4051,3885,3748,54,0,78,1,4,166,2092,1949,143,Atlantic Highlands borough
352,34,25.0,3402502440,60,1933,1334,1933,1933,141,1792,1747,1702,22,1,20,0,2,45,1334,902,432,Avon-by-the-Sea borough
353,34,25.0,3402504930,60,5907,4066,5907,5907,963,4944,4815,4605,100,5,71,0,34,129,4066,2867,1199,Belmar borough
354,34,25.0,3402506970,60,4282,3221,4282,4282,880,3402,3280,3119,82,7,57,0,15,122,3221,2157,1064,Bradley Beach borough
355,34,25.0,3402507750,60,4982,2176,4982,4982,226,4756,4628,4500,69,3,34,2,20,128,2176,1949,227,Brielle borough
356,34,25.0,3402514560,60,9957,3451,9957,9957,614,9343,9112,8469,105,0,495,1,42,231,3451,3307,144,Colts Neck township
357,34,25.0,3402516660,60,900,925,900,900,120,780,757,731,6,0,6,0,14,23,925,347,578,Deal borough
358,34,25.0,3402519840,60,13597,6182,13597,13597,2005,11592,10768,7572,1644,19,1316,2,215,824,6182,5842,340,Eatontown borough
359,34,25.0,3402521570,60,2346,820,2346,2346,368,1978,1913,1630,66,0,207,0,10,65,820,789,31,Englishtown borough
360,34,25.0,3402522440,60,6269,2074,6269,6269,241,6028,5839,5664,66,6,92,0,11,189,2074,1994,80,Fair Haven borough
361,34,25.0,3402522950,60,1504,630,1504,1504,167,1337,1270,1148,80,0,40,1,1,67,630,616,14,Farmingdale borough
362,34,25.0,3402525200,60,12538,4394,12538,12538,6649,5889,5597,4060,1110,10,330,3,84,292,4394,4143,251,Freehold borough
363,34,25.0,3402525230,60,35369,13500,35369,35369,3636,31733,30665,26399,1506,28,2585,4,143,1068,13500,12897,603,Freehold township
364,34,25.0,3402530690,60,20125,7492,20125,20125,2292,17833,17287,16173,330,16,682,9,77,546,7492,7179,313,Hazlet township
365,34,25.0,3402531500,60,4621,2931,4621,4621,343,4278,4097,3928,80,3,55,0,31,181,2931,2425,506,Highlands borough
366,34,25.0,3402532640,60,17400,6038,17400,17400,989,16411,15814,11994,189,5,3555,0,71,597,6038,5787,251,Holmdel township
367,34,25.0,3402533300,60,53537,19694,53537,53537,6359,47178,45437,40545,1958,39,2621,10,264,1741,19694,18906,788,Howell township
368,34,25.0,3402534200,60,828,400,828,828,19,809,783,768,1,1,4,0,9,26,400,362,38,Interlaken borough
369,34,25.0,3402536480,60,9755,4361,9755,9755,1932,7823,7368,6136,921,13,265,4,29,455,4361,3808,553,Keansburg borough
370,34,25.0,3402536810,60,7204,3427,7204,7204,1572,5632,5397,4754,387,5,226,1,24,235,3427,3202,225,Keyport borough
371,34,25.0,3402537560,60,1697,1081,1697,1697,336,1361,1314,1199,73,0,33,0,9,47,1081,778,303,Lake Como borough
372,34,25.0,3402540770,60,6131,2323,6131,6131,261,5870,5681,5504,25,1,138,0,13,189,2323,2196,127,Little Silver borough
373,34,25.0,3402541010,60,224,154,224,224,8,216,213,206,0,0,6,0,1,3,154,94,60,Loch Arbour village
374,34,25.0,3402541310,60,31667,14944,31667,31667,10332,21335,18469,13133,3177,23,588,6,1542,2866,14944,12391,2553,Long Branch city
375,34,25.0,3402542990,60,40905,14850,40905,40905,3188,37717,36779,32140,876,13,3561,5,184,938,14850,14325,525,Manalapan township
376,34,25.0,3402543050,60,5938,3412,5938,5938,417,5521,5398,5335,10,1,48,3,1,123,3412,2462,950,Manasquan borough
377,34,25.0,3402544070,60,41502,14215,41502,41502,2323,39179,38362,28433,728,37,9020,4,140,817,14215,13774,441,Marlboro township
378,34,25.0,3402544520,60,9565,4010,9565,9565,1431,8134,7760,6359,725,10,594,0,72,374,4010,3849,161,Matawan borough
379,34,25.0,3402545990,60,67106,25859,67106,67106,5112,61994,60114,57142,823,43,1867,7,232,1880,25859,24710,1149,Middletown township
380,34,25.0,3402546560,60,10376,3428,10376,10376,844,9532,9209,8111,415,14,627,0,42,323,3428,3324,104,Millstone township
381,34,25.0,3402547130,60,3174,2006,3174,3174,122,3052,2978,2908,9,5,36,0,20,74,2006,1452,554,Monmouth Beach borough
382,34,25.0,3402549890,60,28061,13278,28061,28061,4052,24009,22917,12558,9419,32,770,4,134,1092,13278,11466,1812,Neptune township
383,34,25.0,3402549920,60,4626,2251,4626,4626,644,3982,3781,3041,627,8,92,0,13,201,2251,2109,142,Neptune City borough
384,34,25.0,3402554270,60,27672,12257,27672,27672,3007,24665,23719,19270,2507,23,1636,5,278,946,12257,11249,1008,Ocean township
385,34,25.0,3402554570,60,6150,2469,6150,6150,611,5539,5366,5155,85,0,70,1,55,173,2469,2346,123,Oceanport borough
386,34,25.0,3402562430,60,12936,5863,12936,12936,4890,8046,7710,6458,966,4,231,1,50,336,5863,5423,440,Red Bank borough
387,34,25.0,3402564410,60,808,331,808,808,103,705,673,630,23,1,12,0,7,32,331,307,24,Roosevelt borough
388,34,25.0,3402565130,60,7343,2624,7343,7343,308,7035,6799,6635,21,2,106,0,35,236,2624,2398,226,Rumson borough
389,34,25.0,3402566240,60,1449,1200,1449,1449,78,1371,1327,1271,13,0,34,0,9,44,1200,793,407,Sea Bright borough
390,34,25.0,3402566330,60,1866,1305,1866,1866,56,1810,1791,1771,9,2,4,1,4,19,1305,786,519,Sea Girt borough
391,34,25.0,3402567350,60,4184,1509,4184,4184,165,4019,3891,3700,61,4,97,1,28,128,1509,1456,53,Shrewsbury borough
392,34,25.0,3402567365,60,1076,544,1076,1076,217,859,798,557,148,2,88,0,3,61,544,505,39,Shrewsbury township
393,34,25.0,3402570110,60,2789,2107,2789,2789,86,2703,2650,2591,11,1,36,0,11,53,2107,1225,882,Spring Lake borough
394,34,25.0,3402570140,60,4890,2998,4890,4890,221,4669,4553,4463,23,4,54,0,9,116,2998,2428,570,Spring Lake Heights borough
395,34,25.0,3402573020,60,19181,8972,19181,19181,1694,17487,16846,14085,1610,16,1041,0,94,641,8972,8500,472,Tinton Falls borough
396,34,25.0,3402574540,60,5723,2183,5723,5723,726,4997,4776,4499,111,10,125,0,31,221,2183,2036,147,Union Beach borough
397,34,25.0,3402574900,60,7273,2604,7273,7273,454,6819,6612,5950,161,5,460,1,35,207,2604,2471,133,Upper Freehold township
398,34,25.0,3402576460,60,26525,10838,26525,26525,1559,24966,24243,23242,461,13,443,11,73,723,10838,10121,717,Wall township
399,34,25.0,3402579310,60,8587,2755,8587,8587,774,7813,7387,6818,275,5,143,0,146,426,2755,2551,204,West Long Branch borough
400,34,27.0,3402706610,60,8815,3555,8815,8815,1409,7406,7044,5600,444,6,953,1,40,362,3555,3412,143,Boonton town
401,34,27.0,3402706640,60,4380,1583,4380,4380,275,4105,3961,3626,47,2,275,0,11,144,1583,1504,79,Boonton township
402,34,27.0,3402709040,60,8047,3403,8047,8047,1409,6638,6414,5987,123,5,284,0,15,224,3403,3258,145,Butler borough
403,34,27.0,3402712100,60,9212,3224,9212,9212,675,8537,8147,7159,89,0,847,0,52,390,3224,3057,167,Chatham borough
404,34,27.0,3402712130,60,10983,4155,10983,10983,514,10469,10078,8549,81,4,1387,0,57,391,4155,3963,192,Chatham township
405,34,27.0,3402712580,60,1681,660,1681,1681,281,1400,1343,1276,5,1,60,0,1,57,660,633,27,Chester borough
406,34,27.0,3402712610,60,7713,2736,7713,7713,539,7174,6878,6377,90,3,381,1,26,296,2736,2575,161,Chester township
407,34,27.0,3402717650,60,17107,6834,17107,17107,1280,15827,15221,13485,317,27,1351,0,41,606,6834,6442,392,Denville township
408,34,27.0,3402718070,60,18460,5972,18460,18460,14209,4251,4059,2726,783,27,423,0,100,192,5972,5752,220,Dover town
409,34,27.0,3402719210,60,11105,4040,11105,11105,876,10229,10050,8450,141,4,1425,0,30,179,4040,3935,105,East Hanover township
410,34,27.0,3402723910,60,12585,4768,12585,12585,929,11656,11264,9410,725,5,1075,8,41,392,4768,4468,300,Florham Park borough
411,34,27.0,3402729550,60,14677,5928,14677,14677,1046,13631,13208,10880,325,10,1948,5,40,423,5928,5694,234,Hanover township
412,34,27.0,3402729700,60,3871,1569,3871,3871,179,3692,3537,3305,41,1,180,0,10,155,1569,1419,150,Harding township
413,34,27.0,3402734980,60,20538,8566,20538,20538,1998,18540,17974,16605,356,18,860,7,128,566,8566,7840,726,Jefferson township
414,34,27.0,3402737110,60,9966,3571,9966,9966,728,9238,8939,8192,91,6,610,0,40,299,3571,3405,166,Kinnelon borough
415,34,27.0,3402740290,60,10915,4181,10915,10915,1469,9446,9160,8040,332,7,719,2,60,286,4181,4063,118,Lincoln Park borough
416,34,27.0,3402741362,60,8629,3240,8629,8629,912,7717,7418,6576,73,6,693,4,66,299,3240,3118,122,Long Hill township
417,34,27.0,3402742510,60,16937,5989,16937,16937,2004,14933,14309,12482,463,11,1262,7,84,624,5989,5705,284,Madison borough
418,34,27.0,3402745330,60,4981,1867,4981,4981,293,4688,4542,4321,29,2,161,0,29,146,1867,1762,105,Mendham borough
419,34,27.0,3402745360,60,6016,2105,6016,6016,330,5686,5410,4929,93,1,347,0,40,276,2105,1986,119,Mendham township
420,34,27.0,3402746860,60,4015,1523,4015,4015,1283,2732,2612,2178,191,3,210,1,29,120,1523,1477,46,Mine Hill township
421,34,27.0,3402747670,60,22450,8206,22450,22450,1578,20872,20264,15009,319,18,4811,6,101,608,8206,7901,305,Montville township
422,34,27.0,3402748090,60,22974,8993,22974,22974,2378,20596,19775,17253,1019,9,1368,9,117,821,8993,8587,406,Morris township
423,34,27.0,3402748210,60,6153,2527,6153,6153,590,5563,5396,4675,219,0,487,0,15,167,2527,2432,95,Morris Plains borough
424,34,27.0,3402748300,60,20180,9213,20180,20180,7367,12813,12287,9198,1961,28,961,11,128,526,9213,8482,731,Morristown town
425,34,27.0,3402748480,60,4472,1429,4472,4472,247,4225,4016,3285,19,4,694,1,13,209,1429,1376,53,Mountain Lakes borough
426,34,27.0,3402748690,60,5909,2915,5909,5909,719,5190,5037,4478,197,3,334,0,25,153,2915,2651,264,Mount Arlington borough
427,34,27.0,3402749080,60,28886,11597,28886,28886,4460,24426,23387,18399,1807,12,3025,3,141,1039,11597,11079,518,Mount Olive township
428,34,27.0,3402750130,60,3375,1490,3375,3375,817,2558,2454,2162,151,12,118,0,11,104,1490,1434,56,Netcong borough
429,34,27.0,3402756460,60,56162,22146,56162,56162,5631,50531,48965,24960,1911,77,21694,6,317,1566,22146,21346,800,Parsippany-Troy Hills township
430,34,27.0,3402758110,60,15571,6688,15571,15571,1224,14347,14002,13461,98,8,395,3,37,345,6688,6379,309,Pequannock township
431,34,27.0,3402761890,60,26504,9676,26504,26504,3791,22713,21808,17750,740,15,3185,1,117,905,9676,9354,322,Randolph township
432,34,27.0,3402763300,60,4107,2009,4107,4107,411,3696,3586,3269,88,0,219,1,9,110,2009,1929,80,Riverdale borough
433,34,27.0,3402764050,60,6598,2645,6598,6598,1355,5243,5054,4273,187,7,553,1,33,189,2645,2561,84,Rockaway borough
434,34,27.0,3402764080,60,25341,10140,25341,25341,3995,21346,20556,17804,731,10,1918,10,83,790,10140,9643,497,Rockaway township
435,34,27.0,3402764980,60,22950,8682,22950,22950,3340,19610,18923,16865,647,8,1292,2,109,687,8682,8356,326,Roxbury township
436,34,27.0,3402775890,60,1582,584,1582,1582,1185,397,374,177,142,4,41,0,10,23,584,571,13,Victory Gardens borough
437,34,27.0,3402777240,60,18197,6577,18197,18197,1359,16838,16339,15209,286,2,760,2,80,499,6577,6343,234,Washington township
438,34,27.0,3402780390,60,7241,2736,7241,7241,3576,3665,3473,2795,225,7,394,1,51,192,2736,2604,132,Wharton borough
439,34,29.0,3402900000,60,0,0,0,0,0,0,0,0,0,0,0,0,0,0,0,0,0,County subdivisions not defined
440,34,29.0,3402903050,60,24296,10724,24296,24296,2460,21836,21009,19461,987,20,471,4,66,827,10724,9758,966,Barnegat township
441,34,29.0,3402903130,60,640,1257,640,640,21,619,605,601,0,0,1,1,2,14,1257,321,936,Barnegat Light borough
442,34,29.0,3402903520,60,930,1024,930,930,27,903,886,865,5,2,11,0,3,17,1024,434,590,Bay Head borough
443,34,29.0,3402903940,60,1027,2600,1027,1027,102,925,909,906,2,0,0,0,1,16,2600,485,2115,Beach Haven borough
444,34,29.0,3402904180,60,10859,3860,10859,10859,1290,9569,9192,8765,239,7,147,2,32,377,3860,3719,141,Beachwood borough
445,34,29.0,3402905305,60,43754,24629,43754,43754,3680,40074,38945,37056,1079,34,637,11,128,1129,24629,21040,3589,Berkeley township
446,34,29.0,3402907420,60,73620,33863,73620,73620,8218,65402,63096,59338,2071,64,1347,10,266,2306,33863,30119,3744,Brick township
447,34,29.0,3402918670,60,1722,797,1722,1722,116,1606,1550,1519,8,12,10,0,1,56,797,676,121,Eagleswood township
448,34,29.0,3402930390,60,391,1178,391,391,6,385,383,381,0,0,2,0,0,2,1178,198,980,Harvey Cedars borough
449,34,29.0,3402934530,60,1650,841,1650,1650,55,1595,1525,1487,8,3,14,1,12,70,841,722,119,Island Heights borough
450,34,29.0,3402934680,60,58544,21626,58544,58544,7543,51001,49160,44395,2769,42,1558,13,383,1841,21626,20470,1156,Jackson township
451,34,29.0,3402937380,60,28655,12483,28655,28655,2000,26655,25770,25091,223,22,334,5,95,885,12483,11086,1397,Lacey township
452,34,29.0,3402937770,60,2636,979,2636,2636,505,2131,2005,1680,236,2,76,0,11,126,979,908,71,Lakehurst borough
453,34,29.0,3402938550,60,135158,34726,135158,135158,15768,119390,117531,111388,3290,91,699,7,2056,1859,34726,31850,2876,Lakewood township
454,34,29.0,3402939390,60,1787,3078,1787,1787,60,1727,1676,1657,8,2,7,0,2,51,3078,924,2154,Lavallette borough
455,34,29.0,3402940560,60,20784,10812,20784,20784,1541,19243,18541,17859,367,24,225,11,55,702,10812,8715,2097,Little Egg Harbor township
456,34,29.0,3402941250,60,3153,8832,3153,3153,102,3051,2994,2953,2,0,29,0,10,57,8832,1593,7239,Long Beach township
457,34,29.0,3402943140,60,45115,26764,45115,45115,3503,41612,40483,37442,1845,50,1017,6,123,1129,26764,24287,2477,Manchester township
458,34,29.0,3402943380,60,331,498,331,331,15,316,312,305,1,0,4,2,0,4,498,158,340,Mantoloking borough
459,34,29.0,3402954300,60,8835,4715,8835,8835,407,8428,8185,8004,72,14,71,2,22,243,4715,3979,736,Ocean township
460,34,29.0,3402954450,60,1932,1153,1932,1932,156,1776,1682,1623,46,0,5,0,8,94,1153,851,302,Ocean Gate borough
461,34,29.0,3402958590,60,2139,931,2139,2139,133,2006,1930,1876,17,0,29,0,8,76,931,840,91,Pine Beach borough
462,34,29.0,3402959790,60,8072,3139,8072,8072,677,7395,7037,6832,107,10,58,2,28,358,3139,2996,143,Plumsted township
463,34,29.0,3402959880,60,18941,8485,18941,18941,1327,17614,17171,16892,58,20,154,11,36,443,8485,7506,979,Point Pleasant borough
464,34,29.0,3402959910,60,4766,3397,4766,4766,475,4291,4182,4084,28,1,57,1,11,109,3397,2045,1352,Point Pleasant Beach borough
465,34,29.0,3402966450,60,2440,2870,2440,2440,566,1874,1760,1573,136,11,36,0,4,114,2870,1148,1722,Seaside Heights borough
466,34,29.0,3402966480,60,1436,2586,1436,1436,55,1381,1352,1332,4,1,9,3,3,29,2586,772,1814,Seaside Park borough
467,34,29.0,3402967110,60,1098,1938,1098,1098,72,1026,1006,988,1,1,11,0,5,20,1938,549,1389,Ship Bottom borough
468,34,29.0,3402969510,60,3643,1141,3643,3643,1040,2603,2406,1778,528,8,75,0,17,197,1141,1081,60,South Toms River borough
469,34,29.0,3402970320,60,28617,14399,28617,28617,2468,26149,25346,24542,316,12,420,5,51,803,14399,11073,3326,Stafford township
470,34,29.0,3402971640,60,1243,2468,1243,1243,44,1199,1183,1169,1,0,8,0,5,16,2468,644,1824,Surf City borough
471,34,29.0,3402973125,60,95438,44526,95438,95438,11593,83845,81127,73671,3155,65,3780,11,445,2718,44526,36291,8235,Toms River township
472,34,29.0,3402974210,60,3577,2110,3577,3577,304,3273,3160,3065,40,5,37,3,10,113,2110,1574,536,Tuckerton borough
473,34,31.0,3403106340,60,7777,3267,7777,7777,1186,6591,6355,5914,114,9,273,0,45,236,3267,3112,155,Bloomingdale borough
474,34,31.0,3403113690,60,90296,33325,90296,90296,36159,54137,52273,39250,3899,89,8414,14,607,1864,33325,31968,1357,Clifton city
475,34,31.0,3403129070,60,9052,3117,9052,9052,4476,4576,4390,2594,1063,9,631,0,93,186,3117,3017,100,Haledon borough
476,34,31.0,3403130570,60,19637,7946,19637,19637,4778,14859,14372,13129,591,12,532,2,106,487,7946,7624,322,Hawthorne borough
477,34,31.0,3403140620,60,13360,4947,13360,13360,2264,11096,10747,9116,834,4,723,2,68,349,4947,4721,226,Little Falls township
478,34,31.0,3403153040,60,8927,3141,8927,8927,1129,7798,7596,6926,290,9,349,1,21,202,3141,3054,87,North Haledon borough
479,34,31.0,3403156550,60,70537,21513,70537,70537,51584,18953,18213,10818,4005,111,2599,8,672,740,21513,20595,918,Passaic city
480,34,31.0,3403157000,60,159732,52885,159732,159732,98863,60869,58644,12523,36667,186,7991,17,1260,2225,52885,50326,2559,Paterson city
481,34,31.0,3403160090,60,11127,4349,11127,11127,2174,8953,8620,7784,170,9,594,1,62,333,4349,4200,149,Pompton Lakes borough
482,34,31.0,3403161170,60,6372,2017,6372,6372,3752,2620,2529,1153,1023,7,294,0,52,91,2017,1932,85,Prospect Park borough
483,34,31.0,3403163150,60,11735,4364,11735,11735,1084,10651,10220,9700,167,109,196,1,47,431,4364,4180,184,Ringwood borough
484,34,31.0,3403173140,60,11065,4026,11065,11065,2408,8657,8431,7297,247,0,838,1,48,226,4026,3899,127,Totowa borough
485,34,31.0,3403176730,60,11317,4597,11317,11317,1659,9658,9308,8371,305,27,543,0,62,350,4597,4392,205,Wanaque borough
486,34,31.0,3403177840,60,54838,19808,54838,54838,6439,48399,47047,39997,1639,26,5167,0,218,1352,19808,19165,643,Wayne township
487,34,31.0,3403179460,60,24862,10570,24862,24862,2259,22603,21770,20895,320,73,378,4,100,833,10570,9638,932,West Milford township
488,34,31.0,3403182423,60,13484,5495,13484,13484,3816,9668,9349,8075,525,8,687,1,53,319,5495,5252,243,Woodland Park borough
504,34,35.0,3403504450,60,8272,4483,8272,8272,804,7468,7231,6160,153,7,882,0,29,237,4483,4222,261,Bedminster township
505,34,35.0,3403505560,60,27830,10665,27830,27830,1595,26235,25305,18040,447,7,6708,6,97,930,10665,10197,468,Bernards township
506,34,35.0,3403505590,60,7893,2953,7893,7893,1272,6621,6351,5927,49,3,343,0,29,270,2953,2756,197,Bernardsville borough
507,34,35.0,3403506790,60,11988,4389,11988,11988,6374,5614,5327,3642,976,15,483,4,207,287,4389,4181,208,Bound Brook borough
508,34,35.0,3403507180,60,14940,5843,14940,14940,1116,13824,13333,11221,438,7,1609,0,58,491,5843,5660,183,Branchburg township
509,34,35.0,3403507720,60,45977,16739,45977,45977,4517,41460,40166,27547,1268,42,11080,9,220,1294,16739,16044,695,Bridgewater township
510,34,35.0,3403522890,60,924,418,924,924,107,817,798,745,8,0,42,0,3,19,418,372,46,Far Hills borough
511,34,35.0,3403524900,60,68364,27335,68364,68364,11938,56426,54362,21405,16531,95,15835,13,483,2064,27335,25860,1475,Franklin township
512,34,35.0,3403527510,60,7281,2510,7281,7281,843,6438,6229,4134,313,5,1743,0,34,209,2510,2436,74,Green Brook township
513,34,35.0,3403531890,60,43276,15955,43276,43276,4067,39209,37806,25625,2040,30,9889,9,213,1403,15955,15296,659,Hillsborough township
514,34,35.0,3403543620,60,10953,4290,10953,10953,3464,7489,7173,6255,514,14,337,7,46,316,4290,4092,198,Manville borough
515,34,35.0,3403546590,60,448,168,448,448,34,414,397,380,7,1,9,0,0,17,168,153,15,Millstone borough
516,34,35.0,3403547580,60,23690,8390,23690,23690,1314,22376,21567,11391,721,15,9352,5,83,809,8390,8003,387,Montgomery township
517,34,35.0,3403553280,60,22808,8055,22808,22808,11548,11260,10699,4998,4390,17,1064,8,222,561,8055,7715,340,North Plainfield borough
518,34,35.0,3403557300,60,2558,937,2558,2558,319,2239,2178,2061,60,0,50,0,7,61,937,887,50,Peapack and Gladstone borough
519,34,35.0,3403561980,60,7835,3167,7835,7835,1672,6163,5957,4120,247,6,1558,1,25,206,3167,2993,174,Raritan borough
520,34,35.0,3403564320,60,743,298,743,743,70,673,648,604,3,1,36,0,4,25,298,278,20,Rocky Hill borough
521,34,35.0,3403568460,60,12346,5387,12346,12346,3113,9233,8805,6073,1201,22,1433,2,74,428,5387,5050,337,Somerville borough
522,34,35.0,3403568730,60,4863,1941,4863,4863,1537,3326,3178,2212,528,7,395,1,35,148,1941,1854,87,South Bound Brook borough
523,34,35.0,3403576940,60,15923,5614,15923,15923,1156,14767,14200,10569,277,6,3249,4,95,567,5614,5374,240,Warren township
524,34,35.0,3403577600,60,6449,2285,6449,6449,519,5930,5669,4302,309,6,1001,0,51,261,2285,2175,110,Watchung borough
525,34,37.0,3403701330,60,595,277,595,595,59,536,509,484,17,1,5,1,1,27,277,254,23,Andover borough
526,34,37.0,3403701360,60,5996,2219,5996,5996,530,5466,5272,4827,187,10,211,0,37,194,2219,2102,117,Andover township
527,34,37.0,3403707300,60,791,372,791,791,53,738,709,682,8,2,17,0,0,29,372,334,38,Branchville borough
528,34,37.0,3403709160,60,8028,3292,8028,8028,683,7345,7063,6756,132,2,128,0,45,282,3292,2946,346,Byram township
529,34,37.0,3403724810,60,5302,2550,5302,5302,297,5005,4830,4685,42,13,75,0,15,175,2550,2084,466,Frankford township
530,34,37.0,3403724930,60,4912,2177,4912,4912,661,4251,4042,3822,108,6,78,0,28,209,2177,2047,130,Franklin borough
531,34,37.0,3403725140,60,3235,1256,3235,3235,181,3054,2960,2866,20,5,58,0,11,94,1256,1192,64,Fredon township
532,34,37.0,3403727420,60,3627,1291,3627,3627,306,3321,3224,3071,65,2,62,0,24,97,1291,1244,47,Green township
533,34,37.0,3403729220,60,3266,1539,3266,3266,318,2948,2814,2603,98,7,94,0,12,134,1539,1452,87,Hamburg borough
534,34,37.0,3403729490,60,4893,2186,4893,4893,267,4626,4464,4335,26,5,79,0,19,162,2186,1996,190,Hampton township
535,34,37.0,3403729850,60,8125,3847,8125,8125,647,7478,7210,6705,244,10,215,0,36,268,3847,3371,476,Hardyston township
536,34,37.0,3403732910,60,14362,6393,14362,14362,2544,11818,11382,10487,423,34,353,3,82,436,6393,5724,669,Hopatcong borough
537,34,37.0,3403737440,60,2358,921,2358,2358,164,2194,2134,2083,20,1,13,0,17,60,921,881,40,Lafayette township
538,34,37.0,3403747430,60,3792,1832,3792,3792,370,3422,3275,3108,71,6,69,0,21,147,1832,1560,272,Montague township
539,34,37.0,3403751930,60,8374,3687,8374,8374,1363,7011,6669,5894,432,22,292,0,29,342,3687,3400,287,Newton town
540,34,37.0,3403754660,60,2258,927,2258,2258,265,1993,1895,1835,20,3,28,0,9,98,927,873,54,Ogdensburg borough
541,34,37.0,3403765700,60,1977,979,1977,1977,101,1876,1803,1755,9,0,31,0,8,73,979,806,173,Sandyston township
542,34,37.0,3403769690,60,19600,7614,19600,19600,1570,18030,17330,16299,309,10,620,4,88,700,7614,7032,582,Sparta township
543,34,37.0,3403770380,60,3526,1507,3526,3526,492,3034,2916,2724,74,3,93,2,20,118,1507,1432,75,Stanhope borough
544,34,37.0,3403770890,60,4004,1943,4004,4004,202,3802,3691,3609,23,4,38,1,16,111,1943,1609,334,Stillwater township
545,34,37.0,3403771670,60,2024,1013,2024,2024,284,1740,1656,1576,47,0,26,0,7,84,1013,901,112,Sussex borough
546,34,37.0,3403775740,60,22358,10538,22358,22358,2163,20195,19420,18762,331,37,206,0,84,775,10538,8612,1926,Vernon township
547,34,37.0,3403776640,60,7,5,7,7,2,5,5,5,0,0,0,0,0,0,5,5,0,Walpack township
548,34,37.0,3403776790,60,10811,4344,10811,10811,788,10023,9618,9274,152,8,127,0,57,405,4344,4058,286,Wantage township
549,34,39.0,3403905320,60,13285,4660,13285,13285,1140,12145,11675,9278,242,5,2065,1,84,470,4660,4484,176,Berkeley Heights township
550,34,39.0,3403913150,60,15544,6114,15544,15544,1945,13599,13274,12346,231,4,644,3,46,325,6114,5919,195,Clark township
551,34,39.0,3403915640,60,23847,9264,23847,23847,2443,21404,20618,18946,653,6,903,4,106,786,9264,8891,373,Cranford township
552,34,39.0,3403921000,60,137298,48439,137298,137298,90233,47065,43886,16553,22261,152,2757,18,2145,3179,48439,46314,2125,Elizabeth city
553,34,39.0,3403922860,60,7774,2829,7774,7774,729,7045,6719,5604,386,3,713,2,11,326,2829,2725,104,Fanwood borough
554,34,39.0,3403925800,60,4454,2016,4454,4454,670,3784,3657,3436,69,1,119,0,32,127,2016,1920,96,Garwood borough
555,34,39.0,3403931980,60,22456,7844,22456,22456,5189,17267,16174,3787,11327,25,498,0,537,1093,7844,7517,327,Hillside township
556,34,39.0,3403936690,60,8427,3019,8427,8427,1933,6494,6226,5524,219,8,435,2,38,268,3019,2932,87,Kenilworth borough
557,34,39.0,3403940350,60,43738,16452,43738,43738,15055,28683,27529,13744,11722,33,1484,5,541,1154,16452,15609,843,Linden city
558,34,39.0,3403948510,60,7020,2564,7020,7020,667,6353,6150,5498,134,2,466,0,50,203,2564,2399,165,Mountainside borough
559,34,39.0,3403951810,60,13650,5497,13650,13650,1251,12399,11910,9429,241,7,2171,2,60,489,5497,5071,426,New Providence borough
560,34,39.0,3403959190,60,54586,17125,54586,54586,29792,24794,23663,3383,19034,104,500,8,634,1131,17125,16308,817,Plainfield city
561,34,39.0,3403961530,60,29556,12363,29556,29556,8867,20689,19699,8913,8892,40,1622,4,228,990,12363,11544,819,Rahway city
562,34,39.0,3403964620,60,22695,8431,22695,22695,7900,14795,14120,2474,10800,37,580,7,222,675,8431,8008,423,Roselle borough
563,34,39.0,3403964650,60,13967,5346,13967,13967,5293,8674,8326,5725,1186,7,1271,1,136,348,5346,5213,133,Roselle Park borough
564,34,39.0,3403966060,60,24968,9103,24968,24968,2579,22389,21431,16297,2365,14,2610,0,145,958,9103,8807,296,Scotch Plains township
565,34,39.0,3403970020,60,17178,7105,17178,17178,2235,14943,14324,11140,1504,7,1541,1,131,619,7105,6820,285,Springfield township
566,34,39.0,3403971430,60,22719,8365,22719,22719,3313,19406,18421,15016,895,8,2371,5,126,985,8365,7905,460,Summit city
567,34,39.0,3403974480,60,59728,21571,59728,59728,11899,47829,45761,19146,19296,68,6472,13,766,2068,21571,20672,899,Union township
568,34,39.0,3403979040,60,31032,11095,31032,31032,2247,28785,27514,23819,790,19,2735,1,150,1271,11095,10622,473,Westfield town
569,34,39.0,3403981650,60,1423,706,1423,1423,139,1284,1212,1187,14,2,6,1,2,72,706,692,14,Winfield township
570,34,41.0,3404100670,60,5335,2467,5335,5335,465,4870,4701,4258,227,7,181,0,28,169,2467,2358,109,Allamuchy township
571,34,41.0,3404101030,60,2328,1047,2328,2328,211,2117,2046,1935,65,1,41,1,3,71,1047,972,75,Alpha borough
572,34,41.0,3404104990,60,2520,1143,2520,2520,198,2322,2233,2166,28,7,20,0,12,89,1143,1031,112,Belvidere town
573,34,41.0,3404106160,60,5704,2245,5704,5704,332,5372,5180,4986,67,9,74,4,40,192,2245,2106,139,Blairstown township
574,34,41.0,3404124960,60,2968,1219,2968,2968,174,2794,2683,2519,54,0,92,5,13,111,1219,1124,95,Franklin township
575,34,41.0,3404125320,60,2199,833,2199,2199,124,2075,1997,1956,26,0,11,0,4,78,833,780,53,Frelinghuysen township
576,34,41.0,3404128260,60,5473,1868,5473,5473,546,4927,4707,3792,474,1,416,0,24,220,1868,1798,70,Greenwich township
577,34,41.0,3404128710,60,10248,3945,10248,10248,2393,7855,7579,6781,341,11,402,1,43,276,3945,3769,176,Hackettstown town
578,34,41.0,3404129820,60,1598,612,1598,1598,105,1493,1440,1414,12,1,11,0,2,53,612,578,34,Hardwick township
579,34,41.0,3404130090,60,2503,1066,2503,2503,57,2446,2365,2305,29,1,21,0,9,81,1066,993,73,Harmony township
580,34,41.0,3404133060,60,1835,806,1835,1835,139,1696,1627,1594,8,0,16,0,9,69,806,743,63,Hope township
581,34,41.0,3404133930,60,5469,2439,5469,5469,444,5025,4836,4543,143,2,122,1,25,189,2439,2325,114,Independence township
582,34,41.0,3404137320,60,2894,1197,2894,2894,197,2697,2542,2469,22,4,37,0,10,155,1197,1103,94,Knowlton township
583,34,41.0,3404140110,60,2670,1144,2670,2670,156,2514,2424,2323,40,6,41,0,14,90,1144,1022,122,Liberty township
584,34,41.0,3404141490,60,8776,3859,8776,8776,803,7973,7726,6496,714,7,440,4,65,247,3859,3588,271,Lopatcong township
585,34,41.0,3404143320,60,7781,3351,7781,7781,1153,6628,6307,5599,408,7,251,0,42,321,3351,3139,212,Mansfield township
586,34,41.0,3404155530,60,2444,1040,2444,2444,186,2258,2130,2055,47,0,24,0,4,128,1040,967,73,Oxford township
587,34,41.0,3404158350,60,15249,6659,15249,15249,2552,12697,11887,9686,1907,6,219,1,68,810,6659,6024,635,Phillipsburg town
588,34,41.0,3404159820,60,3241,1428,3241,3241,215,3026,2878,2731,89,2,43,2,11,148,1428,1310,118,Pohatcong township
589,34,41.0,3404177270,60,7299,3219,7299,7299,1002,6297,6025,5198,540,15,230,7,35,272,3219,3002,217,Washington borough
590,34,41.0,3404177300,60,6492,2553,6492,6492,533,5959,5751,5327,238,5,153,2,26,208,2553,2426,127,Washington township
591,34,41.0,3404180570,60,4606,2317,4606,4606,240,4366,4274,4122,94,4,41,0,13,92,2317,2169,148,White township
