id,name,stco,subreg,H_Occ,H_Tot,H_Vac,P_18p,P_Asian,P_Black,P_Hisp,P_NonHisp,P_Other,P_Tot,P_Two,P_White,geotype,yr
9001,"Fairfield County, Connecticut",9001,CT,354084,378479,24395,743170,50751,99992,205351,752068,12263,957419,36937,552125,county,2020
9005,"Litchfield County, Connecticut",9005,CT,77502,87615,10113,151879,3434,2957,14580,170606,1262,185186,7352,155601,county,2020
9009,"New Haven County, Connecticut",9009,CT,343437,369178,25741,690994,36995,110273,170081,694754,7613,864835,30185,509688,county,2020
36005,"Bronx County, New York",36005,NYC,522450,547030,24580,1123075,67766,419393,806463,666191,19866,1472654,28370,130796,county,2020
36027,"Dutchess County, New York",36027,MHV,111927,122009,10082,239623,10635,30126,42224,253687,2410,295911,12021,198495,county,2020
36047,"Kings County, New York",36047,NYC,1009804,1077654,67850,2140371,370776,729696,516426,2219648,37579,2736074,113170,968427,county,2020
36059,"Nassau County, New York",36059,LI,455482,476732,21250,1098884,163165,147216,256425,1139349,13786,1395774,35728,779454,county,2020
36061,"New York County, New York",36061,NYC,817782,913926,96144,1461740,219624,199592,402640,1291611,16112,1694251,62989,793294,county,2020
36071,"Orange County, New York",36071,MHV,135746,146879,11133,299303,11665,41341,89744,311566,12870,401310,13842,231848,county,2020
36079,"Putnam County, New York",36079,LHV,35329,38308,2979,78270,2146,2425,17760,79908,653,97668,2742,71942,county,2020
36081,"Queens County, New York",36081,NYC,847210,896333,49123,1949469,656583,381375,667861,1737603,66175,2405464,84112,549358,county,2020
36085,"Richmond County, New York",36085,NYC,173202,183692,10490,389393,58753,46835,96960,398787,3900,495747,11318,277981,county,2020
36087,"Rockland County, New York",36087,LHV,102948,108068,5120,239516,20413,33775,66451,271878,3877,338329,7700,206113,county,2020
36103,"Suffolk County, New York",36103,LI,516872,578940,62068,1214412,65019,107268,332959,1192961,12822,1525920,40522,967330,county,2020
36105,"Sullivan County, New York",36105,MHV,30183,49125,18942,61786,1569,6069,14007,64617,786,78624,3502,52691,county,2020
36111,"Ulster County, New York",36111,MHV,73321,85853,12532,149457,3778,10152,21119,160732,1569,181851,8538,136695,county,2020
36119,"Westchester County, New York",36119,LHV,367296,388963,21667,782442,64907,131010,269334,735123,9818,1004457,31704,497684,county,2020
34003,"Bergen County, New Jersey",34003,INJ,350664,367383,16719,755234,157500,49909,204683,751049,7405,955732,24316,511919,county,2020
34013,"Essex County, New Jersey",34013,INJ,312913,334896,21983,661508,46957,324081,210353,653375,13485,863728,33727,235125,county,2020
34017,"Hudson County, New Jersey",34017,INJ,289408,312706,23298,582751,123424,71385,293019,431835,10512,724854,19984,206530,county,2020
34019,"Hunterdon County, New Jersey",34019,ONJ,48978,51687,2709,104020,5677,3030,10929,118018,635,128947,4009,104667,county,2020
34021,"Mercer County, New Jersey",34021,ONJ,139361,150442,11081,304672,48330,72364,84177,303163,2412,387340,11477,168580,county,2020
34023,"Middlesex County, New Jersey",34023,INJ,300547,315521,14974,680009,227973,78719,193687,669475,8428,863162,21197,333158,county,2020
34025,"Monmouth County, New Jersey",34025,ONJ,244630,268912,24282,511670,36008,39178,80730,562885,5145,643615,21729,460825,county,2020
34027,"Morris County, New Jersey",34027,INJ,188496,197722,9226,403593,57700,15586,76661,432624,2803,509285,15360,341175,county,2020
34029,"Ocean County, New Jersey",34029,ONJ,238812,294429,55617,482600,11339,17649,66329,570900,4533,637229,16801,520578,county,2020
34031,"Passaic County, New Jersey",34031,INJ,177075,185367,8292,403816,30209,51859,224030,300088,4254,524118,10224,203542,county,2020
34035,"Somerset County, New Jersey",34035,INJ,125598,131822,6224,271204,67098,30480,57379,287982,2390,345361,10603,177411,county,2020
34037,"Sussex County, New Jersey",34037,ONJ,55915,62709,6794,116445,2918,2858,14310,129911,868,144221,5020,118247,county,2020
34039,"Union County, New Jersey",34039,INJ,200372,209908,9536,440856,31963,112261,195519,379826,6820,575345,17537,211245,county,2020
34041,"Warren County, New Jersey",34041,ONJ,43327,46457,3130,87819,2886,5573,12225,97407,624,109632,4069,84255,county,2020
CT,Connecticut,,CT,775023,835272,60249,1586043,91180,213222,390012,1617428,21138,2007440,74474,1217414,subregion,2020
INJ,Inner New Jersey,,INJ,1945073,2055325,110252,4198971,742824,734280,1455331,3906254,56097,5361585,152948,2220105,subregion,2020
LHV,Lower Hudson Valley,,LHV,505573,535339,29766,1100228,87466,167210,353545,1086909,14348,1440454,42146,775739,subregion,2020
LI,Long Island,,LI,972354,1055672,83318,2313296,228184,254484,589384,2332310,26608,2921694,76250,1746784,subregion,2020
MHV,Mid Hudson Valley,,MHV,351177,403866,52689,750169,27647,87688,167094,790602,17635,957696,37903,619729,subregion,2020
NYC,New York City,,NYC,3370448,3618635,248187,7064048,1373502,1776891,2490350,6313840,143632,8804190,299959,2719856,subregion,2020
ONJ,Outer New Jersey,,ONJ,771023,874636,103613,1607226,107158,140652,268700,1782284,14217,2050984,63105,1457152,subregion,2020
36005CS,BX Central and South,36005,NYC,169664,176934,7270,370194,38360,121583,275049,213671,7689,488720,9834,36205,municipality,2020
36005NE,BX North and East,36005,NYC,102721,108236,5515,216423,8026,125441,87739,184807,4184,272546,6824,40332,municipality,2020
36005W,BX West,36005,NYC,250065,261860,11795,536458,21380,172369,443675,267713,7993,711388,11712,54259,municipality,2020
36047C,BK Central,36047,NYC,219831,233830,13999,478585,22709,360365,58718,536659,8666,595377,32568,112351,municipality,2020
36047E,BK East,36047,NYC,105312,111587,6275,229845,16180,162190,96051,207726,5680,303777,13746,9930,municipality,2020
36047N,BK North,36047,NYC,181849,196281,14432,372730,27094,90632,135560,330752,6608,466312,17963,188455,municipality,2020
36047S,BK Southern,36047,NYC,333754,353658,19904,721546,222461,72951,129656,817911,12537,947567,30650,479312,municipality,2020
36047W,BK West,36047,NYC,169058,182298,13240,337665,82332,43558,96441,326600,4088,423041,18243,178379,municipality,2020
36061E,MN East Side,36061,NYC,213958,243538,29580,347123,55392,12077,33055,362767,3343,395822,14885,277070,municipality,2020
36061L,MN Lower,36061,NYC,163598,182984,19386,293659,76373,18011,52885,281091,2988,333976,13396,170323,municipality,2020
36061U,MN Upper,36061,NYC,232977,247817,14840,476093,33681,142810,258287,313746,5991,572033,18636,112628,municipality,2020
36061WM,MN West Side and Midtown,36061,NYC,207249,239587,32338,344865,54178,26694,58413,334007,3790,392420,16072,233273,municipality,2020
36081NE,QN Northeast,36081,NYC,200522,211569,11047,457353,276442,27810,93934,464143,6103,558077,11465,142323,municipality,2020
36081NW,QN Northwest,36081,NYC,371899,394292,22393,810745,235705,40649,381069,609265,11786,990334,25659,295466,municipality,2020
36081SE,QN Southeast,36081,NYC,185459,196342,10883,455210,77796,284721,98648,476151,22313,574799,28505,62816,municipality,2020
36081SW,QN Southwest,36081,NYC,89330,94130,4800,226161,66640,28195,94210,188044,25973,282254,18483,48753,municipality,2020
36085C,SI Central,36085,NYC,48976,51972,2996,112691,25915,4948,20379,121197,1065,141576,2850,86419,municipality,2020
36085N,SI North,36085,NYC,64940,69066,4126,145447,20632,40093,58955,130708,1995,189663,5428,62560,municipality,2020
36085S,SI South,36085,NYC,59286,62654,3368,131255,12206,1794,17626,146882,840,164508,3040,129002,municipality,2020
900104720,"Bethel town, Fairfield County, Connecticut",9001,CT,7653,7980,327,15901,1213,565,2622,17736,426,20358,1123,14409,municipality,2020
900108070,"Bridgeport town, Fairfield County, Connecticut",9001,CT,54261,58874,4613,113716,4024,48690,62853,85801,3197,148654,5486,24404,municipality,2020
900108980,"Brookfield town, Fairfield County, Connecticut",9001,CT,6695,7116,421,13824,946,299,1470,16058,193,17528,835,13785,municipality,2020
900118500,"Danbury town, Fairfield County, Connecticut",9001,CT,31762,33562,1800,68248,5339,5630,28690,57828,3075,86518,5821,37963,municipality,2020
900118850,"Darien town, Fairfield County, Connecticut",9001,CT,6814,7265,451,14668,1197,148,1234,20265,109,21499,795,18016,municipality,2020
900123890,"Easton town, Fairfield County, Connecticut",9001,CT,2605,2756,151,5790,328,106,444,7161,41,7605,278,6408,municipality,2020
900126620,"Fairfield town, Fairfield County, Connecticut",9001,CT,20820,21982,1162,47703,2906,1110,4806,56706,446,61512,2209,50035,municipality,2020
900133620,"Greenwich town, Fairfield County, Connecticut",9001,CT,23316,25677,2361,47939,4726,1157,8135,55383,654,63518,2969,45877,municipality,2020
900148620,"Monroe town, Fairfield County, Connecticut",9001,CT,6690,6918,228,14549,660,400,1470,17355,109,18825,638,15548,municipality,2020
900150580,"New Canaan town, Fairfield County, Connecticut",9001,CT,6923,7502,579,14574,1159,244,1121,19501,98,20622,831,17169,municipality,2020
900150860,"New Fairfield town, Fairfield County, Connecticut",9001,CT,4948,5635,687,10729,230,153,1201,12378,112,13579,445,11438,municipality,2020
900152980,"Newtown town, Fairfield County, Connecticut",9001,CT,9766,10322,556,21295,734,592,1757,25416,158,27173,982,22950,municipality,2020
900156060,"Norwalk town, Fairfield County, Connecticut",9001,CT,36078,38152,2074,72682,4772,11074,27629,63555,768,91184,2627,44314,municipality,2020
900163480,"Redding town, Fairfield County, Connecticut",9001,CT,3356,3664,308,6918,243,75,465,8300,72,8765,330,7580,municipality,2020
900163970,"Ridgefield town, Fairfield County, Connecticut",9001,CT,8968,9506,538,18659,1261,214,1506,23527,181,25033,915,20956,municipality,2020
900168170,"Shelton town, Fairfield County, Connecticut",9001,CT,16356,17174,818,33739,1800,1812,4080,36789,328,40869,1148,31701,municipality,2020
900168310,"Sherman town, Fairfield County, Connecticut",9001,CT,1425,1834,409,2925,51,25,159,3368,7,3527,136,3149,municipality,2020
900173070,"Stamford town, Fairfield County, Connecticut",9001,CT,53241,56953,3712,108715,11453,16201,37958,97512,1180,135470,3802,64876,municipality,2020
900174190,"Stratford town, Fairfield County, Connecticut",9001,CT,20435,21643,1208,41976,1310,9136,11107,41248,476,52355,1919,28407,municipality,2020
900177200,"Trumbull town, Fairfield County, Connecticut",9001,CT,12622,13159,537,27767,2509,1642,3505,33322,300,36827,1219,27652,municipality,2020
900183430,"Weston town, Fairfield County, Connecticut",9001,CT,3420,3671,251,7470,575,143,631,9723,81,10354,481,8443,municipality,2020
900183500,"Westport town, Fairfield County, Connecticut",9001,CT,9720,10567,847,19943,1703,375,1592,25549,167,27141,1135,22169,municipality,2020
900186370,"Wilton town, Fairfield County, Connecticut",9001,CT,6210,6567,357,13440,1612,201,916,17587,85,18503,813,14876,municipality,2020
900502760,"Barkhamsted town, Litchfield County, Connecticut",9005,CT,1457,1566,109,2964,26,11,84,3563,17,3647,127,3382,municipality,2020
900504930,"Bethlehem town, Litchfield County, Connecticut",9005,CT,1398,1605,207,2854,22,31,104,3281,16,3385,108,3104,municipality,2020
900508210,"Bridgewater town, Litchfield County, Connecticut",9005,CT,728,863,135,1455,10,14,41,1621,9,1662,68,1520,municipality,2020
900510940,"Canaan town, Litchfield County, Connecticut",9005,CT,480,639,159,898,1,15,56,1024,10,1080,23,975,municipality,2020
900516050,"Colebrook town, Litchfield County, Connecticut",9005,CT,584,694,110,1160,4,5,31,1330,9,1361,55,1257,municipality,2020
900517240,"Cornwall town, Litchfield County, Connecticut",9005,CT,732,1002,270,1355,24,4,61,1506,6,1567,39,1433,municipality,2020
900532290,"Goshen town, Litchfield County, Connecticut",9005,CT,1285,1708,423,2607,32,16,120,3030,7,3150,106,2869,municipality,2020
900537280,"Harwinton town, Litchfield County, Connecticut",9005,CT,2179,2313,134,4371,31,35,172,5312,21,5484,180,5045,municipality,2020
900540290,"Kent town, Litchfield County, Connecticut",9005,CT,1285,1687,402,2538,85,31,156,2863,31,3019,130,2586,municipality,2020
900543370,"Litchfield town, Litchfield County, Connecticut",9005,CT,3467,3966,499,6859,114,51,276,7916,25,8192,263,7463,municipality,2020
900549460,"Morris town, Litchfield County, Connecticut",9005,CT,933,1253,320,1874,14,12,67,2189,6,2256,64,2093,municipality,2020
900551350,"New Hartford town, Litchfield County, Connecticut",9005,CT,2681,2968,287,5413,75,18,177,6481,40,6658,243,6105,municipality,2020
900552630,"New Milford town, Litchfield County, Connecticut",9005,CT,10994,11928,934,22380,958,639,3241,24874,320,28115,1442,21515,municipality,2020
900553470,"Norfolk town, Litchfield County, Connecticut",9005,CT,715,932,217,1329,18,8,48,1540,6,1588,59,1449,municipality,2020
900554030,"North Canaan town, Litchfield County, Connecticut",9005,CT,1399,1582,183,2654,15,36,266,2945,16,3211,131,2747,municipality,2020
900560750,"Plymouth town, Litchfield County, Connecticut",9005,CT,4856,5151,295,9619,145,141,739,10932,45,11671,544,10057,municipality,2020
900565930,"Roxbury town, Litchfield County, Connecticut",9005,CT,979,1163,184,1930,29,9,70,2190,11,2260,88,2053,municipality,2020
900566420,"Salisbury town, Litchfield County, Connecticut",9005,CT,1717,2519,802,3431,78,80,197,3997,44,4194,152,3643,municipality,2020
900567960,"Sharon town, Litchfield County, Connecticut",9005,CT,1238,1724,486,2338,44,35,98,2582,30,2680,83,2390,municipality,2020
900575730,"Thomaston town, Litchfield County, Connecticut",9005,CT,3145,3340,195,6083,91,58,340,7102,40,7442,276,6637,municipality,2020
900576570,"Torrington town, Litchfield County, Connecticut",9005,CT,15490,17040,1550,28966,891,1060,5433,30082,226,35515,1597,26308,municipality,2020
900579510,"Warren town, Litchfield County, Connecticut",9005,CT,580,790,210,1106,14,1,56,1295,12,1351,57,1211,municipality,2020
900579720,"Washington town, Litchfield County, Connecticut",9005,CT,1526,2056,530,3033,49,24,219,3427,29,3646,108,3217,municipality,2020
900580490,"Watertown town, Litchfield County, Connecticut",9005,CT,8742,9137,395,17955,399,399,1390,20715,145,22105,651,19121,municipality,2020
900586440,"Winchester town, Litchfield County, Connecticut",9005,CT,4661,5405,744,8553,124,116,684,9540,65,10224,423,8812,municipality,2020
900587910,"Woodbury town, Litchfield County, Connecticut",9005,CT,4251,4584,333,8154,141,108,454,9269,76,9723,335,8609,municipality,2020
900900000,"County subdivisions not defined, New Haven County, Connecticut",9009,CT,0,0,0,0,0,0,0,0,0,0,0,0,municipality,2020
900901220,"Ansonia town, New Haven County, Connecticut",9009,CT,7570,8104,534,14944,382,2474,4493,14425,141,18918,740,10688,municipality,2020
900903250,"Beacon Falls town, New Haven County, Connecticut",9009,CT,2485,2618,133,4884,84,124,413,5587,52,6000,201,5126,municipality,2020
900904580,"Bethany town, New Haven County, Connecticut",9009,CT,1948,2039,91,4255,248,101,182,5115,28,5297,177,4561,municipality,2020
900907310,"Branford town, New Haven County, Connecticut",9009,CT,13069,14180,1111,24215,1311,654,1862,26411,172,28273,847,23427,municipality,2020
900914160,"Cheshire town, New Haven County, Connecticut",9009,CT,10041,10401,360,22743,1788,1226,1818,26915,119,28733,900,22882,municipality,2020
900919550,"Derby town, New Haven County, Connecticut",9009,CT,5408,5759,351,9986,336,1373,2544,9781,87,12325,390,7595,municipality,2020
900922910,"East Haven town, New Haven County, Connecticut",9009,CT,11635,12394,759,23293,1066,1262,5054,22869,141,27923,744,19656,municipality,2020
900934950,"Guilford town, New Haven County, Connecticut",9009,CT,8813,9693,880,17617,781,202,1135,20938,74,22073,796,19085,municipality,2020
900935650,"Hamden town, New Haven County, Connecticut",9009,CT,23988,25984,1996,50658,3447,14834,7836,53333,505,61169,2163,32384,municipality,2020
900944560,"Madison town, New Haven County, Connecticut",9009,CT,6987,8060,1073,14170,562,127,641,17050,83,17691,573,15705,municipality,2020
900946520,"Meriden town, New Haven County, Connecticut",9009,CT,24346,26177,1831,47541,1311,5565,22295,38555,404,60850,2171,29104,municipality,2020
900946940,"Middlebury town, New Haven County, Connecticut",9009,CT,2859,3047,188,5926,377,67,332,7242,34,7574,204,6560,municipality,2020
900947535,"Milford town, New Haven County, Connecticut",9009,CT,22338,23749,1411,43544,2840,1531,4111,47933,334,52044,1811,41417,municipality,2020
900949950,"Naugatuck town, New Haven County, Connecticut",9009,CT,12432,13239,807,24872,749,2195,4871,26648,599,31519,1739,21366,municipality,2020
900952070,"New Haven town, New Haven County, Connecticut",9009,CT,52263,57525,5262,105010,9044,40788,41068,92955,1273,134023,4840,37010,municipality,2020
900953890,"North Branford town, New Haven County, Connecticut",9009,CT,5323,5633,310,11085,234,145,670,12874,40,13544,318,12137,municipality,2020
900954870,"North Haven town, New Haven County, Connecticut",9009,CT,9546,9981,435,19771,1468,889,1490,22763,136,24253,639,19631,municipality,2020
900957600,"Orange town, New Haven County, Connecticut",9009,CT,5282,5480,198,11239,1458,259,715,13565,69,14280,453,11326,municipality,2020
900958300,"Oxford town, New Haven County, Connecticut",9009,CT,4774,5022,248,10182,218,128,681,12025,57,12706,368,11254,municipality,2020
900962290,"Prospect town, New Haven County, Connecticut",9009,CT,3627,3762,135,7583,94,206,426,8975,45,9401,299,8331,municipality,2020
900967610,"Seymour town, New Haven County, Connecticut",9009,CT,6779,7112,333,13486,421,668,1752,14996,92,16748,517,13298,municipality,2020
900969640,"Southbury town, New Haven County, Connecticut",9009,CT,8587,9270,683,16530,556,200,830,19049,96,19879,572,17625,municipality,2020
900978740,"Wallingford town, New Haven County, Connecticut",9009,CT,18104,18938,834,36256,1809,842,4770,39626,235,44396,1343,35397,municipality,2020
900980070,"Waterbury town, New Haven County, Connecticut",9009,CT,44425,48392,3967,86056,2349,22269,45281,69122,2137,114403,4607,37760,municipality,2020
900982870,"West Haven town, New Haven County, Connecticut",9009,CT,21409,22735,1326,45116,2609,11485,13177,42407,477,55584,1876,25960,municipality,2020
900987560,"Wolcott town, New Haven County, Connecticut",9009,CT,6141,6408,267,13063,250,395,1087,15055,102,16142,530,13778,municipality,2020
900987700,"Woodbridge town, New Haven County, Connecticut",9009,CT,3258,3476,218,6969,1203,264,547,8540,81,9087,367,6625,municipality,2020
3400300700,"Allendale borough, Bergen County, New Jersey",34003,INJ,2327,2450,123,5219,837,42,456,6392,25,6848,227,5261,municipality,2020
3400301090,"Alpine borough, Bergen County, New Jersey",34003,INJ,587,676,89,1403,593,54,121,1641,5,1762,40,949,municipality,2020
3400305170,"Bergenfield borough, Bergen County, New Jersey",34003,INJ,9097,9387,290,21956,7222,1894,9121,19200,274,28321,532,9278,municipality,2020
3400306490,"Bogota borough, Bergen County, New Jersey",34003,INJ,2939,3026,87,6984,748,585,4506,4272,110,8778,215,2614,municipality,2020
3400310480,"Carlstadt borough, Bergen County, New Jersey",34003,INJ,2429,2563,134,5202,608,132,1582,4790,51,6372,144,3855,municipality,2020
3400313570,"Cliffside Park borough, Bergen County, New Jersey",34003,INJ,10735,11435,700,21106,3784,656,8954,16739,382,25693,732,11185,municipality,2020
3400313810,"Closter borough, Bergen County, New Jersey",34003,INJ,2762,2891,129,6451,3009,83,725,7869,32,8594,249,4496,municipality,2020
3400315820,"Cresskill borough, Bergen County, New Jersey",34003,INJ,3015,3157,142,6768,2865,90,630,8525,41,9155,224,5305,municipality,2020
3400317530,"Demarest borough, Bergen County, New Jersey",34003,INJ,1598,1680,82,3692,1562,41,270,4711,26,4981,141,2941,municipality,2020
3400318400,"Dumont borough, Bergen County, New Jersey",34003,INJ,6408,6572,164,14251,3081,503,3883,13980,107,17863,442,9847,municipality,2020
3400319510,"East Rutherford borough, Bergen County, New Jersey",34003,INJ,4306,4585,279,8234,1612,456,2556,7466,129,10022,241,5028,municipality,2020
3400320020,"Edgewater borough, Bergen County, New Jersey",34003,INJ,6742,7315,573,11617,5071,772,1959,12377,101,14336,499,5934,municipality,2020
3400321300,"Elmwood Park borough, Bergen County, New Jersey",34003,INJ,7652,7949,297,17199,2367,1494,5898,15524,263,21422,472,10928,municipality,2020
3400321450,"Emerson borough, Bergen County, New Jersey",34003,INJ,2482,2600,118,5755,709,108,948,6342,19,7290,178,5328,municipality,2020
3400321480,"Englewood city, Bergen County, New Jersey",34003,INJ,10909,11563,654,23213,2863,7180,9639,19669,369,29308,760,8497,municipality,2020
3400321510,"Englewood Cliffs borough, Bergen County, New Jersey",34003,INJ,1846,1961,115,4229,2534,107,341,5001,21,5342,138,2201,municipality,2020
3400322470,"Fair Lawn borough, Bergen County, New Jersey",34003,INJ,12243,12649,406,27012,4468,784,5369,29558,224,34927,777,23305,municipality,2020
3400322560,"Fairview borough, Bergen County, New Jersey",34003,INJ,5021,5291,270,11686,694,240,10018,5007,265,15025,295,3513,municipality,2020
3400324420,"Fort Lee borough, Bergen County, New Jersey",34003,INJ,18451,19861,1410,33322,16949,1192,5376,34815,266,40191,920,15488,municipality,2020
3400324990,"Franklin Lakes borough, Bergen County, New Jersey",34003,INJ,3722,4051,329,8563,1051,172,786,10293,53,11079,262,8755,municipality,2020
3400325770,"Garfield city, Bergen County, New Jersey",34003,INJ,11773,12407,634,25237,985,1684,12781,19874,276,32655,531,16398,municipality,2020
3400326640,"Glen Rock borough, Bergen County, New Jersey",34003,INJ,3934,4041,107,8691,1617,163,848,11285,26,12133,442,9037,municipality,2020
3400328680,"Hackensack city, Bergen County, New Jersey",34003,INJ,19132,20290,1158,37982,4734,9558,19220,26810,504,46030,961,11053,municipality,2020
3400330150,"Harrington Park borough, Bergen County, New Jersey",34003,INJ,1594,1643,49,3588,1049,35,299,4442,14,4741,109,3235,municipality,2020
3400330420,"Hasbrouck Heights borough, Bergen County, New Jersey",34003,INJ,4535,4715,180,9672,1421,333,2551,9574,81,12125,273,7466,municipality,2020
3400330540,"Haworth borough, Bergen County, New Jersey",34003,INJ,1104,1148,44,2553,545,51,191,3152,12,3343,128,2416,municipality,2020
3400331920,"Hillsdale borough, Bergen County, New Jersey",34003,INJ,3502,3635,133,7819,742,115,1138,9005,51,10143,236,7861,municipality,2020
3400332310,"Ho-Ho-Kus borough, Bergen County, New Jersey",34003,INJ,1416,1473,57,3099,321,26,302,3956,20,4258,114,3475,municipality,2020
3400340020,"Leonia borough, Bergen County, New Jersey",34003,INJ,3359,3476,117,7277,3876,202,1669,7635,34,9304,267,3256,municipality,2020
3400340680,"Little Ferry borough, Bergen County, New Jersey",34003,INJ,4351,4527,176,9052,2717,469,3468,7519,100,10987,221,4012,municipality,2020
3400341100,"Lodi borough, Bergen County, New Jersey",34003,INJ,9971,10414,443,21004,2194,2020,10838,15368,215,26206,526,10413,municipality,2020
3400342090,"Lyndhurst township, Bergen County, New Jersey",34003,INJ,9069,9516,447,18388,1587,688,6081,16438,232,22519,543,13388,municipality,2020
3400342750,"Mahwah township, Bergen County, New Jersey",34003,INJ,9727,10109,382,21363,2830,686,2204,23283,198,25487,729,18840,municipality,2020
3400344880,"Maywood borough, Bergen County, New Jersey",34003,INJ,3717,3829,112,8080,1442,605,2567,7513,96,10080,227,5143,municipality,2020
3400346110,"Midland Park borough, Bergen County, New Jersey",34003,INJ,2750,2887,137,5585,241,70,734,6280,40,7014,180,5749,municipality,2020
3400347610,"Montvale borough, Bergen County, New Jersey",34003,INJ,3016,3115,99,6492,1324,121,683,7753,18,8436,221,6069,municipality,2020
3400347700,"Moonachie borough, Bergen County, New Jersey",34003,INJ,1120,1149,29,2486,351,20,1292,1841,27,3133,52,1391,municipality,2020
3400351660,"New Milford borough, Bergen County, New Jersey",34003,INJ,6276,6432,156,13576,3420,796,3304,13619,145,16923,428,8830,municipality,2020
3400352320,"North Arlington borough, Bergen County, New Jersey",34003,INJ,6525,6749,224,13447,1173,257,5109,11348,175,16457,498,9245,municipality,2020
3400353430,"Northvale borough, Bergen County, New Jersey",34003,INJ,1641,1700,59,3761,1278,55,569,4192,13,4761,132,2714,municipality,2020
3400353610,"Norwood borough, Bergen County, New Jersey",34003,INJ,1943,2032,89,4430,1809,74,418,5223,12,5641,132,3196,municipality,2020
3400353850,"Oakland borough, Bergen County, New Jersey",34003,INJ,4356,4561,205,9951,605,119,1210,11538,43,12748,401,10370,municipality,2020
3400354870,"Old Tappan borough, Bergen County, New Jersey",34003,INJ,1982,2083,101,4550,1600,59,380,5508,18,5888,158,3673,municipality,2020
3400354990,"Oradell borough, Bergen County, New Jersey",34003,INJ,2782,2850,68,6295,1277,73,734,7510,46,8244,225,5889,municipality,2020
3400355770,"Palisades Park borough, Bergen County, New Jersey",34003,INJ,7314,7668,354,16938,11900,262,4862,15430,109,20292,256,2903,municipality,2020
3400355950,"Paramus borough, Bergen County, New Jersey",34003,INJ,8448,8786,338,21591,6966,459,2810,23888,138,26698,769,15556,municipality,2020
3400356130,"Park Ridge borough, Bergen County, New Jersey",34003,INJ,3310,3435,125,7111,631,91,936,7947,35,8883,218,6972,municipality,2020
3400361680,"Ramsey borough, Bergen County, New Jersey",34003,INJ,5488,5670,182,11422,1134,127,1374,13424,69,14798,383,11711,municipality,2020
3400362910,"Ridgefield borough, Bergen County, New Jersey",34003,INJ,4050,4237,187,9330,3319,200,3343,8158,121,11501,237,4281,municipality,2020
3400362940,"Ridgefield Park village, Bergen County, New Jersey",34003,INJ,4986,5269,283,10601,1460,649,6189,7035,102,13224,347,4477,municipality,2020
3400363000,"Ridgewood village, Bergen County, New Jersey",34003,INJ,8490,8814,324,18458,4556,353,2069,23910,118,25979,1097,17786,municipality,2020
3400363360,"River Edge borough, Bergen County, New Jersey",34003,INJ,4191,4337,146,9064,3434,283,1339,10710,58,12049,286,6649,municipality,2020
3400363690,"River Vale township, Bergen County, New Jersey",34003,INJ,3536,3644,108,7717,993,117,731,9178,39,9909,273,7756,municipality,2020
3400363990,"Rochelle Park township, Bergen County, New Jersey",34003,INJ,2151,2227,76,4811,602,208,1575,4239,31,5814,144,3254,municipality,2020
3400364170,"Rockleigh borough, Bergen County, New Jersey",34003,INJ,69,81,12,350,27,10,33,374,1,407,9,327,municipality,2020
3400365280,"Rutherford borough, Bergen County, New Jersey",34003,INJ,7061,7370,309,15044,2688,631,3395,15439,157,18834,721,11242,municipality,2020
3400365340,"Saddle Brook township, Bergen County, New Jersey",34003,INJ,5378,5618,240,11586,1219,442,2748,11546,70,14294,261,9554,municipality,2020
3400365400,"Saddle River borough, Bergen County, New Jersey",34003,INJ,1246,1458,212,2801,451,65,181,3191,27,3372,98,2550,municipality,2020
3400368970,"South Hackensack township, Bergen County, New Jersey",34003,INJ,922,950,28,2124,172,135,1256,1445,19,2701,51,1068,municipality,2020
3400372360,"Teaneck township, Bergen County, New Jersey",34003,INJ,13784,14430,646,31768,4378,9180,8848,32398,644,41246,1351,16845,municipality,2020
3400372420,"Tenafly borough, Bergen County, New Jersey",34003,INJ,4913,5184,271,10863,4711,240,1137,14272,107,15409,495,8719,municipality,2020
3400372480,"Teterboro borough, Bergen County, New Jersey",34003,INJ,25,26,1,44,1,7,25,36,0,61,2,26,municipality,2020
3400375140,"Upper Saddle River borough, Bergen County, New Jersey",34003,INJ,2658,2785,127,6252,1240,129,579,7774,35,8353,250,6120,municipality,2020
3400376400,"Waldwick borough, Bergen County, New Jersey",34003,INJ,3577,3691,114,7680,640,126,1315,8743,37,10058,239,7701,municipality,2020
3400376490,"Wallington borough, Bergen County, New Jersey",34003,INJ,4825,5108,283,9712,694,320,2299,9569,108,11868,161,8286,municipality,2020
3400377135,"Washington township, Bergen County, New Jersey",34003,INJ,3278,3375,97,7352,566,87,800,8485,35,9285,212,7585,municipality,2020
3400380270,"Westwood borough, Bergen County, New Jersey",34003,INJ,4515,4716,201,8982,928,448,1651,9631,45,11282,349,7861,municipality,2020
3400382300,"Woodcliff Lake borough, Bergen County, New Jersey",34003,INJ,2114,2235,121,4695,536,46,407,5721,31,6128,153,4955,municipality,2020
3400382570,"Wood-Ridge borough, Bergen County, New Jersey",34003,INJ,3920,4057,137,8131,1617,337,1738,8399,80,10137,224,6141,municipality,2020
3400383050,"Wyckoff township, Bergen County, New Jersey",34003,INJ,5569,5769,200,12567,872,93,1315,15270,30,16585,508,13767,municipality,2020
3401304695,"Belleville township, Essex County, New Jersey",34013,INJ,14282,14970,688,30732,4201,3092,19181,19041,585,38222,853,10310,municipality,2020
3401306260,"Bloomfield township, Essex County, New Jersey",34013,INJ,20810,21714,904,42750,4495,9941,16197,36908,801,53105,2003,19668,municipality,2020
3401309250,"Caldwell borough, Essex County, New Jersey",34013,INJ,3538,3669,131,7479,545,419,1313,7714,63,9027,216,6471,municipality,2020
3401311200,"Cedar Grove township, Essex County, New Jersey",34013,INJ,4754,5042,288,10510,1016,305,1465,11515,85,12980,355,9754,municipality,2020
3401313045,"City of Orange township, Essex County, New Jersey",34013,INJ,12788,13590,802,26070,262,21627,9983,24464,354,34447,1148,1073,municipality,2020
3401319390,"East Orange city, Essex County, New Jersey",34013,INJ,27410,30357,2947,53596,501,54689,9032,60580,740,69612,3262,1388,municipality,2020
3401321840,"Essex Fells borough, Essex County, New Jersey",34013,INJ,750,806,56,1677,104,24,137,2107,4,2244,86,1889,municipality,2020
3401322385,"Fairfield township, Essex County, New Jersey",34013,INJ,2747,2826,79,6179,355,38,733,7139,25,7872,159,6562,municipality,2020
3401326610,"Glen Ridge borough, Essex County, New Jersey",34013,INJ,2529,2592,63,5441,587,289,558,7244,48,7802,495,5825,municipality,2020
3401334450,"Irvington township, Essex County, New Jersey",34013,INJ,22638,24984,2346,46115,413,48208,8985,52191,520,61176,2067,983,municipality,2020
3401340890,"Livingston township, Essex County, New Jersey",34013,INJ,10337,10719,382,23323,9014,953,1583,29747,193,31330,775,18812,municipality,2020
3401343800,"Maplewood township, Essex County, New Jersey",34013,INJ,8866,9269,403,18776,951,7740,2182,23502,200,25684,1441,13170,municipality,2020
3401346380,"Millburn township, Essex County, New Jersey",34013,INJ,6908,7241,333,15287,7123,458,973,20737,163,21710,846,12147,municipality,2020
3401347500,"Montclair township, Essex County, New Jersey",34013,INJ,15555,16304,749,31380,2045,9008,4304,36617,491,40921,2480,22593,municipality,2020
3401351000,"Newark city, Essex County, New Jersey",34013,INJ,108789,118163,9374,235126,4871,147905,113374,198175,8014,311549,12469,24916,municipality,2020
3401352620,"North Caldwell borough, Essex County, New Jersey",34013,INJ,2258,2364,106,5043,518,85,405,6289,13,6694,197,5476,municipality,2020
3401353680,"Nutley township, Essex County, New Jersey",34013,INJ,11887,12340,453,24072,3518,928,5858,24285,229,30143,746,18864,municipality,2020
3401364590,"Roseland borough, Essex County, New Jersey",34013,INJ,2523,2607,84,5137,551,192,437,5862,30,6299,185,4904,municipality,2020
3401369274,"South Orange Village township, Essex County, New Jersey",34013,INJ,5940,6306,366,14560,1228,3803,1604,16880,295,18484,1044,10510,municipality,2020
3401375815,"Verona township, Essex County, New Jersey",34013,INJ,5862,6150,288,11319,696,323,1431,13141,65,14572,466,11591,municipality,2020
3401378510,"West Caldwell township, Essex County, New Jersey",34013,INJ,4004,4137,133,8597,440,138,971,10041,60,11012,339,9064,municipality,2020
3401379800,"West Orange township, Essex County, New Jersey",34013,INJ,17738,18746,1008,38339,3523,13916,9647,39196,507,48843,2095,19155,municipality,2020
3401703580,"Bayonne city, Hudson County, New Jersey",34017,INJ,27867,29727,1860,55847,7011,7116,22101,49585,735,71686,2026,32697,municipality,2020
3401719360,"East Newark borough, Hudson County, New Jersey",34017,INJ,889,920,31,2057,257,54,1619,975,84,2594,69,511,municipality,2020
3401728650,"Guttenberg town, Hudson County, New Jersey",34017,INJ,4920,5142,222,9593,1064,343,7868,4149,132,12017,184,2426,municipality,2020
3401730210,"Harrison town, Hudson County, New Jersey",34017,INJ,8111,8594,483,16104,4946,722,7759,11691,547,19450,786,4690,municipality,2020
3401732250,"Hoboken city, Hudson County, New Jersey",34017,INJ,28175,30202,2027,51022,6518,2106,8542,51877,516,60419,2080,40657,municipality,2020
3401736000,"Jersey City city, Hudson County, New Jersey",34017,INJ,119517,130992,11475,235745,81425,54199,72777,219672,4943,292449,9481,69624,municipality,2020
3401736510,"Kearny town, Hudson County, New Jersey",34017,INJ,14639,15392,753,33499,2034,1246,20465,21534,1345,41999,2020,14889,municipality,2020
3401752470,"North Bergen township, Hudson County, New Jersey",34017,INJ,23426,25079,1653,51265,4269,1403,44900,18461,696,63361,858,11235,municipality,2020
3401766570,"Secaucus town, Hudson County, New Jersey",34017,INJ,8840,9316,476,18118,7167,922,4700,17481,148,22181,484,8760,municipality,2020
3401774630,"Union City city, Hudson County, New Jersey",34017,INJ,24511,26455,1944,53100,2394,1355,56509,12080,706,68589,770,6855,municipality,2020
3401777930,"Weehawken township, Hudson County, New Jersey",34017,INJ,7969,9089,1120,14362,2594,685,5665,11532,154,17197,562,7537,municipality,2020
3401779610,"West New York town, Hudson County, New Jersey",34017,INJ,20544,21798,1254,42039,3745,1234,40114,12798,506,52912,664,6649,municipality,2020
3401900550,"Alexandria township, Hunterdon County, New Jersey",34019,ONJ,1751,1857,106,3865,105,65,287,4522,32,4809,152,4168,municipality,2020
3401905650,"Bethlehem township, Hunterdon County, New Jersey",34019,ONJ,1347,1406,59,2973,92,40,209,3536,14,3745,123,3267,municipality,2020
3401906370,"Bloomsbury borough, Hunterdon County, New Jersey",34019,ONJ,340,371,31,658,13,25,54,738,5,792,24,671,municipality,2020
3401909280,"Califon borough, Hunterdon County, New Jersey",34019,ONJ,404,429,25,797,15,1,41,964,6,1005,41,901,municipality,2020
3401913720,"Clinton town, Hunterdon County, New Jersey",34019,ONJ,1114,1157,43,2162,235,50,281,2492,14,2773,78,2115,municipality,2020
3401913750,"Clinton township, Hunterdon County, New Jersey",34019,ONJ,4658,4888,230,10940,768,757,1071,12434,75,13505,443,10391,municipality,2020
3401917170,"Delaware township, Hunterdon County, New Jersey",34019,ONJ,1795,1952,157,3796,64,39,264,4296,23,4560,164,4006,municipality,2020
3401918820,"East Amwell township, Hunterdon County, New Jersey",34019,ONJ,1548,1628,80,3277,64,35,217,3700,31,3917,103,3467,municipality,2020
3401923700,"Flemington borough, Hunterdon County, New Jersey",34019,ONJ,1853,1974,121,3591,317,133,1928,2948,39,4876,109,2350,municipality,2020
3401924870,"Franklin township, Hunterdon County, New Jersey",34019,ONJ,1172,1257,85,2671,58,28,214,3053,21,3267,118,2828,municipality,2020
3401925350,"Frenchtown borough, Hunterdon County, New Jersey",34019,ONJ,629,677,48,1110,23,16,104,1266,14,1370,57,1156,municipality,2020
3401926550,"Glen Gardner borough, Hunterdon County, New Jersey",34019,ONJ,785,835,50,1364,18,62,141,1541,17,1682,46,1398,municipality,2020
3401929460,"Hampton borough, Hunterdon County, New Jersey",34019,ONJ,612,650,38,1169,34,31,126,1312,8,1438,53,1186,municipality,2020
3401931320,"High Bridge borough, Hunterdon County, New Jersey",34019,ONJ,1424,1517,93,2785,113,51,340,3206,8,3546,106,2928,municipality,2020
3401932460,"Holland township, Hunterdon County, New Jersey",34019,ONJ,2001,2099,98,4181,44,31,220,4957,11,5177,177,4694,municipality,2020
3401937065,"Kingwood township, Hunterdon County, New Jersey",34019,ONJ,1476,1606,130,3098,40,42,143,3659,13,3802,128,3436,municipality,2020
3401938610,"Lambertville city, Hunterdon County, New Jersey",34019,ONJ,2093,2265,172,3563,62,75,525,3614,25,4139,115,3337,municipality,2020
3401939630,"Lebanon borough, Hunterdon County, New Jersey",34019,ONJ,795,828,33,1380,70,70,144,1521,3,1665,50,1328,municipality,2020
3401939660,"Lebanon township, Hunterdon County, New Jersey",34019,ONJ,2368,2505,137,5011,123,64,356,5839,30,6195,200,5422,municipality,2020
3401946260,"Milford borough, Hunterdon County, New Jersey",34019,ONJ,524,556,32,996,12,17,83,1149,6,1232,32,1082,municipality,2020
3401961920,"Raritan township, Hunterdon County, New Jersey",34019,ONJ,8613,8911,298,18411,2104,588,1899,21548,117,23447,750,17989,municipality,2020
3401962250,"Readington township, Hunterdon County, New Jersey",34019,ONJ,6271,6552,281,13050,744,213,1217,14911,56,16128,455,13443,municipality,2020
3401970980,"Stockton borough, Hunterdon County, New Jersey",34019,ONJ,233,255,22,430,8,0,10,485,1,495,13,463,municipality,2020
3401972510,"Tewksbury township, Hunterdon County, New Jersey",34019,ONJ,2185,2386,201,4765,232,54,332,5538,35,5870,198,5019,municipality,2020
3401974420,"Union township, Hunterdon County, New Jersey",34019,ONJ,1840,1917,77,5553,258,481,543,5964,25,6507,174,5026,municipality,2020
3401978230,"West Amwell township, Hunterdon County, New Jersey",34019,ONJ,1147,1209,62,2424,61,62,180,2825,6,3005,100,2596,municipality,2020
3402119780,"East Windsor township, Mercer County, New Jersey",34021,ONJ,11158,11690,532,23696,6780,2653,7750,22295,229,30045,723,11910,municipality,2020
3402122185,"Ewing township, Mercer County, New Jersey",34021,ONJ,13889,15637,1748,31710,1938,11364,4868,32396,290,37264,1217,17587,municipality,2020
3402129310,"Hamilton township, Mercer County, New Jersey",34021,ONJ,36125,37716,1591,74558,4121,11724,18279,74018,429,92297,2545,55199,municipality,2020
3402131620,"Hightstown borough, Mercer County, New Jersey",34021,ONJ,2097,2216,119,4552,333,402,2166,3734,47,5900,213,2739,municipality,2020
3402133150,"Hopewell borough, Mercer County, New Jersey",34021,ONJ,787,828,41,1511,27,32,84,1834,8,1918,82,1685,municipality,2020
3402133180,"Hopewell township, Mercer County, New Jersey",34021,ONJ,6367,6748,381,13641,2035,586,1039,16452,105,17491,618,13108,municipality,2020
3402139510,"Lawrence township, Mercer County, New Jersey",34021,ONJ,12550,13268,718,27031,5883,3755,3687,29390,192,33077,1190,18370,municipality,2020
3402157600,"Pennington borough, Mercer County, New Jersey",34021,ONJ,1028,1088,60,2109,83,45,88,2714,10,2802,110,2466,municipality,2020
3402160900,"Princeton borough, Mercer County, New Jersey",34021,ONJ,9373,10380,1007,25204,6732,1742,3014,27667,221,30681,1526,17446,municipality,2020
3402163850,"Robbinsville township, Mercer County, New Jersey",34021,ONJ,5479,5687,208,11449,4307,469,790,14686,94,15476,480,9336,municipality,2020
3402174000,"Trenton city, Mercer County, New Jersey",34021,ONJ,30139,34322,4183,67089,592,38386,40905,49966,608,90871,1870,8510,municipality,2020
3402180240,"West Windsor township, Mercer County, New Jersey",34021,ONJ,10369,10862,493,22122,15499,1206,1507,28011,179,29518,903,10224,municipality,2020
3402310750,"Carteret borough, Middlesex County, New Jersey",34023,INJ,8387,8809,422,19575,5756,3820,9340,15986,268,25326,556,5586,municipality,2020
3402315550,"Cranbury township, Middlesex County, New Jersey",34023,INJ,1323,1388,65,2940,803,108,183,3659,20,3842,116,2612,municipality,2020
3402318490,"Dunellen borough, Middlesex County, New Jersey",34023,INJ,2620,2727,107,5802,430,669,2820,4817,98,7637,230,3390,municipality,2020
3402319000,"East Brunswick township, Middlesex County, New Jersey",34023,INJ,17302,18088,786,38727,13894,2113,4758,44957,356,49715,1409,27185,municipality,2020
3402320230,"Edison township, Middlesex County, New Jersey",34023,INJ,36852,38493,1641,82850,57687,7764,10771,96817,875,107588,2187,28304,municipality,2020
3402330840,"Helmetta borough, Middlesex County, New Jersey",34023,INJ,1052,1091,39,2023,119,99,282,2173,17,2455,92,1846,municipality,2020
3402331470,"Highland Park borough, Middlesex County, New Jersey",34023,INJ,6320,6669,349,12023,2643,1258,2251,12821,189,15072,519,8212,municipality,2020
3402334890,"Jamesburg borough, Middlesex County, New Jersey",34023,INJ,2115,2228,113,4497,267,401,1843,3940,44,5783,185,3043,municipality,2020
3402345690,"Metuchen borough, Middlesex County, New Jersey",34023,INJ,5822,6053,231,11600,2825,645,1510,13539,101,15049,709,9259,municipality,2020
3402345900,"Middlesex borough, Middlesex County, New Jersey",34023,INJ,5302,5472,170,11498,1159,902,3751,10885,79,14636,414,8331,municipality,2020
3402346620,"Milltown borough, Middlesex County, New Jersey",34023,INJ,2613,2707,94,5460,246,178,810,6227,34,7037,214,5555,municipality,2020
3402347280,"Monroe township, Middlesex County, New Jersey",34023,INJ,20289,21504,1215,40168,12892,1655,2746,45848,260,48594,856,30185,municipality,2020
3402351210,"New Brunswick city, Middlesex County, New Jersey",34023,INJ,15387,17509,2122,43015,5722,6278,31376,23890,814,55266,754,10322,municipality,2020
3402352560,"North Brunswick township, Middlesex County, New Jersey",34023,INJ,15025,15585,560,34695,11212,7737,10676,33229,523,43905,1143,12614,municipality,2020
3402354705,"Old Bridge township, Middlesex County, New Jersey",34023,INJ,25059,26067,1008,54192,10119,4671,9276,57600,511,66876,1905,40394,municipality,2020
3402358200,"Perth Amboy city, Middlesex County, New Jersey",34023,INJ,17136,17855,719,41049,610,3483,46149,9287,501,55436,540,4153,municipality,2020
3402359010,"Piscataway township, Middlesex County, New Jersey",34023,INJ,18071,18904,833,50242,23973,11771,8276,52528,985,60804,1548,14251,municipality,2020
3402359280,"Plainsboro township, Middlesex County, New Jersey",34023,INJ,9720,10281,561,18815,13578,1579,1449,22635,176,24084,606,6696,municipality,2020
3402365790,"Sayreville borough, Middlesex County, New Jersey",34023,INJ,16910,17695,785,35845,7611,5743,7868,37477,467,45345,1290,22366,municipality,2020
3402368550,"South Amboy city, Middlesex County, New Jersey",34023,INJ,3740,3906,166,7565,470,529,2093,7318,59,9411,312,5948,municipality,2020
3402368790,"South Brunswick township, Middlesex County, New Jersey",34023,INJ,16014,16647,633,36320,22604,3405,3510,43533,286,47043,1140,16098,municipality,2020
3402369390,"South Plainfield borough, Middlesex County, New Jersey",34023,INJ,8217,8432,215,19329,4579,2496,4555,19783,345,24338,775,11588,municipality,2020
3402369420,"South River borough, Middlesex County, New Jersey",34023,INJ,5694,5977,283,12700,826,1000,4198,11920,445,16118,845,8804,municipality,2020
3402369810,"Spotswood borough, Middlesex County, New Jersey",34023,INJ,3196,3297,101,6646,523,272,917,7246,29,8163,278,6144,municipality,2020
3402382000,"Woodbridge township, Middlesex County, New Jersey",34023,INJ,36381,38137,1756,82433,27425,10143,22279,81360,946,103639,2574,40272,municipality,2020
3402500000,"County subdivisions not defined, Monmouth County, New Jersey",34025,ONJ,0,0,0,0,0,0,0,0,0,0,0,0,municipality,2020
3402500070,"Aberdeen township, Monmouth County, New Jersey",34025,ONJ,7697,7967,270,15591,1116,1883,2642,16687,136,19329,732,12820,municipality,2020
3402500730,"Allenhurst borough, Monmouth County, New Jersey",34025,ONJ,199,369,170,402,3,4,19,453,0,472,11,435,municipality,2020
3402500760,"Allentown borough, Monmouth County, New Jersey",34025,ONJ,694,724,30,1374,28,64,92,1642,13,1734,60,1477,municipality,2020
3402501960,"Asbury Park city, Monmouth County, New Jersey",34025,ONJ,7087,8274,1187,12254,162,5059,4079,11109,97,15188,507,5284,municipality,2020
3402502110,"Atlantic Highlands borough, Monmouth County, New Jersey",34025,ONJ,1949,2092,143,3637,78,54,363,4051,5,4414,166,3748,municipality,2020
3402502440,"Avon-by-the-Sea borough, Monmouth County, New Jersey",34025,ONJ,902,1334,432,1690,20,22,141,1792,3,1933,45,1702,municipality,2020
3402504930,"Belmar borough, Monmouth County, New Jersey",34025,ONJ,2867,4066,1199,5105,71,100,963,4944,39,5907,129,4605,municipality,2020
3402506970,"Bradley Beach borough, Monmouth County, New Jersey",34025,ONJ,2157,3221,1064,3731,57,82,880,3402,22,4282,122,3119,municipality,2020
3402507750,"Brielle borough, Monmouth County, New Jersey",34025,ONJ,1949,2176,227,3994,34,69,226,4756,25,4982,128,4500,municipality,2020
3402514560,"Colts Neck township, Monmouth County, New Jersey",34025,ONJ,3307,3451,144,7651,495,105,614,9343,43,9957,231,8469,municipality,2020
3402516660,"Deal borough, Monmouth County, New Jersey",34025,ONJ,347,925,578,723,6,6,120,780,14,900,23,731,municipality,2020
3402519840,"Eatontown borough, Monmouth County, New Jersey",34025,ONJ,5842,6182,340,11159,1316,1644,2005,11592,236,13597,824,7572,municipality,2020
3402521570,"Englishtown borough, Monmouth County, New Jersey",34025,ONJ,789,820,31,1809,207,66,368,1978,10,2346,65,1630,municipality,2020
3402522440,"Fair Haven borough, Monmouth County, New Jersey",34025,ONJ,1994,2074,80,4303,92,66,241,6028,17,6269,189,5664,municipality,2020
3402522950,"Farmingdale borough, Monmouth County, New Jersey",34025,ONJ,616,630,14,1201,40,80,167,1337,2,1504,67,1148,municipality,2020
3402525200,"Freehold borough, Monmouth County, New Jersey",34025,ONJ,4143,4394,251,9480,330,1110,6649,5889,97,12538,292,4060,municipality,2020
3402525230,"Freehold township, Monmouth County, New Jersey",34025,ONJ,12897,13500,603,28150,2585,1506,3636,31733,175,35369,1068,26399,municipality,2020
3402530690,"Hazlet township, Monmouth County, New Jersey",34025,ONJ,7179,7492,313,16245,682,330,2292,17833,102,20125,546,16173,municipality,2020
3402531500,"Highlands borough, Monmouth County, New Jersey",34025,ONJ,2425,2931,506,4076,55,80,343,4278,34,4621,181,3928,municipality,2020
3402532640,"Holmdel township, Monmouth County, New Jersey",34025,ONJ,5787,6038,251,13374,3555,189,989,16411,76,17400,597,11994,municipality,2020
3402533300,"Howell township, Monmouth County, New Jersey",34025,ONJ,18906,19694,788,41880,2621,1958,6359,47178,313,53537,1741,40545,municipality,2020
3402534200,"Interlaken borough, Monmouth County, New Jersey",34025,ONJ,362,400,38,707,4,1,19,809,10,828,26,768,municipality,2020
3402536480,"Keansburg borough, Monmouth County, New Jersey",34025,ONJ,3808,4361,553,7543,265,921,1932,7823,46,9755,455,6136,municipality,2020
3402536810,"Keyport borough, Monmouth County, New Jersey",34025,ONJ,3202,3427,225,5927,226,387,1572,5632,30,7204,235,4754,municipality,2020
3402537560,"Lake Como borough, Monmouth County, New Jersey",34025,ONJ,778,1081,303,1429,33,73,336,1361,9,1697,47,1199,municipality,2020
3402540770,"Little Silver borough, Monmouth County, New Jersey",34025,ONJ,2196,2323,127,4588,138,25,261,5870,14,6131,189,5504,municipality,2020
3402541010,"Loch Arbour village, Monmouth County, New Jersey",34025,ONJ,94,154,60,190,6,0,8,216,1,224,3,206,municipality,2020
3402541310,"Long Branch city, Monmouth County, New Jersey",34025,ONJ,12391,14944,2553,24709,588,3177,10332,21335,1571,31667,2866,13133,municipality,2020
3402542990,"Manalapan township, Monmouth County, New Jersey",34025,ONJ,14325,14850,525,32109,3561,876,3188,37717,202,40905,938,32140,municipality,2020
3402543050,"Manasquan borough, Monmouth County, New Jersey",34025,ONJ,2462,3412,950,4865,48,10,417,5521,5,5938,123,5335,municipality,2020
3402544070,"Marlboro township, Monmouth County, New Jersey",34025,ONJ,13774,14215,441,32004,9020,728,2323,39179,181,41502,817,28433,municipality,2020
3402544520,"Matawan borough, Monmouth County, New Jersey",34025,ONJ,3849,4010,161,7597,594,725,1431,8134,82,9565,374,6359,municipality,2020
3402545990,"Middletown township, Monmouth County, New Jersey",34025,ONJ,24710,25859,1149,52717,1867,823,5112,61994,282,67106,1880,57142,municipality,2020
3402546560,"Millstone township, Monmouth County, New Jersey",34025,ONJ,3324,3428,104,8123,627,415,844,9532,56,10376,323,8111,municipality,2020
3402547130,"Monmouth Beach borough, Monmouth County, New Jersey",34025,ONJ,1452,2006,554,2689,36,9,122,3052,25,3174,74,2908,municipality,2020
3402549890,"Neptune township, Monmouth County, New Jersey",34025,ONJ,11466,13278,1812,23173,770,9419,4052,24009,170,28061,1092,12558,municipality,2020
3402549920,"Neptune City borough, Monmouth County, New Jersey",34025,ONJ,2109,2251,142,3943,92,627,644,3982,21,4626,201,3041,municipality,2020
3402554270,"Ocean township, Monmouth County, New Jersey",34025,ONJ,11249,12257,1008,22250,1636,2507,3007,24665,306,27672,946,19270,municipality,2020
3402554570,"Oceanport borough, Monmouth County, New Jersey",34025,ONJ,2346,2469,123,4927,70,85,611,5539,56,6150,173,5155,municipality,2020
3402562430,"Red Bank borough, Monmouth County, New Jersey",34025,ONJ,5423,5863,440,10210,231,966,4890,8046,55,12936,336,6458,municipality,2020
3402564410,"Roosevelt borough, Monmouth County, New Jersey",34025,ONJ,307,331,24,677,12,23,103,705,8,808,32,630,municipality,2020
3402565130,"Rumson borough, Monmouth County, New Jersey",34025,ONJ,2398,2624,226,5184,106,21,308,7035,37,7343,236,6635,municipality,2020
3402566240,"Sea Bright borough, Monmouth County, New Jersey",34025,ONJ,793,1200,407,1326,34,13,78,1371,9,1449,44,1271,municipality,2020
3402566330,"Sea Girt borough, Monmouth County, New Jersey",34025,ONJ,786,1305,519,1623,4,9,56,1810,7,1866,19,1771,municipality,2020
3402567350,"Shrewsbury borough, Monmouth County, New Jersey",34025,ONJ,1456,1509,53,3207,97,61,165,4019,33,4184,128,3700,municipality,2020
3402567365,"Shrewsbury township, Monmouth County, New Jersey",34025,ONJ,505,544,39,893,88,148,217,859,5,1076,61,557,municipality,2020
3402570110,"Spring Lake borough, Monmouth County, New Jersey",34025,ONJ,1225,2107,882,2399,36,11,86,2703,12,2789,53,2591,municipality,2020
3402570140,"Spring Lake Heights borough, Monmouth County, New Jersey",34025,ONJ,2428,2998,570,4170,54,23,221,4669,13,4890,116,4463,municipality,2020
3402573020,"Tinton Falls borough, Monmouth County, New Jersey",34025,ONJ,8500,8972,472,16011,1041,1610,1694,17487,110,19181,641,14085,municipality,2020
3402574540,"Union Beach borough, Monmouth County, New Jersey",34025,ONJ,2036,2183,147,4565,125,111,726,4997,41,5723,221,4499,municipality,2020
3402574900,"Upper Freehold township, Monmouth County, New Jersey",34025,ONJ,2471,2604,133,5586,460,161,454,6819,41,7273,207,5950,municipality,2020
3402576460,"Wall township, Monmouth County, New Jersey",34025,ONJ,10121,10838,717,21495,443,461,1559,24966,97,26525,723,23242,municipality,2020
3402579310,"West Long Branch borough, Monmouth County, New Jersey",34025,ONJ,2551,2755,204,7005,143,275,774,7813,151,8587,426,6818,municipality,2020
3402706610,"Boonton town, Morris County, New Jersey",34027,INJ,3412,3555,143,7045,953,444,1409,7406,47,8815,362,5600,municipality,2020
3402706640,"Boonton township, Morris County, New Jersey",34027,INJ,1504,1583,79,3466,275,47,275,4105,13,4380,144,3626,municipality,2020
3402709040,"Butler borough, Morris County, New Jersey",34027,INJ,3258,3403,145,6510,284,123,1409,6638,20,8047,224,5987,municipality,2020
3402712100,"Chatham borough, Morris County, New Jersey",34027,INJ,3057,3224,167,6513,847,89,675,8537,52,9212,390,7159,municipality,2020
3402712130,"Chatham township, Morris County, New Jersey",34027,INJ,3963,4155,192,7978,1387,81,514,10469,61,10983,391,8549,municipality,2020
3402712580,"Chester borough, Morris County, New Jersey",34027,INJ,633,660,27,1302,60,5,281,1400,2,1681,57,1276,municipality,2020
3402712610,"Chester township, Morris County, New Jersey",34027,INJ,2575,2736,161,5874,381,90,539,7174,30,7713,296,6377,municipality,2020
3402717650,"Denville township, Morris County, New Jersey",34027,INJ,6442,6834,392,13549,1351,317,1280,15827,68,17107,606,13485,municipality,2020
3402718070,"Dover town, Morris County, New Jersey",34027,INJ,5752,5972,220,14544,423,783,14209,4251,127,18460,192,2726,municipality,2020
3402719210,"East Hanover township, Morris County, New Jersey",34027,INJ,3935,4040,105,9102,1425,141,876,10229,34,11105,179,8450,municipality,2020
3402723910,"Florham Park borough, Morris County, New Jersey",34027,INJ,4468,4768,300,10365,1075,725,929,11656,54,12585,392,9410,municipality,2020
3402729550,"Hanover township, Morris County, New Jersey",34027,INJ,5694,5928,234,11895,1948,325,1046,13631,55,14677,423,10880,municipality,2020
3402729700,"Harding township, Morris County, New Jersey",34027,INJ,1419,1569,150,3106,180,41,179,3692,11,3871,155,3305,municipality,2020
3402734980,"Jefferson township, Morris County, New Jersey",34027,INJ,7840,8566,726,16553,860,356,1998,18540,153,20538,566,16605,municipality,2020
3402737110,"Kinnelon borough, Morris County, New Jersey",34027,INJ,3405,3571,166,7722,610,91,728,9238,46,9966,299,8192,municipality,2020
3402740290,"Lincoln Park borough, Morris County, New Jersey",34027,INJ,4063,4181,118,9013,719,332,1469,9446,69,10915,286,8040,municipality,2020
3402741362,"Long Hill township, Morris County, New Jersey",34027,INJ,3118,3240,122,6746,693,73,912,7717,76,8629,299,6576,municipality,2020
3402742510,"Madison borough, Morris County, New Jersey",34027,INJ,5705,5989,284,13046,1262,463,2004,14933,102,16937,624,12482,municipality,2020
3402745330,"Mendham borough, Morris County, New Jersey",34027,INJ,1762,1867,105,3858,161,29,293,4688,31,4981,146,4321,municipality,2020
3402745360,"Mendham township, Morris County, New Jersey",34027,INJ,1986,2105,119,4469,347,93,330,5686,41,6016,276,4929,municipality,2020
3402746860,"Mine Hill township, Morris County, New Jersey",34027,INJ,1477,1523,46,3293,210,191,1283,2732,33,4015,120,2178,municipality,2020
3402747670,"Montville township, Morris County, New Jersey",34027,INJ,7901,8206,305,17573,4811,319,1578,20872,125,22450,608,15009,municipality,2020
3402748090,"Morris township, Morris County, New Jersey",34027,INJ,8587,8993,406,18357,1368,1019,2378,20596,135,22974,821,17253,municipality,2020
3402748210,"Morris Plains borough, Morris County, New Jersey",34027,INJ,2432,2527,95,4875,487,219,590,5563,15,6153,167,4675,municipality,2020
3402748300,"Morristown town, Morris County, New Jersey",34027,INJ,8482,9213,731,16670,961,1961,7367,12813,167,20180,526,9198,municipality,2020
3402748480,"Mountain Lakes borough, Morris County, New Jersey",34027,INJ,1376,1429,53,3141,694,19,247,4225,18,4472,209,3285,municipality,2020
3402748690,"Mount Arlington borough, Morris County, New Jersey",34027,INJ,2651,2915,264,5050,334,197,719,5190,28,5909,153,4478,municipality,2020
3402749080,"Mount Olive township, Morris County, New Jersey",34027,INJ,11079,11597,518,22474,3025,1807,4460,24426,156,28886,1039,18399,municipality,2020
3402750130,"Netcong borough, Morris County, New Jersey",34027,INJ,1434,1490,56,2736,118,151,817,2558,23,3375,104,2162,municipality,2020
3402756460,"Parsippany-Troy Hills township, Morris County, New Jersey",34027,INJ,21346,22146,800,45284,21694,1911,5631,50531,400,56162,1566,24960,municipality,2020
3402758110,"Pequannock township, Morris County, New Jersey",34027,INJ,6379,6688,309,12695,395,98,1224,14347,48,15571,345,13461,municipality,2020
3402761890,"Randolph township, Morris County, New Jersey",34027,INJ,9354,9676,322,20247,3185,740,3791,22713,133,26504,905,17750,municipality,2020
3402763300,"Riverdale borough, Morris County, New Jersey",34027,INJ,1929,2009,80,3481,219,88,411,3696,10,4107,110,3269,municipality,2020
3402764050,"Rockaway borough, Morris County, New Jersey",34027,INJ,2561,2645,84,5326,553,187,1355,5243,41,6598,189,4273,municipality,2020
3402764080,"Rockaway township, Morris County, New Jersey",34027,INJ,9643,10140,497,20341,1918,731,3995,21346,103,25341,790,17804,municipality,2020
3402764980,"Roxbury township, Morris County, New Jersey",34027,INJ,8356,8682,326,18268,1292,647,3340,19610,119,22950,687,16865,municipality,2020
3402775890,"Victory Gardens borough, Morris County, New Jersey",34027,INJ,571,584,13,1189,41,142,1185,397,14,1582,23,177,municipality,2020
3402777240,"Washington township, Morris County, New Jersey",34027,INJ,6343,6577,234,14133,760,286,1359,16838,84,18197,499,15209,municipality,2020
3402780390,"Wharton borough, Morris County, New Jersey",34027,INJ,2604,2736,132,5804,394,225,3576,3665,59,7241,192,2795,municipality,2020
3402900000,"County subdivisions not defined, Ocean County, New Jersey",34029,ONJ,0,0,0,0,0,0,0,0,0,0,0,0,municipality,2020
3402903050,"Barnegat township, Ocean County, New Jersey",34029,ONJ,9758,10724,966,19798,471,987,2460,21836,90,24296,827,19461,municipality,2020
3402903130,"Barnegat Light borough, Ocean County, New Jersey",34029,ONJ,321,1257,936,596,1,0,21,619,3,640,14,601,municipality,2020
3402903520,"Bay Head borough, Ocean County, New Jersey",34029,ONJ,434,1024,590,803,11,5,27,903,5,930,17,865,municipality,2020
3402903940,"Beach Haven borough, Ocean County, New Jersey",34029,ONJ,485,2600,2115,927,0,2,102,925,1,1027,16,906,municipality,2020
3402904180,"Beachwood borough, Ocean County, New Jersey",34029,ONJ,3719,3860,141,8320,147,239,1290,9569,41,10859,377,8765,municipality,2020
3402905305,"Berkeley township, Ocean County, New Jersey",34029,ONJ,21040,24629,3589,38217,637,1079,3680,40074,173,43754,1129,37056,municipality,2020
3402907420,"Brick township, Ocean County, New Jersey",34029,ONJ,30119,33863,3744,60946,1347,2071,8218,65402,340,73620,2306,59338,municipality,2020
3402918670,"Eagleswood township, Ocean County, New Jersey",34029,ONJ,676,797,121,1384,10,8,116,1606,13,1722,56,1519,municipality,2020
3402930390,"Harvey Cedars borough, Ocean County, New Jersey",34029,ONJ,198,1178,980,351,2,0,6,385,0,391,2,381,municipality,2020
3402934530,"Island Heights borough, Ocean County, New Jersey",34029,ONJ,722,841,119,1373,14,8,55,1595,16,1650,70,1487,municipality,2020
3402934680,"Jackson township, Ocean County, New Jersey",34029,ONJ,20470,21626,1156,44652,1558,2769,7543,51001,438,58544,1841,44395,municipality,2020
3402937380,"Lacey township, Ocean County, New Jersey",34029,ONJ,11086,12483,1397,23126,334,223,2000,26655,122,28655,885,25091,municipality,2020
3402937770,"Lakehurst borough, Ocean County, New Jersey",34029,ONJ,908,979,71,2044,76,236,505,2131,13,2636,126,1680,municipality,2020
3402938550,"Lakewood township, Ocean County, New Jersey",34029,ONJ,31850,34726,2876,70393,699,3290,15768,119390,2154,135158,1859,111388,municipality,2020
3402939390,"Lavallette borough, Ocean County, New Jersey",34029,ONJ,924,3078,2154,1642,7,8,60,1727,4,1787,51,1657,municipality,2020
3402940560,"Little Egg Harbor township, Ocean County, New Jersey",34029,ONJ,8715,10812,2097,17275,225,367,1541,19243,90,20784,702,17859,municipality,2020
3402941250,"Long Beach township, Ocean County, New Jersey",34029,ONJ,1593,8832,7239,2908,29,2,102,3051,10,3153,57,2953,municipality,2020
3402943140,"Manchester township, Ocean County, New Jersey",34029,ONJ,24287,26764,2477,41110,1017,1845,3503,41612,179,45115,1129,37442,municipality,2020
3402943380,"Mantoloking borough, Ocean County, New Jersey",34029,ONJ,158,498,340,296,4,1,15,316,2,331,4,305,municipality,2020
3402954300,"Ocean township, Ocean County, New Jersey",34029,ONJ,3979,4715,736,7659,71,72,407,8428,38,8835,243,8004,municipality,2020
3402954450,"Ocean Gate borough, Ocean County, New Jersey",34029,ONJ,851,1153,302,1613,5,46,156,1776,8,1932,94,1623,municipality,2020
3402958590,"Pine Beach borough, Ocean County, New Jersey",34029,ONJ,840,931,91,1733,29,17,133,2006,8,2139,76,1876,municipality,2020
3402959790,"Plumsted township, Ocean County, New Jersey",34029,ONJ,2996,3139,143,6512,58,107,677,7395,40,8072,358,6832,municipality,2020
3402959880,"Point Pleasant borough, Ocean County, New Jersey",34029,ONJ,7506,8485,979,15053,154,58,1327,17614,67,18941,443,16892,municipality,2020
3402959910,"Point Pleasant Beach borough, Ocean County, New Jersey",34029,ONJ,2045,3397,1352,4043,57,28,475,4291,13,4766,109,4084,municipality,2020
3402966450,"Seaside Heights borough, Ocean County, New Jersey",34029,ONJ,1148,2870,1722,1971,36,136,566,1874,15,2440,114,1573,municipality,2020
3402966480,"Seaside Park borough, Ocean County, New Jersey",34029,ONJ,772,2586,1814,1328,9,4,55,1381,7,1436,29,1332,municipality,2020
3402967110,"Ship Bottom borough, Ocean County, New Jersey",34029,ONJ,549,1938,1389,982,11,1,72,1026,6,1098,20,988,municipality,2020
3402969510,"South Toms River borough, Ocean County, New Jersey",34029,ONJ,1081,1141,60,2652,75,528,1040,2603,25,3643,197,1778,municipality,2020
3402970320,"Stafford township, Ocean County, New Jersey",34029,ONJ,11073,14399,3326,22886,420,316,2468,26149,68,28617,803,24542,municipality,2020
3402971640,"Surf City borough, Ocean County, New Jersey",34029,ONJ,644,2468,1824,1121,8,1,44,1199,5,1243,16,1169,municipality,2020
3402973125,"Toms River township, Ocean County, New Jersey",34029,ONJ,36291,44526,8235,75913,3780,3155,11593,83845,521,95438,2718,73671,municipality,2020
3402974210,"Tuckerton borough, Ocean County, New Jersey",34029,ONJ,1574,2110,536,2973,37,40,304,3273,18,3577,113,3065,municipality,2020
3403106340,"Bloomingdale borough, Passaic County, New Jersey",34031,INJ,3112,3267,155,6457,273,114,1186,6591,54,7777,236,5914,municipality,2020
3403113690,"Clifton city, Passaic County, New Jersey",34031,INJ,31968,33325,1357,71555,8414,3899,36159,54137,710,90296,1864,39250,municipality,2020
3403129070,"Haledon borough, Passaic County, New Jersey",34031,INJ,3017,3117,100,6973,631,1063,4476,4576,102,9052,186,2594,municipality,2020
3403130570,"Hawthorne borough, Passaic County, New Jersey",34031,INJ,7624,7946,322,15788,532,591,4778,14859,120,19637,487,13129,municipality,2020
3403140620,"Little Falls township, Passaic County, New Jersey",34031,INJ,4721,4947,226,11354,723,834,2264,11096,74,13360,349,9116,municipality,2020
3403153040,"North Haledon borough, Passaic County, New Jersey",34031,INJ,3054,3141,87,7447,349,290,1129,7798,31,8927,202,6926,municipality,2020
3403156550,"Passaic city, Passaic County, New Jersey",34031,INJ,20595,21513,918,49265,2599,4005,51584,18953,791,70537,740,10818,municipality,2020
3403157000,"Paterson city, Passaic County, New Jersey",34031,INJ,50326,52885,2559,118285,7991,36667,98863,60869,1463,159732,2225,12523,municipality,2020
3403160090,"Pompton Lakes borough, Passaic County, New Jersey",34031,INJ,4200,4349,149,8877,594,170,2174,8953,72,11127,333,7784,municipality,2020
3403161170,"Prospect Park borough, Passaic County, New Jersey",34031,INJ,1932,2017,85,4690,294,1023,3752,2620,59,6372,91,1153,municipality,2020
3403163150,"Ringwood borough, Passaic County, New Jersey",34031,INJ,4180,4364,184,9356,196,167,1084,10651,157,11735,431,9700,municipality,2020
3403173140,"Totowa borough, Passaic County, New Jersey",34031,INJ,3899,4026,127,9016,838,247,2408,8657,49,11065,226,7297,municipality,2020
3403176730,"Wanaque borough, Passaic County, New Jersey",34031,INJ,4392,4597,205,9399,543,305,1659,9658,89,11317,350,8371,municipality,2020
3403177840,"Wayne township, Passaic County, New Jersey",34031,INJ,19165,19808,643,44041,5167,1639,6439,48399,244,54838,1352,39997,municipality,2020
3403179460,"West Milford township, Passaic County, New Jersey",34031,INJ,9638,10570,932,20354,378,320,2259,22603,177,24862,833,20895,municipality,2020
3403182423,"Woodland Park borough, Passaic County, New Jersey",34031,INJ,5252,5495,243,10959,687,525,3816,9668,62,13484,319,8075,municipality,2020
3403504450,"Bedminster township, Somerset County, New Jersey",34035,INJ,4222,4483,261,7066,882,153,804,7468,36,8272,237,6160,municipality,2020
3403505560,"Bernards township, Somerset County, New Jersey",34035,INJ,10197,10665,468,21148,6708,447,1595,26235,110,27830,930,18040,municipality,2020
3403505590,"Bernardsville borough, Somerset County, New Jersey",34035,INJ,2756,2953,197,5886,343,49,1272,6621,32,7893,270,5927,municipality,2020
3403506790,"Bound Brook borough, Somerset County, New Jersey",34035,INJ,4181,4389,208,9285,483,976,6374,5614,226,11988,287,3642,municipality,2020
3403507180,"Branchburg township, Somerset County, New Jersey",34035,INJ,5660,5843,183,11948,1609,438,1116,13824,65,14940,491,11221,municipality,2020
3403507720,"Bridgewater township, Somerset County, New Jersey",34035,INJ,16044,16739,695,35926,11080,1268,4517,41460,271,45977,1294,27547,municipality,2020
3403522890,"Far Hills borough, Somerset County, New Jersey",34035,INJ,372,418,46,768,42,8,107,817,3,924,19,745,municipality,2020
3403524900,"Franklin township, Somerset County, New Jersey",34035,INJ,25860,27335,1475,55465,15835,16531,11938,56426,591,68364,2064,21405,municipality,2020
3403527510,"Green Brook township, Somerset County, New Jersey",34035,INJ,2436,2510,74,5716,1743,313,843,6438,39,7281,209,4134,municipality,2020
3403531890,"Hillsborough township, Somerset County, New Jersey",34035,INJ,15296,15955,659,33356,9889,2040,4067,39209,252,43276,1403,25625,municipality,2020
3403543620,"Manville borough, Somerset County, New Jersey",34035,INJ,4092,4290,198,8705,337,514,3464,7489,67,10953,316,6255,municipality,2020
3403546590,"Millstone borough, Somerset County, New Jersey",34035,INJ,153,168,15,334,9,7,34,414,1,448,17,380,municipality,2020
3403547580,"Montgomery township, Somerset County, New Jersey",34035,INJ,8003,8390,387,17642,9352,721,1314,22376,103,23690,809,11391,municipality,2020
3403553280,"North Plainfield borough, Somerset County, New Jersey",34035,INJ,7715,8055,340,17606,1064,4390,11548,11260,247,22808,561,4998,municipality,2020
3403557300,"Peapack and Gladstone borough, Somerset County, New Jersey",34035,INJ,887,937,50,1967,50,60,319,2239,7,2558,61,2061,municipality,2020
3403561980,"Raritan borough, Somerset County, New Jersey",34035,INJ,2993,3167,174,6238,1558,247,1672,6163,32,7835,206,4120,municipality,2020
3403564320,"Rocky Hill borough, Somerset County, New Jersey",34035,INJ,278,298,20,553,36,3,70,673,5,743,25,604,municipality,2020
3403568460,"Somerville borough, Somerset County, New Jersey",34035,INJ,5050,5387,337,9985,1433,1201,3113,9233,98,12346,428,6073,municipality,2020
3403568730,"South Bound Brook borough, Somerset County, New Jersey",34035,INJ,1854,1941,87,3915,395,528,1537,3326,43,4863,148,2212,municipality,2020
3403576940,"Warren township, Somerset County, New Jersey",34035,INJ,5374,5614,240,12543,3249,277,1156,14767,105,15923,567,10569,municipality,2020
3403577600,"Watchung borough, Somerset County, New Jersey",34035,INJ,2175,2285,110,5152,1001,309,519,5930,57,6449,261,4302,municipality,2020
3403701330,"Andover borough, Sussex County, New Jersey",34037,ONJ,254,277,23,498,5,17,59,536,3,595,27,484,municipality,2020
3403701360,"Andover township, Sussex County, New Jersey",34037,ONJ,2102,2219,117,4976,211,187,530,5466,47,5996,194,4827,municipality,2020
3403707300,"Branchville borough, Sussex County, New Jersey",34037,ONJ,334,372,38,631,17,8,53,738,2,791,29,682,municipality,2020
3403709160,"Byram township, Sussex County, New Jersey",34037,ONJ,2946,3292,346,6384,128,132,683,7345,47,8028,282,6756,municipality,2020
3403724810,"Frankford township, Sussex County, New Jersey",34037,ONJ,2084,2550,466,4401,75,42,297,5005,28,5302,175,4685,municipality,2020
3403724930,"Franklin borough, Sussex County, New Jersey",34037,ONJ,2047,2177,130,3978,78,108,661,4251,34,4912,209,3822,municipality,2020
3403725140,"Fredon township, Sussex County, New Jersey",34037,ONJ,1192,1256,64,2629,58,20,181,3054,16,3235,94,2866,municipality,2020
3403727420,"Green township, Sussex County, New Jersey",34037,ONJ,1244,1291,47,2811,62,65,306,3321,26,3627,97,3071,municipality,2020
3403729220,"Hamburg borough, Sussex County, New Jersey",34037,ONJ,1452,1539,87,2693,94,98,318,2948,19,3266,134,2603,municipality,2020
3403729490,"Hampton township, Sussex County, New Jersey",34037,ONJ,1996,2186,190,4021,79,26,267,4626,24,4893,162,4335,municipality,2020
3403729850,"Hardyston township, Sussex County, New Jersey",34037,ONJ,3371,3847,476,6733,215,244,647,7478,46,8125,268,6705,municipality,2020
3403732910,"Hopatcong borough, Sussex County, New Jersey",34037,ONJ,5724,6393,669,11897,353,423,2544,11818,119,14362,436,10487,municipality,2020
3403737440,"Lafayette township, Sussex County, New Jersey",34037,ONJ,881,921,40,1924,13,20,164,2194,18,2358,60,2083,municipality,2020
3403747430,"Montague township, Sussex County, New Jersey",34037,ONJ,1560,1832,272,3110,69,71,370,3422,27,3792,147,3108,municipality,2020
3403751930,"Newton town, Sussex County, New Jersey",34037,ONJ,3400,3687,287,6731,292,432,1363,7011,51,8374,342,5894,municipality,2020
3403754660,"Ogdensburg borough, Sussex County, New Jersey",34037,ONJ,873,927,54,1837,28,20,265,1993,12,2258,98,1835,municipality,2020
3403765700,"Sandyston township, Sussex County, New Jersey",34037,ONJ,806,979,173,1612,31,9,101,1876,8,1977,73,1755,municipality,2020
3403769690,"Sparta township, Sussex County, New Jersey",34037,ONJ,7032,7614,582,14988,620,309,1570,18030,102,19600,700,16299,municipality,2020
3403770380,"Stanhope borough, Sussex County, New Jersey",34037,ONJ,1432,1507,75,2890,93,74,492,3034,25,3526,118,2724,municipality,2020
3403770890,"Stillwater township, Sussex County, New Jersey",34037,ONJ,1609,1943,334,3305,38,23,202,3802,21,4004,111,3609,municipality,2020
3403771670,"Sussex borough, Sussex County, New Jersey",34037,ONJ,901,1013,112,1637,26,47,284,1740,7,2024,84,1576,municipality,2020
3403775740,"Vernon township, Sussex County, New Jersey",34037,ONJ,8612,10538,1926,17995,206,331,2163,20195,121,22358,775,18762,municipality,2020
3403776640,"Walpack township, Sussex County, New Jersey",34037,ONJ,5,5,0,4,0,0,2,5,0,7,0,5,municipality,2020
3403776790,"Wantage township, Sussex County, New Jersey",34037,ONJ,4058,4344,286,8760,127,152,788,10023,65,10811,405,9274,municipality,2020
3403905320,"Berkeley Heights township, Union County, New Jersey",34039,INJ,4484,4660,176,10097,2065,242,1140,12145,90,13285,470,9278,municipality,2020
3403913150,"Clark township, Union County, New Jersey",34039,INJ,5919,6114,195,12424,644,231,1945,13599,53,15544,325,12346,municipality,2020
3403915640,"Cranford township, Union County, New Jersey",34039,INJ,8891,9264,373,18391,903,653,2443,21404,116,23847,786,18946,municipality,2020
3403921000,"Elizabeth city, Union County, New Jersey",34039,INJ,46314,48439,2125,102537,2757,22261,90233,47065,2315,137298,3179,16553,municipality,2020
3403922860,"Fanwood borough, Union County, New Jersey",34039,INJ,2725,2829,104,5781,713,386,729,7045,16,7774,326,5604,municipality,2020
3403925800,"Garwood borough, Union County, New Jersey",34039,INJ,1920,2016,96,3663,119,69,670,3784,33,4454,127,3436,municipality,2020
3403931980,"Hillside township, Union County, New Jersey",34039,INJ,7517,7844,327,17624,498,11327,5189,17267,562,22456,1093,3787,municipality,2020
3403936690,"Kenilworth borough, Union County, New Jersey",34039,INJ,2932,3019,87,6619,435,219,1933,6494,48,8427,268,5524,municipality,2020
3403940350,"Linden city, Union County, New Jersey",34039,INJ,15609,16452,843,34514,1484,11722,15055,28683,579,43738,1154,13744,municipality,2020
3403948510,"Mountainside borough, Union County, New Jersey",34039,INJ,2399,2564,165,5457,466,134,667,6353,52,7020,203,5498,municipality,2020
3403951810,"New Providence borough, Union County, New Jersey",34039,INJ,5071,5497,426,10216,2171,241,1251,12399,69,13650,489,9429,municipality,2020
3403959190,"Plainfield city, Union County, New Jersey",34039,INJ,16308,17125,817,39581,500,19034,29792,24794,746,54586,1131,3383,municipality,2020
3403961530,"Rahway city, Union County, New Jersey",34039,INJ,11544,12363,819,23805,1622,8892,8867,20689,272,29556,990,8913,municipality,2020
3403964620,"Roselle borough, Union County, New Jersey",34039,INJ,8008,8431,423,17964,580,10800,7900,14795,266,22695,675,2474,municipality,2020
3403964650,"Roselle Park borough, Union County, New Jersey",34039,INJ,5213,5346,133,10980,1271,1186,5293,8674,144,13967,348,5725,municipality,2020
3403966060,"Scotch Plains township, Union County, New Jersey",34039,INJ,8807,9103,296,18760,2610,2365,2579,22389,159,24968,958,16297,municipality,2020
3403970020,"Springfield township, Union County, New Jersey",34039,INJ,6820,7105,285,13626,1541,1504,2235,14943,139,17178,619,11140,municipality,2020
3403971430,"Summit city, Union County, New Jersey",34039,INJ,7905,8365,460,16582,2371,895,3313,19406,139,22719,985,15016,municipality,2020
3403974480,"Union township, Union County, New Jersey",34039,INJ,20672,21571,899,48674,6472,19296,11899,47829,847,59728,2068,19146,municipality,2020
3403979040,"Westfield town, Union County, New Jersey",34039,INJ,10622,11095,473,22351,2735,790,2247,28785,170,31032,1271,23819,municipality,2020
3403981650,"Winfield township, Union County, New Jersey",34039,INJ,692,706,14,1210,6,14,139,1284,5,1423,72,1187,municipality,2020
3404100670,"Allamuchy township, Warren County, New Jersey",34041,ONJ,2358,2467,109,4417,181,227,465,4870,35,5335,169,4258,municipality,2020
3404101030,"Alpha borough, Warren County, New Jersey",34041,ONJ,972,1047,75,1886,41,65,211,2117,5,2328,71,1935,municipality,2020
3404104990,"Belvidere town, Warren County, New Jersey",34041,ONJ,1031,1143,112,1983,20,28,198,2322,19,2520,89,2166,municipality,2020
3404106160,"Blairstown township, Warren County, New Jersey",34041,ONJ,2106,2245,139,4669,74,67,332,5372,53,5704,192,4986,municipality,2020
3404124960,"Franklin township, Warren County, New Jersey",34041,ONJ,1124,1219,95,2406,92,54,174,2794,18,2968,111,2519,municipality,2020
3404125320,"Frelinghuysen township, Warren County, New Jersey",34041,ONJ,780,833,53,1763,11,26,124,2075,4,2199,78,1956,municipality,2020
3404128260,"Greenwich township, Warren County, New Jersey",34041,ONJ,1798,1868,70,4165,416,474,546,4927,25,5473,220,3792,municipality,2020
3404128710,"Hackettstown town, Warren County, New Jersey",34041,ONJ,3769,3945,176,8129,402,341,2393,7855,55,10248,276,6781,municipality,2020
3404129820,"Hardwick township, Warren County, New Jersey",34041,ONJ,578,612,34,1296,11,12,105,1493,3,1598,53,1414,municipality,2020
3404130090,"Harmony township, Warren County, New Jersey",34041,ONJ,993,1066,73,2043,21,29,57,2446,10,2503,81,2305,municipality,2020
3404133060,"Hope township, Warren County, New Jersey",34041,ONJ,743,806,63,1522,16,8,139,1696,9,1835,69,1594,municipality,2020
3404133930,"Independence township, Warren County, New Jersey",34041,ONJ,2325,2439,114,4511,122,143,444,5025,28,5469,189,4543,municipality,2020
3404137320,"Knowlton township, Warren County, New Jersey",34041,ONJ,1103,1197,94,2393,37,22,197,2697,14,2894,155,2469,municipality,2020
3404140110,"Liberty township, Warren County, New Jersey",34041,ONJ,1022,1144,122,2176,41,40,156,2514,20,2670,90,2323,municipality,2020
3404141490,"Lopatcong township, Warren County, New Jersey",34041,ONJ,3588,3859,271,7141,440,714,803,7973,76,8776,247,6496,municipality,2020
3404143320,"Mansfield township, Warren County, New Jersey",34041,ONJ,3139,3351,212,6284,251,408,1153,6628,49,7781,321,5599,municipality,2020
3404155530,"Oxford township, Warren County, New Jersey",34041,ONJ,967,1040,73,1922,24,47,186,2258,4,2444,128,2055,municipality,2020
3404158350,"Phillipsburg town, Warren County, New Jersey",34041,ONJ,6024,6659,635,11423,219,1907,2552,12697,75,15249,810,9686,municipality,2020
3404159820,"Pohatcong township, Warren County, New Jersey",34041,ONJ,1310,1428,118,2653,43,89,215,3026,15,3241,148,2731,municipality,2020
3404177270,"Washington borough, Warren County, New Jersey",34041,ONJ,3002,3219,217,5778,230,540,1002,6297,57,7299,272,5198,municipality,2020
3404177300,"Washington township, Warren County, New Jersey",34041,ONJ,2426,2553,127,5225,153,238,533,5959,33,6492,208,5327,municipality,2020
3404180570,"White township, Warren County, New Jersey",34041,ONJ,2169,2317,148,4034,41,94,240,4366,17,4606,92,4122,municipality,2020
3600508510,"Bronx borough, Bronx County, New York",36005,NYC,522450,547030,24580,1123075,67766,419393,806463,666191,19866,1472654,28370,130796,municipality,2020
3602701693,"Amenia town, Dutchess County, New York",36027,MHV,1622,1962,340,3130,70,87,425,3344,33,3769,180,2974,municipality,2020
3602705100,"Beacon city, Dutchess County, New York",36027,MHV,5780,6262,482,11176,290,1741,2686,11083,161,13769,687,8204,municipality,2020
3602705452,"Beekman town, Dutchess County, New York",36027,MHV,4409,4874,465,11512,356,1485,1881,12291,67,14172,431,9952,municipality,2020
3602716408,"Clinton town, Dutchess County, New York",36027,MHV,1593,1901,308,3355,56,75,196,3841,14,4037,175,3521,municipality,2020
3602720819,"Dover town, Dutchess County, New York",36027,MHV,3182,3505,323,6610,266,372,1638,6777,44,8415,359,5736,municipality,2020
3602721996,"East Fishkill town, Dutchess County, New York",36027,MHV,10206,10829,623,23121,1254,1130,3679,26028,215,29707,1026,22403,municipality,2020
3602725978,"Fishkill town, Dutchess County, New York",36027,MHV,9039,9521,482,20557,1180,3160,3822,20404,177,24226,749,15138,municipality,2020
3602737209,"Hyde Park town, Dutchess County, New York",36027,MHV,7921,8433,512,17431,810,1594,1989,19032,148,21021,1075,15405,municipality,2020
3602740299,"La Grange town, Dutchess County, New York",36027,MHV,5617,5897,280,12529,707,842,1783,14192,121,15975,670,11852,municipality,2020
3602747207,"Milan town, Dutchess County, New York",36027,MHV,957,1202,245,1871,30,32,131,2114,20,2245,120,1912,municipality,2020
3602751891,"North East town, Dutchess County, New York",36027,MHV,1223,1543,320,2464,53,48,419,2552,12,2971,121,2318,municipality,2020
3602756825,"Pawling town, Dutchess County, New York",36027,MHV,3117,3518,401,6518,133,201,1178,6834,58,8012,246,6196,municipality,2020
3602758156,"Pine Plains town, Dutchess County, New York",36027,MHV,946,1175,229,1817,30,18,126,2092,11,2218,112,1921,municipality,2020
3602758695,"Pleasant Valley town, Dutchess County, New York",36027,MHV,3921,4151,230,7847,184,384,866,8933,89,9799,459,7817,municipality,2020
3602759641,"Poughkeepsie city, Dutchess County, New York",36027,MHV,13139,14604,1465,24676,505,11165,7105,24472,290,31577,1659,10853,municipality,2020
3602759652,"Poughkeepsie town, Dutchess County, New York",36027,MHV,15857,16878,1021,37129,2802,5115,6794,38677,541,45471,1813,28406,municipality,2020
3602760905,"Red Hook town, Dutchess County, New York",36027,MHV,3926,4415,489,8158,299,148,733,9220,44,9953,348,8381,municipality,2020
3602761357,"Rhinebeck town, Dutchess County, New York",36027,MHV,3320,3787,467,6553,154,97,506,7090,45,7596,284,6510,municipality,2020
3602770662,"Stanford town, Dutchess County, New York",36027,MHV,1494,1859,365,3082,43,135,277,3405,25,3682,129,3073,municipality,2020
3602776166,"Union Vale town, Dutchess County, New York",36027,MHV,1587,1766,179,3689,78,74,312,4246,26,4558,142,3926,municipality,2020
3602778157,"Wappinger town, Dutchess County, New York",36027,MHV,11183,11657,474,22727,1270,2120,5228,22988,244,28216,1023,18331,municipality,2020
3602778388,"Washington town, Dutchess County, New York",36027,MHV,1888,2270,382,3671,65,103,450,4072,25,4522,213,3666,municipality,2020
3604710022,"Brooklyn borough, Kings County, New York",36047,NYC,1009804,1077654,67850,2140371,370776,729696,516426,2219648,37579,2736074,113170,968427,municipality,2020
3601011,"Albertson CDP, New York",36059,LI,1795,1857,62,4201,1700,25,468,4752,46,5220,114,2867,municipality,2020
3602968,"Atlantic Beach village, New York",36059,LI,763,1046,283,1505,28,3,83,1624,16,1707,44,1533,municipality,2020
3604143,"Baldwin CDP, New York",36059,LI,10702,11092,390,26928,1576,12989,7588,26331,598,33919,1337,9831,municipality,2020
3604550,"Barnum Island CDP, New York",36059,LI,1026,1062,36,2207,156,69,504,2086,38,2590,61,1762,municipality,2020
3604803,"Baxter Estates village, New York",36059,LI,394,425,31,791,74,7,173,818,4,991,33,700,municipality,2020
3604891,"Bay Park CDP, New York",36059,LI,845,888,43,1703,28,42,228,1889,12,2117,41,1766,municipality,2020
3605034,"Bayville village, New York",36059,LI,2518,2691,173,5513,140,32,704,6044,25,6748,156,5691,municipality,2020
3605639,"Bellerose village, New York",36059,LI,384,388,4,918,62,36,121,1052,15,1173,43,896,municipality,2020
3605661,"Bellerose Terrace CDP, New York",36059,LI,670,692,22,1817,782,151,655,1674,63,2329,77,601,municipality,2020
3605738,"Bellmore CDP, New York",36059,LI,5572,5776,204,12819,737,242,1570,14727,57,16297,454,13237,municipality,2020
3606387,"Bethpage CDP, New York",36059,LI,5810,6072,262,13417,2066,151,1735,14923,78,16658,336,12292,municipality,2020
3610132,"Brookville village, New York",36059,LI,625,661,36,2506,390,45,152,2787,10,2939,69,2273,municipality,2020
3612419,"Carle Place CDP, New York",36059,LI,1825,1908,83,4043,488,148,740,4265,50,5005,145,3434,municipality,2020
3613233,"Cedarhurst village, New York",36059,LI,2265,2413,148,5016,189,151,1040,6334,74,7374,117,5803,municipality,2020
3613618,"Centre Island village, New York",36059,LI,160,229,69,334,19,2,31,376,1,407,3,351,municipality,2020
3618597,"Cove Neck village, New York",36059,LI,125,138,13,218,0,0,18,275,2,293,9,264,municipality,2020
3621578,"East Atlantic Beach CDP, New York",36059,LI,860,994,134,1843,18,8,128,1973,9,2101,40,1898,municipality,2020
3622260,"East Hills village, New York",36059,LI,2218,2294,76,5274,888,85,303,6981,34,7284,166,5808,municipality,2020
3622480,"East Massapequa CDP, New York",36059,LI,6884,7112,228,16066,486,2415,2775,17079,156,19854,548,13474,municipality,2020
3622502,"East Meadow CDP, New York",36059,LI,12361,12951,590,30442,6758,1668,6048,31748,367,37796,916,22039,municipality,2020
3622623,"East Norwich CDP, New York",36059,LI,968,998,30,2205,111,26,222,2570,8,2792,63,2362,municipality,2020
3622876,"East Rockaway village, New York",36059,LI,3814,4000,186,8157,327,296,1451,8708,47,10159,249,7789,municipality,2020
3623217,"East Williston village, New York",36059,LI,828,864,36,1958,340,5,150,2495,7,2645,83,2060,municipality,2020
3624273,"Elmont CDP, New York",36059,LI,9896,10270,374,28191,5290,15460,8024,27241,901,35265,1308,4282,municipality,2020
3625384,"Farmingdale village, New York",36059,LI,3627,3868,241,7196,618,280,1291,7175,70,8466,188,6019,municipality,2020
3626264,"Floral Park village, New York",36059,LI,5746,5961,215,12714,1889,262,2067,14105,99,16172,360,11495,municipality,2020
3626352,"Flower Hill village, New York",36059,LI,1473,1529,56,3556,904,32,280,4514,36,4794,119,3423,municipality,2020
3627309,"Franklin Square CDP, New York",36059,LI,9903,10231,328,24938,3947,1385,5979,24924,341,30903,647,18604,municipality,2020
3627485,"Freeport village, New York",36059,LI,13501,14137,636,34879,792,12830,21312,23160,649,44472,1257,7632,municipality,2020
3628178,"Garden City village, New York",36059,LI,7513,7715,202,17677,1589,212,1486,21786,129,23272,512,19344,municipality,2020
3628189,"Garden City Park CDP, New York",36059,LI,2499,2592,93,6396,3742,223,999,6986,95,7985,224,2702,municipality,2020
3628200,"Garden City South CDP, New York",36059,LI,1401,1454,53,3282,348,42,475,3644,17,4119,77,3160,municipality,2020
3629113,"Glen Cove city, New York",36059,LI,10099,10793,694,23159,1449,1595,9752,18613,236,28365,558,14775,municipality,2020
3629245,"Glen Head CDP, New York",36059,LI,1718,1787,69,3774,330,32,546,4291,28,4837,115,3786,municipality,2020
3629421,"Glenwood Landing CDP, New York",36059,LI,1375,1422,47,3087,236,25,355,3593,28,3948,92,3212,municipality,2020
3630169,"Great Neck village, New York",36059,LI,3620,3883,263,8142,1497,145,1204,9941,103,11145,429,7767,municipality,2020
3630191,"Great Neck Estates village, New York",36059,LI,879,937,58,2195,563,16,122,2868,32,2990,98,2159,municipality,2020
3630202,"Great Neck Gardens CDP, New York",36059,LI,380,397,17,887,390,3,30,1238,5,1268,28,812,municipality,2020
3630213,"Great Neck Plaza village, New York",36059,LI,3702,3954,252,6218,1960,135,626,6856,43,7482,195,4523,municipality,2020
3630598,"Greenvale CDP, New York",36059,LI,344,373,29,849,270,8,118,951,12,1069,39,622,municipality,2020
3632094,"Harbor Hills CDP, New York",36059,LI,177,188,11,395,45,0,5,557,3,562,21,488,municipality,2020
3632105,"Harbor Isle CDP, New York",36059,LI,473,497,24,1139,22,26,145,1291,7,1436,35,1201,municipality,2020
3633139,"Hempstead village, New York",36059,LI,16299,16954,655,44564,1242,23041,29640,29529,785,59169,1394,3067,municipality,2020
3634198,"Herricks CDP, New York",36059,LI,1330,1380,50,3501,2522,27,196,4202,57,4398,109,1487,municipality,2020
3634286,"Hewlett CDP, New York",36059,LI,2532,2698,166,5582,630,303,1086,6176,61,7262,193,4989,municipality,2020
3634297,"Hewlett Bay Park village, New York",36059,LI,140,144,4,358,40,7,20,474,4,494,23,400,municipality,2020
3634308,"Hewlett Harbor village, New York",36059,LI,418,442,24,1009,59,13,59,1231,5,1290,30,1124,municipality,2020
3634319,"Hewlett Neck village, New York",36059,LI,149,161,12,395,22,12,30,539,8,569,6,491,municipality,2020
3634374,"Hicksville CDP, New York",36059,LI,13477,13889,412,35802,14178,1129,8003,35866,408,43869,1078,19073,municipality,2020
3637583,"Inwood CDP, New York",36059,LI,3180,3355,175,8159,431,1920,5997,5343,127,11340,185,2680,municipality,2020
3637847,"Island Park village, New York",36059,LI,1725,1851,126,3983,203,149,1645,3283,77,4928,125,2729,municipality,2020
3638539,"Jericho CDP, New York",36059,LI,4597,4818,221,11140,7168,301,595,14213,87,14808,288,6369,municipality,2020
3639309,"Kensington village, New York",36059,LI,430,457,27,939,282,4,15,1211,10,1226,38,877,municipality,2020
3639694,"Kings Point village, New York",36059,LI,1293,1416,123,4381,307,88,214,5405,27,5619,303,4680,municipality,2020
3640937,"Lake Success village, New York",36059,LI,820,858,38,2125,1587,12,103,2725,20,2828,67,1039,municipality,2020
3641003,"Lakeview CDP, New York",36059,LI,1567,1625,58,4732,157,4249,1123,4954,143,6077,253,152,municipality,2020
3641432,"Lattingtown village, New York",36059,LI,614,708,94,1445,81,5,117,1764,9,1881,56,1613,municipality,2020
3641487,"Laurel Hollow village, New York",36059,LI,594,630,36,1426,168,15,92,1848,7,1940,55,1603,municipality,2020
3641553,"Lawrence village, New York",36059,LI,2185,2432,247,4936,93,85,308,6501,116,6809,112,6095,municipality,2020
3642081,"Levittown CDP, New York",36059,LI,16634,17123,489,41214,5900,675,8617,43141,354,51758,1359,34853,municipality,2020
3642279,"Lido Beach CDP, New York",36059,LI,1161,1302,141,2300,52,10,148,2571,4,2719,51,2454,municipality,2020
3643192,"Locust Valley CDP, New York",36059,LI,1268,1339,71,2753,124,90,861,2710,23,3571,65,2408,municipality,2020
3643335,"Long Beach city, New York",36059,LI,15360,16771,1411,29730,1107,1820,5370,29659,336,35029,865,25531,municipality,2020
3643874,"Lynbrook village, New York",36059,LI,7459,7798,339,16101,1270,1345,3847,16591,177,20438,589,13210,municipality,2020
3644787,"Malverne village, New York",36059,LI,3068,3159,91,6929,488,464,1116,7444,120,8560,209,6163,municipality,2020
3644792,"Malverne Park Oaks CDP, New York",36059,LI,186,194,8,436,47,60,63,475,16,538,18,334,municipality,2020
3644897,"Manhasset CDP, New York",36059,LI,2790,2947,157,6307,1863,597,868,7308,28,8176,214,4606,municipality,2020
3644908,"Manhasset Hills CDP, New York",36059,LI,1119,1154,35,2842,1974,32,237,3412,48,3649,71,1287,municipality,2020
3645106,"Manorhaven village, New York",36059,LI,2534,2699,165,5319,995,106,2487,4469,42,6956,131,3195,municipality,2020
3645986,"Massapequa CDP, New York",36059,LI,7152,7375,223,16885,432,112,1586,19769,59,21355,505,18661,municipality,2020
3645997,"Massapequa Park village, New York",36059,LI,5759,5913,154,13441,306,78,1235,15874,74,17109,311,15105,municipality,2020
3646107,"Matinecock village, New York",36059,LI,284,323,39,680,46,1,77,770,0,847,13,710,municipality,2020
3646668,"Merrick CDP, New York",36059,LI,7436,7672,236,17139,928,339,2066,19974,139,22040,494,18074,municipality,2020
3647405,"Mill Neck village, New York",36059,LI,349,414,65,838,67,20,132,922,1,1054,32,802,municipality,2020
3647636,"Mineola village, New York",36059,LI,8311,8776,465,17149,2860,528,4071,16729,216,20800,625,12500,municipality,2020
3649231,"Munsey Park village, New York",36059,LI,821,842,21,1960,378,29,149,2660,10,2809,102,2141,municipality,2020
3649330,"Muttontown village, New York",36059,LI,1057,1141,84,2786,1189,54,159,3353,16,3512,67,2027,municipality,2020
3650067,"New Cassel CDP, New York",36059,LI,3185,3402,217,10499,422,4895,7917,6282,99,14199,199,667,municipality,2020
3650397,"New Hyde Park village, New York",36059,LI,3260,3376,116,8167,4063,176,1413,8844,118,10257,234,4253,municipality,2020
3651517,"North Bellmore CDP, New York",36059,LI,6723,6866,143,16241,1470,645,2374,18209,133,20583,518,15443,municipality,2020
3653022,"North Hills village, New York",36059,LI,2290,2500,210,4710,1878,53,151,5313,27,5464,110,3245,municipality,2020
3653231,"North Lynbrook CDP, New York",36059,LI,233,234,1,611,68,70,113,634,4,747,24,468,municipality,2020
3653253,"North Massapequa CDP, New York",36059,LI,5963,6103,140,14292,459,107,1541,16288,48,17829,305,15369,municipality,2020
3653264,"North Merrick CDP, New York",36059,LI,4023,4137,114,9467,668,305,1332,10906,88,12238,279,9566,municipality,2020
3653275,"North New Hyde Park CDP, New York",36059,LI,4887,5024,137,12558,7238,108,1230,14427,204,15657,289,6588,municipality,2020
3653748,"North Valley Stream CDP, New York",36059,LI,5447,5638,191,14821,3515,8111,2677,15520,492,18197,767,2635,municipality,2020
3653792,"North Wantagh CDP, New York",36059,LI,4174,4282,108,9493,375,138,1416,10515,74,11931,255,9673,municipality,2020
3654441,"Oceanside CDP, New York",36059,LI,11212,11552,340,25795,1181,658,4529,28108,237,32637,773,25259,municipality,2020
3654551,"Old Bethpage CDP, New York",36059,LI,2390,2836,446,5168,597,17,340,6063,17,6403,139,5293,municipality,2020
3654562,"Old Brookville village, New York",36059,LI,692,718,26,1600,260,31,120,1900,17,2020,34,1558,municipality,2020
3654705,"Old Westbury village, New York",36059,LI,1080,1209,129,3605,977,586,318,3971,26,4289,148,2234,municipality,2020
3655992,"Oyster Bay CDP, New York",36059,LI,2831,2964,133,5701,236,228,1396,5653,29,7049,167,4993,municipality,2020
3656011,"Oyster Bay Cove village, New York",36059,LI,695,759,64,1782,270,22,113,2152,16,2265,70,1774,municipality,2020
3658409,"Plainedge CDP, New York",36059,LI,2863,2941,78,7691,815,172,1093,8424,66,9517,194,7177,municipality,2020
3658442,"Plainview CDP, New York",36059,LI,8861,9207,346,20888,5548,131,1598,25502,128,27100,561,19134,municipality,2020
3658475,"Plandome village, New York",36059,LI,411,445,34,1031,165,9,67,1381,7,1448,31,1169,municipality,2020
3658486,"Plandome Heights village, New York",36059,LI,327,333,6,734,185,0,71,938,11,1009,24,718,municipality,2020
3658497,"Plandome Manor village, New York",36059,LI,252,272,20,620,91,2,50,743,5,793,7,638,municipality,2020
3658849,"Point Lookout CDP, New York",36059,LI,668,855,187,1313,18,8,62,1465,4,1527,28,1407,municipality,2020
3659520,"Port Washington CDP, New York",36059,LI,5925,6269,344,12733,1502,312,2524,14229,76,16753,592,11747,municipality,2020
3659531,"Port Washington North village, New York",36059,LI,1324,1377,53,2509,296,28,297,2863,27,3160,77,2435,municipality,2020
3663264,"Rockville Centre village, New York",36059,LI,9669,9991,322,20321,617,1314,3029,22987,129,26016,608,20319,municipality,2020
3663506,"Roosevelt CDP, New York",36059,LI,4242,4441,199,13678,169,8519,8406,9660,216,18066,413,343,municipality,2020
3663770,"Roslyn village, New York",36059,LI,1309,1441,132,2496,465,44,513,2475,20,2988,74,1872,municipality,2020
3663792,"Roslyn Estates village, New York",36059,LI,391,407,16,1010,169,10,42,1276,7,1318,28,1062,municipality,2020
3663803,"Roslyn Harbor village, New York",36059,LI,330,379,49,845,196,4,63,1004,3,1067,45,756,municipality,2020
3663814,"Roslyn Heights CDP, New York",36059,LI,2108,2218,110,5074,2239,375,700,6047,61,6747,169,3203,municipality,2020
3664232,"Russell Gardens village, New York",36059,LI,314,339,25,776,418,3,30,948,11,978,24,492,municipality,2020
3664430,"Saddle Rock village, New York",36059,LI,281,293,12,708,94,1,18,971,9,989,27,840,municipality,2020
3664441,"Saddle Rock Estates CDP, New York",36059,LI,130,139,9,306,41,3,1,427,11,428,17,355,municipality,2020
3664842,"Salisbury CDP, New York",36059,LI,3989,4106,117,10015,2383,321,2484,10134,96,12618,340,6994,municipality,2020
3665035,"Sands Point village, New York",36059,LI,878,947,69,2043,261,32,117,2595,9,2712,44,2249,municipality,2020
3666047,"Sea Cliff village, New York",36059,LI,1954,2086,132,4002,148,82,475,4587,17,5062,180,4160,municipality,2020
3666058,"Seaford CDP, New York",36059,LI,5293,5475,182,12148,428,111,1239,14012,68,15251,354,13051,municipality,2020
3666102,"Searingtown CDP, New York",36059,LI,1556,1607,51,3973,2647,58,197,4847,35,5044,121,1986,municipality,2020
3669001,"South Farmingdale CDP, New York",36059,LI,4765,4902,137,11568,773,284,2078,12267,82,14345,306,10822,municipality,2020
3669023,"South Floral Park village, New York",36059,LI,507,534,27,1370,240,834,384,1357,35,1741,90,158,municipality,2020
3669188,"South Hempstead CDP, New York",36059,LI,1029,1074,45,2562,79,506,836,2570,45,3406,88,1852,municipality,2020
3669892,"South Valley Stream CDP, New York",36059,LI,1995,2063,68,4957,1376,1674,793,5593,181,6386,237,2125,municipality,2020
3671267,"Stewart Manor village, New York",36059,LI,691,709,18,1577,149,39,256,1736,12,1992,56,1480,municipality,2020
3672554,"Syosset CDP, New York",36059,LI,6033,6293,260,14373,6944,118,971,18288,95,19259,486,10645,municipality,2020
3673605,"Thomaston village, New York",36059,LI,984,1024,40,2124,1265,37,121,2638,28,2759,63,1245,municipality,2020
3676089,"Uniondale CDP, New York",36059,LI,7850,8255,405,26236,1119,11543,12934,19539,376,32473,857,5644,municipality,2020
3676287,"University Gardens CDP, New York",36059,LI,1642,1706,64,3479,2119,60,323,4035,24,4358,130,1702,municipality,2020
3676331,"Upper Brookville village, New York",36059,LI,557,612,55,1404,278,31,87,1699,13,1786,54,1323,municipality,2020
3676705,"Valley Stream village, New York",36059,LI,12494,12925,431,31915,6503,9343,10672,29962,1119,40634,1547,11450,municipality,2020
3678146,"Wantagh CDP, New York",36059,LI,6062,6228,166,14446,495,59,1399,17214,71,18613,378,16211,municipality,2020
3679444,"Westbury village, New York",36059,LI,5083,5265,182,12777,1481,2741,5143,10721,178,15864,446,5875,municipality,2020
3680225,"West Hempstead CDP, New York",36059,LI,6093,6315,222,15294,1438,2249,3956,15879,308,19835,562,11322,municipality,2020
3682117,"Williston Park village, New York",36059,LI,2691,2787,96,6052,1448,81,753,6838,65,7591,219,5025,municipality,2020
3682744,"Woodbury CDP, New York",36059,LI,3155,3402,247,7510,1611,127,532,8803,45,9335,139,6881,municipality,2020
3682942,"Woodmere CDP, New York",36059,LI,5199,5485,286,12467,586,757,960,17709,284,18669,291,15791,municipality,2020
3682986,"Woodsburgh village, New York",36059,LI,293,306,13,665,33,3,28,869,12,897,10,811,municipality,2020
3605929113,"Glen Cove city, Nassau County, New York",36059,LI,10099,10793,694,23159,1449,1595,9752,18613,236,28365,558,14775,municipality,2020
3605934000,"Hempstead town, Nassau County, New York",36059,LI,250261,260524,10263,620910,59525,125839,174883,618526,9584,793409,21112,402466,municipality,2020
3605943335,"Long Beach city, Nassau County, New York",36059,LI,15360,16771,1411,29730,1107,1820,5370,29659,336,35029,865,25531,municipality,2020
3605953000,"North Hempstead town, Nassau County, New York",36059,LI,79546,83729,4183,185502,54700,11312,35083,202556,1952,237639,6424,128168,municipality,2020
3605956000,"Oyster Bay town, Nassau County, New York",36059,LI,100216,104915,4699,239583,46384,6650,31337,269995,1678,301332,6769,208514,municipality,2020
3606144919,"Manhattan borough, New York County, New York",36061,NYC,817782,913926,96144,1461740,219624,199592,402640,1291611,16112,1694251,62989,793294,municipality,2020
3607107003,"Blooming Grove town, Orange County, New York",36071,MHV,6253,6944,691,14050,401,1387,3913,14898,459,18811,670,11981,municipality,2020
3607115308,"Chester town, Orange County, New York",36071,MHV,4356,4590,234,9793,498,1058,2446,10200,122,12646,457,8065,municipality,2020
3607118300,"Cornwall town, Orange County, New York",36071,MHV,4923,5240,317,10058,408,414,1664,11220,116,12884,521,9761,municipality,2020
3607118916,"Crawford town, Orange County, New York",36071,MHV,3339,3549,210,7160,138,346,1370,7760,71,9130,358,6847,municipality,2020
3607119961,"Deerpark town, Orange County, New York",36071,MHV,2954,3319,365,6119,328,211,657,6852,67,7509,395,5851,municipality,2020
3607129553,"Goshen town, Orange County, New York",36071,MHV,4832,5226,394,11595,473,888,3133,11438,96,14571,377,9604,municipality,2020
3607130631,"Greenville town, Orange County, New York",36071,MHV,1613,1725,112,3621,54,144,626,4063,53,4689,160,3652,municipality,2020
3607131907,"Hamptonburgh town, Orange County, New York",36071,MHV,1778,1877,99,4300,203,175,797,4692,39,5489,189,4086,municipality,2020
3607134550,"Highlands town, Orange County, New York",36071,MHV,3156,3554,398,10256,598,1333,2066,10873,153,12939,554,8235,municipality,2020
3607147042,"Middletown city, Orange County, New York",36071,MHV,11011,11980,969,23028,1130,6304,13243,17102,349,30345,1083,8236,municipality,2020
3607147713,"Minisink town, Orange County, New York",36071,MHV,1579,1659,80,3532,45,127,618,4003,37,4621,137,3657,municipality,2020
3607147999,"Monroe town, Orange County, New York",36071,MHV,12853,13628,775,29432,1199,1588,5807,48534,8930,54341,1359,35458,municipality,2020
3607148153,"Montgomery town, Orange County, New York",36071,MHV,8367,8920,553,18134,389,1663,4320,19002,183,23322,970,15797,municipality,2020
3607148857,"Mount Hope town, Orange County, New York",36071,MHV,1869,2059,190,5301,298,756,1143,5394,75,6537,186,4079,municipality,2020
3607150034,"Newburgh city, Orange County, New York",36071,MHV,9771,11099,1328,20845,246,7545,15085,13771,261,28856,886,4833,municipality,2020
3607150045,"Newburgh town, Orange County, New York",36071,MHV,11745,12406,661,25742,929,4095,7066,24919,300,31985,1185,18410,municipality,2020
3607150848,"New Windsor town, Orange County, New York",36071,MHV,10500,11156,656,21835,1059,3969,7100,20705,239,27805,970,14468,municipality,2020
3607159388,"Port Jervis city, Orange County, New York",36071,MHV,3542,3992,450,6690,181,727,1311,7464,163,8775,550,5843,municipality,2020
3607175781,"Tuxedo town, Orange County, New York",36071,MHV,1441,1660,219,3164,191,182,466,3345,26,3811,115,2831,municipality,2020
3607177992,"Wallkill town, Orange County, New York",36071,MHV,11371,12047,676,24203,1289,5709,8492,21994,408,30486,1124,13464,municipality,2020
3607178366,"Warwick town, Orange County, New York",36071,MHV,12115,13315,1200,25808,622,1268,4429,27598,258,32027,1037,24413,municipality,2020
3607178839,"Wawayanda town, Orange County, New York",36071,MHV,2593,2758,165,5863,190,451,1335,6199,55,7534,231,5272,municipality,2020
3607182755,"Woodbury town, Orange County, New York",36071,MHV,3785,4176,391,8774,796,1001,2657,9540,410,12197,328,7005,municipality,2020
3607912529,"Carmel town, Putnam County, New York",36079,LHV,11897,12578,681,26674,698,752,5301,28275,199,33576,795,25831,municipality,2020
3607939331,"Kent town, Putnam County, New York",36079,LHV,4866,5429,563,10395,270,359,2818,10082,100,12900,390,8963,municipality,2020
3607956748,"Patterson town, Putnam County, New York",36079,LHV,3786,4101,315,9500,253,447,2557,8984,73,11541,339,7872,municipality,2020
3607957584,"Philipstown town, Putnam County, New York",36079,LHV,3847,4325,478,7888,208,150,916,8915,60,9831,410,8087,municipality,2020
3607960147,"Putnam Valley town, Putnam County, New York",36079,LHV,4237,4817,580,9354,251,292,1852,9910,86,11762,422,8859,municipality,2020
3607968924,"Southeast town, Putnam County, New York",36079,LHV,6696,7058,362,14459,466,425,4316,13742,135,18058,386,12330,municipality,2020
3608160323,"Queens borough, Queens County, New York",36081,NYC,847210,896333,49123,1949469,656583,381375,667861,1737603,66175,2405464,84112,549358,municipality,2020
3608570915,"Staten Island borough, Richmond County, New York",36085,NYC,173202,183692,10490,389393,58753,46835,96960,398787,3900,495747,11318,277981,municipality,2020
3608715968,"Clarkstown town, Rockland County, New York",36087,LHV,29489,30629,1140,68454,10152,8298,16275,70580,678,86855,2171,49281,municipality,2020
3608732765,"Haverstraw town, Rockland County, New York",36087,LHV,12646,13178,532,29629,1713,5434,18556,20531,303,39087,741,12340,municipality,2020
3608755211,"Orangetown town, Rockland County, New York",36087,LHV,17945,18986,1041,39240,3480,2577,6428,42227,311,48655,1397,34462,municipality,2020
3608760510,"Ramapo town, Rockland County, New York",36087,LHV,37722,39869,2147,90360,4563,16555,21984,126935,2485,148919,2995,100337,municipality,2020
3608771674,"Stony Point town, Rockland County, New York",36087,LHV,5146,5406,260,11833,505,911,3208,11605,100,14813,396,9693,municipality,2020
3601594,"Amagansett CDP, New York",36103,LI,770,1776,1006,1511,18,35,186,1638,24,1824,39,1522,municipality,2020
3602044,"Amityville village, New York",36103,LI,3846,4015,169,8105,163,876,1761,7739,72,9500,225,6403,municipality,2020
3602374,"Aquebogue CDP, New York",36103,LI,969,1164,195,2079,26,52,476,2071,8,2547,66,1919,municipality,2020
3602737,"Asharoken village, New York",36103,LI,231,296,65,512,6,2,31,561,10,592,11,532,municipality,2020
3603408,"Babylon village, New York",36103,LI,4544,4732,188,9741,294,199,1067,11121,59,12188,348,10221,municipality,2020
3604055,"Baiting Hollow CDP, New York",36103,LI,1081,1656,575,2283,21,67,309,2454,18,2763,58,2290,municipality,2020
3604913,"Bayport CDP, New York",36103,LI,3245,3506,261,6846,142,161,754,7855,40,8609,211,7301,municipality,2020
3604935,"Bay Shore CDP, New York",36103,LI,9667,10126,459,22561,1236,5044,11127,18117,382,29244,795,10660,municipality,2020
3605039,"Baywood CDP, New York",36103,LI,2210,2266,56,6060,301,1019,3470,4256,111,7726,264,2561,municipality,2020
3605672,"Belle Terre village, New York",36103,LI,287,312,25,660,42,8,54,754,5,808,27,672,municipality,2020
3605771,"Bellport village, New York",36103,LI,938,1170,232,1840,34,46,118,2085,9,2203,72,1924,municipality,2020
3607069,"Blue Point CDP, New York",36103,LI,2029,2132,103,4180,87,42,287,4869,26,5156,115,4599,municipality,2020
3607157,"Bohemia CDP, New York",36103,LI,3581,3720,139,7907,349,170,1040,8812,17,9852,202,8074,municipality,2020
3608026,"Brentwood CDP, New York",36103,LI,13658,14127,469,46299,1134,6766,47072,15315,804,62387,795,5816,municipality,2020
3608136,"Bridgehampton CDP, New York",36103,LI,1136,2632,1496,2356,71,199,417,2536,16,2953,90,2160,municipality,2020
3608323,"Brightwaters village, New York",36103,LI,1135,1160,25,2451,46,82,250,2931,3,3181,82,2718,municipality,2020
3609000,"Brookhaven CDP, New York",36103,LI,1097,1177,80,2754,34,190,303,3027,23,3330,94,2686,municipality,2020
3611781,"Calverton CDP, New York",36103,LI,2779,3016,237,4986,47,414,1095,4839,34,5934,141,4203,municipality,2020
3613376,"Centereach CDP, New York",36103,LI,10008,10405,397,24667,2658,964,5147,25833,177,30980,859,21175,municipality,2020
3613420,"Center Moriches CDP, New York",36103,LI,2770,2960,190,6249,109,243,1129,6917,30,8046,227,6308,municipality,2020
3613442,"Centerport CDP, New York",36103,LI,2171,2272,101,4677,108,20,306,5516,38,5822,169,5181,municipality,2020
3613552,"Central Islip CDP, New York",36103,LI,9870,10344,474,27835,1085,7005,21856,14858,573,36714,781,5414,municipality,2020
3616958,"Cold Spring Harbor CDP, New York",36103,LI,975,1020,45,2286,119,10,203,2861,13,3064,98,2621,municipality,2020
3617530,"Commack CDP, New York",36103,LI,12009,12312,303,28798,2536,632,2914,33622,221,36536,765,29468,municipality,2020
3618146,"Copiague CDP, New York",36103,LI,7684,8024,340,18791,524,1836,9634,13795,205,23429,487,10743,municipality,2020
3618157,"Coram CDP, New York",36103,LI,15234,16060,826,32506,2197,4703,7454,32766,308,40220,1395,24163,municipality,2020
3619466,"Cutchogue CDP, New York",36103,LI,1400,2121,721,2910,28,36,417,3020,12,3437,58,2886,municipality,2020
3619972,"Deer Park CDP, New York",36103,LI,9510,9839,329,22826,3322,3982,5206,23631,341,28837,786,15200,municipality,2020
3620379,"Dering Harbor village, New York",36103,LI,17,34,17,39,4,0,16,34,1,50,5,24,municipality,2020
3620687,"Dix Hills CDP, New York",36103,LI,8016,8315,299,20346,4397,1410,2224,23956,272,26180,778,17099,municipality,2020
3621985,"East Farmingdale CDP, New York",36103,LI,2177,2275,98,5376,528,785,1706,4911,53,6617,161,3384,municipality,2020
3622183,"East Hampton village, New York",36103,LI,668,1774,1106,1293,24,24,177,1340,7,1517,32,1253,municipality,2020
3622200,"East Hampton North CDP, New York",36103,LI,1889,2856,967,4217,75,219,2396,2981,46,5377,117,2524,municipality,2020
3622315,"East Islip CDP, New York",36103,LI,4769,4918,149,11081,302,209,1454,12477,71,13931,328,11567,municipality,2020
3622447,"East Marion CDP, New York",36103,LI,494,946,452,927,11,11,109,939,9,1048,27,881,municipality,2020
3622546,"East Moriches CDP, New York",36103,LI,2120,2349,229,4713,84,112,571,5375,38,5946,140,5001,municipality,2020
3622612,"East Northport CDP, New York",36103,LI,6996,7246,250,15945,591,205,2120,17928,93,20048,500,16539,municipality,2020
3622733,"East Patchogue CDP, New York",36103,LI,8221,8612,391,17575,522,982,4975,16605,144,21580,660,14297,municipality,2020
3622810,"Eastport CDP, New York",36103,LI,907,1015,108,1893,19,32,300,1919,14,2219,68,1786,municipality,2020
3622832,"East Quogue CDP, New York",36103,LI,2152,3104,952,4420,77,36,1029,4528,27,5557,120,4268,municipality,2020
3622980,"East Shoreham CDP, New York",36103,LI,2181,2248,67,5307,183,121,647,6194,38,6841,232,5620,municipality,2020
3623316,"Eatons Neck CDP, New York",36103,LI,507,570,63,1110,22,5,60,1274,5,1334,25,1217,municipality,2020
3624405,"Elwood CDP, New York",36103,LI,3730,3846,116,9115,941,535,1387,10039,59,11426,314,8190,municipality,2020
3625417,"Farmingville CDP, New York",36103,LI,4706,4845,139,11792,709,510,2659,12324,113,14983,472,10520,municipality,2020
3625839,"Fire Island CDP, New York",36103,LI,393,3357,2964,668,17,29,99,678,19,777,28,585,municipality,2020
3625923,"Fishers Island CDP, New York",36103,LI,180,609,429,352,11,3,32,392,4,424,22,352,municipality,2020
3626121,"Flanders CDP, New York",36103,LI,1492,1714,222,3810,37,421,2764,2334,44,5098,125,1707,municipality,2020
3626946,"Fort Salonga CDP, New York",36103,LI,3299,3430,131,7805,227,75,619,9033,31,9652,250,8450,municipality,2020
3628997,"Gilgo-Oak Beach-Captree CDP, New York",36103,LI,224,405,181,438,20,7,26,475,2,501,5,441,municipality,2020
3629509,"Gordon Heights CDP, New York",36103,LI,1059,1131,72,2932,91,1478,1479,2502,101,3981,183,649,municipality,2020
3630235,"Great River CDP, New York",36103,LI,798,842,44,1691,36,29,155,1850,1,2005,32,1752,municipality,2020
3630543,"Greenlawn CDP, New York",36103,LI,4524,4669,145,10677,773,1660,2420,11241,92,13661,387,8329,municipality,2020
3630576,"Greenport village, New York",36103,LI,950,1277,327,1998,25,197,957,1626,20,2583,84,1300,municipality,2020
3630581,"Greenport West CDP, New York",36103,LI,1056,1658,602,1988,29,85,388,1894,11,2282,40,1729,municipality,2020
3631445,"Halesite CDP, New York",36103,LI,1034,1099,65,2097,60,41,176,2351,18,2527,63,2169,municipality,2020
3631896,"Hampton Bays CDP, New York",36103,LI,5669,7879,2210,12251,177,167,5715,9513,136,15228,274,8759,municipality,2020
3632732,"Hauppauge CDP, New York",36103,LI,7180,7384,204,16164,1481,503,2080,18003,111,20083,468,15440,municipality,2020
3632963,"Head of the Harbor village, New York",36103,LI,475,537,62,1235,59,4,177,1343,12,1520,56,1212,municipality,2020
3635056,"Holbrook CDP, New York",36103,LI,9439,9714,275,21274,1194,701,3166,23321,156,26487,547,20723,municipality,2020
3635254,"Holtsville CDP, New York",36103,LI,6448,6646,198,15190,1040,455,2728,16209,105,18937,479,14130,municipality,2020
3636233,"Huntington CDP, New York",36103,LI,7920,8341,421,16354,568,368,1458,18187,103,19645,536,16612,municipality,2020
3637022,"Huntington Bay village, New York",36103,LI,552,593,41,1249,29,5,56,1390,16,1446,39,1301,municipality,2020
3637044,"Huntington Station CDP, New York",36103,LI,10517,10943,426,26642,1588,3012,15793,19085,289,34878,808,13388,municipality,2020
3637840,"Islandia village, New York",36103,LI,1044,1087,43,2981,219,437,1135,2432,33,3567,92,1651,municipality,2020
3637869,"Islip CDP, New York",36103,LI,6407,6605,198,14701,635,889,3574,14844,144,18418,473,12703,municipality,2020
3638022,"Islip Terrace CDP, New York",36103,LI,1698,1774,76,4205,147,146,836,4487,48,5323,123,4023,municipality,2020
3638253,"Jamesport CDP, New York",36103,LI,689,1126,437,1384,7,22,177,1432,1,1609,21,1381,municipality,2020
3639672,"Kings Park CDP, New York",36103,LI,6311,6564,253,13924,554,179,1414,15671,74,17085,365,14499,municipality,2020
3640530,"Lake Grove village, New York",36103,LI,3910,4078,168,9067,920,277,1252,9820,36,11072,288,8299,municipality,2020
3640838,"Lake Ronkonkoma CDP, New York",36103,LI,6645,7223,578,14952,1086,687,2588,16031,161,18619,537,13560,municipality,2020
3641465,"Laurel CDP, New York",36103,LI,550,800,250,1225,15,6,249,1246,14,1495,29,1182,municipality,2020
3642554,"Lindenhurst village, New York",36103,LI,9260,9712,452,21992,729,629,4458,22690,147,27148,637,20548,municipality,2020
3643005,"Lloyd Harbor village, New York",36103,LI,1150,1246,96,2700,136,9,206,3365,17,3571,103,3100,municipality,2020
3645139,"Manorville CDP, New York",36103,LI,5159,5364,205,11251,253,326,1428,12889,63,14317,433,11814,municipality,2020
3646074,"Mastic CDP, New York",36103,LI,4557,4792,235,11658,390,1440,4605,10799,177,15404,601,8191,municipality,2020
3646085,"Mastic Beach CDP, New York",36103,LI,4677,5198,521,10750,208,1771,3160,11039,161,14199,705,8194,municipality,2020
3646140,"Mattituck CDP, New York",36103,LI,1805,2527,722,3635,39,65,516,3806,16,4322,100,3586,municipality,2020
3646404,"Medford CDP, New York",36103,LI,8095,8416,321,19402,758,1545,5973,18274,171,24247,720,15080,municipality,2020
3646514,"Melville CDP, New York",36103,LI,7368,7777,409,15804,1997,794,1288,17996,93,19284,458,14654,municipality,2020
3646976,"Middle Island CDP, New York",36103,LI,4375,4588,213,8692,282,1308,1290,9256,103,10546,337,7226,municipality,2020
3647306,"Miller Place CDP, New York",36103,LI,4001,4157,156,9096,348,178,882,10841,49,11723,275,9991,municipality,2020
3648054,"Montauk CDP, New York",36103,LI,1804,4487,2683,3638,62,86,804,3514,41,4318,130,3195,municipality,2020
3648450,"Moriches CDP, New York",36103,LI,1361,1460,99,2490,54,321,390,2636,29,3026,131,2101,municipality,2020
3649066,"Mount Sinai CDP, New York",36103,LI,4131,4339,208,9177,599,157,984,10639,60,11623,267,9556,municipality,2020
3649424,"Napeague CDP, New York",36103,LI,179,480,301,303,11,7,29,339,4,368,10,307,municipality,2020
3649825,"Nesconset CDP, New York",36103,LI,4560,4707,147,10476,838,208,1186,12021,88,13207,312,10575,municipality,2020
3650727,"New Suffolk CDP, New York",36103,LI,187,316,129,331,2,1,38,365,3,403,5,354,municipality,2020
3651286,"Nissequogue village, New York",36103,LI,578,625,47,1287,40,6,78,1486,13,1564,35,1392,municipality,2020
3651396,"North Amityville CDP, New York",36103,LI,5304,5628,324,14230,280,8834,6899,11744,356,18643,596,1678,municipality,2020
3651418,"Northampton CDP, New York",36103,LI,227,246,19,573,10,141,324,439,11,763,15,262,municipality,2020
3651440,"North Babylon CDP, New York",36103,LI,6229,6430,201,14491,1007,1732,3381,14546,165,17927,488,11154,municipality,2020
3651495,"North Bay Shore CDP, New York",36103,LI,4579,4742,163,14617,940,2663,13376,6243,263,19619,345,2032,municipality,2020
3651528,"North Bellport CDP, New York",36103,LI,3484,3670,186,8944,322,2532,4451,7449,197,11900,515,3883,municipality,2020
3652078,"North Great River CDP, New York",36103,LI,1505,1535,30,3459,94,137,728,3538,23,4266,87,3197,municipality,2020
3652188,"North Haven village, New York",36103,LI,464,732,268,947,18,8,47,1115,7,1162,20,1062,municipality,2020
3653198,"North Lindenhurst CDP, New York",36103,LI,3861,4016,155,9506,445,719,3390,8610,105,12000,301,7040,municipality,2020
3653319,"North Patchogue CDP, New York",36103,LI,2314,2421,107,5380,131,179,1792,4959,51,6751,151,4447,municipality,2020
3653396,"Northport village, New York",36103,LI,2983,3128,145,6059,146,53,401,6946,25,7347,159,6563,municipality,2020
3653561,"North Sea CDP, New York",36103,LI,2158,3587,1429,4392,125,60,1080,4381,79,5461,171,3946,municipality,2020
3653775,"Northville CDP, New York",36103,LI,620,813,193,1349,18,19,224,1342,2,1566,33,1270,municipality,2020
3653852,"Northwest Harbor CDP, New York",36103,LI,1912,3512,1600,3866,110,83,863,3774,70,4637,133,3378,municipality,2020
3654056,"Noyack CDP, New York",36103,LI,1797,2832,1035,3573,76,60,578,3747,19,4325,111,3481,municipality,2020
3654144,"Oakdale CDP, New York",36103,LI,3109,3240,131,6219,103,86,517,6913,21,7430,153,6550,municipality,2020
3654430,"Ocean Beach village, New York",36103,LI,76,591,515,137,0,2,10,143,3,153,5,133,municipality,2020
3654617,"Old Field village, New York",36103,LI,334,365,31,746,74,2,42,851,13,893,24,738,municipality,2020
3655321,"Orient CDP, New York",36103,LI,470,800,330,875,10,2,41,958,7,999,19,920,municipality,2020
3656660,"Patchogue village, New York",36103,LI,5456,5776,320,10302,242,662,3520,8888,68,12408,312,7604,municipality,2020
3656968,"Peconic CDP, New York",36103,LI,300,495,195,596,6,13,83,609,6,692,16,568,municipality,2020
3659157,"Poquott village, New York",36103,LI,364,374,10,747,91,8,43,860,1,903,17,743,municipality,2020
3659355,"Port Jefferson village, New York",36103,LI,3291,3471,180,6590,537,109,712,7250,53,7962,293,6258,municipality,2020
3659377,"Port Jefferson Station CDP, New York",36103,LI,2859,2985,126,6293,512,302,1570,6380,41,7950,248,5277,municipality,2020
3660408,"Quiogue CDP, New York",36103,LI,364,625,261,785,20,40,279,734,13,1013,32,629,municipality,2020
3660422,"Quogue village, New York",36103,LI,688,1613,925,1375,58,41,134,1528,23,1662,38,1368,municipality,2020
3661142,"Remsenburg-Speonk CDP, New York",36103,LI,1200,1644,444,2498,35,36,351,2759,9,3110,80,2599,municipality,2020
3661665,"Ridge CDP, New York",36103,LI,5877,6336,459,11205,333,723,1145,12126,58,13271,351,10661,municipality,2020
3661973,"Riverhead CDP, New York",36103,LI,5365,5763,398,11880,225,1716,5674,9319,139,14993,386,6853,municipality,2020
3662066,"Riverside CDP, New York",36103,LI,838,910,72,2417,26,539,1176,1706,36,2882,51,1054,municipality,2020
3663319,"Rocky Point CDP, New York",36103,LI,4826,5285,459,10562,239,171,1651,11982,49,13633,450,11073,municipality,2020
3663473,"Ronkonkoma CDP, New York",36103,LI,6496,6701,205,15096,1166,548,2814,16141,240,18955,546,13641,municipality,2020
3664452,"Sagaponack village, New York",36103,LI,305,718,413,627,28,9,60,710,19,770,30,624,municipality,2020
3664485,"Sag Harbor village, New York",36103,LI,1202,2013,811,2296,35,206,301,2471,29,2772,101,2100,municipality,2020
3664584,"St. James CDP, New York",36103,LI,4729,4921,192,10871,513,117,1037,12450,34,13487,286,11500,municipality,2020
3664881,"Saltaire village, New York",36103,LI,31,432,401,99,2,0,3,110,0,113,3,105,municipality,2020
3665409,"Sayville CDP, New York",36103,LI,5935,6228,293,13269,283,186,1148,15421,71,16569,392,14489,municipality,2020
3666212,"Selden CDP, New York",36103,LI,6838,7167,329,16787,1495,885,4129,17133,157,21262,583,14013,municipality,2020
3666481,"Setauket-East Setauket CDP, New York",36103,LI,5304,5569,265,11917,1562,177,1056,13928,82,14984,475,11632,municipality,2020
3666828,"Shelter Island CDP, New York",36103,LI,703,1145,442,1354,18,13,181,1421,2,1602,59,1329,municipality,2020
3666850,"Shelter Island Heights CDP, New York",36103,LI,761,1552,791,1408,24,8,92,1509,2,1601,51,1424,municipality,2020
3667048,"Shinnecock Hills CDP, New York",36103,LI,845,1537,692,1796,51,45,702,1580,16,2282,64,1404,municipality,2020
3667070,"Shirley CDP, New York",36103,LI,8262,8782,520,20416,724,1907,6200,20160,268,26360,993,16268,municipality,2020
3667191,"Shoreham village, New York",36103,LI,188,232,44,453,13,11,45,516,1,561,24,467,municipality,2020
3667851,"Smithtown CDP, New York",36103,LI,8495,8800,305,20459,1007,351,2484,23145,131,25629,690,20966,municipality,2020
3668374,"Sound Beach CDP, New York",36103,LI,2728,2943,215,5845,136,125,758,6658,40,7416,246,6111,municipality,2020
3668462,"Southampton village, New York",36103,LI,1701,3438,1737,3765,129,236,792,3758,53,4550,122,3218,municipality,2020
3669254,"South Huntington CDP, New York",36103,LI,3290,3418,128,7790,773,210,1428,8133,39,9561,247,6864,municipality,2020
3669452,"Southold CDP, New York",36103,LI,2617,4222,1605,5132,78,66,779,5261,24,6040,152,4941,municipality,2020
3670387,"Springs CDP, New York",36103,LI,2973,4482,1509,6474,128,112,2728,5358,36,8086,199,4883,municipality,2020
3671608,"Stony Brook CDP, New York",36103,LI,4831,5033,202,10926,1667,217,826,12641,68,13467,379,10310,municipality,2020
3671620,"Stony Brook University CDP, New York",36103,LI,72,115,43,10302,1829,3516,1748,8661,118,10409,540,2658,municipality,2020
3673352,"Terryville CDP, New York",36103,LI,3853,4006,153,9116,430,392,2411,9061,86,11472,263,7890,municipality,2020
3675572,"Tuckahoe CDP, New York",36103,LI,628,995,367,1259,35,83,342,1163,21,1505,37,987,municipality,2020
3677519,"Village of the Branch village, New York",36103,LI,563,573,10,1359,49,23,92,1643,7,1735,43,1521,municipality,2020
3677772,"Wading River CDP, New York",36103,LI,2789,3223,434,6101,102,160,690,7041,35,7731,232,6512,municipality,2020
3677805,"Wainscott CDP, New York",36103,LI,386,916,530,755,23,17,142,762,10,904,24,688,municipality,2020
3678575,"Water Mill CDP, New York",36103,LI,958,2125,1167,2057,93,28,189,2317,18,2506,99,2079,municipality,2020
3679246,"West Babylon CDP, New York",36103,LI,14523,15139,616,34632,1455,5291,8202,35011,331,43213,1207,26727,municipality,2020
3679301,"West Bay Shore CDP, New York",36103,LI,1742,1809,67,3750,137,133,495,4130,20,4625,160,3680,municipality,2020
3680170,"Westhampton CDP, New York",36103,LI,1291,2206,915,2932,45,80,654,2967,28,3621,77,2737,municipality,2020
3680181,"Westhampton Beach village, New York",36103,LI,858,2455,1597,1755,49,33,319,1831,11,2150,44,1694,municipality,2020
3680186,"West Hampton Dunes village, New York",36103,LI,28,271,243,105,2,0,5,121,0,126,0,119,municipality,2020
3680258,"West Hills CDP, New York",36103,LI,1968,2024,56,4467,377,108,530,4855,22,5385,117,4231,municipality,2020
3680302,"West Islip CDP, New York",36103,LI,8763,9021,258,21447,528,166,2659,24389,60,27048,557,23078,municipality,2020
3680885,"West Sayville CDP, New York",36103,LI,1765,2109,344,3948,72,45,342,4530,13,4872,118,4282,municipality,2020
3681419,"Wheatley Heights CDP, New York",36103,LI,1442,1493,51,3942,395,2619,878,4262,79,5140,250,919,municipality,2020
3683294,"Wyandanch CDP, New York",36103,LI,3290,3548,258,9372,163,6352,5487,7503,187,12990,350,451,municipality,2020
3683426,"Yaphank CDP, New York",36103,LI,2280,2480,200,4900,145,278,793,5181,62,5974,221,4475,municipality,2020
3610304000,"Babylon town, Suffolk County, New York",36103,LI,71907,75270,3363,173514,9329,33874,52142,166081,2103,218223,5844,114931,municipality,2020
3610310000,"Brookhaven town, Suffolk County, New York",36103,LI,167187,178581,11394,388658,23108,30287,83528,402245,3523,485773,15328,329999,municipality,2020
3610322194,"East Hampton town, Suffolk County, New York",36103,LI,11118,21163,10045,23159,474,770,7531,20854,255,28385,748,18607,municipality,2020
3610337000,"Huntington town, Suffolk County, New York",36103,LI,70014,73073,3059,162582,13598,8667,31403,172724,1284,204127,5225,143950,municipality,2020
3610338000,"Islip town, Suffolk County, New York",36103,LI,105002,111346,6344,265143,11001,26931,118903,221035,3179,339938,7307,172617,municipality,2020
3610359106,"Poospatuck Reservation, Suffolk County, New York",36103,LI,150,159,9,322,0,55,87,349,215,436,45,34,municipality,2020
3610361984,"Riverhead town, Suffolk County, New York",36103,LI,13879,16310,2431,29170,436,2193,8262,27640,232,35902,898,23881,municipality,2020
3610366839,"Shelter Island town, Suffolk County, New York",36103,LI,1481,2731,1250,2801,46,21,289,2964,5,3253,115,2777,municipality,2020
3610367059,"Shinnecock Reservation, Suffolk County, New York",36103,LI,300,349,49,616,2,30,47,772,684,819,28,28,municipality,2020
3610368000,"Smithtown town, Suffolk County, New York",36103,LI,40018,41415,1397,92863,5585,1662,9979,106317,612,116296,2756,95702,municipality,2020
3610368473,"Southampton town, Suffolk County, New York",36103,LI,25806,42770,16964,55611,1185,2293,17178,51858,604,69036,1672,46104,municipality,2020
3610369463,"Southold town, Suffolk County, New York",36103,LI,10010,15773,5763,19973,255,485,3610,20122,126,23732,556,18700,municipality,2020
3610506310,"Bethel town, Sullivan County, New York",36105,MHV,1766,3703,1937,3362,32,94,503,3456,34,3959,144,3152,municipality,2020
3610511759,"Callicoon town, Sullivan County, New York",36105,MHV,1280,1852,572,2508,63,31,232,2757,14,2989,115,2534,municipality,2020
3610516661,"Cochecton town, Sullivan County, New York",36105,MHV,653,1042,389,1184,9,22,80,1368,7,1448,58,1272,municipality,2020
3610520104,"Delaware town, Sullivan County, New York",36105,MHV,927,1458,531,1796,22,140,171,2032,15,2203,76,1779,municipality,2020
3610525241,"Fallsburg town, Sullivan County, New York",36105,MHV,4148,8830,4682,10992,306,1811,3845,10347,184,14192,460,7586,municipality,2020
3610526528,"Forestburgh town, Sullivan County, New York",36105,MHV,347,552,205,690,23,18,38,770,4,808,30,695,municipality,2020
3610527573,"Fremont town, Sullivan County, New York",36105,MHV,537,1197,660,990,10,20,72,1089,13,1161,32,1014,municipality,2020
3610534473,"Highland town, Sullivan County, New York",36105,MHV,1004,1722,718,1866,17,27,144,2052,12,2196,78,1918,municipality,2020
3610542235,"Liberty town, Sullivan County, New York",36105,MHV,3916,5450,1534,7793,173,685,2789,7370,83,10159,517,5912,municipality,2020
3610543786,"Lumberland town, Sullivan County, New York",36105,MHV,911,1547,636,1817,31,32,201,2042,17,2243,118,1844,municipality,2020
3610544809,"Mamakating town, Sullivan County, New York",36105,MHV,4731,6157,1426,9621,189,428,1573,11082,124,12655,708,9633,municipality,2020
3610549847,"Neversink town, Sullivan County, New York",36105,MHV,1411,2020,609,2713,41,43,222,3144,16,3366,117,2927,municipality,2020
3610563176,"Rockland town, Sullivan County, New York",36105,MHV,1420,2432,1012,2634,54,49,322,2968,23,3290,159,2683,municipality,2020
3610573627,"Thompson town, Sullivan County, New York",36105,MHV,6478,10023,3545,12656,572,2638,3719,12831,232,16550,844,8545,municipality,2020
3610575759,"Tusten town, Sullivan County, New York",36105,MHV,654,1140,486,1164,27,31,96,1309,8,1405,46,1197,municipality,2020
3611120247,"Denning town, Ulster County, New York",36111,MHV,219,501,282,426,3,12,30,463,8,493,40,400,municipality,2020
3611124691,"Esopus town, Ulster County, New York",36111,MHV,3668,4089,421,7856,111,401,603,8945,46,9548,473,7914,municipality,2020
3611128255,"Gardiner town, Ulster County, New York",36111,MHV,2302,2672,370,4563,96,83,452,5158,39,5610,283,4657,municipality,2020
3611132116,"Hardenburgh town, Ulster County, New York",36111,MHV,101,301,200,186,13,1,14,207,0,221,1,192,municipality,2020
3611137143,"Hurley town, Ulster County, New York",36111,MHV,2718,3079,361,5166,114,107,356,5822,57,6178,257,5287,municipality,2020
3611139727,"Kingston city, Ulster County, New York",36111,MHV,10407,11571,1164,19217,630,2956,4107,19962,193,24069,1560,14623,municipality,2020
3611139738,"Kingston town, Ulster County, New York",36111,MHV,422,477,55,770,9,10,64,869,9,933,45,796,municipality,2020
3611142994,"Lloyd town, Ulster County, New York",36111,MHV,4438,4785,347,8996,324,681,1157,9976,89,11133,453,8429,municipality,2020
3611145458,"Marbletown town, Ulster County, New York",36111,MHV,2503,3080,577,4782,112,66,310,5348,44,5658,255,4871,municipality,2020
3611145722,"Marlborough town, Ulster County, New York",36111,MHV,3426,3794,368,6969,99,494,1022,7690,35,8712,298,6764,municipality,2020
3611150562,"New Paltz town, Ulster County, New York",36111,MHV,4906,5358,452,12341,775,751,1835,12572,258,14407,542,10246,municipality,2020
3611154749,"Olive town, Ulster County, New York",36111,MHV,1923,2564,641,3565,59,47,248,3978,40,4226,192,3640,municipality,2020
3611158552,"Plattekill town, Ulster County, New York",36111,MHV,4032,4412,380,8272,87,521,2055,8369,104,10424,490,7167,municipality,2020
3611163011,"Rochester town, Ulster County, New York",36111,MHV,3046,4062,1016,5902,107,130,495,6777,60,7272,362,6118,municipality,2020
3611163737,"Rosendale town, Ulster County, New York",36111,MHV,2570,2931,361,4845,72,111,361,5421,50,5782,275,4913,municipality,2020
3611165299,"Saugerties town, Ulster County, New York",36111,MHV,8300,9370,1070,15713,280,386,1468,17570,94,19038,898,15912,municipality,2020
3611166597,"Shandaken town, Ulster County, New York",36111,MHV,1419,2482,1063,2436,51,36,230,2636,49,2866,144,2356,municipality,2020
3611166674,"Shawangunk town, Ulster County, New York",36111,MHV,4053,4418,365,11313,165,1082,1863,11700,88,13563,428,9937,municipality,2020
3611175935,"Ulster town, Ulster County, New York",36111,MHV,5229,5714,485,10438,320,592,1176,11484,103,12660,622,9847,municipality,2020
3611178828,"Wawarsing town, Ulster County, New York",36111,MHV,4504,5943,1439,10240,193,1569,2925,9846,144,12771,639,7301,municipality,2020
3611183052,"Woodstock town, Ulster County, New York",36111,MHV,3135,4250,1115,5461,158,116,348,5939,59,6287,281,5325,municipality,2020
3611905320,"Bedford town, Westchester County, New York",36119,LHV,5758,6314,556,13389,589,726,2910,14399,127,17309,533,12424,municipality,2020
3611918410,"Cortlandt town, Westchester County, New York",36119,LHV,15288,16229,941,33695,1679,2494,8547,33998,322,42545,1562,27941,municipality,2020
3611921820,"Eastchester town, Westchester County, New York",36119,LHV,13595,14410,815,26385,3200,1036,3117,31524,214,34641,1222,25852,municipality,2020
3611930367,"Greenburgh town, Westchester County, New York",36119,LHV,35776,37565,1789,74939,11602,10141,16821,78576,863,95397,3670,52300,municipality,2020
3611932413,"Harrison town, Westchester County, New York",36119,LHV,8747,9274,527,21601,3231,745,4402,23816,196,28218,864,18780,municipality,2020
3611942136,"Lewisboro town, Westchester County, New York",36119,LHV,4495,4867,372,9562,435,191,969,11296,79,12265,484,10107,municipality,2020
3611944842,"Mamaroneck town, Westchester County, New York",36119,LHV,11423,11969,546,23362,1544,921,5671,26087,283,31758,1249,22090,municipality,2020
3611948895,"Mount Kisco town, Westchester County, New York",36119,LHV,4271,4465,194,8720,513,439,4569,6390,88,10959,274,5076,municipality,2020
3611949011,"Mount Pleasant town, Westchester County, New York",36119,LHV,14595,15221,626,34534,2501,1260,9259,35177,270,44436,1216,29930,municipality,2020
3611949121,"Mount Vernon city, Westchester County, New York",36119,LHV,28286,30350,2064,58572,1398,44655,14003,59890,1620,73893,3140,9077,municipality,2020
3611950078,"New Castle town, Westchester County, New York",36119,LHV,5918,6160,242,13155,2144,267,1243,17068,132,18311,701,13824,municipality,2020
3611950617,"New Rochelle city, Westchester County, New York",36119,LHV,28702,30531,1829,63189,3859,14324,26257,53469,1002,79726,2275,32009,municipality,2020
3611951693,"North Castle town, Westchester County, New York",36119,LHV,4098,4310,212,9335,793,196,1448,10960,60,12408,400,9511,municipality,2020
3611953517,"North Salem town, Westchester County, New York",36119,LHV,1887,2126,239,4191,120,83,594,4649,30,5243,146,4270,municipality,2020
3611955541,"Ossining town, Westchester County, New York",36119,LHV,14077,14975,898,31785,2195,4096,14493,25568,284,40061,1061,17932,municipality,2020
3611956979,"Peekskill city, Westchester County, New York",36119,LHV,9813,10464,651,20104,725,4693,11160,14271,272,25431,861,7720,municipality,2020
3611957012,"Pelham town, Westchester County, New York",36119,LHV,4323,4490,167,9331,844,717,1656,11422,188,13078,643,9030,municipality,2020
3611959685,"Pound Ridge town, Westchester County, New York",36119,LHV,1860,2076,216,4009,165,65,344,4738,22,5082,222,4264,municipality,2020
3611964309,"Rye city, Westchester County, New York",36119,LHV,5654,6038,384,11682,1185,189,1388,15204,73,16592,705,13052,municipality,2020
3611964320,"Rye town, Westchester County, New York",36119,LHV,16909,17678,769,38058,1961,1757,23918,25695,494,49613,1267,20216,municipality,2020
3611965442,"Scarsdale town, Westchester County, New York",36119,LHV,5510,5747,237,12603,3816,220,922,17331,134,18253,912,12249,municipality,2020
3611968308,"Somers town, Westchester County, New York",36119,LHV,8457,9010,553,17390,776,278,1907,19634,71,21541,597,17912,municipality,2020
3611981677,"White Plains city, Westchester County, New York",36119,LHV,24162,25494,1332,48238,4747,6746,19426,40133,589,59559,1809,26242,municipality,2020
3611984000,"Yonkers city, Westchester County, New York",36119,LHV,80548,85528,4980,166003,12915,33509,89065,122504,2197,211569,4913,68970,municipality,2020
3611984077,"Yorktown town, Westchester County, New York",36119,LHV,13144,13672,528,28610,1970,1262,5245,31324,208,36569,978,26906,municipality,2020
0,United States,,,126817580,140498736,13681156,258343281,19618719,39940338,62080044,269369237,4563550,331449281,13548983,191697647,nation,2020
9001,"Fairfield County, Connecticut",9001,CT,324232,339466,15234,656353,28473,84724,104835,777732,4687,882567,14696,645152,county,2000
9005,"Litchfield County, Connecticut",9005,CT,71551,79267,7716,137347,2107,1837,3894,178299,517,182193,1684,172154,county,2000
9009,"New Haven County, Connecticut",9009,CT,319040,340732,21692,622329,19061,89286,83131,740877,3544,824008,12445,616541,county,2000
34003,"Bergen County, New Jersey",34003,INJ,330817,339820,9003,681064,93979,44149,91377,792741,2620,884118,13040,638953,county,2000
34013,"Essex County, New Jersey",34013,INJ,283736,301011,17275,586683,29141,319883,122347,671286,5220,793633,18334,298708,county,2000
34017,"Hudson County, New Jersey",34017,INJ,230546,240618,10072,471477,56370,74040,242123,366852,4768,608975,16458,215216,county,2000
34019,"Hunterdon County, New Jersey",34019,ONJ,43678,45032,1354,90615,2332,2638,3371,118618,261,121989,914,112473,county,2000
34021,"Mercer County, New Jersey",34021,ONJ,125807,133280,7473,266424,17250,67922,33898,316863,1229,350761,5178,225284,county,2000
34023,"Middlesex County, New Jersey",34023,INJ,265815,273637,7822,572534,103788,64435,101940,648222,3057,750162,12405,464537,county,2000
34025,"Monmouth County, New Jersey",34025,ONJ,224236,240884,16648,454959,24257,47745,38175,577126,1728,615301,7494,495902,county,2000
34027,"Morris County, New Jersey",34027,INJ,169711,174379,4668,353374,29310,12506,36626,433586,1173,470212,5015,385582,county,2000
34029,"Ocean County, New Jersey",34029,ONJ,200402,248711,48309,391870,6426,14431,25638,485278,967,510916,4280,459174,county,2000
34031,"Passaic County, New Jersey",34031,INJ,163856,170048,6192,361563,17747,60528,146492,342557,2081,489049,10514,251687,county,2000
34035,"Somerset County, New Jersey",34035,INJ,108984,112023,3039,221499,24870,21571,25811,271679,885,297490,3769,220584,county,2000
34037,"Sussex County, New Jersey",34037,ONJ,50831,56528,5697,103948,1723,1444,4822,139344,279,144166,1274,134624,county,2000
34039,"Union County, New Jersey",34039,INJ,186124,192945,6821,392600,19789,104926,103011,419530,2130,522541,9340,283345,county,2000
34041,"Warren County, New Jersey",34041,ONJ,38660,41157,2497,75747,1235,1838,3751,98686,223,102437,985,94405,county,2000
36005,"Bronx County, New York",36005,NYC,463212,490659,27447,935278,38558,416338,644705,687945,12189,1332650,27209,193651,county,2000
36027,"Dutchess County, New York",36027,MHV,99536,106103,6567,209882,6990,25059,18060,262090,1005,280150,4123,224913,county,2000
36047,"Kings County, New York",36047,NYC,880727,930866,50139,1802827,184291,848583,487878,1977448,21354,2465326,68688,854532,county,2000
36059,"Nassau County, New York",36059,LI,447387,458151,10764,1005465,62744,129860,133282,1201262,4597,1334544,17114,986947,county,2000
36061,"New York County, New York",36061,NYC,738644,798144,59500,1279279,143291,234698,417816,1119379,8573,1537195,28944,703873,county,2000
36071,"Orange County, New York",36071,MHV,114788,122754,7966,242211,5054,25567,39738,301629,1390,341367,4858,264760,county,2000
36079,"Putnam County, New York",36079,LHV,32703,35030,2327,70371,1157,1437,5976,89769,244,95745,958,85973,county,2000
36081,"Queens County, New York",36081,NYC,782664,817250,34586,1720155,389303,422831,556605,1672774,35234,2229379,92511,732895,county,2000
36085,"Richmond County, New York",36085,NYC,156341,163993,7652,330470,24786,39704,53550,390178,1575,443728,7797,316316,county,2000
36087,"Rockland County, New York",36087,LHV,92675,94973,2298,206467,15707,30139,29182,257571,1100,286753,4972,205653,county,2000
36103,"Suffolk County, New York",36103,LI,469299,522323,53024,1049288,34355,93262,149411,1269958,5458,1419369,18478,1118405,county,2000
36105,"Sullivan County, New York",36105,MHV,27661,44730,17069,55514,810,5897,6839,67127,332,73966,863,59225,county,2000
36111,"Ulster County, New York",36111,MHV,67499,77656,10157,135978,2169,9044,10941,166808,794,177749,2737,152064,county,2000
36119,"Westchester County, New York",36119,LHV,337142,349445,12303,692662,40941,125227,144124,779335,4385,923459,17006,591776,county,2000
9001,"Fairfield County, Connecticut",9001,CT,335545,361221,25676,689810,41801,92705,155025,761804,6918,916829,13664,606716,county,2010
9005,"Litchfield County, Connecticut",9005,CT,76640,87550,10910,148975,2877,2206,8535,181392,564,189927,2342,173403,county,2010
9009,"New Haven County, Connecticut",9009,CT,334502,362004,27502,669503,29933,101763,129743,732734,4381,862477,14273,582384,county,2010
36047,"Kings County, New York",36047,NYC,916856,1000293,83437,1910322,260129,799066,496285,2008415,15904,2504700,40010,893306,county,2010
36059,"Nassau County, New York",36059,LI,448528,468346,19818,1027952,101558,141305,195355,1144177,6316,1339532,17689,877309,county,2010
36061,"New York County, New York",36061,NYC,763846,847090,83244,1351438,177624,205340,403577,1182296,7882,1585873,29957,761493,county,2010
36079,"Putnam County, New York",36079,LHV,35041,38224,3183,76060,1832,2047,11661,88049,306,99710,1155,82709,county,2010
36071,"Orange County, New York",36071,MHV,125925,137025,11100,271284,8685,33895,67185,305628,1785,372813,7004,254259,county,2010
36081,"Queens County, New York",36081,NYC,780117,835127,55010,1768821,508334,395881,613750,1616972,39923,2230722,56107,616727,county,2010
36085,"Richmond County, New York",36085,NYC,165516,176656,11140,359529,34697,44313,81051,387679,1860,468730,6640,300169,county,2010
36087,"Rockland County, New York",36087,LHV,99242,104057,4815,224107,19099,34623,48783,262904,1139,311687,4373,203670,county,2010
36103,"Suffolk County, New York",36103,LI,499922,569985,70063,1135680,50295,102117,246239,1247111,6222,1493350,19749,1068728,county,2010
36105,"Sullivan County, New York",36105,MHV,30139,49186,19047,59971,1033,6349,10554,66993,431,77547,1400,57780,county,2010
36111,"Ulster County, New York",36111,MHV,71049,83638,12589,145677,3060,9982,15909,166584,787,182493,3656,149099,county,2010
36119,"Westchester County, New York",36119,LHV,347232,370821,23589,721113,51123,126585,207032,742081,5116,949113,14694,544563,county,2010
34041,"Warren County, New Jersey",34041,ONJ,41480,44925,3445,83084,2642,3592,7659,101033,266,108692,1368,93165,county,2010
34035,"Somerset County, New Jersey",34035,INJ,117759,123127,5368,242609,45473,27480,42091,281353,1143,323444,5408,201849,county,2010
34037,"Sussex County, New Jersey",34037,ONJ,54752,62057,7305,113492,2605,2448,9617,139648,340,149265,1771,132484,county,2010
34039,"Union County, New Jersey",34039,INJ,188118,199489,11371,405241,24496,111705,146704,389795,2932,536499,7350,243312,county,2010
36005,"Bronx County, New York",36005,NYC,483449,511896,28447,1016912,47335,416695,741413,643695,12494,1385108,15962,151209,county,2010
36027,"Dutchess County, New York",36027,MHV,107965,118638,10673,231519,10330,27395,31267,266221,1270,297488,5414,221812,county,2010
34021,"Mercer County, New Jersey",34021,ONJ,133155,143169,10014,283531,32545,71378,55318,311195,1311,366513,6052,199909,county,2010
34023,"Middlesex County, New Jersey",34023,INJ,281186,294800,13614,624401,172534,71557,148975,660883,4069,809858,13999,398724,county,2010
34025,"Monmouth County, New Jersey",34025,ONJ,233983,258410,24427,480081,31018,43931,60939,569441,2518,630380,8539,483435,county,2010
34027,"Morris County, New Jersey",34027,INJ,180534,189842,9308,374581,43862,14134,56482,435794,1245,492276,7002,369551,county,2010
34029,"Ocean County, New Jersey",34029,ONJ,221111,278052,56941,441648,9924,16583,47783,528784,1104,576567,5639,495534,county,2010
34003,"Bergen County, New Jersey",34003,INJ,335730,352388,16658,700711,130491,46850,145281,759835,3610,905116,12831,566053,county,2010
34019,"Hunterdon County, New Jersey",34019,ONJ,47169,49487,2318,98132,4155,3233,6722,121627,290,128349,1342,112607,county,2010
34013,"Essex County, New Jersey",34013,INJ,283712,312954,29242,589051,35292,308358,159117,624852,7807,783969,13218,260177,county,2010
34017,"Hudson County, New Jersey",34017,INJ,246437,270335,23898,503104,83825,71315,267853,366413,5362,634266,10401,195510,county,2010
34031,"Passaic County, New Jersey",34031,INJ,166785,175966,9181,376613,24556,55480,185677,315549,2190,501226,6179,227144,county,2010
CT,Connecticut,0<NA>,CT,714823,759465,44642,1416029,49641,175847,191860,1696908,8748,1888768,28825,1433847,subregion,2000
CT,Connecticut,0<NA>,CT,746687,810775,64088,1508288,74611,196674,293303,1675930,11863,1969233,30279,1362503,subregion,2010
INJ,Inner New Jersey,0<NA>,INJ,1739589,1804481,64892,3640794,374994,702038,869727,3946453,21934,4816180,88875,2758612,subregion,2000
INJ,Inner New Jersey,0<NA>,INJ,1800261,1918901,118640,3816311,560529,706879,1152180,3834474,28358,4986654,76388,2462320,subregion,2010
LHV,Lower Hudson Valley,0<NA>,LHV,462520,479448,16928,969500,57805,156803,179282,1126675,5729,1305957,22936,883402,subregion,2000
LHV,Lower Hudson Valley,0<NA>,LHV,481515,513102,31587,1021280,72054,163255,267476,1093034,6561,1360510,20222,830942,subregion,2010
LI,Long Island,0<NA>,LI,916686,980474,63788,2054753,97099,223122,282693,2471220,10055,2753913,35592,2105352,subregion,2000
LI,Long Island,0<NA>,LI,948450,1038331,89881,2163632,151853,243422,441594,2391288,12538,2832882,37438,1946037,subregion,2010
MHV,Mid Hudson Valley,0<NA>,MHV,309484,351243,41759,643585,15023,65567,75578,797654,3521,873232,12581,700962,subregion,2000
MHV,Mid Hudson Valley,0<NA>,MHV,335078,388487,53409,708451,23108,77621,124915,805426,4273,930341,17474,682950,subregion,2010
NYC,New York City,0<NA>,NYC,3021588,3200912,179324,6068009,780229,1962154,2160554,5847724,78925,8008278,225149,2801267,subregion,2000
NYC,New York City,0<NA>,NYC,3109784,3371062,261278,6407022,1028119,1861295,2336076,5839057,78063,8175133,148676,2722904,subregion,2010
ONJ,Outer New Jersey,0<NA>,ONJ,683614,765592,81978,1383563,53223,136018,109655,1735915,4687,1845570,20125,1521862,subregion,2000
ONJ,Outer New Jersey,0<NA>,ONJ,731650,836100,104450,1499968,82889,141165,188038,1771728,5829,1959766,24711,1517134,subregion,2010
us,United States,0<NA>,,105480101,115904641,10424540,209128094,10123169,33947837,35305818,246116088,2890162,281421906,4602146,194552774,nation,2000
us,United States,0<NA>,,116716292,131704730,14988438,234564071,14465124,37685848,50477594,258267944,3332939,308745538,5966481,196817552,nation,2010
900100000,"County subdivisions not defined, Fairfield County, Connecticut",9001,CT,0,0,0,0,0,0,0,0,0,0,0,0,municipality,2000
900100000,"County subdivisions not defined, Fairfield County, Connecticut",9001,CT,0,0,0,0,0,0,0,0,0,0,0,0,municipality,2010
900104720,"Bethel town, Fairfield County, Connecticut",9001,CT,13010,13306,296,26284,1262,438,1338,34796,172,36134,450,32474,municipality,2000
900104720,"Bethel town, Fairfield County, Connecticut",9001,CT,6938,7310,372,14208,820,315,1419,17165,162,18584,270,15598,municipality,2010
900108070,"Bridgeport town, Fairfield County, Connecticut",9001,CT,100614,108734,8120,199714,8918,81948,88956,190102,3344,279058,9576,86316,municipality,2000
900108070,"Bridgeport town, Fairfield County, Connecticut",9001,CT,51255,57012,5757,108182,4781,46472,55100,89129,2282,144229,2800,32794,municipality,2010
900108980,"Brookfield town, Fairfield County, Connecticut",9001,CT,11144,11562,418,22752,774,228,744,30584,40,31328,210,29332,municipality,2000
900108980,"Brookfield town, Fairfield County, Connecticut",9001,CT,6129,6562,433,12342,595,161,710,15742,78,16452,142,14766,municipality,2010
900118500,"Danbury town, Fairfield County, Connecticut",9001,CT,54366,57038,2672,117242,8136,9486,23582,126114,2480,149696,4122,101890,municipality,2000
900118500,"Danbury town, Fairfield County, Connecticut",9001,CT,28907,31154,2247,63851,5399,5030,20185,60708,1972,80893,1998,46309,municipality,2010
900118850,"Darien town, Fairfield County, Connecticut",9001,CT,13184,13584,400,26486,948,166,858,38356,64,39214,288,36890,municipality,2000
900118850,"Darien town, Fairfield County, Connecticut",9001,CT,6698,7074,376,13351,744,98,743,19989,51,20732,198,18898,municipality,2010
900123890,"Easton town, Fairfield County, Connecticut",9001,CT,4930,5022,92,10380,294,30,256,14288,22,14544,76,13866,municipality,2000
900123890,"Easton town, Fairfield County, Connecticut",9001,CT,2577,2715,138,5362,238,46,220,7270,18,7490,76,6892,municipality,2010
900126620,"Fairfield town, Fairfield County, Connecticut",9001,CT,40794,42058,1264,87462,2314,1196,2680,112000,236,114680,916,107338,municipality,2000
900126620,"Fairfield town, Fairfield County, Connecticut",9001,CT,20457,21648,1191,44309,2177,1015,2999,56405,198,59404,737,52278,municipality,2010
900133620,"Greenwich town, Fairfield County, Connecticut",9001,CT,46460,49022,2562,91114,6322,1980,7692,114510,358,122202,1392,104458,municipality,2000
900133620,"Greenwich town, Fairfield County, Connecticut",9001,CT,23076,25631,2555,44833,4017,1232,5964,55207,276,61171,875,48807,municipality,2010
900148620,"Monroe town, Fairfield County, Connecticut",9001,CT,12962,13202,240,27308,582,450,964,37530,64,38494,272,36162,municipality,2000
900148620,"Monroe town, Fairfield County, Connecticut",9001,CT,6735,6918,183,14314,402,259,919,18560,33,19479,221,17645,municipality,2010
900150580,"New Canaan town, Fairfield County, Connecticut",9001,CT,13644,14282,638,26690,886,392,676,38114,52,38790,344,36440,municipality,2000
900150580,"New Canaan town, Fairfield County, Connecticut",9001,CT,7010,7551,541,13409,662,194,570,19168,51,19738,229,18032,municipality,2010
900150860,"New Fairfield town, Fairfield County, Connecticut",9001,CT,9276,10296,1020,19524,354,106,786,27120,28,27906,208,26424,municipality,2000
900150860,"New Fairfield town, Fairfield County, Connecticut",9001,CT,4802,5593,791,10103,232,142,611,13270,63,13881,139,12694,municipality,2010
900152980,"Newtown town, Fairfield County, Connecticut",9001,CT,16650,17202,552,35398,692,830,1180,48882,80,50062,398,46882,municipality,2000
900152980,"Newtown town, Fairfield County, Connecticut",9001,CT,9459,10061,602,19955,645,433,1033,26527,60,27560,256,25133,municipality,2010
900156060,"Norwalk town, Fairfield County, Connecticut",9001,CT,65422,67506,2084,129282,5344,24462,25932,139970,520,165902,2996,106648,municipality,2000
900156060,"Norwalk town, Fairfield County, Connecticut",9001,CT,33217,35415,2198,66729,4045,11472,20770,64833,363,85603,1235,47718,municipality,2010
900163480,"Redding town, Fairfield County, Connecticut",9001,CT,5836,6172,336,11730,294,122,244,16296,44,16540,126,15710,municipality,2000
900163480,"Redding town, Fairfield County, Connecticut",9001,CT,3470,3811,341,6781,195,60,237,8921,30,9158,136,8500,municipality,2010
900163970,"Ridgefield town, Fairfield County, Connecticut",9001,CT,16866,17754,888,32822,980,266,930,46356,114,47286,274,44722,municipality,2000
900163970,"Ridgefield town, Fairfield County, Connecticut",9001,CT,8801,9420,619,17288,780,174,941,23697,57,24638,282,22404,municipality,2010
900168170,"Shelton town, Fairfield County, Connecticut",9001,CT,28380,29414,1034,58258,1574,786,2652,73550,146,76202,838,70206,municipality,2000
900168170,"Shelton town, Fairfield County, Connecticut",9001,CT,15325,16146,821,31221,1522,865,2353,37206,125,39559,361,34333,municipality,2010
900168310,"Sherman town, Fairfield County, Connecticut",9001,CT,2868,3212,344,5612,46,38,132,7522,24,7654,36,7378,municipality,2000
900168310,"Sherman town, Fairfield County, Connecticut",9001,CT,1388,1831,443,2749,33,12,76,3505,3,3581,42,3415,municipality,2010
900173070,"Stamford town, Fairfield County, Connecticut",9001,CT,90798,94634,3836,182374,11636,34842,39270,194896,874,234166,4324,143220,municipality,2000
900173070,"Stamford town, Fairfield County, Connecticut",9001,CT,47357,50573,3216,96182,9604,16106,29188,93455,623,122643,1716,65406,municipality,2010
900174190,"Stratford town, Fairfield County, Connecticut",9001,CT,39796,41192,1396,76940,1390,9530,6798,93154,318,99952,1262,80654,municipality,2000
900174190,"Stratford town, Fairfield County, Connecticut",9001,CT,20095,21091,996,40092,1199,6963,7114,44270,240,51384,828,35040,municipality,2010
900177200,"Trumbull town, Fairfield County, Connecticut",9001,CT,23822,24320,498,50660,1626,1226,1846,66640,166,68486,524,63098,municipality,2000
900177200,"Trumbull town, Fairfield County, Connecticut",9001,CT,12725,13157,432,26776,1559,1070,2068,33950,88,36018,361,30872,municipality,2010
900183430,"Weston town, Fairfield County, Connecticut",9001,CT,6624,7064,440,13416,386,174,412,19662,52,20074,164,18886,municipality,2000
900183430,"Weston town, Fairfield County, Connecticut",9001,CT,3379,3674,295,6869,293,130,336,9843,31,10179,177,9212,municipality,2010
900183500,"Westport town, Fairfield County, Connecticut",9001,CT,19172,20130,958,37118,1244,558,1204,50294,104,51498,358,48030,municipality,2000
900183500,"Westport town, Fairfield County, Connecticut",9001,CT,9573,10399,826,18524,1038,292,932,25459,73,26391,341,23715,municipality,2010
900186370,"Wilton town, Fairfield County, Connecticut",9001,CT,11846,12226,380,24140,944,194,538,34728,72,35266,238,33280,municipality,2000
900186370,"Wilton town, Fairfield County, Connecticut",9001,CT,6172,6475,303,12380,821,164,537,17525,41,18062,244,16255,municipality,2010
900502760,"Barkhamsted town, Litchfield County, Connecticut",9005,CT,2668,2872,204,5242,28,4,62,6926,22,6988,38,6834,municipality,2000
900502760,"Barkhamsted town, Litchfield County, Connecticut",9005,CT,1452,1589,137,2909,23,10,57,3742,9,3799,38,3662,municipality,2010
900504930,"Bethlehem town, Litchfield County, Connecticut",9005,CT,2492,2776,284,5118,54,18,44,6800,26,6844,62,6640,municipality,2000
900504930,"Bethlehem town, Litchfield County, Connecticut",9005,CT,1411,1575,164,2860,18,16,61,3546,7,3607,28,3477,municipality,2010
900508210,"Bridgewater town, Litchfield County, Connecticut",9005,CT,1406,1558,152,2842,26,34,18,3630,2,3648,24,3544,municipality,2000
900508210,"Bridgewater town, Litchfield County, Connecticut",9005,CT,735,881,146,1403,15,13,26,1701,6,1727,6,1661,municipality,2010
900510940,"Canaan town, Litchfield County, Connecticut",9005,CT,890,1220,330,1652,4,32,8,2154,8,2162,18,2092,municipality,2000
900510940,"Canaan town, Litchfield County, Connecticut",9005,CT,583,779,196,1019,3,8,19,1215,3,1234,15,1186,municipality,2010
900516050,"Colebrook town, Litchfield County, Connecticut",9005,CT,1132,1312,180,2220,18,20,72,2870,0,2942,4,2828,municipality,2000
900516050,"Colebrook town, Litchfield County, Connecticut",9005,CT,589,722,133,1172,9,4,17,1468,3,1485,12,1440,municipality,2010
900517240,"Cornwall town, Litchfield County, Connecticut",9005,CT,1230,1746,516,2168,20,4,42,2826,2,2868,34,2766,municipality,2000
900517240,"Cornwall town, Litchfield County, Connecticut",9005,CT,628,1007,379,1141,9,2,34,1386,2,1420,16,1357,municipality,2010
900532290,"Goshen town, Litchfield County, Connecticut",9005,CT,2132,2964,832,4168,40,26,66,5328,6,5394,20,5236,municipality,2000
900532290,"Goshen town, Litchfield County, Connecticut",9005,CT,1192,1664,472,2361,36,9,67,2909,8,2976,14,2842,municipality,2010
900537280,"Harwinton town, Litchfield County, Connecticut",9005,CT,3916,4044,128,7918,54,8,94,10472,18,10566,50,10342,municipality,2000
900537280,"Harwinton town, Litchfield County, Connecticut",9005,CT,2170,2282,112,4357,48,12,80,5562,13,5642,36,5453,municipality,2010
900540290,"Kent town, Litchfield County, Connecticut",9005,CT,2286,2926,640,4410,42,32,144,5572,48,5716,48,5402,municipality,2000
900540290,"Kent town, Litchfield County, Connecticut",9005,CT,1246,1665,419,2414,49,34,94,2885,25,2979,38,2739,municipality,2010
900543370,"Litchfield town, Litchfield County, Connecticut",9005,CT,6620,7258,638,12440,78,110,260,16372,56,16632,128,16000,municipality,2000
900543370,"Litchfield town, Litchfield County, Connecticut",9005,CT,3459,3975,516,6679,76,49,173,8293,36,8466,107,8025,municipality,2010
900549460,"Morris town, Litchfield County, Connecticut",9005,CT,1824,2362,538,3472,38,32,40,4562,12,4602,32,4448,municipality,2000
900549460,"Morris town, Litchfield County, Connecticut",9005,CT,958,1314,356,1904,18,11,50,2338,2,2388,27,2280,municipality,2010
900551350,"New Hartford town, Litchfield County, Connecticut",9005,CT,4456,4736,280,8898,90,66,164,12012,18,12176,56,11782,municipality,2000
900551350,"New Hartford town, Litchfield County, Connecticut",9005,CT,2632,2923,291,5338,79,18,124,6846,6,6970,57,6686,municipality,2010
900552630,"New Milford town, Litchfield County, Connecticut",9005,CT,20036,21420,1384,39370,1030,742,1502,52740,192,54242,700,50076,municipality,2000
900552630,"New Milford town, Litchfield County, Connecticut",9005,CT,10618,11731,1113,21303,772,452,1693,26449,125,28142,391,24709,municipality,2010
900553470,"Norfolk town, Litchfield County, Connecticut",9005,CT,1352,1742,390,2534,18,16,32,3288,24,3320,26,3204,municipality,2000
900553470,"Norfolk town, Litchfield County, Connecticut",9005,CT,720,967,247,1348,11,12,30,1679,3,1709,16,1637,municipality,2010
900554030,"North Canaan town, Litchfield County, Connecticut",9005,CT,2686,2888,202,5140,10,72,158,6542,8,6700,60,6392,municipality,2000
900554030,"North Canaan town, Litchfield County, Connecticut",9005,CT,1400,1587,187,2627,8,39,195,3120,4,3315,26,3043,municipality,2010
900560750,"Plymouth town, Litchfield County, Connecticut",9005,CT,8906,9292,386,17272,96,174,294,22974,64,23268,210,22430,municipality,2000
900560750,"Plymouth town, Litchfield County, Connecticut",9005,CT,4803,5109,306,9536,98,94,370,11873,26,12243,161,11494,municipality,2010
900565930,"Roxbury town, Litchfield County, Connecticut",9005,CT,1696,2036,340,3300,40,10,56,4216,26,4272,28,4112,municipality,2000
900565930,"Roxbury town, Litchfield County, Connecticut",9005,CT,936,1167,231,1826,18,13,48,2214,6,2262,27,2150,municipality,2010
900566420,"Salisbury town, Litchfield County, Connecticut",9005,CT,3474,4820,1346,6170,76,128,122,7832,32,7954,64,7532,municipality,2000
900566420,"Salisbury town, Litchfield County, Connecticut",9005,CT,1693,2593,900,3123,41,52,107,3634,4,3741,58,3479,municipality,2010
900567960,"Sharon town, Litchfield County, Connecticut",9005,CT,2492,3234,742,4670,34,56,116,5820,18,5936,46,5666,municipality,2000
900567960,"Sharon town, Litchfield County, Connecticut",9005,CT,1250,1775,525,2332,20,44,56,2726,3,2782,27,2632,municipality,2010
900575730,"Thomaston town, Litchfield County, Connecticut",9005,CT,5832,6028,196,11208,74,88,218,14788,22,15006,68,14536,municipality,2000
900575730,"Thomaston town, Litchfield County, Connecticut",9005,CT,3108,3276,168,6072,58,27,202,7685,23,7887,66,7511,municipality,2010
900576570,"Torrington town, Litchfield County, Connecticut",9005,CT,29486,32294,2808,54182,1268,1388,2324,68080,174,70404,850,64400,municipality,2000
900576570,"Torrington town, Litchfield County, Connecticut",9005,CT,15243,16761,1518,28724,777,776,3193,33190,111,36383,628,30898,municipality,2010
900579510,"Warren town, Litchfield County, Connecticut",9005,CT,994,1300,306,1940,20,4,6,2502,8,2508,18,2452,municipality,2000
900579510,"Warren town, Litchfield County, Connecticut",9005,CT,601,811,210,1147,20,8,31,1430,4,1461,4,1394,municipality,2010
900579720,"Washington town, Litchfield County, Connecticut",9005,CT,2832,3528,696,5440,112,42,154,7038,20,7192,86,6778,municipality,2000
900579720,"Washington town, Litchfield County, Connecticut",9005,CT,1512,2124,612,2905,26,20,142,3436,8,3578,37,3345,municipality,2010
900580490,"Watertown town, Litchfield County, Connecticut",9005,CT,16092,16596,504,32584,546,298,812,42510,86,43322,324,41256,municipality,2000
900580490,"Watertown town, Litchfield County, Connecticut",9005,CT,8672,9096,424,17655,376,292,838,21676,70,22514,231,20707,municipality,2010
900586440,"Winchester town, Litchfield County, Connecticut",9005,CT,8742,9844,1102,16360,196,178,676,20652,84,21328,272,19922,municipality,2000
900586440,"Winchester town, Litchfield County, Connecticut",9005,CT,4815,5613,798,8944,102,136,583,10659,25,11242,166,10230,municipality,2010
900587910,"Woodbury town, Litchfield County, Connecticut",9005,CT,7430,7738,308,13976,202,92,304,18092,58,18396,102,17638,municipality,2000
900587910,"Woodbury town, Litchfield County, Connecticut",9005,CT,4214,4564,350,7876,167,55,245,9730,32,9975,110,9366,municipality,2010
900900000,"County subdivisions not defined, New Haven County, Connecticut",9009,CT,0,0,0,0,0,0,0,0,0,0,0,0,municipality,2000
900900000,"County subdivisions not defined, New Haven County, Connecticut",9009,CT,0,0,0,0,0,0,0,0,0,0,0,0,municipality,2010
900901220,"Ansonia town, New Haven County, Connecticut",9009,CT,15014,15874,860,28130,418,3022,2752,34356,150,37108,634,30132,municipality,2000
900901220,"Ansonia town, New Haven County, Connecticut",9009,CT,7510,8148,638,14670,365,2040,3212,16037,83,19249,386,13163,municipality,2010
900903250,"Beacon Falls town, New Haven County, Connecticut",9009,CT,4064,4208,144,7844,108,68,224,10268,16,10492,74,10002,municipality,2000
900903250,"Beacon Falls town, New Haven County, Connecticut",9009,CT,2360,2509,149,4672,70,87,300,5749,8,6049,69,5515,municipality,2010
900904580,"Bethany town, New Haven County, Connecticut",9009,CT,3510,3584,74,7328,154,184,204,9876,48,10080,64,9426,municipality,2000
900904580,"Bethany town, New Haven County, Connecticut",9009,CT,1971,2044,73,4214,268,102,137,5426,18,5563,50,4988,municipality,2010
900907310,"Branford town, New Haven County, Connecticut",9009,CT,25086,26684,1598,45510,1556,748,1474,55892,128,57366,612,52848,municipality,2000
900907310,"Branford town, New Haven County, Connecticut",9009,CT,12739,13972,1233,23064,1020,507,1149,26877,101,28026,294,24955,municipality,2010
900914160,"Cheshire town, New Haven County, Connecticut",9009,CT,18698,19176,478,42682,1486,2540,2194,54892,170,57086,486,50210,municipality,2000
900914160,"Cheshire town, New Haven County, Connecticut",9009,CT,10041,10424,383,22168,1477,1374,1375,27886,55,29261,343,24637,municipality,2010
900919550,"Derby town, New Haven County, Connecticut",9009,CT,10504,11136,632,19408,424,882,1900,22882,56,24782,302,21218,municipality,2000
900919550,"Derby town, New Haven County, Connecticut",9009,CT,5388,5849,461,10194,323,891,1830,11072,59,12902,200,9599,municipality,2010
900922910,"East Haven town, New Haven County, Connecticut",9009,CT,22438,23396,958,43868,1074,754,2456,53922,102,56378,484,51508,municipality,2000
900922910,"East Haven town, New Haven County, Connecticut",9009,CT,11756,12533,777,23602,954,771,3012,26245,67,29257,299,24154,municipality,2010
900934950,"Guilford town, New Haven County, Connecticut",9009,CT,16302,17448,1146,31920,702,384,910,41886,44,42796,338,40418,municipality,2000
900934950,"Guilford town, New Haven County, Connecticut",9009,CT,8715,9596,881,17098,535,160,779,21596,32,22375,229,20640,municipality,2010
900935650,"Hamden town, New Haven County, Connecticut",9009,CT,44816,46928,2112,90160,4000,17284,4850,108976,346,113826,1722,85624,municipality,2000
900935650,"Hamden town, New Haven County, Connecticut",9009,CT,23727,25114,1387,49338,3304,11869,5327,55633,163,60960,1211,39086,municipality,2010
900944560,"Madison town, New Haven County, Connecticut",9009,CT,13030,14772,1742,25632,608,140,480,35236,36,35716,312,34140,municipality,2000
900944560,"Madison town, New Haven County, Connecticut",9009,CT,6971,8049,1078,13490,405,100,375,17894,31,18269,206,17152,municipality,2010
900946520,"Meriden town, New Haven County, Connecticut",9009,CT,45902,49262,3360,86556,1566,6642,24592,91896,406,116488,1864,81418,municipality,2000
900946520,"Meriden town, New Haven County, Connecticut",9009,CT,23977,25892,1915,46315,1250,4980,17590,43278,203,60868,1036,35809,municipality,2010
900946940,"Middlebury town, New Haven County, Connecticut",9009,CT,4796,4988,192,9738,166,42,158,12744,32,12902,90,12414,municipality,2000
900946940,"Middlebury town, New Haven County, Connecticut",9009,CT,2748,2892,144,5712,286,67,208,7367,19,7575,70,6925,municipality,2010
900947535,"Milford town, New Haven County, Connecticut",9009,CT,41800,43924,2124,81254,2412,1902,3500,101110,356,104610,960,95480,municipality,2000
900947535,"Milford town, New Haven County, Connecticut",9009,CT,21708,23074,1366,42209,2801,1238,2756,50003,185,52759,644,45135,municipality,2010
900949950,"Naugatuck town, New Haven County, Connecticut",9009,CT,23658,24682,1024,45328,1040,1684,2772,59206,422,61978,978,55082,municipality,2000
900949950,"Naugatuck town, New Haven County, Connecticut",9009,CT,12339,13061,722,24482,962,1427,2929,28933,242,31862,535,25767,municipality,2010
900952070,"New Haven town, New Haven County, Connecticut",9009,CT,94188,105882,11694,184360,9552,89196,52886,194366,1606,247252,6054,87958,municipality,2000
900952070,"New Haven town, New Haven County, Connecticut",9009,CT,48877,54967,6090,100197,5864,43332,35591,94188,828,129779,2934,41230,municipality,2010
900953890,"North Branford town, New Haven County, Connecticut",9009,CT,10264,10492,228,20692,248,326,500,27312,28,27812,194,26516,municipality,2000
900953890,"North Branford town, New Haven County, Connecticut",9009,CT,5441,5629,188,11225,225,187,421,13986,25,14407,119,13430,municipality,2010
900954870,"North Haven town, New Haven County, Connecticut",9009,CT,17194,17546,352,35666,1536,1004,866,45204,72,46070,338,42254,municipality,2000
900954870,"North Haven town, New Haven County, Connecticut",9009,CT,9135,9491,356,19089,1121,693,929,23164,50,24093,244,21056,municipality,2010
900957600,"Orange town, New Haven County, Connecticut",9009,CT,9478,9740,262,19958,1016,200,380,26086,32,26466,214,24624,municipality,2000
900957600,"Orange town, New Haven County, Connecticut",9009,CT,5123,5345,222,10710,1045,198,398,13558,39,13956,156,12120,municipality,2010
900958300,"Oxford town, New Haven County, Connecticut",9009,CT,6686,6840,154,14316,130,100,360,19282,52,19642,96,18904,municipality,2000
900958300,"Oxford town, New Haven County, Connecticut",9009,CT,4504,4746,242,9598,195,134,468,12215,33,12683,108,11745,municipality,2010
900962290,"Prospect town, New Haven County, Connecticut",9009,CT,6040,6188,148,13070,126,244,336,17078,62,17414,110,16536,municipality,2000
900962290,"Prospect town, New Haven County, Connecticut",9009,CT,3357,3474,117,7281,73,175,312,9093,25,9405,80,8740,municipality,2010
900967610,"Seymour town, New Haven County, Connecticut",9009,CT,12310,12712,402,23534,540,408,940,29968,98,30908,202,28720,municipality,2000
900967610,"Seymour town, New Haven County, Connecticut",9009,CT,6654,6968,314,12922,359,395,1064,15476,34,16540,172,14516,municipality,2010
900969640,"Southbury town, New Haven County, Connecticut",9009,CT,14450,15598,1148,28678,428,160,592,36542,54,37134,212,35688,municipality,2000
900969640,"Southbury town, New Haven County, Connecticut",9009,CT,8213,9091,878,15854,531,156,523,19381,44,19904,188,18462,municipality,2010
900978740,"Wallingford town, New Haven County, Connecticut",9009,CT,33394,34612,1218,65400,1498,834,3892,82160,176,86052,736,78916,municipality,2000
900978740,"Wallingford town, New Haven County, Connecticut",9009,CT,18032,18945,913,35657,1526,587,3562,41573,106,45135,475,38879,municipality,2010
900980070,"Waterbury town, New Haven County, Connecticut",9009,CT,85244,93654,8410,157634,3168,32670,46708,167834,2034,214542,5150,124812,municipality,2000
900980070,"Waterbury town, New Haven County, Connecticut",9009,CT,42761,47991,5230,82101,1933,19654,34446,75920,1565,110366,2687,50081,municipality,2010
900982870,"West Haven town, New Haven County, Connecticut",9009,CT,42180,44672,2492,80504,3024,16514,9514,95206,432,104720,2194,73042,municipality,2000
900982870,"West Haven town, New Haven County, Connecticut",9009,CT,21112,22446,1334,44009,2056,10205,10155,45409,293,55564,1220,31635,municipality,2010
900987560,"Wolcott town, New Haven County, Connecticut",9009,CT,10828,11088,260,22514,226,370,546,29884,82,30430,234,28972,municipality,2000
900987560,"Wolcott town, New Haven County, Connecticut",9009,CT,6007,6276,269,12772,205,261,611,16069,52,16680,191,15360,municipality,2010
900987700,"Woodbridge town, New Haven County, Connecticut",9009,CT,6206,6378,172,12974,916,270,276,17690,48,17966,236,16220,municipality,2000
900987700,"Woodbridge town, New Haven County, Connecticut",9009,CT,3336,3478,142,6860,780,173,284,8706,21,8990,127,7605,municipality,2010
3400300700,"Allendale borough, Bergen County, New Jersey",34003,INJ,4220,4286,66,9326,816,52,340,13058,30,13398,62,12098,municipality,2000
3400300700,"Allendale borough, Bergen County, New Jersey",34003,INJ,2236,2388,152,4658,624,29,304,6201,12,6505,86,5450,municipality,2010
3400301090,"Alpine borough, Bergen County, New Jersey",34003,INJ,1416,1460,44,3288,832,66,110,4256,12,4366,52,3294,municipality,2000
3400301090,"Alpine borough, Bergen County, New Jersey",34003,INJ,611,670,59,1431,482,44,89,1760,2,1849,35,1197,municipality,2010
3400305170,"Bergenfield borough, Bergen County, New Jersey",34003,INJ,17962,18294,332,39452,10654,3330,8948,43546,296,52494,936,28330,municipality,2000
3400305170,"Bergenfield borough, Bergen County, New Jersey",34003,INJ,8852,9200,348,20361,6778,1724,7097,19667,100,26764,519,10546,municipality,2010
3400306490,"Bogota borough, Bergen County, New Jersey",34003,INJ,5748,5830,82,12322,1274,786,3518,12980,94,16498,412,10414,municipality,2000
3400306490,"Bogota borough, Bergen County, New Jersey",34003,INJ,2773,2888,115,6244,795,582,3169,5018,91,8187,139,3411,municipality,2010
3400310480,"Carlstadt borough, Bergen County, New Jersey",34003,INJ,4786,4946,160,9580,732,128,946,10888,28,11834,60,9940,municipality,2000
3400310480,"Carlstadt borough, Bergen County, New Jersey",34003,INJ,2378,2495,117,4889,499,122,1104,5023,29,6127,61,4312,municipality,2010
3400313570,"Cliffside Park borough, Bergen County, New Jersey",34003,INJ,20054,20750,696,38252,5510,712,8354,37660,162,46014,752,30524,municipality,2000
3400313570,"Cliffside Park borough, Bergen County, New Jersey",34003,INJ,9948,10665,717,19526,3219,584,6704,16890,223,23594,430,12434,municipality,2010
3400313810,"Closter borough, Bergen County, New Jersey",34003,INJ,5578,5730,152,12076,3600,152,686,16080,36,16766,174,12118,municipality,2000
3400313810,"Closter borough, Bergen County, New Jersey",34003,INJ,2747,2860,113,6135,2649,100,501,7872,12,8373,92,5019,municipality,2010
3400315820,"Cresskill borough, Bergen County, New Jersey",34003,INJ,5260,5404,144,11420,2882,140,618,14874,36,15492,214,11602,municipality,2000
3400315820,"Cresskill borough, Bergen County, New Jersey",34003,INJ,3002,3114,112,6277,2367,57,537,8036,10,8573,102,5500,municipality,2010
3400317530,"Demarest borough, Bergen County, New Jersey",34003,INJ,3202,3268,66,6888,1954,46,334,9356,16,9690,108,7232,municipality,2000
3400317530,"Demarest borough, Bergen County, New Jersey",34003,INJ,1597,1659,62,3540,1276,26,216,4665,7,4881,83,3273,municipality,2010
3400318400,"Dumont borough, Bergen County, New Jersey",34003,INJ,12740,12930,190,26478,3830,444,2926,32080,46,35006,376,27384,municipality,2000
3400318400,"Dumont borough, Bergen County, New Jersey",34003,INJ,6364,6542,178,13553,2599,375,2580,14899,44,17479,240,11641,municipality,2010
3400319510,"East Rutherford borough, Bergen County, New Jersey",34003,INJ,7288,7542,254,14054,1860,584,1856,15576,34,17432,278,12820,municipality,2000
3400319510,"East Rutherford borough, Bergen County, New Jersey",34003,INJ,3792,4018,226,7296,1237,336,1563,7350,32,8913,129,5616,municipality,2010
3400320020,"Edgewater borough, Bergen County, New Jersey",34003,INJ,7672,8554,882,12988,3530,486,1604,13750,74,15354,338,9322,municipality,2000
3400320020,"Edgewater borough, Bergen County, New Jersey",34003,INJ,5637,6282,645,9472,4076,519,1278,10235,57,11513,240,5343,municipality,2010
3400321300,"Elmwood Park borough, Bergen County, New Jersey",34003,INJ,14178,14484,306,29942,2948,758,5070,32780,82,37850,716,28276,municipality,2000
3400321300,"Elmwood Park borough, Bergen County, New Jersey",34003,INJ,7032,7385,353,15358,2055,884,4117,15286,91,19403,299,11957,municipality,2010
3400321450,"Emerson borough, Bergen County, New Jersey",34003,INJ,4746,4796,50,11054,1136,94,664,13730,16,14394,66,12418,municipality,2000
3400321450,"Emerson borough, Bergen County, New Jersey",34003,INJ,2480,2552,72,5631,629,64,619,6782,9,7401,94,5986,municipality,2010
3400321480,"Englewood city, Bergen County, New Jersey",34003,INJ,18546,19228,682,39894,2712,19774,11406,41000,278,52406,1458,16778,municipality,2000
3400321480,"Englewood city, Bergen County, New Jersey",34003,INJ,10057,10695,638,21124,2169,8373,7460,19687,189,27147,482,8474,municipality,2010
3400321510,"Englewood Cliffs borough, Bergen County, New Jersey",34003,INJ,3636,3778,142,8442,3160,144,520,10124,20,10644,118,6682,municipality,2000
3400321510,"Englewood Cliffs borough, Bergen County, New Jersey",34003,INJ,1824,1924,100,4143,2027,93,316,4965,3,5281,103,2739,municipality,2010
3400322470,"Fair Lawn borough, Bergen County, New Jersey",34003,INJ,23612,24012,400,48846,3098,416,3488,59786,100,63274,698,55474,municipality,2000
3400322470,"Fair Lawn borough, Bergen County, New Jersey",34003,INJ,11930,12266,336,25305,3130,464,3296,29161,75,32457,341,25151,municipality,2010
3400322560,"Fairview borough, Bergen County, New Jersey",34003,INJ,9722,9976,254,20912,1312,322,9822,16688,264,26510,1046,13744,municipality,2000
3400322560,"Fairview borough, Bergen County, New Jersey",34003,INJ,4853,5150,297,11128,612,286,7558,6277,215,13835,219,4945,municipality,2010
3400324420,"Fort Lee borough, Bergen County, New Jersey",34003,INJ,33088,34892,1804,58522,22242,1110,5582,65340,180,70922,1108,40700,municipality,2000
3400324420,"Fort Lee borough, Bergen County, New Jersey",34003,INJ,16371,17818,1447,29348,13552,805,3877,31468,128,35345,469,16514,municipality,2010
3400324990,"Franklin Lakes borough, Bergen County, New Jersey",34003,INJ,6644,6790,146,14866,1310,192,572,20272,44,20844,156,18570,municipality,2000
3400324990,"Franklin Lakes borough, Bergen County, New Jersey",34003,INJ,3527,3692,165,7689,777,136,525,10065,15,10590,120,9017,municipality,2010
3400325770,"Garfield city, Bergen County, New Jersey",34003,INJ,22500,23396,896,46248,1574,1556,11978,47594,154,59572,1190,43120,municipality,2000
3400325770,"Garfield city, Bergen County, New Jersey",34003,INJ,11073,11788,715,23377,659,1564,9830,20657,122,30487,340,17972,municipality,2010
3400326640,"Glen Rock borough, Bergen County, New Jersey",34003,INJ,7954,8048,94,16302,1496,412,628,22464,64,23092,166,20326,municipality,2000
3400326640,"Glen Rock borough, Bergen County, New Jersey",34003,INJ,3917,4016,99,8119,1050,151,527,11074,32,11601,150,9691,municipality,2010
3400328680,"Hackensack city, Bergen County, New Jersey",34003,INJ,36226,37890,1664,69812,6326,20184,22122,63232,418,85354,2278,34026,municipality,2000
3400328680,"Hackensack city, Bergen County, New Jersey",34003,INJ,18142,19375,1233,34979,4372,9693,15186,27824,250,43010,664,12845,municipality,2010
3400330150,"Harrington Park borough, Bergen County, New Jersey",34003,INJ,3126,3166,40,6768,1388,58,244,9236,26,9480,26,7738,municipality,2000
3400330150,"Harrington Park borough, Bergen County, New Jersey",34003,INJ,1592,1624,32,3360,812,31,163,4501,18,4664,48,3592,municipality,2010
3400330420,"Hasbrouck Heights borough, Bergen County, New Jersey",34003,INJ,9042,9234,192,18152,1542,376,1928,21396,42,23324,214,19222,municipality,2000
3400330420,"Hasbrouck Heights borough, Bergen County, New Jersey",34003,INJ,4433,4627,194,9205,1169,293,1760,10082,36,11842,139,8445,municipality,2010
3400330540,"Haworth borough, Bergen County, New Jersey",34003,INJ,2268,2292,24,4822,624,82,184,6596,12,6780,60,5818,municipality,2000
3400330540,"Haworth borough, Bergen County, New Jersey",34003,INJ,1110,1136,26,2426,397,37,148,3234,6,3382,59,2735,municipality,2010
3400331920,"Hillsdale borough, Bergen County, New Jersey",34003,INJ,7004,7094,90,14930,1022,172,858,19316,36,20174,120,17966,municipality,2000
3400331920,"Hillsdale borough, Bergen County, New Jersey",34003,INJ,3493,3567,74,7501,638,93,794,9425,32,10219,72,8590,municipality,2010
3400332310,"Ho-Ho-Kus borough, Bergen County, New Jersey",34003,INJ,2866,2930,64,5884,424,40,160,7960,36,8120,68,7392,municipality,2000
3400332310,"Ho-Ho-Kus borough, Bergen County, New Jersey",34003,INJ,1401,1462,61,2885,235,9,168,3910,9,4078,57,3600,municipality,2010
3400340020,"Leonia borough, Bergen County, New Jersey",34003,INJ,6542,6686,144,13450,4634,370,2270,15558,30,17828,278,10246,municipality,2000
3400340020,"Leonia borough, Bergen County, New Jersey",34003,INJ,3284,3428,144,6942,3122,169,1489,7448,38,8937,178,3941,municipality,2010
3400340680,"Little Ferry borough, Bergen County, New Jersey",34003,INJ,8732,8898,166,17232,3684,974,3282,18318,76,21600,576,13008,municipality,2000
3400340680,"Little Ferry borough, Bergen County, New Jersey",34003,INJ,4239,4439,200,8533,2550,366,2442,8184,58,10626,194,5016,municipality,2010
3400341100,"Lodi borough, Bergen County, New Jersey",34003,INJ,19056,19816,760,37730,4222,1538,8618,39324,200,47942,810,32554,municipality,2000
3400341100,"Lodi borough, Bergen County, New Jersey",34003,INJ,9471,10127,656,18989,2036,1589,7360,16776,140,24136,419,12592,municipality,2010
3400342090,"Lyndhurst township, Bergen County, New Jersey",34003,INJ,15754,16206,452,31380,2084,196,3488,35278,102,38766,564,32332,municipality,2000
3400342090,"Lyndhurst township, Bergen County, New Jersey",34003,INJ,8337,8787,450,16671,1333,325,3769,16785,132,20554,286,14709,municipality,2010
3400342750,"Mahwah township, Bergen County, New Jersey",34003,INJ,18680,19154,474,37434,3020,1020,2056,46068,376,48124,542,41110,municipality,2000
3400342750,"Mahwah township, Bergen County, New Jersey",34003,INJ,9505,9868,363,20754,2014,616,1622,24268,141,25890,409,21088,municipality,2010
3400344880,"Maywood borough, Bergen County, New Jersey",34003,INJ,7420,7554,134,15028,1358,494,2230,16816,60,19046,244,14660,municipality,2000
3400344880,"Maywood borough, Bergen County, New Jersey",34003,INJ,3649,3769,120,7544,1042,460,1785,7770,49,9555,138,6081,municipality,2010
3400346110,"Midland Park borough, Bergen County, New Jersey",34003,INJ,5226,5300,74,10516,308,58,512,13382,30,13894,64,12922,municipality,2000
3400346110,"Midland Park borough, Bergen County, New Jersey",34003,INJ,2756,2861,105,5391,192,51,474,6654,11,7128,98,6302,municipality,2010
3400347610,"Montvale borough, Bergen County, New Jersey",34003,INJ,5018,5180,162,10418,746,60,434,13634,26,14068,86,12716,municipality,2000
3400347610,"Montvale borough, Bergen County, New Jersey",34003,INJ,2778,2872,94,5745,861,70,419,7425,15,7844,84,6395,municipality,2010
3400347700,"Moonachie borough, Bergen County, New Jersey",34003,INJ,2082,2148,66,4358,350,44,698,4810,12,5508,118,4286,municipality,2000
3400347700,"Moonachie borough, Bergen County, New Jersey",34003,INJ,1005,1053,48,2206,267,23,660,2048,8,2708,42,1708,municipality,2010
3400351660,"New Milford borough, Bergen County, New Jersey",34003,INJ,12692,12874,182,25790,4804,792,2652,30148,58,32800,478,24016,municipality,2000
3400351660,"New Milford borough, Bergen County, New Jersey",34003,INJ,6141,6362,221,12938,3163,507,2227,14114,46,16341,238,10160,municipality,2010
3400352320,"North Arlington borough, Bergen County, New Jersey",34003,INJ,12784,13058,274,24890,1682,116,3210,27152,68,30362,410,24876,municipality,2000
3400352320,"North Arlington borough, Bergen County, New Jersey",34003,INJ,6295,6573,278,12684,1201,148,3211,12181,112,15392,153,10567,municipality,2010
3400353430,"Northvale borough, Bergen County, New Jersey",34003,INJ,3150,3192,42,6916,1252,64,422,8498,14,8920,62,7106,municipality,2000
3400353430,"Northvale borough, Bergen County, New Jersey",34003,INJ,1564,1635,71,3473,1110,46,378,4262,9,4640,58,3039,municipality,2010
3400353610,"Norwood borough, Bergen County, New Jersey",34003,INJ,3714,3776,62,8538,2184,96,344,11158,32,11502,134,8712,municipality,2000
3400353610,"Norwood borough, Bergen County, New Jersey",34003,INJ,1927,2007,80,4394,1551,64,260,5451,15,5711,55,3766,municipality,2010
3400353850,"Oakland borough, Bergen County, New Jersey",34003,INJ,8510,8690,180,18588,670,188,966,23966,34,24932,192,22882,municipality,2000
3400353850,"Oakland borough, Bergen County, New Jersey",34003,INJ,4335,4470,135,9442,532,104,681,12073,30,12754,134,11273,municipality,2010
3400354870,"Old Tappan borough, Bergen County, New Jersey",34003,INJ,3556,3608,52,8008,1714,60,302,10662,10,10964,54,8824,municipality,2000
3400354870,"Old Tappan borough, Bergen County, New Jersey",34003,INJ,1931,1995,64,4175,1276,40,288,5462,6,5750,68,4072,municipality,2010
3400354990,"Oradell borough, Bergen County, New Jersey",34003,INJ,5578,5666,88,12040,1298,68,498,15596,6,16094,130,14094,municipality,2000
3400354990,"Oradell borough, Bergen County, New Jersey",34003,INJ,2749,2831,82,5894,895,46,397,7581,12,7978,91,6537,municipality,2010
3400355770,"Palisades Park borough, Bergen County, New Jersey",34003,INJ,12494,12772,278,27522,14020,352,5626,28520,122,34146,690,13336,municipality,2000
3400355770,"Palisades Park borough, Bergen County, New Jersey",34003,INJ,6934,7362,428,16379,11312,283,3575,16047,78,19622,161,4213,municipality,2010
3400355950,"Paramus borough, Bergen County, New Jersey",34003,INJ,16164,16418,254,39510,8838,556,2506,48968,58,51474,650,38866,municipality,2000
3400355950,"Paramus borough, Bergen County, New Jersey",34003,INJ,8630,8915,285,20674,5850,335,1913,24429,81,26342,537,17626,municipality,2010
3400356130,"Park Ridge borough, Bergen County, New Jersey",34003,INJ,6322,6516,194,13328,672,134,926,16490,18,17416,110,15556,municipality,2000
3400356130,"Park Ridge borough, Bergen County, New Jersey",34003,INJ,3283,3428,145,6667,524,80,669,7976,21,8645,63,7288,municipality,2010
3400361680,"Ramsey borough, Bergen County, New Jersey",34003,INJ,10626,10800,174,20948,1666,220,840,27862,34,28702,250,25692,municipality,2000
3400361680,"Ramsey borough, Bergen County, New Jersey",34003,INJ,5363,5550,187,10627,959,90,866,13607,28,14473,139,12391,municipality,2010
3400362910,"Ridgefield borough, Bergen County, New Jersey",34003,INJ,8040,8240,200,16930,3762,142,2988,18672,74,21660,316,14378,municipality,2000
3400362910,"Ridgefield borough, Bergen County, New Jersey",34003,INJ,3905,4145,240,8651,3199,95,2362,8670,39,11032,122,5215,municipality,2010
3400362940,"Ridgefield Park village, Bergen County, New Jersey",34003,INJ,10024,10268,244,19990,2014,892,5726,20020,68,25746,370,16676,municipality,2000
3400362940,"Ridgefield Park village, Bergen County, New Jersey",34003,INJ,4851,5164,313,9935,1447,581,4605,8124,57,12729,157,5882,municipality,2010
3400363000,"Ridgewood village, Bergen County, New Jersey",34003,INJ,17206,17604,398,34922,4310,790,1884,47988,80,49872,480,42328,municipality,2000
3400363000,"Ridgewood village, Bergen County, New Jersey",34003,INJ,8456,8743,287,17306,3237,373,1316,23642,47,24958,424,19561,municipality,2010
3400363360,"River Edge borough, Bergen County, New Jersey",34003,INJ,8330,8420,90,16624,2756,216,1162,20730,36,21892,206,17516,municipality,2000
3400363360,"River Edge borough, Bergen County, New Jersey",34003,INJ,4134,4261,127,8396,2505,156,869,10471,24,11340,117,7669,municipality,2010
3400363690,"River Vale township, Bergen County, New Jersey",34003,INJ,6550,6624,74,13752,1112,100,608,18290,22,18898,116,16940,municipality,2000
3400363690,"River Vale township, Bergen County, New Jersey",34003,INJ,3421,3521,100,7086,809,64,481,9178,12,9659,107,8186,municipality,2010
3400363990,"Rochelle Park township, Bergen County, New Jersey",34003,INJ,4122,4222,100,8994,654,50,948,10108,10,11056,94,9300,municipality,2000
3400363990,"Rochelle Park township, Bergen County, New Jersey",34003,INJ,2087,2170,83,4524,481,147,904,4626,9,5530,71,3918,municipality,2010
3400364170,"Rockleigh borough, Bergen County, New Jersey",34003,INJ,148,160,12,576,30,26,38,744,2,782,14,672,municipality,2000
3400364170,"Rockleigh borough, Bergen County, New Jersey",34003,INJ,75,86,11,445,8,10,20,511,1,531,5,487,municipality,2010
3400365280,"Rutherford borough, Bergen County, New Jersey",34003,INJ,14110,14428,318,28698,4108,950,3110,33110,102,36220,558,27392,municipality,2000
3400365280,"Rutherford borough, Bergen County, New Jersey",34003,INJ,6949,7278,329,14272,2340,454,2543,15518,73,18061,353,12298,municipality,2010
3400365340,"Saddle Brook township, Bergen County, New Jersey",34003,INJ,10124,10322,198,20998,1222,324,1650,24660,50,26310,264,22800,municipality,2000
3400365340,"Saddle Brook township, Bergen County, New Jersey",34003,INJ,5286,5485,199,10906,1102,268,1666,11993,48,13659,157,10418,municipality,2010
3400365400,"Saddle River borough, Bergen County, New Jersey",34003,INJ,2236,2366,130,4964,458,48,164,6238,24,6402,86,5622,municipality,2000
3400365400,"Saddle River borough, Bergen County, New Jersey",34003,INJ,1216,1341,125,2487,291,60,162,2990,12,3152,57,2570,municipality,2010
3400368970,"South Hackensack township, Bergen County, New Jersey",34003,INJ,1622,1660,38,3614,258,94,678,3820,20,4498,52,3396,municipality,2000
3400368970,"South Hackensack township, Bergen County, New Jersey",34003,INJ,845,879,34,1856,121,98,792,1586,6,2378,35,1326,municipality,2010
3400372360,"Teaneck township, Bergen County, New Jersey",34003,INJ,26836,27438,602,58278,5582,21810,8206,70314,400,78520,2048,40474,municipality,2000
3400372360,"Teaneck township, Bergen County, New Jersey",34003,INJ,13470,14024,554,29823,3574,10266,6575,33201,218,39776,797,18346,municipality,2010
3400372420,"Tenafly borough, Bergen County, New Jersey",34003,INJ,9548,9794,246,19800,5258,244,1284,26328,80,27612,394,20352,municipality,2000
3400372420,"Tenafly borough, Bergen County, New Jersey",34003,INJ,4766,4980,214,9972,3794,123,776,13712,44,14488,276,9475,municipality,2010
3400372480,"Teterboro borough, Bergen County, New Jersey",34003,INJ,14,16,2,24,0,0,0,36,0,36,6,30,municipality,2000
3400372480,"Teterboro borough, Bergen County, New Jersey",34003,INJ,25,27,2,51,2,2,24,43,2,67,6,31,municipality,2010
3400375140,"Upper Saddle River borough, Bergen County, New Jersey",34003,INJ,4994,5120,126,10736,968,144,338,15144,30,15482,130,13872,municipality,2000
3400375140,"Upper Saddle River borough, Bergen County, New Jersey",34003,INJ,2639,2776,137,5693,822,108,355,7853,22,8208,92,6809,municipality,2010
3400376400,"Waldwick borough, Bergen County, New Jersey",34003,INJ,6856,6990,134,14340,868,114,1022,18222,20,19244,130,17090,municipality,2000
3400376400,"Waldwick borough, Bergen County, New Jersey",34003,INJ,3420,3537,117,7196,478,74,830,8795,17,9625,104,8122,municipality,2010
3400376490,"Wallington borough, Bergen County, New Jersey",34003,INJ,9504,9812,308,18902,1148,568,1552,21614,30,23166,402,19466,municipality,2000
3400376490,"Wallington borough, Bergen County, New Jersey",34003,INJ,4637,4946,309,9296,610,303,1225,10110,31,11335,118,9048,municipality,2010
3400377135,"Washington township, Bergen County, New Jersey",34003,INJ,6438,6490,52,13810,992,156,598,17278,40,17876,128,15962,municipality,2000
3400377135,"Washington township, Bergen County, New Jersey",34003,INJ,3261,3341,80,7015,581,93,495,8607,10,9102,84,7839,municipality,2010
3400380270,"Westwood borough, Bergen County, New Jersey",34003,INJ,8970,9220,250,17262,964,1248,1320,20678,62,21998,182,18222,municipality,2000
3400380270,"Westwood borough, Bergen County, New Jersey",34003,INJ,4438,4636,198,8521,802,466,1263,9645,10,10908,122,8245,municipality,2010
3400382300,"Woodcliff Lake borough, Bergen County, New Jersey",34003,INJ,3648,3684,36,8054,514,98,268,11222,2,11490,60,10548,municipality,2000
3400382300,"Woodcliff Lake borough, Bergen County, New Jersey",34003,INJ,1916,1980,64,4131,371,47,310,5420,8,5730,48,4946,municipality,2010
3400382570,"Wood-Ridge borough, Bergen County, New Jersey",34003,INJ,6048,6174,126,12042,764,122,1112,14176,18,15288,148,13124,municipality,2000
3400382570,"Wood-Ridge borough, Bergen County, New Jersey",34003,INJ,2939,3051,112,5986,538,95,1000,6626,24,7626,71,5898,municipality,2010
3400383050,"Wyckoff township, Bergen County, New Jersey",34003,INJ,11082,11276,194,23674,1222,146,752,32264,68,33016,204,30624,municipality,2000
3400383050,"Wyckoff township, Bergen County, New Jersey",34003,INJ,5646,5827,181,12081,705,81,737,15959,17,16696,151,15005,municipality,2010
3401304695,"Belleville township, Essex County, New Jersey",34013,INJ,27462,28288,826,56164,8048,3416,17014,54842,370,71856,1670,41338,municipality,2000
3401304695,"Belleville township, Essex County, New Jersey",34013,INJ,13395,14327,932,28146,4251,2794,14133,21793,361,35926,519,13868,municipality,2010
3401306260,"Bloomfield township, Essex County, New Jersey",34013,INJ,38034,39016,982,75288,7960,10664,13802,81564,754,95366,2114,60072,municipality,2000
3401306260,"Bloomfield township, Essex County, New Jersey",34013,INJ,18387,19470,1083,37306,3846,8092,11606,35709,523,47315,957,22291,municipality,2010
3401309250,"Caldwell borough, Essex County, New Jersey",34013,INJ,6622,6792,170,12430,616,330,704,14464,36,15168,110,13372,municipality,2000
3401309250,"Caldwell borough, Essex County, New Jersey",34013,INJ,3359,3510,151,6375,366,233,786,7036,18,7822,113,6306,municipality,2010
3401311200,"Cedar Grove township, Essex County, New Jersey",34013,INJ,8806,8940,134,19868,1332,728,786,23814,26,24600,174,21554,municipality,2000
3401311200,"Cedar Grove township, Essex County, New Jersey",34013,INJ,4523,4661,138,9909,800,294,727,11684,17,12411,98,10475,municipality,2010
3401313045,"City of Orange township, Essex County, New Jersey",34013,INJ,23770,25330,1560,47520,828,48636,8194,57542,528,65736,2546,5004,municipality,2000
3401313045,"City of Orange township, Essex County, New Jersey",34013,INJ,11202,12222,1020,22615,448,21067,6531,23603,286,30134,445,1357,municipality,2010
3401319390,"East Orange city, Essex County, New Jersey",34013,INJ,52048,56970,4922,100376,588,123208,6568,133080,910,139648,4626,3748,municipality,2000
3401319390,"East Orange city, Essex County, New Jersey",34013,INJ,24945,28803,3858,47776,436,55702,5095,59175,550,64270,1065,1422,municipality,2010
3401321840,"Essex Fells borough, Essex County, New Jersey",34013,INJ,1474,1522,48,3040,44,20,52,4272,8,4324,52,4148,municipality,2000
3401321840,"Essex Fells borough, Essex County, New Jersey",34013,INJ,728,758,30,1481,43,20,42,2071,1,2113,31,1976,municipality,2010
3401322385,"Fairfield township, Essex County, New Jersey",34013,INJ,4592,4652,60,11012,398,72,488,13638,16,14126,64,13088,municipality,2000
3401322385,"Fairfield township, Essex County, New Jersey",34013,INJ,2645,2723,78,5780,183,46,384,7082,3,7466,50,6800,municipality,2010
3401326610,"Glen Ridge borough, Essex County, New Jersey",34013,INJ,4916,4980,64,10078,482,684,502,14040,58,14542,146,12670,municipality,2000
3401326610,"Glen Ridge borough, Essex County, New Jersey",34013,INJ,2476,2541,65,5102,348,356,377,7150,29,7527,164,6253,municipality,2010
3401334450,"Irvington township, Essex County, New Jersey",34013,INJ,44064,48232,4168,87382,1322,97704,10172,111218,734,121390,4528,6930,municipality,2000
3401334450,"Irvington township, Essex County, New Jersey",34013,INJ,20093,23196,3103,40235,462,45285,5716,48210,336,53926,698,1429,municipality,2010
3401340890,"Livingston township, Essex County, New Jersey",34013,INJ,18600,18914,314,40214,7928,650,1390,53392,96,54782,418,44300,municipality,2000
3401340890,"Livingston township, Essex County, New Jersey",34013,INJ,9990,10284,294,21433,5609,632,1192,28174,57,29366,341,21535,municipality,2010
3401343800,"Maplewood township, Essex County, New Jersey",34013,INJ,16904,17230,326,34350,1320,15288,2496,45240,256,47736,1612,26764,municipality,2000
3401343800,"Maplewood township, Essex County, New Jersey",34013,INJ,8240,8608,368,17109,722,8189,1595,22272,131,23867,645,12585,municipality,2010
3401346380,"Millburn township, Essex County, New Jersey",34013,INJ,14030,14316,286,27578,3316,424,808,38722,80,39530,378,34524,municipality,2000
3401346380,"Millburn township, Essex County, New Jersey",34013,INJ,6813,7106,293,13647,3149,303,703,19446,32,20149,375,15587,municipality,2010
3401347500,"Montclair township, Essex County, New Jersey",34013,INJ,30040,31062,1022,58026,2428,24388,3990,73964,578,77954,2034,44536,municipality,2000
3401347500,"Montclair township, Essex County, New Jersey",34013,INJ,15089,15911,822,28072,1416,9902,2810,34859,284,37669,1337,21920,municipality,2010
3401351000,"Newark city, Essex County, New Jersey",34013,INJ,182764,200282,17518,394254,6276,284166,161244,385848,5264,547092,12242,77900,municipality,2000
3401351000,"Newark city, Essex County, New Jersey",34013,INJ,94542,109520,14978,206253,4318,138074,93746,183394,4680,277140,4200,32122,municipality,2010
3401352620,"North Caldwell borough, Essex County, New Jersey",34013,INJ,4140,4216,76,11346,694,2106,318,14432,12,14750,112,11508,municipality,2000
3401352620,"North Caldwell borough, Essex County, New Jersey",34013,INJ,2092,2134,42,4498,350,41,260,5923,1,6183,58,5473,municipality,2010
3401353680,"Nutley township, Essex County, New Jersey",34013,INJ,21768,22236,468,42792,3868,968,3660,51064,138,54724,500,45590,municipality,2000
3401353680,"Nutley township, Essex County, New Jersey",34013,INJ,11314,11789,475,22492,2789,541,3354,25016,97,28370,393,21196,municipality,2010
3401364590,"Roseland borough, Essex County, New Jersey",34013,INJ,4284,4374,90,8414,500,76,242,10354,16,10596,68,9694,municipality,2000
3401364590,"Roseland borough, Essex County, New Jersey",34013,INJ,2345,2432,87,4598,333,101,262,5557,11,5819,44,5068,municipality,2010
3401369274,"South Orange Village township, Essex County, New Jersey",34013,INJ,11044,11342,298,26374,1318,10300,1674,32254,144,33928,750,19742,municipality,2000
3401369274,"South Orange Village township, Essex County, New Jersey",34013,INJ,5516,5815,299,12483,829,4484,993,15205,110,16198,551,9231,municipality,2010
3401375815,"Verona township, Essex County, New Jersey",34013,INJ,11170,11438,268,20980,914,394,934,26132,40,27066,264,24520,municipality,2000
3401375815,"Verona township, Essex County, New Jersey",34013,INJ,5315,5523,208,10238,535,239,795,12537,30,13332,164,11569,municipality,2010
3401378510,"West Caldwell township, Essex County, New Jersey",34013,INJ,7980,8088,108,16926,864,200,628,21838,34,22466,140,20600,municipality,2000
3401378510,"West Caldwell township, Essex County, New Jersey",34013,INJ,3913,4009,96,8239,418,122,523,10236,19,10759,103,9574,municipality,2010
3401379800,"West Orange township, Essex County, New Jersey",34013,INJ,32960,33802,842,68954,7238,15344,9028,80858,342,89886,2120,55814,municipality,2000
3401379800,"West Orange township, Essex County, New Jersey",34013,INJ,16790,17612,822,35264,3641,11841,7487,38720,231,46207,867,22140,municipality,2010
3401703580,"Bayonne city, Hudson County, New Jersey",34017,INJ,51090,53652,2562,96340,5058,6196,22030,101654,446,123684,3520,86434,municipality,2000
3401703580,"Bayonne city, Hudson County, New Jersey",34017,INJ,25237,27799,2562,48862,4803,4730,16251,46773,310,63024,1109,35821,municipality,2010
3401719360,"East Newark borough, Hudson County, New Jersey",34017,INJ,1534,1598,64,3522,118,44,2260,2494,92,4754,124,2116,municipality,2000
3401719360,"East Newark borough, Hudson County, New Jersey",34017,INJ,759,794,35,1877,188,17,1477,929,32,2406,24,668,municipality,2010
3401728650,"Guttenberg town, Hudson County, New Jersey",34017,INJ,8986,9300,314,17040,1558,614,11742,9872,94,21614,636,6970,municipality,2000
3401728650,"Guttenberg town, Hudson County, New Jersey",34017,INJ,4473,4839,366,8881,803,330,7245,3931,69,11176,107,2622,municipality,2010
3401730210,"Harrison town, Hudson County, New Jersey",34017,INJ,10272,10508,236,22640,3400,174,10666,18182,448,28848,648,13512,municipality,2000
3401730210,"Harrison town, Hudson County, New Jersey",34017,INJ,4869,5228,359,10789,2198,173,6017,7603,242,13620,172,4818,municipality,2010
3401732250,"Hoboken city, Hudson County, New Jersey",34017,INJ,38836,39830,994,69086,3296,2598,15566,61588,196,77154,1106,54392,municipality,2000
3401732250,"Hoboken city, Hudson County, New Jersey",34017,INJ,25041,26855,1814,43892,3516,1289,7602,42403,161,50005,830,36607,municipality,2010
3401736000,"Jersey City city, Hudson County, New Jersey",34017,INJ,177264,187296,10032,361304,77246,128778,135904,344206,5758,480110,18952,113472,municipality,2000
3401736000,"Jersey City city, Hudson County, New Jersey",34017,INJ,96859,108720,11861,195249,58106,59060,68256,179341,3104,247597,5835,53236,municipality,2010
3401736510,"Kearny town, Hudson County, New Jersey",34017,INJ,27078,27744,666,63628,4412,2884,22150,58876,850,81026,1880,48850,municipality,2000
3401736510,"Kearny town, Hudson County, New Jersey",34017,INJ,13462,14180,718,32253,1746,1721,16253,24431,588,40684,560,19816,municipality,2010
3401752470,"North Bergen township, Hudson County, New Jersey",34017,INJ,42472,44018,1546,89774,7422,1800,66520,49664,646,116184,2942,36854,municipality,2000
3401752470,"North Bergen township, Hudson County, New Jersey",34017,INJ,22062,23912,1850,47710,3835,1065,41569,19204,311,60773,623,13370,municipality,2010
3401766570,"Secaucus town, Hudson County, New Jersey",34017,INJ,12428,12770,342,25732,3748,1302,3906,27956,78,31862,484,22344,municipality,2000
3401766570,"Secaucus town, Hudson County, New Jersey",34017,INJ,6297,6846,549,13125,3269,575,3025,13239,57,16264,247,9091,municipality,2010
3401774630,"Union City city, Hudson County, New Jersey",34017,INJ,45744,47482,1738,100234,2666,1750,110452,23724,490,134176,1038,17780,municipality,2000
3401774630,"Union City city, Hudson County, New Jersey",34017,INJ,22814,24931,2117,50692,1447,1070,56291,10164,268,66455,339,7040,municipality,2010
3401777930,"Weehawken township, Hudson County, New Jersey",34017,INJ,11950,12318,368,22530,1232,624,10974,16028,140,27002,500,13532,municipality,2000
3401777930,"Weehawken township, Hudson County, New Jersey",34017,INJ,5712,6213,501,10510,1010,412,5055,7499,51,12554,176,5850,municipality,2010
3401779610,"West New York town, Hudson County, New Jersey",34017,INJ,33438,34720,1282,71124,2584,1316,72076,19460,298,91536,1086,14176,municipality,2000
3401779610,"West New York town, Hudson County, New Jersey",34017,INJ,18852,20018,1166,39264,2904,873,38812,10896,169,49708,379,6571,municipality,2010
3401900550,"Alexandria township, Hunterdon County, New Jersey",34019,ONJ,3070,3196,126,6756,68,72,162,9234,22,9396,54,9018,municipality,2000
3401900550,"Alexandria township, Hunterdon County, New Jersey",34019,ONJ,1758,1865,107,3677,90,98,159,4779,12,4938,29,4550,municipality,2010
3401905650,"Bethlehem township, Hunterdon County, New Jersey",34019,ONJ,2532,2606,74,5386,78,62,124,7516,12,7640,24,7340,municipality,2000
3401905650,"Bethlehem township, Hunterdon County, New Jersey",34019,ONJ,1344,1386,42,2879,75,39,160,3819,7,3979,28,3670,municipality,2010
3401906370,"Bloomsbury borough, Hunterdon County, New Jersey",34019,ONJ,644,684,40,1244,6,6,26,1746,4,1772,8,1722,municipality,2000
3401906370,"Bloomsbury borough, Hunterdon County, New Jersey",34019,ONJ,337,358,21,635,16,9,35,835,0,870,11,799,municipality,2010
3401909280,"Califon borough, Hunterdon County, New Jersey",34019,ONJ,802,820,18,1544,16,0,10,2100,0,2110,12,2072,municipality,2000
3401909280,"Califon borough, Hunterdon County, New Jersey",34019,ONJ,394,419,25,773,9,3,14,1062,1,1076,26,1023,municipality,2010
3401913720,"Clinton town, Hunterdon County, New Jersey",34019,ONJ,2136,2190,54,3876,196,70,216,5048,30,5264,42,4710,municipality,2000
3401913720,"Clinton town, Hunterdon County, New Jersey",34019,ONJ,1057,1098,41,2013,181,36,169,2550,3,2719,31,2299,municipality,2010
3401913750,"Clinton township, Hunterdon County, New Jersey",34019,ONJ,8258,8468,210,19118,606,1716,1014,24900,96,25914,202,22280,municipality,2000
3401913750,"Clinton township, Hunterdon County, New Jersey",34019,ONJ,4568,4737,169,10236,523,734,755,12723,56,13478,171,11239,municipality,2010
3401917170,"Delaware township, Hunterdon County, New Jersey",34019,ONJ,3286,3402,116,6858,92,36,102,8854,12,8956,30,8684,municipality,2000
3401917170,"Delaware township, Hunterdon County, New Jersey",34019,ONJ,1788,1927,139,3648,41,26,112,4451,7,4563,53,4324,municipality,2010
3401918820,"East Amwell township, Hunterdon County, New Jersey",34019,ONJ,3162,3248,86,6656,82,64,136,8774,10,8910,62,8556,municipality,2000
3401918820,"East Amwell township, Hunterdon County, New Jersey",34019,ONJ,1518,1580,62,3130,57,50,113,3900,5,4013,28,3760,municipality,2010
3401923700,"Flemington borough, Hunterdon County, New Jersey",34019,ONJ,3608,3752,144,6534,262,254,922,7478,48,8400,98,6816,municipality,2000
3401923700,"Flemington borough, Hunterdon County, New Jersey",34019,ONJ,1815,1926,111,3559,257,159,1198,3383,22,4581,82,2863,municipality,2010
3401924870,"Franklin township, Hunterdon County, New Jersey",34019,ONJ,2182,2250,68,4488,46,24,134,5846,10,5980,32,5734,municipality,2000
3401924870,"Franklin township, Hunterdon County, New Jersey",34019,ONJ,1137,1204,67,2407,37,18,110,3085,12,3195,10,3008,municipality,2010
3401925350,"Frenchtown borough, Hunterdon County, New Jersey",34019,ONJ,1226,1260,34,2306,36,12,78,2898,6,2976,18,2826,municipality,2000
3401925350,"Frenchtown borough, Hunterdon County, New Jersey",34019,ONJ,596,656,60,1086,13,10,70,1303,1,1373,11,1268,municipality,2010
3401926550,"Glen Gardner borough, Hunterdon County, New Jersey",34019,ONJ,1610,1658,48,2842,56,34,130,3674,14,3804,32,3538,municipality,2000
3401926550,"Glen Gardner borough, Hunterdon County, New Jersey",34019,ONJ,768,825,57,1341,31,28,90,1614,1,1704,20,1534,municipality,2010
3401929460,"Hampton borough, Hunterdon County, New Jersey",34019,ONJ,1118,1148,30,2296,30,146,88,3004,6,3092,52,2770,municipality,2000
3401929460,"Hampton borough, Hunterdon County, New Jersey",34019,ONJ,570,612,42,1099,26,32,75,1326,7,1401,14,1247,municipality,2010
3401931320,"High Bridge borough, Hunterdon County, New Jersey",34019,ONJ,2856,2956,100,5464,108,58,160,7392,26,7552,42,7158,municipality,2000
3401931320,"High Bridge borough, Hunterdon County, New Jersey",34019,ONJ,1418,1481,63,2763,114,47,219,3429,4,3648,37,3227,municipality,2010
3401932460,"Holland township, Hunterdon County, New Jersey",34019,ONJ,3762,3884,122,7712,44,44,174,10074,18,10248,52,9916,municipality,2000
3401932460,"Holland township, Hunterdon County, New Jersey",34019,ONJ,1972,2066,94,4015,41,29,142,5149,9,5291,24,5046,municipality,2010
3401937065,"Kingwood township, Hunterdon County, New Jersey",34019,ONJ,2680,2844,164,5500,58,46,140,7424,8,7564,42,7270,municipality,2000
3401937065,"Kingwood township, Hunterdon County, New Jersey",34019,ONJ,1446,1569,123,2957,41,23,92,3753,7,3845,41,3641,municipality,2010
3401938610,"Lambertville city, Hunterdon County, New Jersey",34019,ONJ,3720,3922,202,6548,64,148,240,7496,26,7736,68,7190,municipality,2000
3401938610,"Lambertville city, Hunterdon County, New Jersey",34019,ONJ,1958,2075,117,3372,51,70,381,3525,4,3906,31,3369,municipality,2010
3401939630,"Lebanon borough, Hunterdon County, New Jersey",34019,ONJ,916,954,38,1616,66,14,44,2086,4,2130,6,1996,municipality,2000
3401939630,"Lebanon borough, Hunterdon County, New Jersey",34019,ONJ,602,664,62,1072,71,22,68,1290,6,1358,20,1171,municipality,2010
3401939660,"Lebanon township, Hunterdon County, New Jersey",34019,ONJ,3926,4040,114,8664,106,90,200,11432,14,11632,72,11150,municipality,2000
3401939660,"Lebanon township, Hunterdon County, New Jersey",34019,ONJ,2296,2439,143,5097,97,107,205,6383,27,6588,56,6096,municipality,2010
3401946260,"Milford borough, Hunterdon County, New Jersey",34019,ONJ,938,968,30,1784,10,4,48,2342,2,2390,12,2314,municipality,2000
3401946260,"Milford borough, Hunterdon County, New Jersey",34019,ONJ,520,552,32,979,12,3,27,1206,3,1233,11,1177,municipality,2010
3401961920,"Raritan township, Hunterdon County, New Jersey",34019,ONJ,13878,14188,310,28020,1384,474,1104,38514,60,39618,426,36170,municipality,2000
3401961920,"Raritan township, Hunterdon County, New Jersey",34019,ONJ,8056,8288,232,16380,1315,438,1138,21047,35,22185,266,18993,municipality,2010
3401962250,"Readington township, Hunterdon County, New Jersey",34019,ONJ,11352,11588,236,23236,810,236,648,30958,44,31606,254,29614,municipality,2000
3401962250,"Readington township, Hunterdon County, New Jersey",34019,ONJ,5971,6191,220,12076,578,205,633,15493,25,16126,155,14530,municipality,2010
3401970980,"Stockton borough, Hunterdon County, New Jersey",34019,ONJ,492,516,24,882,10,0,6,1114,0,1120,2,1102,municipality,2000
3401970980,"Stockton borough, Hunterdon County, New Jersey",34019,ONJ,237,259,22,433,5,0,3,535,0,538,3,527,municipality,2010
3401972510,"Tewksbury township, Hunterdon County, New Jersey",34019,ONJ,3972,4104,132,8182,204,54,170,10912,18,11082,46,10590,municipality,2000
3401972510,"Tewksbury township, Hunterdon County, New Jersey",34019,ONJ,2189,2323,134,4476,175,48,209,5784,13,5993,65,5483,municipality,2010
3401974420,"Union township, Hunterdon County, New Jersey",34019,ONJ,3332,3450,118,9960,194,1582,632,11688,28,12320,118,9766,municipality,2000
3401974420,"Union township, Hunterdon County, New Jersey",34019,ONJ,1752,1830,78,4822,244,502,359,5549,18,5908,79,4706,municipality,2010
3401978230,"West Amwell township, Hunterdon County, New Jersey",34019,ONJ,1898,1968,70,3758,32,30,34,4732,4,4766,22,4644,municipality,2000
3401978230,"West Amwell township, Hunterdon County, New Jersey",34019,ONJ,1102,1157,55,3207,55,497,186,3654,5,3840,40,3057,municipality,2010
3402119780,"East Windsor township, Mercer County, New Jersey",34021,ONJ,18896,19760,864,37870,4730,4244,7118,42720,204,49838,676,32866,municipality,2000
3402119780,"East Windsor township, Mercer County, New Jersey",34021,ONJ,10224,10851,627,20618,4786,2220,5340,21850,110,27190,433,14301,municipality,2010
3402122185,"Ewing township, Mercer County, New Jersey",34021,ONJ,25102,25848,746,58526,1610,17414,3172,68242,204,71414,1078,47936,municipality,2000
3402122185,"Ewing township, Mercer County, New Jersey",34021,ONJ,13171,13926,755,29946,1520,9586,2727,33063,142,35790,627,21188,municipality,2010
3402129310,"Hamilton township, Mercer County, New Jersey",34021,ONJ,67046,69070,2024,133818,4452,13814,8942,165276,424,174218,2350,144236,municipality,2000
3402129310,"Hamilton township, Mercer County, New Jersey",34021,ONJ,34534,36170,1636,69740,2890,10042,9613,78851,245,88464,1144,64530,municipality,2010
3402131620,"Hightstown borough, Mercer County, New Jersey",34021,ONJ,4002,4162,160,8084,238,846,2092,8340,50,10432,172,7034,municipality,2000
3402131620,"Hightstown borough, Mercer County, New Jersey",34021,ONJ,1976,2108,132,4181,218,413,1664,3830,22,5494,89,3088,municipality,2010
3402133150,"Hopewell borough, Mercer County, New Jersey",34021,ONJ,1626,1672,46,3006,40,44,94,3976,26,4070,26,3840,municipality,2000
3402133150,"Hopewell borough, Mercer County, New Jersey",34021,ONJ,778,817,39,1460,13,29,71,1851,7,1922,16,1786,municipality,2010
3402133180,"Hopewell township, Mercer County, New Jersey",34021,ONJ,10996,11258,262,23666,1278,1810,790,31420,96,32210,280,27956,municipality,2000
3402133180,"Hopewell township, Mercer County, New Jersey",34021,ONJ,6282,6551,269,12728,1532,354,573,16731,33,17304,261,14551,municipality,2010
3402139510,"Lawrence township, Mercer County, New Jersey",34021,ONJ,21594,22360,766,45672,4594,5338,2688,55630,286,58318,762,44650,municipality,2000
3402139510,"Lawrence township, Mercer County, New Jersey",34021,ONJ,12524,13239,715,26780,4711,3493,2503,30969,136,33472,626,22003,municipality,2010
3402157600,"Pennington borough, Mercer County, New Jersey",34021,ONJ,2026,2080,54,3844,54,142,64,5328,10,5392,30,5092,municipality,2000
3402157600,"Pennington borough, Mercer County, New Jersey",34021,ONJ,1031,1083,52,1903,46,45,37,2548,2,2585,23,2432,municipality,2010
3402160900,"Princeton borough, Mercer County, New Jersey",34021,ONJ,18740,19438,698,49790,5308,3438,3712,56748,276,60460,1254,46472,municipality,2000
3402160900,"Princeton borough, Mercer County, New Jersey",34021,ONJ,9521,10302,781,23377,3955,1547,2392,26180,127,28572,757,19794,municipality,2010
3402163850,"Robbinsville township, Mercer County, New Jersey",34021,ONJ,8148,8326,178,15180,880,586,558,19992,60,20550,192,18274,municipality,2000
3402163850,"Robbinsville township, Mercer County, New Jersey",34021,ONJ,5087,5277,190,9722,1728,407,564,13078,38,13642,197,10708,municipality,2010
3402174000,"Trenton city, Mercer County, New Jersey",34021,ONJ,58874,67686,8812,123514,1368,86994,36782,134024,712,170806,2906,42044,municipality,2000
3402174000,"Trenton city, Mercer County, New Jersey",34021,ONJ,28578,33035,4457,63635,923,42286,28621,56292,355,84913,1286,11442,municipality,2010
3402180240,"West Windsor township, Mercer County, New Jersey",34021,ONJ,14564,14900,336,29878,9948,1174,1784,42030,110,43814,630,30168,municipality,2000
3402180240,"West Windsor township, Mercer County, New Jersey",34021,ONJ,9449,9810,361,19441,10223,956,1213,25952,94,27165,593,14086,municipality,2010
3402310750,"Carteret borough, Middlesex County, New Jersey",34023,INJ,14078,14640,562,30962,3410,3712,9678,31740,172,41418,736,23710,municipality,2000
3402310750,"Carteret borough, Middlesex County, New Jersey",34023,INJ,7591,8148,557,17053,4308,3056,7066,15778,165,22844,437,7812,municipality,2010
3402315550,"Cranbury township, Middlesex County, New Jersey",34023,INJ,2182,2242,60,4490,478,144,110,6344,6,6454,74,5642,municipality,2000
3402315550,"Cranbury township, Middlesex County, New Jersey",34023,INJ,1320,1371,51,2806,530,130,99,3758,7,3857,60,3031,municipality,2010
3402318490,"Dunellen borough, Middlesex County, New Jersey",34023,INJ,4902,5040,138,10248,484,482,2020,11626,46,13646,160,10454,municipality,2000
3402318490,"Dunellen borough, Middlesex County, New Jersey",34023,INJ,2566,2683,117,5512,323,549,1933,5294,28,7227,103,4291,municipality,2010
3402319000,"East Brunswick township, Middlesex County, New Jersey",34023,INJ,32744,33280,536,69176,15168,2564,3914,89598,194,93512,1664,70008,municipality,2000
3402319000,"East Brunswick township, Middlesex County, New Jersey",34023,INJ,16810,17367,557,36051,10812,1741,3184,44328,166,47512,722,30887,municipality,2010
3402320230,"Edison township, Middlesex County, New Jersey",34023,INJ,70272,72036,1764,150730,57082,12916,12452,182922,758,195374,3244,108922,municipality,2000
3402320230,"Edison township, Middlesex County, New Jersey",34023,INJ,34972,36302,1330,77308,43092,6631,8112,91855,419,99967,2136,39577,municipality,2010
3402330840,"Helmetta borough, Middlesex County, New Jersey",34023,INJ,1492,1538,46,2844,88,80,194,3456,4,3650,22,3262,municipality,2000
3402330840,"Helmetta borough, Middlesex County, New Jersey",34023,INJ,891,920,29,1725,102,72,164,2014,5,2178,25,1810,municipality,2010
3402331470,"Highland Park borough, Middlesex County, New Jersey",34023,INJ,11798,12142,344,21910,3806,2134,2290,25708,178,27998,556,19034,municipality,2000
3402331470,"Highland Park borough, Middlesex County, New Jersey",34023,INJ,5875,6203,328,11025,2494,1018,1252,12730,50,13982,282,8886,municipality,2010
3402334890,"Jamesburg borough, Middlesex County, New Jersey",34023,INJ,4352,4480,128,9082,266,1030,1212,10838,60,12050,154,9328,municipality,2000
3402334890,"Jamesburg borough, Middlesex County, New Jersey",34023,INJ,2172,2267,95,4418,264,488,1324,4591,39,5915,83,3717,municipality,2010
3402345690,"Metuchen borough, Middlesex County, New Jersey",34023,INJ,9984,10208,224,19698,1844,1336,1016,24664,106,25680,412,20966,municipality,2000
3402345690,"Metuchen borough, Middlesex County, New Jersey",34023,INJ,5243,5440,197,10292,1744,617,935,12639,48,13574,278,9952,municipality,2010
3402345900,"Middlesex borough, Middlesex County, New Jersey",34023,INJ,10096,10260,164,20822,1124,880,2470,24964,62,27434,300,22598,municipality,2000
3402345900,"Middlesex borough, Middlesex County, New Jersey",34023,INJ,4984,5148,164,10568,804,645,2246,11389,37,13635,155,9748,municipality,2010
3402346620,"Milltown borough, Middlesex County, New Jersey",34023,INJ,5254,5340,86,10798,430,90,522,13478,26,14000,118,12814,municipality,2000
3402346620,"Milltown borough, Middlesex County, New Jersey",34023,INJ,2599,2698,99,5391,227,77,445,6448,13,6893,57,6074,municipality,2010
3402347280,"Monroe township, Middlesex County, New Jersey",34023,INJ,25072,26518,1446,47042,1296,1584,1332,54666,140,55998,260,51386,municipality,2000
3402347280,"Monroe township, Middlesex County, New Jersey",34023,INJ,16497,18002,1505,31755,4911,1486,1673,37459,84,39132,402,30576,municipality,2010
3402351210,"New Brunswick city, Middlesex County, New Jersey",34023,INJ,26114,27786,1672,77648,5088,20086,37894,59252,552,97146,1598,31928,municipality,2000
3402351210,"New Brunswick city, Middlesex County, New Jersey",34023,INJ,14119,15053,934,43560,4122,7743,27553,27628,299,55181,703,14761,municipality,2010
3402352560,"North Brunswick township, Middlesex County, New Jersey",34023,INJ,27270,27864,594,55868,10284,10740,7550,65024,346,72574,1542,42112,municipality,2000
3402352560,"North Brunswick township, Middlesex County, New Jersey",34023,INJ,14551,15045,494,31196,9865,6625,7223,33519,257,40742,826,15946,municipality,2010
3402354705,"Old Bridge township, Middlesex County, New Jersey",34023,INJ,42876,43792,916,89644,13040,6104,9156,111756,404,120912,2152,90056,municipality,2000
3402354705,"Old Bridge township, Middlesex County, New Jersey",34023,INJ,23777,24638,861,50479,9319,3770,7064,58311,321,65375,1119,43782,municipality,2010
3402358200,"Perth Amboy city, Middlesex County, New Jersey",34023,INJ,29124,30472,1348,67662,1338,7580,66066,28540,532,94606,1252,17838,municipality,2000
3402358200,"Perth Amboy city, Middlesex County, New Jersey",34023,INJ,15419,16556,1137,36945,806,3742,39685,11129,191,50814,286,6104,municipality,2010
3402359010,"Piscataway township, Middlesex County, New Jersey",34023,INJ,33000,33892,892,78860,24944,19970,8004,92960,524,100964,2158,45364,municipality,2000
3402359010,"Piscataway township, Middlesex County, New Jersey",34023,INJ,17050,17777,727,44775,18654,11053,6289,49755,333,56044,1444,18271,municipality,2010
3402359280,"Plainsboro township, Middlesex County, New Jersey",34023,INJ,17484,18266,782,30478,12286,2980,1874,38556,158,40430,708,22424,municipality,2000
3402359280,"Plainsboro township, Middlesex County, New Jersey",34023,INJ,9402,10089,687,17322,10608,1749,1429,21570,112,22999,486,8615,municipality,2010
3402365790,"Sayreville borough, Middlesex County, New Jersey",34023,INJ,29910,30470,560,61726,8494,6668,5884,74870,236,80754,1336,58136,municipality,2000
3402365790,"Sayreville borough, Middlesex County, New Jersey",34023,INJ,15636,16393,757,33054,6841,4287,5258,37446,291,42704,677,25350,municipality,2010
3402368550,"South Amboy city, Middlesex County, New Jersey",34023,INJ,5934,6220,286,11980,216,114,1068,14758,42,15826,144,14242,municipality,2000
3402368550,"South Amboy city, Middlesex County, New Jersey",34023,INJ,3372,3576,204,6834,345,347,1158,7473,19,8631,124,6638,municipality,2010
3402368790,"South Brunswick township, Middlesex County, New Jersey",34023,INJ,26856,27724,868,54010,13598,5772,3836,71632,238,75468,1240,50784,municipality,2000
3402368790,"South Brunswick township, Middlesex County, New Jersey",34023,INJ,15069,15708,639,31383,15571,3172,2624,40793,161,43417,911,20978,municipality,2010
3402369390,"South Plainfield borough, Middlesex County, New Jersey",34023,INJ,14302,14614,312,32650,3264,3596,3776,39844,408,43620,772,31804,municipality,2000
3402369390,"South Plainfield borough, Middlesex County, New Jersey",34023,INJ,7876,8093,217,18011,3422,2266,3097,20288,252,23385,498,13850,municipality,2010
3402369420,"South River borough, Middlesex County, New Jersey",34023,INJ,11212,11538,326,23586,1074,1784,2960,27684,166,30644,670,23990,municipality,2000
3402369420,"South River borough, Middlesex County, New Jersey",34023,INJ,5652,5957,305,12393,758,1028,2913,13095,248,16008,324,10737,municipality,2010
3402369810,"Spotswood borough, Middlesex County, New Jersey",34023,INJ,6198,6316,118,12234,460,216,690,15070,20,15760,100,14274,municipality,2000
3402369810,"Spotswood borough, Middlesex County, New Jersey",34023,INJ,3128,3242,114,6516,419,227,687,7570,18,8257,106,6800,municipality,2010
3402382000,"Woodbridge township, Middlesex County, New Jersey",34023,INJ,69124,70596,1472,150920,28014,16308,17912,176494,736,194406,3438,127998,municipality,2000
3402382000,"Woodbridge township, Middlesex County, New Jersey",34023,INJ,34615,36124,1509,78029,22193,9038,15562,84023,506,99585,1755,50531,municipality,2010
3402500000,"County subdivisions not defined, Monmouth County, New Jersey",34025,ONJ,0,0,0,0,0,0,0,0,0,0,0,0,municipality,2000
3402500000,"County subdivisions not defined, Monmouth County, New Jersey",34025,ONJ,0,0,0,0,0,0,0,0,0,0,0,0,municipality,2010
3402500070,"Aberdeen township, Monmouth County, New Jersey",34025,ONJ,12842,13116,274,26370,1906,4080,2450,32458,108,34908,478,25886,municipality,2000
3402500070,"Aberdeen township, Monmouth County, New Jersey",34025,ONJ,6876,7102,226,14003,1162,2041,1900,16310,80,18210,270,12757,municipality,2010
3402500730,"Allenhurst borough, Monmouth County, New Jersey",34025,ONJ,570,740,170,1164,6,12,36,1400,4,1436,8,1370,municipality,2000
3402500730,"Allenhurst borough, Monmouth County, New Jersey",34025,ONJ,217,365,148,420,5,5,22,474,0,496,3,461,municipality,2010
3402500760,"Allentown borough, Monmouth County, New Jersey",34025,ONJ,1416,1436,20,2758,24,240,72,3692,30,3764,36,3362,municipality,2000
3402500760,"Allentown borough, Monmouth County, New Jersey",34025,ONJ,704,735,31,1375,27,76,65,1763,2,1828,29,1629,municipality,2010
3402501960,"Asbury Park city, Monmouth County, New Jersey",34025,ONJ,13508,15488,1980,23682,236,20472,5274,28586,166,33860,1418,6294,municipality,2000
3402501960,"Asbury Park city, Monmouth County, New Jersey",34025,ONJ,6725,8076,1351,12288,72,7955,4115,12001,110,16116,353,3511,municipality,2010
3402502110,"Atlantic Highlands borough, Monmouth County, New Jersey",34025,ONJ,3938,4112,174,7400,114,210,330,9080,8,9410,84,8664,municipality,2000
3402502110,"Atlantic Highlands borough, Monmouth County, New Jersey",34025,ONJ,1870,2002,132,3526,91,62,225,4160,11,4385,59,3937,municipality,2010
3402502440,"Avon-by-the-Sea borough, Monmouth County, New Jersey",34025,ONJ,2086,2774,688,3662,40,16,108,4380,10,4488,16,4298,municipality,2000
3402502440,"Avon-by-the-Sea borough, Monmouth County, New Jersey",34025,ONJ,901,1321,420,1582,12,6,71,1830,2,1901,16,1794,municipality,2010
3402504930,"Belmar borough, Monmouth County, New Jersey",34025,ONJ,5892,7992,2100,10014,122,400,828,11262,36,12090,156,10548,municipality,2000
3402504930,"Belmar borough, Monmouth County, New Jersey",34025,ONJ,2695,3931,1236,4820,52,184,971,4823,11,5794,56,4520,municipality,2010
3402506970,"Bradley Beach borough, Monmouth County, New Jersey",34025,ONJ,4594,6264,1670,7862,138,334,1230,8356,36,9586,146,7702,municipality,2000
3402506970,"Bradley Beach borough, Monmouth County, New Jersey",34025,ONJ,2098,3180,1082,3663,78,189,840,3458,16,4298,61,3114,municipality,2010
3402507750,"Brielle borough, Monmouth County, New Jersey",34025,ONJ,3876,4246,370,7466,66,340,324,9462,16,9786,92,8948,municipality,2000
3402507750,"Brielle borough, Monmouth County, New Jersey",34025,ONJ,1805,2034,229,3526,43,121,152,4622,8,4774,54,4396,municipality,2010
3402514560,"Colts Neck township, Monmouth County, New Jersey",34025,ONJ,7026,7228,202,17462,890,1832,1040,23622,82,24662,240,20578,municipality,2000
3402514560,"Colts Neck township, Monmouth County, New Jersey",34025,ONJ,3277,3735,458,7255,463,163,359,9783,8,10142,107,9042,municipality,2010
3402516660,"Deal borough, Monmouth County, New Jersey",34025,ONJ,868,1906,1038,1702,6,24,108,2032,14,2140,18,1970,municipality,2000
3402516660,"Deal borough, Monmouth County, New Jersey",34025,ONJ,333,926,593,643,26,11,55,695,2,750,7,649,municipality,2010
3402519840,"Eatontown borough, Monmouth County, New Jersey",34025,ONJ,11560,12682,1122,21592,2602,3144,1856,26160,162,28016,640,19612,municipality,2000
3402519840,"Eatontown borough, Monmouth County, New Jersey",34025,ONJ,5319,5723,404,10072,1097,1475,1571,11138,110,12709,327,8129,municipality,2010
3402521570,"Englishtown borough, Monmouth County, New Jersey",34025,ONJ,1286,1360,74,2502,154,134,220,3308,6,3528,28,2986,municipality,2000
3402521570,"Englishtown borough, Monmouth County, New Jersey",34025,ONJ,621,647,26,1376,121,43,148,1699,2,1847,20,1513,municipality,2010
3402522440,"Fair Haven borough, Monmouth County, New Jersey",34025,ONJ,3996,4074,78,7952,112,480,158,11716,12,11874,90,11022,municipality,2000
3402522440,"Fair Haven borough, Monmouth County, New Jersey",34025,ONJ,1970,2065,95,4017,66,151,165,5956,11,6121,67,5661,municipality,2010
3402522950,"Farmingdale borough, Monmouth County, New Jersey",34025,ONJ,1250,1276,26,2318,74,36,122,3052,2,3174,24,2916,municipality,2000
3402522950,"Farmingdale borough, Monmouth County, New Jersey",34025,ONJ,547,578,31,1043,42,35,92,1237,7,1329,21,1132,municipality,2010
3402525200,"Freehold borough, Monmouth County, New Jersey",34025,ONJ,7390,7642,252,16516,536,3270,6162,15790,40,21952,238,11706,municipality,2000
3402525200,"Freehold borough, Monmouth County, New Jersey",34025,ONJ,4006,4249,243,9095,342,1391,5167,6885,37,12052,158,4957,municipality,2010
3402525230,"Freehold township, Monmouth County, New Jersey",34025,ONJ,21628,22064,436,47128,3224,3100,3274,59800,130,63074,604,52742,municipality,2000
3402525230,"Freehold township, Monmouth County, New Jersey",34025,ONJ,12577,13140,563,27387,2530,1860,2808,33376,100,36184,459,28427,municipality,2010
3402530690,"Hazlet township, Monmouth County, New Jersey",34025,ONJ,14488,14812,324,31864,1438,420,2508,40248,80,42756,332,37978,municipality,2000
3402530690,"Hazlet township, Monmouth County, New Jersey",34025,ONJ,7140,7417,277,15712,675,279,1601,18733,39,20334,190,17550,municipality,2010
3402531500,"Highlands borough, Monmouth County, New Jersey",34025,ONJ,4900,5640,740,8280,100,104,414,9780,34,10194,110,9432,municipality,2000
3402531500,"Highlands borough, Monmouth County, New Jersey",34025,ONJ,2623,3146,523,4296,64,70,324,4681,13,5005,73,4461,municipality,2010
3402532640,"Holmdel township, Monmouth County, New Jersey",34025,ONJ,9894,10274,380,22558,5496,202,774,30788,64,31562,342,24684,municipality,2000
3402532640,"Holmdel township, Monmouth County, New Jersey",34025,ONJ,5584,5792,208,12450,3201,135,621,16152,44,16773,274,12498,municipality,2010
3402533300,"Howell township, Monmouth County, New Jersey",34025,ONJ,32126,33144,1018,67630,3470,3338,5220,92586,218,97806,1034,84526,municipality,2000
3402533300,"Howell township, Monmouth County, New Jersey",34025,ONJ,17260,17979,719,37624,2283,1767,4153,46922,142,51075,642,42088,municipality,2010
3402534200,"Interlaken borough, Monmouth County, New Jersey",34025,ONJ,772,794,22,1478,4,0,20,1780,2,1800,12,1762,municipality,2000
3402534200,"Interlaken borough, Monmouth County, New Jersey",34025,ONJ,361,393,32,701,4,0,14,806,0,820,5,797,municipality,2010
3402536480,"Keansburg borough, Monmouth County, New Jersey",34025,ONJ,7744,8538,794,15628,262,414,1706,19758,60,21464,216,18806,municipality,2000
3402536480,"Keansburg borough, Monmouth County, New Jersey",34025,ONJ,3805,4318,513,7741,169,582,1493,8612,33,10105,212,7616,municipality,2010
3402536810,"Keyport borough, Monmouth County, New Jersey",34025,ONJ,6528,6800,272,11838,324,1002,1678,13458,32,15136,234,11866,municipality,2000
3402536810,"Keyport borough, Monmouth County, New Jersey",34025,ONJ,3067,3272,205,5804,171,479,1322,5918,33,7240,93,5142,municipality,2010
3402537560,"Lake Como borough, Monmouth County, New Jersey",34025,ONJ,1648,2214,566,2826,46,268,366,3246,24,3612,56,2852,municipality,2000
3402537560,"Lake Como borough, Monmouth County, New Jersey",34025,ONJ,785,1115,330,1415,21,106,322,1437,11,1759,22,1277,municipality,2010
3402540770,"Little Silver borough, Monmouth County, New Jersey",34025,ONJ,4464,4576,112,8958,186,38,162,12178,26,12340,80,11848,municipality,2000
3402540770,"Little Silver borough, Monmouth County, New Jersey",34025,ONJ,2146,2278,132,4289,102,14,179,5771,16,5950,62,5577,municipality,2010
3402541010,"Loch Arbour village, Monmouth County, New Jersey",34025,ONJ,240,312,72,462,4,12,4,556,0,560,10,530,municipality,2000
3402541010,"Loch Arbour village, Monmouth County, New Jersey",34025,ONJ,82,159,77,156,3,3,7,187,0,194,3,178,municipality,2010
3402541310,"Long Branch city, Monmouth County, New Jersey",34025,ONJ,25188,27966,2778,47780,1008,10942,12954,49726,580,62680,1534,35662,municipality,2000
3402541310,"Long Branch city, Monmouth County, New Jersey",34025,ONJ,11753,14170,2417,24063,633,3946,8624,22095,830,30719,747,15939,municipality,2010
3402542990,"Manalapan township, Monmouth County, New Jersey",34025,ONJ,21562,22132,570,46566,3006,1282,2366,64480,136,66846,530,59526,municipality,2000
3402542990,"Manalapan township, Monmouth County, New Jersey",34025,ONJ,13263,13735,472,28853,2670,872,2202,36670,81,38872,362,32685,municipality,2010
3402543050,"Manasquan borough, Monmouth County, New Jersey",34025,ONJ,5200,7062,1862,9616,56,50,566,12054,14,12620,48,11886,municipality,2000
3402543050,"Manasquan borough, Monmouth County, New Jersey",34025,ONJ,2374,3500,1126,4521,36,14,414,5483,7,5897,21,5405,municipality,2010
3402544070,"Marlboro township, Monmouth County, New Jersey",34025,ONJ,22956,23792,836,50818,9204,1442,2102,70694,116,72796,590,59342,municipality,2000
3402544070,"Marlboro township, Monmouth County, New Jersey",34025,ONJ,13001,13436,435,28616,6921,814,1619,38572,65,40191,410,30362,municipality,2010
3402544520,"Matawan borough, Monmouth County, New Jersey",34025,ONJ,7062,7280,218,13800,1416,1106,1150,16670,58,17820,246,13844,municipality,2000
3402544520,"Matawan borough, Monmouth County, New Jersey",34025,ONJ,3358,3606,248,6819,557,576,949,7861,21,8810,183,6524,municipality,2010
3402545990,"Middletown township, Monmouth County, New Jersey",34025,ONJ,46472,47682,1210,97772,3406,1538,4530,128124,180,132654,866,122134,municipality,2000
3402545990,"Middletown township, Monmouth County, New Jersey",34025,ONJ,23962,24959,997,50288,1717,814,3569,62953,110,66522,610,59702,municipality,2010
3402546560,"Millstone township, Monmouth County, New Jersey",34025,ONJ,5416,5594,178,12056,608,538,630,17310,48,17940,122,15994,municipality,2000
3402546560,"Millstone township, Monmouth County, New Jersey",34025,ONJ,3301,3434,133,7564,472,363,579,9987,28,10566,131,8993,municipality,2010
3402547130,"Monmouth Beach borough, Monmouth County, New Jersey",34025,ONJ,3266,3938,672,5728,62,38,136,7054,2,7190,30,6922,municipality,2000
3402547130,"Monmouth Beach borough, Monmouth County, New Jersey",34025,ONJ,1494,1981,487,2619,24,11,62,3217,4,3279,29,3149,municipality,2010
3402549890,"Neptune township, Monmouth County, New Jersey",34025,ONJ,21814,24434,2620,42584,644,20620,3074,52306,196,55380,1128,29718,municipality,2000
3402549890,"Neptune township, Monmouth County, New Jersey",34025,ONJ,11201,12991,1790,22167,628,10377,2607,25328,117,27935,628,13578,municipality,2010
3402549920,"Neptune City borough, Monmouth County, New Jersey",34025,ONJ,4442,4684,242,8192,282,962,554,9882,34,10436,180,8424,municipality,2000
3402549920,"Neptune City borough, Monmouth County, New Jersey",34025,ONJ,2133,2312,179,3971,213,490,491,4378,15,4869,89,3571,municipality,2010
3402554270,"Ocean township, Monmouth County, New Jersey",34025,ONJ,20508,21512,1004,40176,3366,2932,2430,51488,242,53918,844,44104,municipality,2000
3402554270,"Ocean township, Monmouth County, New Jersey",34025,ONJ,10611,11541,930,21103,1775,2038,2453,24838,113,27291,465,20447,municipality,2010
3402554570,"Oceanport borough, Monmouth County, New Jersey",34025,ONJ,4086,4228,142,8768,92,220,240,11374,12,11614,88,10962,municipality,2000
3402554570,"Oceanport borough, Monmouth County, New Jersey",34025,ONJ,2227,2390,163,4470,88,161,236,5596,13,5832,58,5276,municipality,2010
3402562430,"Red Bank borough, Monmouth County, New Jersey",34025,ONJ,10402,10900,498,19540,518,4574,4054,19634,64,23688,352,14126,municipality,2000
3402562430,"Red Bank borough, Monmouth County, New Jersey",34025,ONJ,4929,5381,452,9719,223,1408,4198,8008,68,12206,162,6147,municipality,2010
3402564410,"Roosevelt borough, Monmouth County, New Jersey",34025,ONJ,674,702,28,1348,38,46,84,1782,24,1866,64,1610,municipality,2000
3402564410,"Roosevelt borough, Monmouth County, New Jersey",34025,ONJ,314,327,13,673,28,8,52,830,7,882,11,776,municipality,2010
3402565130,"Rumson borough, Monmouth County, New Jersey",34025,ONJ,4904,5220,316,9724,152,34,198,14076,8,14274,64,13818,municipality,2000
3402565130,"Rumson borough, Monmouth County, New Jersey",34025,ONJ,2344,2585,241,4806,88,18,173,6949,8,7122,64,6771,municipality,2010
3402566240,"Sea Bright borough, Monmouth County, New Jersey",34025,ONJ,2006,2404,398,3230,82,62,164,3472,4,3636,22,3302,municipality,2000
3402566240,"Sea Bright borough, Monmouth County, New Jersey",34025,ONJ,792,1211,419,1252,32,11,78,1334,4,1412,8,1279,municipality,2010
3402566330,"Sea Girt borough, Monmouth County, New Jersey",34025,ONJ,1884,2570,686,3432,4,4,60,4236,0,4296,14,4214,municipality,2000
3402566330,"Sea Girt borough, Monmouth County, New Jersey",34025,ONJ,823,1291,468,1477,4,0,30,1798,3,1828,5,1786,municipality,2010
3402567350,"Shrewsbury borough, Monmouth County, New Jersey",34025,ONJ,2414,2446,32,4970,118,22,138,7042,8,7180,56,6838,municipality,2000
3402567350,"Shrewsbury borough, Monmouth County, New Jersey",34025,ONJ,1261,1310,49,2782,79,24,95,3714,13,3809,25,3573,municipality,2010
3402567365,"Shrewsbury township, Monmouth County, New Jersey",34025,ONJ,1042,1092,50,1744,218,352,146,2050,8,2196,78,1394,municipality,2000
3402567365,"Shrewsbury township, Monmouth County, New Jersey",34025,ONJ,583,648,65,927,75,147,161,980,3,1141,28,727,municipality,2010
3402570110,"Spring Lake borough, Monmouth County, New Jersey",34025,ONJ,2926,3860,934,5580,20,24,52,7082,4,7134,30,7004,municipality,2000
3402570110,"Spring Lake borough, Monmouth County, New Jersey",34025,ONJ,1253,2048,795,2347,30,8,57,2936,9,2993,14,2875,municipality,2010
3402570140,"Spring Lake Heights borough, Monmouth County, New Jersey",34025,ONJ,5022,5900,878,8694,38,114,222,10232,24,10454,30,10026,municipality,2000
3402570140,"Spring Lake Heights borough, Monmouth County, New Jersey",34025,ONJ,2316,2972,656,3933,51,25,155,4558,8,4713,27,4447,municipality,2010
3402573020,"Tinton Falls borough, Monmouth County, New Jersey",34025,ONJ,11766,12422,656,22430,1480,3832,1414,28692,96,30106,492,22792,municipality,2000
3402573020,"Tinton Falls borough, Monmouth County, New Jersey",34025,ONJ,8355,8766,411,14498,829,1610,1118,16774,26,17892,306,14003,municipality,2010
3402574540,"Union Beach borough, Monmouth County, New Jersey",34025,ONJ,4286,4458,172,9426,160,104,1076,12222,32,13298,184,11742,municipality,2000
3402574540,"Union Beach borough, Monmouth County, New Jersey",34025,ONJ,2143,2269,126,4746,108,85,686,5559,29,6245,110,5227,municipality,2010
3402574900,"Upper Freehold township, Monmouth County, New Jersey",34025,ONJ,2874,3002,128,6182,120,90,302,8262,34,8564,126,7892,municipality,2000
3402574900,"Upper Freehold township, Monmouth County, New Jersey",34025,ONJ,2363,2458,95,5066,300,134,254,6648,18,6902,80,6116,municipality,2010
3402576460,"Wall township, Monmouth County, New Jersey",34025,ONJ,18874,19914,1040,37774,636,298,782,49740,90,50522,264,48452,municipality,2000
3402576460,"Wall township, Monmouth County, New Jersey",34025,ONJ,10051,10883,832,20009,420,611,908,25256,49,26164,251,23925,municipality,2010
3402579310,"West Long Branch borough, Monmouth County, New Jersey",34025,ONJ,4896,5070,174,12916,200,342,482,16034,40,16516,264,15188,municipality,2000
3402579310,"West Long Branch borough, Monmouth County, New Jersey",34025,ONJ,2384,2528,144,6513,95,163,407,7690,21,8097,72,7339,municipality,2010
3402706610,"Boonton town, Morris County, New Jersey",34027,INJ,6544,6704,160,13266,1310,642,1164,15828,76,16992,414,13386,municipality,2000
3402706610,"Boonton town, Morris County, New Jersey",34027,INJ,3235,3398,163,6576,838,363,920,7427,47,8347,211,5968,municipality,2010
3402706640,"Boonton township, Morris County, New Jersey",34027,INJ,2952,3020,68,6442,350,102,184,8390,18,8574,78,7842,municipality,2000
3402706640,"Boonton township, Morris County, New Jersey",34027,INJ,1575,1647,72,3208,170,63,178,4085,3,4263,51,3798,municipality,2010
3402709040,"Butler borough, Morris County, New Jersey",34027,INJ,5736,5846,110,11626,274,84,758,14082,30,14840,110,13584,municipality,2000
3402709040,"Butler borough, Morris County, New Jersey",34027,INJ,3031,3169,138,5975,228,78,860,6679,19,7539,88,6266,municipality,2010
3402712100,"Chatham borough, Morris County, New Jersey",34027,INJ,6318,6464,146,12136,476,22,446,16474,32,16920,106,15838,municipality,2000
3402712100,"Chatham borough, Morris County, New Jersey",34027,INJ,3073,3210,137,5962,433,85,457,8505,31,8962,131,7825,municipality,2010
3402712130,"Chatham township, Morris County, New Jersey",34027,INJ,7840,8038,198,14784,966,82,394,19778,20,20172,146,18564,municipality,2000
3402712130,"Chatham township, Morris County, New Jersey",34027,INJ,3915,4128,213,7431,657,69,349,10103,20,10452,160,9197,municipality,2010
3402712580,"Chester borough, Morris County, New Jersey",34027,INJ,1218,1254,36,2458,56,10,224,3046,6,3270,20,2954,municipality,2000
3402712580,"Chester borough, Morris County, New Jersey",34027,INJ,615,647,32,1196,38,13,222,1427,5,1649,27,1344,municipality,2010
3402712610,"Chester township, Morris County, New Jersey",34027,INJ,4646,4754,108,10128,342,144,376,14188,14,14564,130,13558,municipality,2000
3402712610,"Chester township, Morris County, New Jersey",34027,INJ,2592,2697,105,5490,268,77,341,7497,12,7838,106,7034,municipality,2010
3402717650,"Denville township, Morris County, New Jersey",34027,INJ,11980,12356,376,24094,1468,338,836,30812,68,31648,284,28654,municipality,2000
3402717650,"Denville township, Morris County, New Jersey",34027,INJ,6432,6734,302,12687,1081,220,883,15752,31,16635,234,14186,municipality,2010
3402718070,"Dover town, Morris County, New Jersey",34027,INJ,10872,11136,264,27952,892,2070,21078,15298,76,36376,386,11874,municipality,2000
3402718070,"Dover town, Morris County, New Jersey",34027,INJ,5562,5783,221,14240,447,845,12598,5559,51,18157,145,4071,municipality,2010
3402719210,"East Hanover township, Morris County, New Jersey",34027,INJ,7686,7790,104,17656,2514,128,624,22162,6,22786,178,19336,municipality,2000
3402719210,"East Hanover township, Morris County, New Jersey",34027,INJ,3893,3976,83,8756,1322,90,600,10557,19,11157,84,9042,municipality,2010
3402723910,"Florham Park borough, Morris County, New Jersey",34027,INJ,6478,6684,206,13870,686,176,380,17334,16,17714,92,16364,municipality,2000
3402723910,"Florham Park borough, Morris County, New Jersey",34027,INJ,4003,4201,198,9451,743,488,594,11102,38,11696,169,9664,municipality,2010
3402729550,"Hanover township, Morris County, New Jersey",34027,INJ,9490,9636,146,19912,2246,254,904,24892,30,25796,136,22226,municipality,2000
3402729550,"Hanover township, Morris County, New Jersey",34027,INJ,5308,5526,218,10672,1480,134,630,13082,26,13712,145,11297,municipality,2010
3402729700,"Harding township, Morris County, New Jersey",34027,INJ,2360,2486,126,4758,68,26,114,6246,14,6360,62,6076,municipality,2000
3402729700,"Harding township, Morris County, New Jersey",34027,INJ,1474,1610,136,2917,102,35,134,3704,8,3838,56,3503,municipality,2010
3402734980,"Jefferson township, Morris County, New Jersey",34027,INJ,14262,15054,792,28814,418,306,1344,38090,106,39434,372,36888,municipality,2000
3402734980,"Jefferson township, Morris County, New Jersey",34027,INJ,7830,8597,767,16063,977,305,1382,19932,42,21314,235,18373,municipality,2010
3402737110,"Kinnelon borough, Morris County, New Jersey",34027,INJ,6124,6246,122,13112,526,88,436,18294,32,18730,98,17550,municipality,2000
3402737110,"Kinnelon borough, Morris County, New Jersey",34027,INJ,3472,3600,128,7463,433,86,418,9830,16,10248,91,9204,municipality,2010
3402740290,"Lincoln Park borough, Morris County, New Jersey",34027,INJ,8052,8220,168,17432,1150,354,1266,20594,36,21860,258,18796,municipality,2000
3402740290,"Lincoln Park borough, Morris County, New Jersey",34027,INJ,4001,4145,144,8560,775,165,1009,9512,30,10521,143,8399,municipality,2010
3402741362,"Long Hill township, Morris County, New Jersey",34027,INJ,6278,6412,134,12940,840,62,606,16948,28,17554,186,15832,municipality,2000
3402741362,"Long Hill township, Morris County, New Jersey",34027,INJ,3105,3226,121,6472,520,48,614,8088,19,8702,116,7385,municipality,2010
3402742510,"Madison borough, Morris County, New Jersey",34027,INJ,11040,11282,242,26252,1232,962,1974,31086,160,33060,388,28344,municipality,2000
3402742510,"Madison borough, Morris County, New Jersey",34027,INJ,5485,5775,290,12088,869,441,1406,14439,28,15845,261,12840,municipality,2010
3402745330,"Mendham borough, Morris County, New Jersey",34027,INJ,3562,3656,94,7460,144,44,250,9944,10,10194,54,9692,municipality,2000
3402745330,"Mendham borough, Morris County, New Jersey",34027,INJ,1722,1798,76,3567,101,51,135,4846,12,4981,41,4641,municipality,2010
3402745360,"Mendham township, Morris County, New Jersey",34027,INJ,3576,3698,122,7348,218,96,164,10636,18,10800,74,10230,municipality,2000
3402745360,"Mendham township, Morris County, New Jersey",34027,INJ,1952,2062,110,4094,199,76,211,5658,8,5869,75,5300,municipality,2010
3402746860,"Mine Hill township, Morris County, New Jersey",34027,INJ,2730,2776,46,5556,178,236,638,6720,14,7358,90,6202,municipality,2000
3402746860,"Mine Hill township, Morris County, New Jersey",34027,INJ,1329,1380,51,2826,177,148,840,2811,12,3651,61,2413,municipality,2010
3402747670,"Montville township, Morris County, New Jersey",34027,INJ,14760,15082,322,31194,5224,376,1062,40616,64,41678,404,34548,municipality,2000
3402747670,"Montville township, Morris County, New Jersey",34027,INJ,7485,7823,338,15987,3885,252,900,20628,45,21528,312,16134,municipality,2010
3402748090,"Morris township, Morris County, New Jersey",34027,INJ,16232,16596,364,33692,1694,2308,1660,41932,84,43592,362,37484,municipality,2000
3402748090,"Morris township, Morris County, New Jersey",34027,INJ,8128,8502,374,17270,1136,1216,1683,20623,65,22306,313,17893,municipality,2010
3402748210,"Morris Plains borough, Morris County, New Jersey",34027,INJ,3910,3988,78,8006,450,140,282,10190,32,10472,74,9494,municipality,2000
3402748210,"Morris Plains borough, Morris County, New Jersey",34027,INJ,2131,2197,66,4158,275,135,314,5218,3,5532,74,4731,municipality,2010
3402748300,"Morristown town, Morris County, New Jersey",34027,INJ,14504,15230,726,30280,1388,6132,10068,27020,146,37088,550,18804,municipality,2000
3402748300,"Morristown town, Morris County, New Jersey",34027,INJ,7417,8172,755,15178,794,2479,6277,12134,56,18411,244,8561,municipality,2010
3402748480,"Mountain Lakes borough, Morris County, New Jersey",34027,INJ,2660,2714,54,5476,438,30,144,8368,24,8512,60,7816,municipality,2000
3402748480,"Mountain Lakes borough, Morris County, New Jersey",34027,INJ,1313,1363,50,2709,318,15,106,4054,5,4160,78,3638,municipality,2010
3402748690,"Mount Arlington borough, Morris County, New Jersey",34027,INJ,3836,4078,242,7268,346,168,424,8902,28,9326,118,8242,municipality,2000
3402748690,"Mount Arlington borough, Morris County, New Jersey",34027,INJ,2283,2545,262,4145,179,115,415,4635,6,5050,68,4267,municipality,2010
3402749080,"Mount Olive township, Morris County, New Jersey",34027,INJ,18136,18622,486,35050,2892,1790,2890,45496,172,48386,664,39978,municipality,2000
3402749080,"Mount Olive township, Morris County, New Jersey",34027,INJ,10690,11244,554,20727,2297,1514,3237,24880,116,28117,431,20522,municipality,2010
3402750130,"Netcong borough, Morris County, New Jersey",34027,INJ,2016,2086,70,3974,86,62,368,4792,8,5160,56,4580,municipality,2000
3402750130,"Netcong borough, Morris County, New Jersey",34027,INJ,1381,1449,68,2626,89,119,572,2660,4,3232,38,2410,municipality,2010
3402756460,"Parsippany-Troy Hills township, Morris County, New Jersey",34027,INJ,39248,40132,884,80068,18248,3020,7070,94228,362,101298,2032,70566,municipality,2000
3402756460,"Parsippany-Troy Hills township, Morris County, New Jersey",34027,INJ,20279,21274,995,42160,15443,1741,4430,48808,189,53238,1221,30214,municipality,2010
3402758110,"Pequannock township, Morris County, New Jersey",34027,INJ,10052,10194,142,20586,530,78,816,26960,36,27776,118,26198,municipality,2000
3402758110,"Pequannock township, Morris County, New Jersey",34027,INJ,6471,6794,323,12200,291,72,703,14837,26,15540,106,14342,municipality,2010
3402761890,"Randolph township, Morris County, New Jersey",34027,INJ,17358,17806,448,34938,4530,1110,2416,47278,158,49694,566,40914,municipality,2000
3402761890,"Randolph township, Morris County, New Jersey",34027,INJ,9013,9343,330,18527,2674,638,2616,23118,65,25734,365,19376,municipality,2010
3402763300,"Riverdale borough, Morris County, New Jersey",34027,INJ,1838,1880,42,3822,136,54,220,4776,28,4996,28,4530,municipality,2000
3402763300,"Riverdale borough, Morris County, New Jersey",34027,INJ,1547,1657,110,2890,187,42,256,3303,7,3559,53,3014,municipality,2010
3402764050,"Rockaway borough, Morris County, New Jersey",34027,INJ,4890,4982,92,9936,822,168,1216,11730,28,12946,86,10626,municipality,2000
3402764050,"Rockaway borough, Morris County, New Jersey",34027,INJ,2443,2521,78,5016,491,192,970,5468,15,6438,67,4703,municipality,2010
3402764080,"Rockaway township, Morris County, New Jersey",34027,INJ,16216,17012,796,33430,2574,1076,2880,42980,98,45860,446,38786,municipality,2000
3402764080,"Rockaway township, Morris County, New Jersey",34027,INJ,8983,9587,604,18417,1605,552,2705,21451,58,24156,317,18919,municipality,2010
3402764980,"Roxbury township, Morris County, New Jersey",34027,INJ,16728,17100,372,34876,1694,864,2308,45458,112,47766,366,42422,municipality,2000
3402764980,"Roxbury township, Morris County, New Jersey",34027,INJ,8292,8582,290,17579,1330,496,2083,21241,38,23324,336,19041,municipality,2010
3402775890,"Victory Gardens borough, Morris County, New Jersey",34027,INJ,1128,1176,48,2274,168,636,1566,1526,6,3092,56,660,municipality,2000
3402775890,"Victory Gardens borough, Morris County, New Jersey",34027,INJ,533,566,33,1118,35,210,957,563,8,1520,22,288,municipality,2010
3402777240,"Washington township, Morris County, New Jersey",34027,INJ,11510,11780,270,24562,650,286,778,34406,62,35184,188,33220,municipality,2000
3402777240,"Washington township, Morris County, New Jersey",34027,INJ,6237,6488,251,13218,607,239,847,17686,28,18533,222,16590,municipality,2010
3402780390,"Wharton borough, Morris County, New Jersey",34027,INJ,4656,4788,132,9320,396,488,2924,9672,88,12596,194,8506,municipality,2000
3402780390,"Wharton borough, Morris County, New Jersey",34027,INJ,2304,2426,122,4962,368,227,2630,3892,34,6522,105,3158,municipality,2010
3402900000,"County subdivisions not defined, Ocean County, New Jersey",34029,ONJ,0,0,0,0,0,0,0,0,0,0,0,0,municipality,2000
3402900000,"County subdivisions not defined, Ocean County, New Jersey",34029,ONJ,0,0,0,0,0,0,0,0,0,0,0,0,municipality,2010
3402903050,"Barnegat township, Ocean County, New Jersey",34029,ONJ,10986,12132,1146,22274,304,640,1180,29360,30,30540,286,28100,municipality,2000
3402903050,"Barnegat township, Ocean County, New Jersey",34029,ONJ,8128,9085,957,16552,360,607,1420,19516,40,20936,294,18215,municipality,2010
3402903130,"Barnegat Light borough, Ocean County, New Jersey",34029,ONJ,742,2414,1672,1308,4,6,12,1516,4,1528,4,1498,municipality,2000
3402903130,"Barnegat Light borough, Ocean County, New Jersey",34029,ONJ,274,1282,1008,532,0,6,11,563,1,574,1,555,municipality,2010
3402903520,"Bay Head borough, Ocean County, New Jersey",34029,ONJ,1168,2106,938,2094,14,4,32,2444,2,2476,18,2406,municipality,2000
3402903520,"Bay Head borough, Ocean County, New Jersey",34029,ONJ,459,1023,564,818,7,5,10,958,0,968,2,944,municipality,2010
3402903940,"Beach Haven borough, Ocean County, New Jersey",34029,ONJ,1172,5110,3938,2118,14,2,120,2436,0,2556,12,2408,municipality,2000
3402903940,"Beach Haven borough, Ocean County, New Jersey",34029,ONJ,531,2667,2136,1009,9,1,116,1054,0,1170,4,1040,municipality,2010
3402904180,"Beachwood borough, Ocean County, New Jersey",34029,ONJ,6950,7246,296,14830,228,190,876,19874,42,20750,144,19270,municipality,2000
3402904180,"Beachwood borough, Ocean County, New Jersey",34029,ONJ,3682,3826,144,8233,166,185,898,10147,9,11045,108,9679,municipality,2010
3402905305,"Berkeley township, Ocean County, New Jersey",34029,ONJ,39656,44576,4920,70866,352,964,1864,78118,66,79982,430,76306,municipality,2000
3402905305,"Berkeley township, Ocean County, New Jersey",34029,ONJ,20349,23818,3469,36353,458,681,2028,39227,63,41255,302,37723,municipality,2010
3402907420,"Brick township, Ocean County, New Jersey",34029,ONJ,59022,65378,6356,115930,1766,1410,5860,146378,320,152238,1162,141720,municipality,2000
3402907420,"Brick township, Ocean County, New Jersey",34029,ONJ,29842,33677,3835,59525,1144,1374,5301,69771,153,75072,728,66372,municipality,2010
3402918670,"Eagleswood township, Ocean County, New Jersey",34029,ONJ,1092,1386,294,2170,6,2,32,2850,8,2882,14,2820,municipality,2000
3402918670,"Eagleswood township, Ocean County, New Jersey",34029,ONJ,621,760,139,1255,10,13,54,1549,1,1603,15,1510,municipality,2010
3402930390,"Harvey Cedars borough, Ocean County, New Jersey",34029,ONJ,334,2410,2076,614,2,4,26,692,2,718,0,684,municipality,2000
3402930390,"Harvey Cedars borough, Ocean County, New Jersey",34029,ONJ,169,1214,1045,298,1,2,3,334,0,337,0,331,municipality,2010
3402934530,"Island Heights borough, Ocean County, New Jersey",34029,ONJ,1410,1614,204,2718,22,4,48,3454,16,3502,34,3378,municipality,2000
3402934530,"Island Heights borough, Ocean County, New Jersey",34029,ONJ,683,831,148,1364,23,2,40,1633,1,1673,31,1576,municipality,2010
3402934680,"Jackson township, Ocean County, New Jersey",34029,ONJ,28352,29280,928,60228,1716,3138,4948,80684,146,85632,988,74696,municipality,2000
3402934680,"Jackson township, Ocean County, New Jersey",34029,ONJ,19417,20342,925,41325,1592,2460,4295,50561,119,54856,758,45632,municipality,2010
3402937380,"Lacey township, Ocean County, New Jersey",34029,ONJ,18672,21160,2488,37726,270,178,1090,49602,84,50692,284,48786,municipality,2000
3402937380,"Lacey township, Ocean County, New Jersey",34029,ONJ,10183,11573,1390,21267,221,150,1310,26334,60,27644,244,25659,municipality,2010
3402937770,"Lakehurst borough, Ocean County, New Jersey",34029,ONJ,1740,1922,182,3502,118,366,402,4642,36,5044,62,4060,municipality,2000
3402937770,"Lakehurst borough, Ocean County, New Jersey",34029,ONJ,881,943,62,1901,56,264,347,2307,14,2654,93,1880,municipality,2010
3402938550,"Lakewood township, Ocean County, New Jersey",34029,ONJ,39752,42428,2676,82332,1598,13756,17870,102834,318,120704,1530,85632,municipality,2000
3402938550,"Lakewood township, Ocean County, New Jersey",34029,ONJ,24283,26337,2054,54001,737,5346,16062,76781,119,92843,574,70005,municipality,2010
3402939390,"Lavallette borough, Ocean County, New Jersey",34029,ONJ,2416,6420,4004,4632,8,14,86,5244,6,5330,34,5182,municipality,2000
3402939390,"Lavallette borough, Ocean County, New Jersey",34029,ONJ,945,3207,2262,1669,10,2,56,1819,0,1875,7,1800,municipality,2010
3402940560,"Little Egg Harbor township, Ocean County, New Jersey",34029,ONJ,12358,15862,3504,24182,192,234,1040,30850,92,31890,272,30060,municipality,2000
3402940560,"Little Egg Harbor township, Ocean County, New Jersey",34029,ONJ,8060,10324,2264,15975,249,259,1047,19018,35,20065,203,18272,municipality,2010
3402941250,"Long Beach township, Ocean County, New Jersey",34029,ONJ,3328,18046,14718,5880,24,10,140,6518,2,6658,26,6456,municipality,2000
3402941250,"Long Beach township, Ocean County, New Jersey",34029,ONJ,1539,9216,7677,2748,15,7,126,2925,4,3051,14,2885,municipality,2010
3402943140,"Manchester township, Ocean County, New Jersey",34029,ONJ,41376,45362,3986,69488,656,2306,2048,75808,132,77856,572,72142,municipality,2000
3402943140,"Manchester township, Ocean County, New Jersey",34029,ONJ,22840,25886,3046,38627,754,1572,2062,41008,75,43070,392,38215,municipality,2010
3402943380,"Mantoloking borough, Ocean County, New Jersey",34029,ONJ,414,1044,630,760,4,14,6,840,0,846,0,822,municipality,2000
3402943380,"Mantoloking borough, Ocean County, New Jersey",34029,ONJ,162,535,373,284,1,5,7,289,3,296,1,279,municipality,2010
3402954300,"Ocean township, Ocean County, New Jersey",34029,ONJ,4892,5962,1070,9614,54,76,400,12500,34,12900,90,12246,municipality,2000
3402954300,"Ocean township, Ocean County, New Jersey",34029,ONJ,3483,4291,808,6988,89,49,230,8102,18,8332,67,7879,municipality,2010
3402954450,"Ocean Gate borough, Ocean County, New Jersey",34029,ONJ,1664,2304,640,3072,40,40,98,4054,14,4152,34,3926,municipality,2000
3402954450,"Ocean Gate borough, Ocean County, New Jersey",34029,ONJ,832,1203,371,1565,4,26,128,1883,5,2011,12,1836,municipality,2010
3402958590,"Pine Beach borough, Ocean County, New Jersey",34029,ONJ,1534,1744,210,3014,24,8,92,3808,2,3900,10,3764,municipality,2000
3402958590,"Pine Beach borough, Ocean County, New Jersey",34029,ONJ,818,903,85,1650,30,7,79,2048,2,2127,14,1995,municipality,2010
3402959790,"Plumsted township, Ocean County, New Jersey",34029,ONJ,5020,5256,236,10408,106,312,560,13990,24,14550,168,13380,municipality,2000
3402959790,"Plumsted township, Ocean County, New Jersey",34029,ONJ,2936,3067,131,6214,73,131,498,7923,29,8421,99,7591,municipality,2010
3402959880,"Point Pleasant borough, Ocean County, New Jersey",34029,ONJ,15120,16700,1580,29458,206,94,930,37682,68,38612,202,37112,municipality,2000
3402959880,"Point Pleasant borough, Ocean County, New Jersey",34029,ONJ,7273,8331,1058,14329,129,56,935,17457,28,18392,111,17133,municipality,2010
3402959910,"Point Pleasant Beach borough, Ocean County, New Jersey",34029,ONJ,4634,7116,2482,8584,108,54,468,10160,20,10628,58,9920,municipality,2000
3402959910,"Point Pleasant Beach borough, Ocean County, New Jersey",34029,ONJ,1985,3373,1388,3782,39,27,421,4244,5,4665,41,4132,municipality,2010
3402966450,"Seaside Heights borough, Ocean County, New Jersey",34029,ONJ,2816,5680,2864,4838,38,228,612,5698,36,6310,138,5258,municipality,2000
3402966450,"Seaside Heights borough, Ocean County, New Jersey",34029,ONJ,1376,3003,1627,2318,44,181,516,2371,11,2887,73,2062,municipality,2010
3402966480,"Seaside Park borough, Ocean County, New Jersey",34029,ONJ,2254,5622,3368,3876,26,12,104,4422,16,4526,16,4352,municipality,2000
3402966480,"Seaside Park borough, Ocean County, New Jersey",34029,ONJ,833,2703,1870,1390,6,15,54,1525,1,1579,11,1492,municipality,2010
3402967110,"Ship Bottom borough, Ocean County, New Jersey",34029,ONJ,1328,4436,3108,2358,24,8,160,2608,0,2768,12,2564,municipality,2000
3402967110,"Ship Bottom borough, Ocean County, New Jersey",34029,ONJ,555,2066,1511,1017,5,6,106,1050,2,1156,5,1032,municipality,2010
3402969510,"South Toms River borough, Ocean County, New Jersey",34029,ONJ,2146,2246,100,4934,50,1462,674,6594,24,7268,144,4914,municipality,2000
3402969510,"South Toms River borough, Ocean County, New Jersey",34029,ONJ,1098,1160,62,2650,23,649,718,2966,13,3684,107,2174,municipality,2010
3402970320,"Stafford township, Ocean County, New Jersey",34029,ONJ,17070,23044,5974,34360,434,314,1084,43980,78,45064,332,42822,municipality,2000
3402970320,"Stafford township, Ocean County, New Jersey",34029,ONJ,10096,13604,3508,20491,393,243,1410,25125,48,26535,213,24228,municipality,2010
3402971640,"Surf City borough, Ocean County, New Jersey",34029,ONJ,1412,5242,3830,2526,10,4,56,2828,16,2884,4,2794,municipality,2000
3402971640,"Surf City borough, Ocean County, New Jersey",34029,ONJ,622,2566,1944,1092,6,16,61,1144,2,1205,7,1113,municipality,2010
3402973125,"Toms River township, Ocean County, New Jersey",34029,ONJ,67020,82232,15212,137630,4396,2980,8140,171272,276,179412,1434,162186,municipality,2000
3402973125,"Toms River township, Ocean County, New Jersey",34029,ONJ,34760,43334,8574,71788,3237,2213,7231,84008,236,91239,1081,77241,municipality,2010
3402974210,"Tuckerton borough, Ocean County, New Jersey",34029,ONJ,2954,3942,988,5416,38,28,218,6816,20,7034,46,6684,municipality,2000
3402974210,"Tuckerton borough, Ocean County, New Jersey",34029,ONJ,1396,1902,506,2638,33,23,203,3144,7,3347,27,3054,municipality,2010
3403106340,"Bloomingdale borough, Passaic County, New Jersey",34031,INJ,5694,5880,186,11828,328,54,664,14556,24,15220,130,14020,municipality,2000
3403106340,"Bloomingdale borough, Passaic County, New Jersey",34031,INJ,2935,3089,154,6038,188,82,714,6942,27,7656,57,6588,municipality,2010
3403113690,"Clifton city, Passaic County, New Jersey",34031,INJ,60488,62120,1632,123400,10056,4004,31216,126128,598,157344,5058,106412,municipality,2000
3403113690,"Clifton city, Passaic County, New Jersey",34031,INJ,30661,31946,1285,65630,7401,3235,26854,57282,434,84136,1342,44870,municipality,2010
3403129070,"Haledon borough, Passaic County, New Jersey",34031,INJ,5640,5812,172,12288,742,1048,3730,12774,38,16504,500,10446,municipality,2000
3403129070,"Haledon borough, Passaic County, New Jersey",34031,INJ,2778,2932,154,6128,505,806,3460,4858,31,8318,123,3393,municipality,2010
3403130570,"Hawthorne borough, Passaic County, New Jersey",34031,INJ,14520,14838,318,28504,678,260,2708,33728,74,36436,434,32282,municipality,2000
3403130570,"Hawthorne borough, Passaic County, New Jersey",34031,INJ,7454,7756,302,14769,524,355,2897,15894,54,18791,169,14792,municipality,2010
3403140620,"Little Falls township, Passaic County, New Jersey",34031,INJ,9374,9594,220,17776,900,142,1158,20552,36,21710,288,19186,municipality,2000
3403140620,"Little Falls township, Passaic County, New Jersey",34031,INJ,4740,4925,185,12449,652,549,1428,13004,48,14432,225,11530,municipality,2010
3403153040,"North Haledon borough, Passaic County, New Jersey",34031,INJ,5252,5350,98,12720,158,194,616,15224,8,15840,174,14690,municipality,2000
3403153040,"North Haledon borough, Passaic County, New Jersey",34031,INJ,3123,3213,90,6702,318,136,628,7789,16,8417,71,7248,municipality,2010
3403156550,"Passaic city, Passaic County, New Jersey",34031,INJ,38916,40388,1472,93924,7234,16084,84774,50948,646,135722,2174,24810,municipality,2000
3403156550,"Passaic city, Passaic County, New Jersey",34031,INJ,19411,20432,1021,47805,2924,5221,49557,20224,258,69781,580,11241,municipality,2010
3403157000,"Paterson city, Passaic County, New Jersey",34031,INJ,89420,94338,4918,209570,5456,93764,149548,148896,1588,298444,8558,39530,municipality,2000
3403157000,"Paterson city, Passaic County, New Jersey",34031,INJ,44329,47946,3617,105375,4663,41431,84254,61945,675,146199,1750,13426,municipality,2010
3403160090,"Pompton Lakes borough, Passaic County, New Jersey",34031,INJ,7898,8048,150,16122,632,254,1222,20058,54,21280,164,18954,municipality,2000
3403160090,"Pompton Lakes borough, Passaic County, New Jersey",34031,INJ,4190,4341,151,8639,595,127,1209,9888,34,11097,113,9019,municipality,2010
3403161170,"Prospect Park borough, Passaic County, New Jersey",34031,INJ,3644,3778,134,8140,360,1406,4422,7136,58,11558,526,4786,municipality,2000
3403161170,"Prospect Park borough, Passaic County, New Jersey",34031,INJ,1797,1931,134,4197,176,1016,3055,2810,32,5865,107,1479,municipality,2010
3403163150,"Ringwood borough, Passaic County, New Jersey",34031,INJ,8216,8442,226,17956,294,366,1054,23738,354,24792,212,22512,municipality,2000
3403163150,"Ringwood borough, Passaic County, New Jersey",34031,INJ,4182,4331,149,9203,209,148,707,11521,170,12228,194,10800,municipality,2010
3403173140,"Totowa borough, Passaic County, New Jersey",34031,INJ,7078,7260,182,16170,446,218,1260,18524,48,19784,168,17644,municipality,2000
3403173140,"Totowa borough, Passaic County, New Jersey",34031,INJ,3783,3918,135,8631,639,220,1550,9254,23,10804,123,8249,municipality,2010
3403176730,"Wanaque borough, Passaic County, New Jersey",34031,INJ,6888,7000,112,15530,736,294,1108,19424,94,20532,306,17994,municipality,2000
3403176730,"Wanaque borough, Passaic County, New Jersey",34031,INJ,4018,4184,166,8822,508,305,1075,10041,47,11116,167,9014,municipality,2010
3403177840,"Wayne township, Passaic County, New Jersey",34031,INJ,37510,38436,926,83086,6112,1686,5508,102630,192,108138,1108,93532,municipality,2000
3403177840,"Wayne township, Passaic County, New Jersey",34031,INJ,19127,19768,641,42683,4441,1124,4335,50382,146,54717,641,44030,municipality,2010
3403179460,"West Milford township, Passaic County, New Jersey",34031,INJ,18380,19818,1438,38444,524,628,1786,51034,300,52820,634,48948,municipality,2000
3403179460,"West Milford township, Passaic County, New Jersey",34031,INJ,9625,10419,794,20052,319,327,1512,24338,130,25850,330,23232,municipality,2010
3403182423,"Woodland Park borough, Passaic County, New Jersey",34031,INJ,8794,8994,200,17668,838,654,2210,19764,50,21974,594,17628,municipality,2000
3403182423,"Woodland Park borough, Passaic County, New Jersey",34031,INJ,4632,4835,203,9490,494,398,2442,9377,65,11819,187,8233,municipality,2010
3403504450,"Bedminster township, Somerset County, New Jersey",34035,INJ,8470,8934,464,13644,1062,286,638,15966,68,16604,114,14436,municipality,2000
3403504450,"Bedminster township, Somerset County, New Jersey",34035,INJ,4100,4349,249,6721,707,157,519,7646,14,8165,122,6646,municipality,2010
3403505560,"Bernards township, Somerset County, New Jersey",34035,INJ,18484,18970,486,35540,3856,682,1292,47858,74,49150,450,42796,municipality,2000
3403505560,"Bernards township, Somerset County, New Jersey",34035,INJ,9783,10103,320,18970,3670,478,1054,25598,72,26652,432,20946,municipality,2010
3403505590,"Bernardsville borough, Somerset County, New Jersey",34035,INJ,5446,5614,168,10860,388,36,878,13812,30,14690,138,13220,municipality,2000
3403505590,"Bernardsville borough, Somerset County, New Jersey",34035,INJ,2685,2871,186,5499,248,58,903,6804,11,7707,85,6402,municipality,2010
3403506790,"Bound Brook borough, Somerset County, New Jersey",34035,INJ,7230,7604,374,15900,564,444,7082,13228,78,20310,214,11928,municipality,2000
3403506790,"Bound Brook borough, Somerset County, New Jersey",34035,INJ,3586,3816,230,8049,264,522,5062,5340,47,10402,124,4383,municipality,2010
3403507180,"Branchburg township, Somerset County, New Jersey",34035,INJ,10544,10810,266,21166,1780,546,784,28348,64,29132,246,25712,municipality,2000
3403507180,"Branchburg township, Somerset County, New Jersey",34035,INJ,5271,5419,148,10692,1210,313,643,13816,47,14459,210,12036,municipality,2010
3403507720,"Bridgewater township, Somerset County, New Jersey",34035,INJ,31122,31758,636,63844,9018,1798,4112,81768,142,85880,820,69990,municipality,2000
3403507720,"Bridgewater township, Somerset County, New Jersey",34035,INJ,16111,16657,546,33110,7901,978,3004,41460,121,44464,608,31852,municipality,2010
3403522890,"Far Hills borough, Somerset County, New Jersey",34035,INJ,736,772,36,1402,36,14,62,1656,2,1718,14,1590,municipality,2000
3403522890,"Far Hills borough, Somerset County, New Jersey",34035,INJ,376,418,42,698,17,6,88,831,0,919,9,799,municipality,2010
3403524900,"Franklin township, Somerset County, New Jersey",34035,INJ,38710,39578,868,78722,12950,25776,8254,93552,582,101806,1792,52452,municipality,2000
3403524900,"Franklin township, Somerset County, New Jersey",34035,INJ,23301,24426,1125,48508,12410,15888,8050,54250,333,62300,1421,24198,municipality,2010
3403527510,"Green Brook township, Somerset County, New Jersey",34035,INJ,3786,3832,46,8556,904,186,462,10846,16,11308,104,9636,municipality,2000
3403527510,"Green Brook township, Somerset County, New Jersey",34035,INJ,2375,2448,73,5301,1453,238,494,6709,9,7203,92,4917,municipality,2010
3403531890,"Hillsborough township, Somerset County, New Jersey",34035,INJ,25298,25708,410,51926,5344,2650,3480,69788,206,73268,864,60724,municipality,2000
3403531890,"Hillsborough township, Somerset County, New Jersey",34035,INJ,13573,14030,457,28203,4723,1674,2893,35410,93,38303,551,28369,municipality,2010
3403543620,"Manville borough, Somerset County, New Jersey",34035,INJ,8230,8592,362,16406,270,90,1118,19568,24,20686,136,19048,municipality,2000
3403543620,"Manville borough, Somerset County, New Jersey",34035,INJ,4016,4277,261,8251,205,259,1963,8381,44,10344,118,7755,municipality,2010
3403546590,"Millstone borough, Somerset County, New Jersey",34035,INJ,338,346,8,662,8,8,26,794,0,820,4,774,municipality,2000
3403546590,"Millstone borough, Somerset County, New Jersey",34035,INJ,162,167,5,319,7,5,15,403,2,418,2,387,municipality,2010
3403547580,"Montgomery township, Somerset County, New Jersey",34035,INJ,11606,12260,654,23444,4020,700,774,34188,52,34962,402,29014,municipality,2000
3403547580,"Montgomery township, Somerset County, New Jersey",34035,INJ,7635,7902,267,15399,5689,586,1017,21237,56,22254,470,14436,municipality,2010
3403553280,"North Plainfield borough, Somerset County, New Jersey",34035,INJ,14404,14786,382,31328,2106,5160,13832,28374,160,42206,902,20046,municipality,2000
3403553280,"North Plainfield borough, Somerset County, New Jersey",34035,INJ,7448,7848,400,16570,1260,3848,9699,12237,110,21936,284,6735,municipality,2010
3403557300,"Peapack and Gladstone borough, Somerset County, New Jersey",34035,INJ,1680,1742,62,3602,60,152,184,4682,10,4866,18,4442,municipality,2000
3403557300,"Peapack and Gladstone borough, Somerset County, New Jersey",34035,INJ,887,949,62,1899,47,99,281,2301,9,2582,22,2124,municipality,2010
3403561980,"Raritan borough, Somerset County, New Jersey",34035,INJ,5112,5288,176,9844,1036,94,1066,11610,28,12676,130,10322,municipality,2000
3403561980,"Raritan borough, Somerset County, New Jersey",34035,INJ,2673,2847,174,5290,975,128,1128,5753,32,6881,111,4507,municipality,2010
3403564320,"Rocky Hill borough, Somerset County, New Jersey",34035,INJ,568,590,22,1056,6,18,52,1272,14,1324,18,1216,municipality,2000
3403564320,"Rocky Hill borough, Somerset County, New Jersey",34035,INJ,280,292,12,524,16,10,33,649,3,682,20,600,municipality,2010
3403568460,"Somerville borough, Somerset County, New Jersey",34035,INJ,9486,9764,278,19396,1818,3096,4224,20622,106,24846,538,15064,municipality,2000
3403568460,"Somerville borough, Somerset County, New Jersey",34035,INJ,4591,4951,360,9516,1359,1389,2873,9225,59,12098,266,6152,municipality,2010
3403568730,"South Bound Brook borough, Somerset County, New Jersey",34035,INJ,3264,3352,88,6874,368,690,2056,6928,32,8984,146,5692,municipality,2000
3403568730,"South Bound Brook borough, Somerset County, New Jersey",34035,INJ,1733,1865,132,3586,275,429,1245,3318,26,4563,114,2474,municipality,2010
3403576940,"Warren township, Somerset County, New Jersey",34035,INJ,9258,9436,178,20054,3040,338,910,27608,56,28518,338,23836,municipality,2000
3403576940,"Warren township, Somerset County, New Jersey",34035,INJ,5059,5258,199,11051,2304,225,820,14491,33,15311,225,11704,municipality,2010
3403577600,"Watchung borough, Somerset County, New Jersey",34035,INJ,4196,4310,114,8772,1106,378,336,10890,26,11226,150,9230,municipality,2000
3403577600,"Watchung borough, Somerset County, New Jersey",34035,INJ,2114,2234,120,4453,733,190,307,5494,22,5801,122,4427,municipality,2010
3403701330,"Andover borough, Sussex County, New Jersey",34037,ONJ,522,546,24,1030,30,26,34,1282,18,1316,6,1202,municipality,2000
3403701330,"Andover borough, Sussex County, New Jersey",34037,ONJ,241,263,22,478,8,5,46,560,3,606,10,534,municipality,2010
3403701360,"Andover township, Sussex County, New Jersey",34037,ONJ,3778,3936,158,9044,274,222,272,11794,16,12066,76,11206,municipality,2000
3403701360,"Andover township, Sussex County, New Jersey",34037,ONJ,2070,2181,111,4924,164,202,325,5994,5,6319,76,5547,municipality,2010
3403707300,"Branchville borough, Sussex County, New Jersey",34037,ONJ,708,754,46,1284,6,0,22,1668,6,1690,4,1652,municipality,2000
3403707300,"Branchville borough, Sussex County, New Jersey",34037,ONJ,364,386,22,649,9,2,33,808,3,841,6,788,municipality,2010
3403709160,"Byram township, Sussex County, New Jersey",34037,ONJ,5666,6156,490,11748,232,158,486,16022,28,16508,160,15444,municipality,2000
3403709160,"Byram township, Sussex County, New Jersey",34037,ONJ,2926,3207,281,6202,173,113,417,7933,18,8350,76,7553,municipality,2010
3403724810,"Frankford township, Sussex County, New Jersey",34037,ONJ,3678,4590,912,8134,42,42,192,10648,12,10840,42,10510,municipality,2000
3403724810,"Frankford township, Sussex County, New Jersey",34037,ONJ,2046,2520,474,4398,46,53,176,5389,4,5565,62,5224,municipality,2010
3403724930,"Franklin borough, Sussex County, New Jersey",34037,ONJ,3796,3994,198,7482,152,60,456,9864,34,10320,108,9510,municipality,2000
3403724930,"Franklin borough, Sussex County, New Jersey",34037,ONJ,1936,2136,200,3926,88,95,395,4650,14,5045,91,4362,municipality,2010
3403725140,"Fredon township, Sussex County, New Jersey",34037,ONJ,1964,2038,74,4198,48,30,124,5596,10,5720,28,5480,municipality,2000
3403725140,"Fredon township, Sussex County, New Jersey",34037,ONJ,1207,1289,82,2554,58,17,127,3310,4,3437,28,3203,municipality,2010
3403727420,"Green township, Sussex County, New Jersey",34037,ONJ,2092,2138,46,4454,62,52,206,6234,4,6440,54,6062,municipality,2000
3403727420,"Green township, Sussex County, New Jersey",34037,ONJ,1181,1251,70,2580,60,42,173,3428,5,3601,34,3287,municipality,2010
3403729220,"Hamburg borough, Sussex County, New Jersey",34037,ONJ,2346,2466,120,4548,142,42,262,5948,24,6210,102,5638,municipality,2000
3403729220,"Hamburg borough, Sussex County, New Jersey",34037,ONJ,1364,1476,112,2540,66,57,225,3052,15,3277,59,2855,municipality,2010
3403729490,"Hampton township, Sussex County, New Jersey",34037,ONJ,3714,4052,338,7264,66,92,188,9698,6,9886,68,9466,municipality,2000
3403729490,"Hampton township, Sussex County, New Jersey",34037,ONJ,2021,2200,179,4103,62,41,200,4996,7,5196,39,4847,municipality,2010
3403729850,"Hardyston township, Sussex County, New Jersey",34037,ONJ,4638,5380,742,9176,190,102,398,11944,22,12342,134,11496,municipality,2000
3403729850,"Hardyston township, Sussex County, New Jersey",34037,ONJ,3255,3783,528,6463,243,200,457,7756,28,8213,86,7199,municipality,2010
3403732910,"Hopatcong borough, Sussex County, New Jersey",34037,ONJ,11312,12380,1068,23374,564,592,1904,29872,76,31776,352,28288,municipality,2000
3403732910,"Hopatcong borough, Sussex County, New Jersey",34037,ONJ,5653,6296,643,11758,334,401,1714,13433,30,15147,178,12490,municipality,2010
3403737440,"Lafayette township, Sussex County, New Jersey",34037,ONJ,1542,1598,56,3338,36,48,108,4492,6,4600,26,4376,municipality,2000
3403737440,"Lafayette township, Sussex County, New Jersey",34037,ONJ,875,919,44,1945,19,36,129,2409,4,2538,30,2320,municipality,2010
3403747430,"Montague township, Sussex County, New Jersey",34037,ONJ,2572,3176,604,4970,46,122,224,6600,22,6824,66,6344,municipality,2000
3403747430,"Montague township, Sussex County, New Jersey",34037,ONJ,1535,1802,267,2971,39,83,246,3601,12,3847,75,3392,municipality,2010
3403751930,"Newton town, Sussex County, New Jersey",34037,ONJ,6516,6850,334,12542,322,544,626,15862,44,16488,170,14782,municipality,2000
3403751930,"Newton town, Sussex County, New Jersey",34037,ONJ,3170,3479,309,6301,233,361,987,7010,40,7997,119,6257,municipality,2010
3403754660,"Ogdensburg borough, Sussex County, New Jersey",34037,ONJ,1762,1806,44,3720,38,8,220,5056,2,5276,46,4962,municipality,2000
3403754660,"Ogdensburg borough, Sussex County, New Jersey",34037,ONJ,864,905,41,1820,44,8,151,2259,5,2410,18,2184,municipality,2010
3403765700,"Sandyston township, Sussex County, New Jersey",34037,ONJ,1386,1814,428,2730,16,12,48,3602,10,3650,26,3538,municipality,2000
3403765700,"Sandyston township, Sussex County, New Jersey",34037,ONJ,788,988,200,1549,11,8,68,1930,5,1998,21,1885,municipality,2010
3403769690,"Sparta township, Sussex County, New Jersey",34037,ONJ,12450,13180,730,25088,502,100,918,35242,58,36160,312,34270,municipality,2000
3403769690,"Sparta township, Sussex County, New Jersey",34037,ONJ,6868,7423,555,14030,490,187,1054,18668,35,19722,241,17715,municipality,2010
3403770380,"Stanhope borough, Sussex County, New Jersey",34037,ONJ,2768,2838,70,5372,108,90,290,6878,30,7168,140,6510,municipality,2000
3403770380,"Stanhope borough, Sussex County, New Jersey",34037,ONJ,1396,1472,76,2790,83,53,307,3303,9,3610,51,3107,municipality,2010
3403770890,"Stillwater township, Sussex County, New Jersey",34037,ONJ,2988,4060,1072,6144,36,14,178,8356,18,8534,54,8234,municipality,2000
3403770890,"Stillwater township, Sussex County, New Jersey",34037,ONJ,1553,1930,377,3201,29,27,90,4009,2,4099,48,3903,municipality,2010
3403771670,"Sussex borough, Sussex County, New Jersey",34037,ONJ,1806,1922,116,3264,52,44,110,4180,4,4290,26,4054,municipality,2000
3403771670,"Sussex borough, Sussex County, New Jersey",34037,ONJ,899,1005,106,1645,49,39,169,1961,12,2130,36,1825,municipality,2010
3403775740,"Vernon township, Sussex County, New Jersey",34037,ONJ,16736,19988,3252,34252,342,356,1778,47594,94,49372,374,46428,municipality,2000
3403775740,"Vernon township, Sussex County, New Jersey",34037,ONJ,8622,10958,2336,18128,185,292,1534,22409,68,23943,240,21624,municipality,2010
3403776640,"Walpack township, Sussex County, New Jersey",34037,ONJ,40,68,28,66,0,0,0,82,0,82,0,82,municipality,2000
3403776640,"Walpack township, Sussex County, New Jersey",34037,ONJ,8,15,7,14,0,0,0,16,0,16,1,15,municipality,2010
3403776790,"Wantage township, Sussex County, New Jersey",34037,ONJ,6882,7326,444,14674,140,132,600,20174,14,20774,174,19714,municipality,2000
3403776790,"Wantage township, Sussex County, New Jersey",34037,ONJ,3910,4173,263,8523,112,126,594,10764,12,11358,146,10368,municipality,2010
3403905320,"Berkeley Heights township, Union County, New Jersey",34039,INJ,8958,9124,166,19624,2110,286,988,25826,56,26814,152,23222,municipality,2000
3403905320,"Berkeley Heights township, Union County, New Jersey",34039,INJ,4470,4596,126,9632,1372,186,675,12508,17,13183,173,10760,municipality,2010
3403913150,"Clark township, Union County, New Jersey",34039,INJ,11274,11418,144,23124,804,70,1070,28124,34,29194,148,27068,municipality,2000
3403913150,"Clark township, Union County, New Jersey",34039,INJ,5562,5751,189,11633,527,116,1107,13649,38,14756,94,12874,municipality,2010
3403915640,"Cranford township, Union County, New Jersey",34039,INJ,16794,17120,326,34632,968,1158,1758,43398,68,45156,276,40928,municipality,2000
3403915640,"Cranford township, Union County, New Jersey",34039,INJ,8583,8816,233,17154,635,563,1474,21151,63,22625,255,19635,municipality,2010
3403921000,"Elizabeth city, Union County, New Jersey",34039,INJ,80964,85676,4712,177776,5490,44658,119254,121882,1318,241136,5740,64676,municipality,2000
3403921000,"Elizabeth city, Union County, New Jersey",34039,INJ,41596,45516,3920,92923,2521,23072,74353,50616,980,124969,1338,22705,municipality,2010
3403922860,"Fanwood borough, Union County, New Jersey",34039,INJ,5148,5230,82,10646,630,728,536,13812,38,14348,152,12264,municipality,2000
3403922860,"Fanwood borough, Union County, New Jersey",34039,INJ,2627,2686,59,5290,490,374,458,6860,17,7318,126,5853,municipality,2010
3403925800,"Garwood borough, Union County, New Jersey",34039,INJ,3462,3564,102,6644,110,30,414,7892,2,8306,48,7702,municipality,2000
3403925800,"Garwood borough, Union County, New Jersey",34039,INJ,1778,1870,92,3412,86,42,373,3853,18,4226,41,3666,municipality,2010
3403931980,"Hillside township, Union County, New Jersey",34039,INJ,14322,14776,454,32370,1488,19922,6306,37188,414,43494,1382,13982,municipality,2000
3403931980,"Hillside township, Union County, New Jersey",34039,INJ,7112,7536,424,16327,571,11091,3774,17630,245,21404,349,5374,municipality,2010
3403936690,"Kenilworth borough, Union County, New Jersey",34039,INJ,5708,5852,144,12158,440,366,1326,14024,12,15350,128,13078,municipality,2000
3403936690,"Kenilworth borough, Union County, New Jersey",34039,INJ,2841,2924,83,6187,303,213,1228,6686,34,7914,89,6047,municipality,2010
3403940350,"Linden city, Union County, New Jersey",34039,INJ,30104,31134,1030,61096,1828,17564,11348,67440,364,78788,2030,45654,municipality,2000
3403940350,"Linden city, Union County, New Jersey",34039,INJ,14909,15872,963,31665,1066,10403,10095,30404,232,40499,614,18089,municipality,2010
3403948510,"Mountainside borough, Union County, New Jersey",34039,INJ,4868,4956,88,10420,360,122,398,12806,22,13204,80,12222,municipality,2000
3403948510,"Mountainside borough, Union County, New Jersey",34039,INJ,2468,2558,90,5131,323,121,407,6278,7,6685,73,5754,municipality,2010
3403951810,"New Providence borough, Union County, New Jersey",34039,INJ,8808,8970,162,17542,1806,208,834,22980,32,23814,216,20718,municipality,2000
3403951810,"New Providence borough, Union County, New Jersey",34039,INJ,4408,4537,129,8849,1187,153,783,11388,28,12171,150,9870,municipality,2010
3403959190,"Plainfield city, Union County, New Jersey",34039,INJ,30274,32360,2086,69324,856,57396,24066,71592,484,95658,1840,11016,municipality,2000
3403959190,"Plainfield city, Union County, New Jersey",34039,INJ,15180,16621,1441,36947,439,24069,20105,29703,307,49808,749,4139,municipality,2010
3403961530,"Rahway city, Union County, New Jersey",34039,INJ,20056,20762,706,40340,1850,14116,7350,45650,308,53000,1178,28198,municipality,2000
3403961530,"Rahway city, Union County, New Jersey",34039,INJ,10533,11300,767,21383,1148,8104,6433,20913,127,27346,521,11013,municipality,2010
3403964620,"Roselle borough, Union County, New Jersey",34039,INJ,15040,15740,700,31682,1146,21338,7282,35266,306,42548,1128,11348,municipality,2000
3403964620,"Roselle borough, Union County, New Jersey",34039,INJ,7407,7939,532,16132,464,11148,5644,15441,137,21085,303,3389,municipality,2010
3403964650,"Roselle Park borough, Union County, New Jersey",34039,INJ,10274,10516,242,20656,2398,596,4340,22222,48,26562,386,18794,municipality,2000
3403964650,"Roselle Park borough, Union County, New Jersey",34039,INJ,5002,5231,229,10320,1337,697,3809,9488,32,13297,161,7261,municipality,2010
3403966060,"Scotch Plains township, Union County, New Jersey",34039,INJ,16698,16958,260,33934,3276,5064,1790,43674,96,45464,568,34670,municipality,2000
3403966060,"Scotch Plains township, Union County, New Jersey",34039,INJ,8595,8896,301,17420,1795,2519,1582,21928,85,23510,408,17121,municipality,2010
3403970020,"Springfield township, Union County, New Jersey",34039,INJ,12002,12408,406,22926,1350,1072,1194,27664,40,28858,220,24982,municipality,2000
3403970020,"Springfield township, Union County, New Jersey",34039,INJ,6511,6736,225,12486,1196,968,1502,14315,32,15817,197,11922,municipality,2010
3403971430,"Summit city, Union County, New Jersey",34039,INJ,15794,16292,498,30868,1870,1754,4300,37962,82,42262,404,33852,municipality,2000
3403971430,"Summit city, Union County, New Jersey",34039,INJ,7708,8190,482,15224,1367,933,2851,18606,53,21457,356,15897,municipality,2010
3403974480,"Union township, Union County, New Jersey",34039,INJ,39068,40002,934,84572,8382,21126,9722,99088,362,108810,1896,67322,municipality,2000
3403974480,"Union township, Union County, New Jersey",34039,INJ,19556,20250,694,44693,5959,15979,8465,48177,397,56642,869,24973,municipality,2010
3403979040,"Westfield town, Union County, New Jersey",34039,INJ,21244,21638,394,42470,2412,2274,1672,57616,164,59288,672,52094,municipality,2000
3403979040,"Westfield town, Union County, New Jersey",34039,INJ,10566,10950,384,21217,1708,940,1492,28824,79,30316,468,25629,municipality,2010
3403981650,"Winfield township, Union County, New Jersey",34039,INJ,1388,1394,6,2396,4,4,74,2954,10,3028,36,2900,municipality,2000
3403981650,"Winfield township, Union County, New Jersey",34039,INJ,706,714,8,1216,2,14,94,1377,4,1471,16,1341,municipality,2010
3404100670,"Allamuchy township, Warren County, New Jersey",34041,ONJ,3384,3548,164,6284,144,72,208,7546,18,7754,48,7264,municipality,2000
3404100670,"Allamuchy township, Warren County, New Jersey",34041,ONJ,1953,2096,143,3525,118,75,194,4129,10,4323,46,3880,municipality,2010
3404101030,"Alpha borough, Warren County, New Jersey",34041,ONJ,1978,2068,90,3752,60,10,94,4870,16,4964,36,4748,municipality,2000
3404101030,"Alpha borough, Warren County, New Jersey",34041,ONJ,964,1032,68,1831,36,55,125,2244,1,2369,37,2115,municipality,2010
3404104990,"Belvidere town, Warren County, New Jersey",34041,ONJ,2176,2330,154,3982,28,28,128,5414,12,5542,36,5310,municipality,2000
3404104990,"Belvidere town, Warren County, New Jersey",34041,ONJ,1054,1140,86,2002,21,38,97,2584,2,2681,29,2494,municipality,2010
3404106160,"Blairstown township, Warren County, New Jersey",34041,ONJ,4080,4272,192,8556,64,30,228,11266,22,11494,50,11100,municipality,2000
3404106160,"Blairstown township, Warren County, New Jersey",34041,ONJ,2124,2272,148,4541,68,63,226,5741,8,5967,44,5558,municipality,2010
3404124960,"Franklin township, Warren County, New Jersey",34041,ONJ,1944,2038,94,3940,48,44,110,5426,4,5536,48,5282,municipality,2000
3404124960,"Franklin township, Warren County, New Jersey",34041,ONJ,1122,1219,97,2385,74,47,122,3054,7,3176,39,2887,municipality,2010
3404125320,"Frelinghuysen township, Warren County, New Jersey",34041,ONJ,1444,1510,66,3080,16,14,110,4056,10,4166,28,3988,municipality,2000
3404125320,"Frelinghuysen township, Warren County, New Jersey",34041,ONJ,760,826,66,1748,12,14,57,2173,3,2230,19,2125,municipality,2010
3404128260,"Greenwich township, Warren County, New Jersey",34041,ONJ,2842,2954,112,5794,194,212,332,8398,16,8730,64,7912,municipality,2000
3404128260,"Greenwich township, Warren County, New Jersey",34041,ONJ,1808,1870,62,3826,343,355,364,5348,17,5712,77,4556,municipality,2010
3404128710,"Hackettstown town, Warren County, New Jersey",34041,ONJ,8268,8694,426,16086,602,442,1666,19140,80,20806,388,17628,municipality,2000
3404128710,"Hackettstown town, Warren County, New Jersey",34041,ONJ,3575,3755,180,7747,478,210,1474,8250,46,9724,109,7407,municipality,2010
3404129820,"Hardwick township, Warren County, New Jersey",34041,ONJ,1004,1060,56,2150,12,16,68,2860,6,2928,14,2812,municipality,2000
3404129820,"Hardwick township, Warren County, New Jersey",34041,ONJ,573,619,46,1275,11,14,67,1629,0,1696,9,1595,municipality,2010
3404130090,"Harmony township, Warren County, New Jersey",34041,ONJ,2020,2152,132,4142,22,38,70,5388,4,5458,38,5286,municipality,2000
3404130090,"Harmony township, Warren County, New Jersey",34041,ONJ,1017,1109,92,2108,5,18,35,2632,5,2667,14,2590,municipality,2010
3404133060,"Hope township, Warren County, New Jersey",34041,ONJ,1394,1494,100,2782,16,16,56,3726,0,3782,28,3666,municipality,2000
3404133060,"Hope township, Warren County, New Jersey",34041,ONJ,741,809,68,1511,31,23,80,1872,1,1952,11,1806,municipality,2010
3404133930,"Independence township, Warren County, New Jersey",34041,ONJ,4292,4420,128,8208,188,130,422,10784,14,11206,120,10332,municipality,2000
3404133930,"Independence township, Warren County, New Jersey",34041,ONJ,2234,2325,91,4338,126,64,307,5355,18,5662,60,5087,municipality,2010
3404137320,"Knowlton township, Warren County, New Jersey",34041,ONJ,2056,2270,214,4308,38,22,110,5844,6,5954,52,5726,municipality,2000
3404137320,"Knowlton township, Warren County, New Jersey",34041,ONJ,1097,1212,115,2342,28,27,111,2944,14,3055,29,2846,municipality,2010
3404140110,"Liberty township, Warren County, New Jersey",34041,ONJ,1960,2176,216,3962,32,20,148,5382,10,5530,46,5274,municipality,2000
3404140110,"Liberty township, Warren County, New Jersey",34041,ONJ,1047,1151,104,2228,41,30,122,2820,8,2942,26,2715,municipality,2010
3404141490,"Lopatcong township, Warren County, New Jersey",34041,ONJ,4286,4858,572,8702,188,124,230,11300,18,11530,42,10928,municipality,2000
3404141490,"Lopatcong township, Warren County, New Jersey",34041,ONJ,3136,3420,284,6162,334,458,480,7534,19,8014,93,6630,municipality,2010
3404143320,"Mansfield township, Warren County, New Jersey",34041,ONJ,4668,4830,162,9714,162,562,582,12724,68,13306,184,11748,municipality,2000
3404143320,"Mansfield township, Warren County, New Jersey",34041,ONJ,2972,3316,344,5959,248,355,845,6880,29,7725,110,6138,municipality,2010
3404155530,"Oxford township, Warren County, New Jersey",34041,ONJ,1772,1876,104,3346,24,54,160,4454,4,4614,20,4352,municipality,2000
3404155530,"Oxford township, Warren County, New Jersey",34041,ONJ,950,1033,83,1910,38,40,95,2419,1,2514,24,2316,municipality,2010
3404158350,"Phillipsburg town, Warren County, New Jersey",34041,ONJ,12088,13302,1214,22256,252,1004,1632,28700,58,30332,396,26990,municipality,2000
3404158350,"Phillipsburg town, Warren County, New Jersey",34041,ONJ,5925,6607,682,11096,222,1037,1767,13183,39,14950,330,11555,municipality,2010
3404159820,"Pohatcong township, Warren County, New Jersey",34041,ONJ,2682,2822,140,5242,20,30,138,6694,4,6832,36,6604,municipality,2000
3404159820,"Pohatcong township, Warren County, New Jersey",34041,ONJ,1310,1420,110,2584,30,53,116,3223,3,3339,38,3099,municipality,2010
3404177270,"Washington borough, Warren County, New Jersey",34041,ONJ,5448,5752,304,9864,192,500,560,12864,40,13424,138,11994,municipality,2000
3404177270,"Washington borough, Warren County, New Jersey",34041,ONJ,2623,2897,274,4914,217,372,549,5912,14,6461,115,5194,municipality,2010
3404177300,"Washington township, Warren County, New Jersey",34041,ONJ,4198,4348,150,8746,118,206,270,12226,12,12496,70,11820,municipality,2000
3404177300,"Washington township, Warren County, New Jersey",34041,ONJ,2380,2493,113,4999,126,152,292,6359,13,6651,65,6003,municipality,2010
3404180570,"White township, Warren County, New Jersey",34041,ONJ,3336,3540,204,6598,50,102,180,8310,24,8490,88,8046,municipality,2000
3404180570,"White township, Warren County, New Jersey",34041,ONJ,2115,2304,189,4053,35,92,134,4748,8,4882,44,4569,municipality,2010
3600508510,"Bronx borough, Bronx County, New York",36005,NYC,926424,981318,54894,1870556,77116,832676,1289410,1375890,24378,2665300,54418,387302,municipality,2000
3600508510,"Bronx borough, Bronx County, New York",36005,NYC,483449,511896,28447,1016912,47335,416695,741413,643695,12494,1385108,15962,151209,municipality,2010
3602701693,"Amenia town, Dutchess County, New York",36027,MHV,3250,3628,378,6180,38,234,272,7824,58,8096,118,7376,municipality,2000
3602701693,"Amenia town, Dutchess County, New York",36027,MHV,1741,2045,304,3529,61,172,376,4060,25,4436,82,3720,municipality,2010
3602705100,"Beacon city, Dutchess County, New York",36027,MHV,10182,10812,630,20130,350,5112,4668,22948,114,27616,618,16754,municipality,2000
3602705100,"Beacon city, Dutchess County, New York",36027,MHV,5347,5715,368,12429,250,3232,3219,12322,105,15541,402,8333,municipality,2010
3602705452,"Beekman town, Dutchess County, New York",36027,MHV,7502,8360,858,15824,388,528,1232,21672,66,22904,268,20422,municipality,2000
3602705452,"Beekman town, Dutchess County, New York",36027,MHV,4251,4797,546,11146,387,1559,1332,13289,90,14621,186,11067,municipality,2010
3602716408,"Clinton town, Dutchess County, New York",36027,MHV,3004,3468,464,6036,80,116,140,7880,28,8020,58,7598,municipality,2000
3602716408,"Clinton town, Dutchess County, New York",36027,MHV,1602,1915,313,3369,50,97,161,4151,18,4312,56,3930,municipality,2010
3602720819,"Dover town, Dutchess County, New York",36027,MHV,6068,6532,464,12134,168,880,968,16162,102,17130,258,14754,municipality,2000
3602720819,"Dover town, Dutchess County, New York",36027,MHV,3259,3637,378,6632,115,379,1199,7500,20,8699,158,6828,municipality,2010
3602721996,"East Fishkill town, Dutchess County, New York",36027,MHV,16466,16990,524,35954,1426,1126,2070,49108,120,51178,546,45890,municipality,2000
3602721996,"East Fishkill town, Dutchess County, New York",36027,MHV,9512,10039,527,21216,1162,918,2224,26805,91,29029,339,24295,municipality,2010
3602725978,"Fishkill town, Dutchess County, New York",36027,MHV,13712,14080,368,33108,1200,5468,4242,36274,138,40516,276,29192,municipality,2000
3602725978,"Fishkill town, Dutchess County, New York",36027,MHV,8642,9246,604,17751,1695,2083,2420,19687,112,22107,318,15479,municipality,2010
3602737209,"Hyde Park town, Dutchess County, New York",36027,MHV,14790,15408,618,31394,576,1692,1348,40354,188,41702,642,37256,municipality,2000
3602737209,"Hyde Park town, Dutchess County, New York",36027,MHV,7829,8416,587,17376,526,1210,1204,20367,92,21571,396,18143,municipality,2010
3602740299,"La Grange town, Dutchess County, New York",36027,MHV,10170,10480,310,21340,868,680,1272,28584,100,29856,336,26600,municipality,2000
3602740299,"La Grange town, Dutchess County, New York",36027,MHV,5440,5668,228,11710,630,545,1116,14614,56,15730,195,13188,municipality,2010
3602747207,"Milan town, Dutchess County, New York",36027,MHV,1764,2180,416,7826,68,2372,1430,7688,72,9118,56,5120,municipality,2000
3602747207,"Milan town, Dutchess County, New York",36027,MHV,964,1279,315,1848,12,35,105,2265,8,2370,21,2189,municipality,2010
3602751891,"North East town, Dutchess County, New York",36027,MHV,2292,2732,440,4620,34,126,196,5808,8,6004,54,5586,municipality,2000
3602751891,"North East town, Dutchess County, New York",36027,MHV,1259,1627,368,2407,32,74,275,2756,18,3031,38,2594,municipality,2010
3602756825,"Pawling town, Dutchess County, New York",36027,MHV,5646,6202,556,11234,190,202,730,14312,30,15042,136,13754,municipality,2000
3602756825,"Pawling town, Dutchess County, New York",36027,MHV,3093,3593,500,6379,183,211,865,7598,19,8463,83,7102,municipality,2010
3602758156,"Pine Plains town, Dutchess County, New York",36027,MHV,1976,2322,346,3808,34,46,70,5068,42,5138,54,4892,municipality,2000
3602758156,"Pine Plains town, Dutchess County, New York",36027,MHV,1007,1284,277,1950,26,29,172,2301,5,2473,33,2208,municipality,2010
3602758695,"Pleasant Valley town, Dutchess County, New York",36027,MHV,6934,7228,294,13400,116,332,480,17652,42,18132,174,16988,municipality,2000
3602758695,"Pleasant Valley town, Dutchess County, New York",36027,MHV,3765,4049,284,7426,109,264,452,9220,28,9672,182,8637,municipality,2010
3602759641,"Poughkeepsie city, Dutchess County, New York",36027,MHV,24028,26306,2278,44242,960,20708,6354,53388,354,59742,1954,29412,municipality,2000
3602759641,"Poughkeepsie city, Dutchess County, New York",36027,MHV,12400,13984,1584,25468,521,10407,6384,26352,171,32736,1001,14252,municipality,2010
3602759652,"Poughkeepsie town, Dutchess County, New York",36027,MHV,29210,30264,1054,66238,4354,6652,4508,81046,226,85554,1352,68462,municipality,2000
3602759652,"Poughkeepsie town, Dutchess County, New York",36027,MHV,15276,16116,840,34248,2614,3983,4233,39108,191,43341,1066,31254,municipality,2010
3602760905,"Red Hook town, Dutchess County, New York",36027,MHV,7148,7680,532,15636,430,270,552,20264,80,20816,264,19220,municipality,2000
3602760905,"Red Hook town, Dutchess County, New York",36027,MHV,3942,4384,442,9092,272,190,555,10764,44,11319,169,10089,municipality,2010
3602761357,"Rhinebeck town, Dutchess County, New York",36027,MHV,6002,6510,508,12378,212,534,612,14912,16,15524,160,13990,municipality,2000
3602761357,"Rhinebeck town, Dutchess County, New York",36027,MHV,3158,3653,495,6280,132,185,387,7161,25,7548,81,6738,municipality,2010
3602770662,"Stanford town, Dutchess County, New York",36027,MHV,2796,3424,628,5432,78,108,188,6900,30,7088,86,6598,municipality,2000
3602770662,"Stanford town, Dutchess County, New York",36027,MHV,1496,1913,417,2969,39,64,219,3604,21,3823,57,3423,municipality,2010
3602776166,"Union Vale town, Dutchess County, New York",36027,MHV,2718,2928,210,6466,108,214,312,8780,12,9092,88,8358,municipality,2000
3602776166,"Union Vale town, Dutchess County, New York",36027,MHV,1708,1911,203,3657,110,74,227,4650,4,4877,56,4406,municipality,2010
3602778157,"Wappinger town, Dutchess County, New York",36027,MHV,19586,20288,702,39212,2240,2470,4136,48412,170,52548,668,42864,municipality,2000
3602778157,"Wappinger town, Dutchess County, New York",36027,MHV,10318,10908,590,20964,1341,1564,3860,23188,101,27048,441,19741,municipality,2010
3602778388,"Washington town, Dutchess County, New York",36027,MHV,3828,4384,556,7172,62,248,340,9144,14,9484,80,8740,municipality,2000
3602778388,"Washington town, Dutchess County, New York",36027,MHV,1956,2459,503,3673,63,120,282,4459,26,4741,54,4196,municipality,2010
3604710022,"Brooklyn borough, Kings County, New York",36047,NYC,1761454,1861732,100278,3605654,368582,1697166,975756,3954896,42708,4930652,137376,1709064,municipality,2000
3604710022,"Brooklyn borough, Kings County, New York",36047,NYC,916856,1000293,83437,1910322,260129,799066,496285,2008415,15904,2504700,40010,893306,municipality,2010
3601011,"Albertson CDP, New York",36059,LI,1812,1853,41,4032,754,8,286,4914,5,5200,80,4067,municipality,2000
3601011,"Albertson CDP, New York",36059,LI,1789,1850,61,4048,1256,12,377,4805,26,5182,126,3385,municipality,2010
3602968,"Atlantic Beach village, New York",36059,LI,766,954,188,1598,16,14,59,1927,1,1986,14,1882,municipality,2000
3602968,"Atlantic Beach village, New York",36059,LI,857,1091,234,1553,18,12,74,1817,1,1891,10,1776,municipality,2010
3604143,"Baldwin CDP, New York",36059,LI,10621,10786,165,23403,1141,5926,3282,28320,174,31602,581,20498,municipality,2000
3604143,"Baldwin CDP, New York",36059,LI,10447,10783,336,24334,1371,9941,5821,26314,290,32135,708,14004,municipality,2010
3604550,"Barnum Island CDP, New York",36059,LI,836,854,18,2039,56,8,256,2231,8,2487,33,2126,municipality,2000
3604550,"Barnum Island CDP, New York",36059,LI,843,889,46,1987,64,22,377,2037,18,2414,19,1914,municipality,2010
3604803,"Baxter Estates village, New York",36059,LI,376,386,10,757,72,23,147,859,1,1006,16,747,municipality,2000
3604803,"Baxter Estates village, New York",36059,LI,382,411,29,777,60,12,168,831,2,999,14,743,municipality,2010
3604891,"Bay Park CDP, New York",36059,LI,874,892,18,1800,22,6,97,2203,1,2300,23,2151,municipality,2000
3604891,"Bay Park CDP, New York",36059,LI,867,903,36,1743,37,6,141,2071,1,2212,13,2014,municipality,2010
3605034,"Bayville village, New York",36059,LI,2566,2683,117,5451,117,20,344,6791,14,7135,33,6607,municipality,2000
3605034,"Bayville village, New York",36059,LI,2471,2651,180,5220,112,18,433,6236,25,6669,68,6013,municipality,2010
3605639,"Bellerose village, New York",36059,LI,378,384,6,875,78,5,51,1122,2,1173,10,1027,municipality,2000
3605639,"Bellerose village, New York",36059,LI,375,378,3,869,52,35,113,1080,9,1193,20,964,municipality,2010
3605661,"Bellerose Terrace CDP, New York",36059,LI,639,649,10,1557,337,122,429,1728,38,2157,55,1176,municipality,2000
3605661,"Bellerose Terrace CDP, New York",36059,LI,633,665,32,1668,611,168,568,1630,38,2198,49,764,municipality,2010
3605738,"Bellmore CDP, New York",36059,LI,5643,5724,81,12283,329,69,515,15926,28,16441,111,15389,municipality,2000
3605738,"Bellmore CDP, New York",36059,LI,5669,5807,138,12324,477,158,922,15296,40,16218,143,14478,municipality,2010
3606387,"Bethpage CDP, New York",36059,LI,5710,5788,78,12790,494,36,785,15758,17,16543,145,15066,municipality,2000
3606387,"Bethpage CDP, New York",36059,LI,5875,6051,176,12908,895,90,1152,15277,33,16429,164,14095,municipality,2010
3610132,"Brookville village, New York",36059,LI,631,648,17,1428,131,43,57,2069,5,2126,24,1866,municipality,2000
3610132,"Brookville village, New York",36059,LI,612,663,51,2895,351,372,219,3246,16,3465,22,2485,municipality,2010
3612419,"Carle Place CDP, New York",36059,LI,1900,1922,22,4051,286,89,408,4839,6,5247,31,4427,municipality,2000
3612419,"Carle Place CDP, New York",36059,LI,1863,1932,69,3927,391,90,552,4429,18,4981,49,3881,municipality,2010
3613233,"Cedarhurst village, New York",36059,LI,2289,2366,77,4617,190,70,515,5649,22,6164,73,5294,municipality,2000
3613233,"Cedarhurst village, New York",36059,LI,2242,2375,133,4668,236,134,705,5887,44,6592,50,5423,municipality,2010
3613618,"Centre Island village, New York",36059,LI,174,209,35,351,4,2,14,430,0,444,3,421,municipality,2000
3613618,"Centre Island village, New York",36059,LI,168,232,64,328,15,0,30,380,3,410,0,362,municipality,2010
3618597,"Cove Neck village, New York",36059,LI,110,140,30,221,12,0,13,287,0,300,0,275,municipality,2000
3618597,"Cove Neck village, New York",36059,LI,104,148,44,214,4,1,14,272,0,286,3,264,municipality,2010
3621578,"East Atlantic Beach CDP, New York",36059,LI,887,965,78,1774,20,7,80,2177,6,2257,14,2130,municipality,2000
3621578,"East Atlantic Beach CDP, New York",36059,LI,849,972,123,1680,22,12,109,1940,1,2049,16,1889,municipality,2010
3622260,"East Hills village, New York",36059,LI,2245,2275,30,4799,330,53,101,6741,21,6842,49,6288,municipality,2000
3622260,"East Hills village, New York",36059,LI,2252,2301,49,4893,513,66,156,6799,4,6955,76,6140,municipality,2010
3622480,"East Massapequa CDP, New York",36059,LI,6432,6535,103,14652,435,2328,1466,18099,62,19565,261,15013,municipality,2000
3622480,"East Massapequa CDP, New York",36059,LI,6599,6796,197,14739,404,2298,1929,17140,67,19069,273,14098,municipality,2010
3622502,"East Meadow CDP, New York",36059,LI,12186,12375,189,28703,2493,1513,2626,34835,75,37461,399,30355,municipality,2000
3622502,"East Meadow CDP, New York",36059,LI,12410,12863,453,30262,4400,1867,4653,33479,133,38132,451,26628,municipality,2010
3622623,"East Norwich CDP, New York",36059,LI,938,950,12,2051,66,16,85,2590,3,2675,15,2490,municipality,2000
3622623,"East Norwich CDP, New York",36059,LI,943,966,23,2021,92,19,118,2591,2,2709,25,2453,municipality,2010
3622876,"East Rockaway village, New York",36059,LI,3926,4003,77,7942,177,56,603,9811,8,10414,52,9518,municipality,2000
3622876,"East Rockaway village, New York",36059,LI,3825,3997,172,7628,200,127,788,9030,22,9818,64,8617,municipality,2010
3623217,"East Williston village, New York",36059,LI,833,846,13,1796,84,9,59,2444,7,2503,10,2334,municipality,2000
3623217,"East Williston village, New York",36059,LI,842,864,22,1814,99,8,110,2446,0,2556,23,2316,municipality,2010
3624273,"Elmont CDP, New York",36059,LI,9902,10151,249,24022,2958,10902,4672,27985,437,32657,1057,12631,municipality,2000
3624273,"Elmont CDP, New York",36059,LI,9847,10279,432,25337,3609,14587,7236,25962,556,33198,716,6494,municipality,2010
3625384,"Farmingdale village, New York",36059,LI,3216,3289,73,6617,311,116,1056,7343,30,8399,97,6789,municipality,2000
3625384,"Farmingdale village, New York",36059,LI,3326,3482,156,6700,445,199,1122,7067,29,8189,79,6315,municipality,2010
3626264,"Floral Park village, New York",36059,LI,5770,5892,122,12063,617,59,859,15108,43,15967,99,14290,municipality,2000
3626264,"Floral Park village, New York",36059,LI,5680,5909,229,12198,1086,198,1391,14472,66,15863,184,12938,municipality,2010
3626352,"Flower Hill village, New York",36059,LI,1477,1514,37,3332,465,46,181,4327,6,4508,84,3726,municipality,2000
3626352,"Flower Hill village, New York",36059,LI,1473,1523,50,3326,591,34,271,4394,7,4665,92,3670,municipality,2010
3627309,"Franklin Square CDP, New York",36059,LI,10187,10364,177,22893,1105,277,2023,27319,90,29342,290,25557,municipality,2000
3627309,"Franklin Square CDP, New York",36059,LI,9941,10313,372,23111,2100,845,3885,25435,175,29320,303,22012,municipality,2010
3627485,"Freeport village, New York",36059,LI,13504,13819,315,32240,579,13610,14648,29135,272,43783,839,13835,municipality,2000
3627485,"Freeport village, New York",36059,LI,13279,13865,586,32852,669,13226,17858,25002,277,42860,717,10113,municipality,2010
3628178,"Garden City village, New York",36059,LI,7386,7555,169,15924,706,254,600,21072,36,21672,138,19938,municipality,2000
3628178,"Garden City village, New York",36059,LI,7366,7647,281,16462,792,294,1003,21368,36,22371,212,20034,municipality,2010
3628189,"Garden City Park CDP, New York",36059,LI,2508,2548,40,5864,1541,308,611,6943,47,7554,140,4907,municipality,2000
3628189,"Garden City Park CDP, New York",36059,LI,2533,2603,70,6135,2578,282,942,6864,71,7806,143,3790,municipality,2010
3628200,"Garden City South CDP, New York",36059,LI,1399,1411,12,3089,122,12,233,3741,4,3974,12,3591,municipality,2000
3628200,"Garden City South CDP, New York",36059,LI,1384,1429,45,3132,229,33,317,3707,8,4024,23,3414,municipality,2010
3629113,"Glen Cove city, New York",36059,LI,9461,9734,273,20979,1082,1614,5336,21286,77,26622,369,18144,municipality,2000
3629113,"Glen Cove city, New York",36059,LI,9764,10352,588,21403,1235,1728,7513,19451,123,26964,352,16013,municipality,2010
3629245,"Glen Head CDP, New York",36059,LI,1681,1717,36,3521,90,22,213,4412,4,4625,32,4264,municipality,2000
3629245,"Glen Head CDP, New York",36059,LI,1718,1784,66,3594,158,36,380,4317,21,4697,52,4050,municipality,2010
3629421,"Glenwood Landing CDP, New York",36059,LI,1262,1284,22,2613,92,10,118,3423,5,3541,29,3287,municipality,2000
3629421,"Glenwood Landing CDP, New York",36059,LI,1336,1400,64,2800,140,29,232,3547,3,3779,42,3333,municipality,2010
3630169,"Great Neck village, New York",36059,LI,3346,3441,95,7023,470,255,875,8663,38,9538,255,7645,municipality,2000
3630169,"Great Neck village, New York",36059,LI,3473,3645,172,7371,721,176,1015,8974,19,9989,309,7749,municipality,2010
3630191,"Great Neck Estates village, New York",36059,LI,919,944,25,2014,133,23,72,2684,2,2756,31,2495,municipality,2000
3630191,"Great Neck Estates village, New York",36059,LI,902,937,35,2014,281,21,80,2681,6,2761,37,2336,municipality,2010
3630202,"Great Neck Gardens CDP, New York",36059,LI,376,381,5,781,81,8,25,1064,1,1089,18,956,municipality,2000
3630202,"Great Neck Gardens CDP, New York",36059,LI,393,401,8,859,143,9,20,1166,6,1186,40,968,municipality,2010
3630213,"Great Neck Plaza village, New York",36059,LI,3603,3925,322,5686,194,98,469,5964,15,6433,97,5560,municipality,2000
3630213,"Great Neck Plaza village, New York",36059,LI,3690,4052,362,5793,769,88,526,6181,26,6707,93,5205,municipality,2010
3630598,"Greenvale CDP, New York",36059,LI,362,372,10,2008,232,256,292,1939,14,2231,50,1387,municipality,2000
3630598,"Greenvale CDP, New York",36059,LI,358,373,15,826,206,20,149,945,1,1094,31,687,municipality,2010
3632094,"Harbor Hills CDP, New York",36059,LI,181,186,5,382,12,2,7,556,0,563,7,535,municipality,2000
3632094,"Harbor Hills CDP, New York",36059,LI,180,190,10,394,30,0,11,564,0,575,4,530,municipality,2010
3632105,"Harbor Isle CDP, New York",36059,LI,490,497,7,1046,15,1,45,1289,1,1334,3,1269,municipality,2000
3632105,"Harbor Isle CDP, New York",36059,LI,470,495,25,1034,21,4,77,1224,3,1301,18,1178,municipality,2010
3633139,"Hempstead village, New York",36059,LI,15188,15579,391,41709,736,28729,17991,38563,388,56554,1250,7460,municipality,2000
3633139,"Hempstead village, New York",36059,LI,15234,16034,800,40087,704,24724,23823,30068,330,53891,762,3548,municipality,2010
3634198,"Herricks CDP, New York",36059,LI,1349,1371,22,3103,989,12,170,3906,10,4076,40,2855,municipality,2000
3634198,"Herricks CDP, New York",36059,LI,1343,1378,35,3228,1854,19,169,4126,26,4295,90,2137,municipality,2010
3634286,"Hewlett CDP, New York",36059,LI,2634,2735,101,5359,335,58,612,6448,11,7060,53,5991,municipality,2000
3634286,"Hewlett CDP, New York",36059,LI,2547,2708,161,5262,480,152,727,6092,17,6819,80,5363,municipality,2010
3634297,"Hewlett Bay Park village, New York",36059,LI,157,163,6,358,19,7,23,461,1,484,5,429,municipality,2000
3634297,"Hewlett Bay Park village, New York",36059,LI,131,145,14,303,23,0,22,382,2,404,1,356,municipality,2010
3634308,"Hewlett Harbor village, New York",36059,LI,429,437,8,898,40,5,14,1257,5,1271,5,1202,municipality,2000
3634308,"Hewlett Harbor village, New York",36059,LI,418,442,24,923,49,10,30,1233,11,1263,3,1160,municipality,2010
3634319,"Hewlett Neck village, New York",36059,LI,155,163,8,337,1,4,5,499,1,504,0,493,municipality,2000
3634319,"Hewlett Neck village, New York",36059,LI,145,159,14,313,9,17,9,436,0,445,3,407,municipality,2010
3634374,"Hicksville CDP, New York",36059,LI,13710,13912,202,31959,3714,538,3819,37441,103,41260,441,32645,municipality,2000
3634374,"Hicksville CDP, New York",36059,LI,13412,13761,349,32786,8139,836,6043,35504,198,41547,728,25603,municipality,2010
3637583,"Inwood CDP, New York",36059,LI,3041,3132,91,6735,190,2356,2454,6871,80,9325,226,4019,municipality,2000
3637583,"Inwood CDP, New York",36059,LI,2964,3153,189,7223,322,2258,4190,5602,114,9792,122,2786,municipality,2010
3637847,"Island Park village, New York",36059,LI,1685,1740,55,3657,50,31,864,3868,19,4732,74,3694,municipality,2000
3637847,"Island Park village, New York",36059,LI,1603,1715,112,3730,115,64,1234,3421,24,4655,48,3170,municipality,2010
3638539,"Jericho CDP, New York",36059,LI,4545,4600,55,9747,1387,179,318,12727,13,13045,114,11034,municipality,2000
3638539,"Jericho CDP, New York",36059,LI,4628,4782,154,10220,3442,247,401,13166,26,13567,154,9297,municipality,2010
3639309,"Kensington village, New York",36059,LI,424,447,23,880,60,8,48,1161,0,1209,14,1079,municipality,2000
3639309,"Kensington village, New York",36059,LI,411,448,37,868,101,8,26,1135,3,1161,35,988,municipality,2010
3639694,"Kings Point village, New York",36059,LI,1401,1455,54,3851,180,43,99,4977,9,5076,152,4593,municipality,2000
3639694,"Kings Point village, New York",36059,LI,1293,1386,93,3765,167,40,84,4921,7,5005,192,4515,municipality,2010
3640937,"Lake Success village, New York",36059,LI,798,824,26,2236,424,131,33,2764,7,2797,23,2179,municipality,2000
3640937,"Lake Success village, New York",36059,LI,799,826,27,2330,791,96,81,2853,14,2934,32,1920,municipality,2010
3641003,"Lakeview CDP, New York",36059,LI,1525,1569,44,4022,27,4674,389,5218,54,5607,173,290,municipality,2000
3641003,"Lakeview CDP, New York",36059,LI,1487,1552,65,4084,44,4399,853,4762,51,5615,140,128,municipality,2010
3641432,"Lattingtown village, New York",36059,LI,627,688,61,1373,65,10,43,1817,2,1860,15,1725,municipality,2000
3641432,"Lattingtown village, New York",36059,LI,614,707,93,1303,47,8,41,1698,1,1739,26,1616,municipality,2010
3641487,"Laurel Hollow village, New York",36059,LI,598,621,23,1343,132,17,38,1892,0,1930,11,1732,municipality,2000
3641487,"Laurel Hollow village, New York",36059,LI,602,635,33,1403,149,29,45,1907,3,1952,18,1708,municipality,2010
3641553,"Lawrence village, New York",36059,LI,2113,2287,174,4393,113,64,223,6299,3,6522,37,6082,municipality,2000
3641553,"Lawrence village, New York",36059,LI,2045,2280,235,4501,108,86,185,6298,6,6483,23,6075,municipality,2010
3642081,"Levittown CDP, New York",36059,LI,17207,17410,203,39423,1493,247,3601,49466,96,53067,379,47251,municipality,2000
3642081,"Levittown CDP, New York",36059,LI,16973,17287,314,40026,2937,403,5979,45902,179,51881,569,41814,municipality,2010
3642279,"Lido Beach CDP, New York",36059,LI,1149,1325,176,2208,45,16,81,2744,4,2825,22,2657,municipality,2000
3642279,"Lido Beach CDP, New York",36059,LI,1192,1403,211,2284,51,18,105,2792,4,2897,29,2690,municipality,2010
3643192,"Locust Valley CDP, New York",36059,LI,1279,1324,45,2684,70,127,512,3009,5,3521,34,2773,municipality,2000
3643192,"Locust Valley CDP, New York",36059,LI,1208,1281,73,2507,82,99,600,2806,5,3406,32,2588,municipality,2010
3643335,"Long Beach city, New York",36059,LI,14923,16128,1205,28885,814,2071,4540,30922,259,35462,450,27328,municipality,2000
3643335,"Long Beach city, New York",36059,LI,14809,16450,1641,27853,881,1958,4691,28584,226,33275,402,25117,municipality,2010
3643874,"Lynbrook village, New York",36059,LI,7369,7570,201,15438,593,174,1648,18263,43,19911,168,17285,municipality,2000
3643874,"Lynbrook village, New York",36059,LI,7513,7921,408,15194,867,648,2534,16893,69,19427,219,15090,municipality,2010
3644787,"Malverne village, New York",36059,LI,3106,3152,46,6869,273,144,537,8397,14,8934,79,7887,municipality,2000
3644787,"Malverne village, New York",36059,LI,3076,3146,70,6766,354,260,736,7778,27,8514,71,7066,municipality,2010
3644792,"Malverne Park Oaks CDP, New York",36059,LI,175,175,0,363,20,17,35,435,0,470,0,398,municipality,2000
3644792,"Malverne Park Oaks CDP, New York",36059,LI,183,189,6,407,19,27,44,461,2,505,9,404,municipality,2010
3644897,"Manhasset CDP, New York",36059,LI,2831,2917,86,6336,574,994,599,7763,17,8362,103,6075,municipality,2000
3644897,"Manhasset CDP, New York",36059,LI,2790,2893,103,5984,877,744,711,7369,31,8080,88,5629,municipality,2010
3644908,"Manhasset Hills CDP, New York",36059,LI,1224,1235,11,2776,985,11,121,3540,13,3661,51,2480,municipality,2000
3644908,"Manhasset Hills CDP, New York",36059,LI,1184,1241,57,2771,1412,22,210,3382,6,3592,74,1868,municipality,2010
3645106,"Manorhaven village, New York",36059,LI,2401,2471,70,4771,820,73,1197,4941,21,6138,124,3903,municipality,2000
3645106,"Manorhaven village, New York",36059,LI,2442,2597,155,5088,1150,90,1775,4781,10,6556,84,3447,municipality,2010
3645986,"Massapequa CDP, New York",36059,LI,7417,7514,97,16863,287,35,587,22065,17,22652,120,21606,municipality,2000
3645986,"Massapequa CDP, New York",36059,LI,7226,7407,181,16370,350,70,900,20785,25,21685,142,20198,municipality,2010
3645997,"Massapequa Park village, New York",36059,LI,5762,5809,47,13073,243,37,525,16974,8,17499,72,16614,municipality,2000
3645997,"Massapequa Park village, New York",36059,LI,5731,5844,113,12827,255,52,757,16251,6,17008,80,15858,municipality,2010
3646107,"Matinecock village, New York",36059,LI,285,313,28,612,13,8,32,804,0,836,8,775,municipality,2000
3646107,"Matinecock village, New York",36059,LI,272,323,51,593,16,14,50,760,0,810,3,727,municipality,2010
3646668,"Merrick CDP, New York",36059,LI,7524,7602,78,16499,505,109,842,21922,42,22764,169,21097,municipality,2000
3646668,"Merrick CDP, New York",36059,LI,7448,7622,174,16603,619,246,1301,20796,34,22097,205,19692,municipality,2010
3647405,"Mill Neck village, New York",36059,LI,295,326,31,633,39,2,46,779,4,825,4,730,municipality,2000
3647405,"Mill Neck village, New York",36059,LI,379,440,61,803,61,12,57,940,9,997,9,849,municipality,2010
3647636,"Mineola village, New York",36059,LI,7473,7650,177,15350,862,179,2507,16727,78,19234,381,15227,municipality,2000
3647636,"Mineola village, New York",36059,LI,7396,7701,305,15150,1579,321,3090,15709,144,18799,223,13442,municipality,2010
3649231,"Munsey Park village, New York",36059,LI,817,833,16,1821,149,8,43,2589,0,2632,15,2417,municipality,2000
3649231,"Munsey Park village, New York",36059,LI,819,840,21,1814,173,11,87,2606,1,2693,41,2380,municipality,2010
3649330,"Muttontown village, New York",36059,LI,1022,1048,26,2391,546,60,78,3334,6,3412,60,2662,municipality,2000
3649330,"Muttontown village, New York",36059,LI,1071,1125,54,2553,794,54,119,3378,14,3497,31,2485,municipality,2010
3650067,"New Cassel CDP, New York",36059,LI,2972,3067,95,9461,182,6082,5467,7831,45,13298,328,1194,municipality,2000
3650067,"New Cassel CDP, New York",36059,LI,2974,3174,200,10161,174,5225,7577,6482,55,14059,187,841,municipality,2010
3650397,"New Hyde Park village, New York",36059,LI,3290,3353,63,7421,1268,52,756,8767,34,9523,92,7321,municipality,2000
3650397,"New Hyde Park village, New York",36059,LI,3271,3371,100,7623,2521,104,1184,8528,91,9712,170,5642,municipality,2010
3651517,"North Bellmore CDP, New York",36059,LI,6555,6634,79,14965,632,418,913,19166,31,20079,197,17888,municipality,2000
3651517,"North Bellmore CDP, New York",36059,LI,6650,6818,168,15252,904,492,1539,18402,59,19941,243,16704,municipality,2010
3653022,"North Hills village, New York",36059,LI,1808,1907,99,3677,681,32,62,4239,1,4301,62,3463,municipality,2000
3653022,"North Hills village, New York",36059,LI,2259,2438,179,4357,1283,54,112,4963,7,5075,89,3530,municipality,2010
3653231,"North Lynbrook CDP, New York",36059,LI,223,228,5,587,26,21,78,664,0,742,5,612,municipality,2000
3653231,"North Lynbrook CDP, New York",36059,LI,231,231,0,641,41,26,119,674,6,793,15,586,municipality,2010
3653253,"North Massapequa CDP, New York",36059,LI,6281,6333,52,14478,221,34,619,18533,16,19152,107,18155,municipality,2000
3653253,"North Massapequa CDP, New York",36059,LI,6084,6212,128,13779,315,46,968,16918,17,17886,110,16430,municipality,2010
3653264,"North Merrick CDP, New York",36059,LI,3963,4004,41,8864,375,119,436,11408,31,11844,131,10752,municipality,2000
3653264,"North Merrick CDP, New York",36059,LI,4044,4125,81,9187,567,169,869,11403,10,12272,120,10537,municipality,2010
3653275,"North New Hyde Park CDP, New York",36059,LI,5032,5116,84,11346,2152,43,707,13835,50,14542,115,11475,municipality,2000
3653275,"North New Hyde Park CDP, New York",36059,LI,4888,5016,128,11543,4329,90,1078,13821,73,14899,270,9059,municipality,2010
3653748,"North Valley Stream CDP, New York",36059,LI,4860,4951,91,11684,1414,5695,1709,14080,168,15789,525,6278,municipality,2000
3653748,"North Valley Stream CDP, New York",36059,LI,5113,5548,435,12755,2132,7720,2411,14217,223,16628,377,3765,municipality,2010
3653792,"North Wantagh CDP, New York",36059,LI,4332,4374,42,9292,215,45,556,11600,8,12156,84,11248,municipality,2000
3653792,"North Wantagh CDP, New York",36059,LI,4230,4321,91,9232,294,77,897,11063,7,11960,88,10597,municipality,2010
3654441,"Oceanside CDP, New York",36059,LI,11224,11396,172,24556,590,173,1931,30802,81,32733,174,29784,municipality,2000
3654441,"Oceanside CDP, New York",36059,LI,11249,11604,355,24889,879,356,2970,29139,82,32109,226,27596,municipality,2010
3654551,"Old Bethpage CDP, New York",36059,LI,1834,1843,9,4091,159,63,104,5296,10,5400,42,5022,municipality,2000
3654551,"Old Bethpage CDP, New York",36059,LI,1894,1927,33,4126,342,11,189,5334,2,5523,53,4926,municipality,2010
3654562,"Old Brookville village, New York",36059,LI,722,760,38,1617,158,31,44,2123,3,2167,26,1905,municipality,2000
3654562,"Old Brookville village, New York",36059,LI,669,720,51,1556,238,42,122,2012,3,2134,34,1695,municipality,2010
3654705,"Old Westbury village, New York",36059,LI,1063,1109,46,3270,487,571,302,3926,10,4228,87,2771,municipality,2000
3654705,"Old Westbury village, New York",36059,LI,1073,1172,99,3868,574,708,316,4355,25,4671,98,2950,municipality,2010
3655992,"Oyster Bay CDP, New York",36059,LI,2815,2898,83,5414,120,206,836,5990,8,6826,70,5586,municipality,2000
3655992,"Oyster Bay CDP, New York",36059,LI,2758,2947,189,5329,195,199,1119,5588,13,6707,99,5082,municipality,2010
3656011,"Oyster Bay Cove village, New York",36059,LI,725,742,17,1620,135,40,38,2224,7,2262,18,2024,municipality,2000
3656011,"Oyster Bay Cove village, New York",36059,LI,708,758,50,1570,187,33,48,2149,3,2197,16,1910,municipality,2010
3658409,"Plainedge CDP, New York",36059,LI,3028,3052,24,6921,225,48,473,8722,13,9195,75,8361,municipality,2000
3658409,"Plainedge CDP, New York",36059,LI,2875,2936,61,6752,399,64,684,8133,25,8817,61,7584,municipality,2010
3658442,"Plainview CDP, New York",36059,LI,8556,8638,82,19214,1219,93,658,24979,24,25637,166,23477,municipality,2000
3658442,"Plainview CDP, New York",36059,LI,9070,9281,211,19888,2799,110,1046,25171,51,26217,330,21881,municipality,2010
3658475,"Plandome village, New York",36059,LI,409,422,13,881,40,3,27,1245,2,1272,7,1193,municipality,2000
3658475,"Plandome village, New York",36059,LI,416,431,15,906,49,11,30,1319,2,1349,5,1252,municipality,2010
3658486,"Plandome Heights village, New York",36059,LI,324,328,4,693,65,3,30,941,3,971,3,867,municipality,2000
3658486,"Plandome Heights village, New York",36059,LI,323,330,7,680,86,2,45,960,2,1005,15,855,municipality,2010
3658497,"Plandome Manor village, New York",36059,LI,281,288,7,602,46,3,19,819,0,838,10,760,municipality,2000
3658497,"Plandome Manor village, New York",36059,LI,280,295,15,619,53,1,22,850,0,872,19,777,municipality,2010
3658849,"Point Lookout CDP, New York",36059,LI,616,792,176,1166,7,6,31,1441,0,1472,12,1416,municipality,2000
3658849,"Point Lookout CDP, New York",36059,LI,500,666,166,989,12,5,39,1180,1,1219,3,1159,municipality,2010
3659520,"Port Washington CDP, New York",36059,LI,5521,5662,141,11371,920,394,1704,13511,47,15215,170,11980,municipality,2000
3659520,"Port Washington CDP, New York",36059,LI,5698,6234,536,11905,1273,346,2116,13730,54,15846,213,11844,municipality,2010
3659531,"Port Washington North village, New York",36059,LI,1063,1071,8,2086,247,28,170,2530,1,2700,27,2227,municipality,2000
3659531,"Port Washington North village, New York",36059,LI,1298,1395,97,2475,263,44,200,2954,7,3154,35,2605,municipality,2010
3663264,"Rockville Centre village, New York",36059,LI,9201,9419,218,18228,341,878,1896,22672,47,24568,144,21262,municipality,2000
3663264,"Rockville Centre village, New York",36059,LI,9258,9679,421,18094,498,1039,2169,21854,47,24023,255,20015,municipality,2010
3663506,"Roosevelt CDP, New York",36059,LI,4061,4234,173,11024,75,12307,2572,13282,88,15854,351,461,municipality,2000
3663506,"Roosevelt CDP, New York",36059,LI,4031,4356,325,11920,85,9873,5548,10710,144,16258,282,326,municipality,2010
3663770,"Roslyn village, New York",36059,LI,1060,1124,64,2102,155,59,163,2407,1,2570,50,2142,municipality,2000
3663770,"Roslyn village, New York",36059,LI,1193,1288,95,2324,243,58,311,2459,13,2770,40,2105,municipality,2010
3663792,"Roslyn Estates village, New York",36059,LI,401,410,9,828,59,2,27,1183,0,1210,6,1116,municipality,2000
3663792,"Roslyn Estates village, New York",36059,LI,415,428,13,865,103,4,17,1234,2,1251,10,1115,municipality,2010
3663803,"Roslyn Harbor village, New York",36059,LI,356,367,11,783,50,13,34,989,0,1023,7,919,municipality,2000
3663803,"Roslyn Harbor village, New York",36059,LI,361,382,21,785,124,15,56,995,1,1051,17,838,municipality,2010
3663814,"Roslyn Heights CDP, New York",36059,LI,2168,2226,58,4615,627,385,406,5889,22,6295,110,4745,municipality,2000
3663814,"Roslyn Heights CDP, New York",36059,LI,2157,2263,106,4773,1357,397,556,6021,33,6577,176,4058,municipality,2010
3664232,"Russell Gardens village, New York",36059,LI,400,409,9,787,113,6,54,1020,1,1074,15,885,municipality,2000
3664232,"Russell Gardens village, New York",36059,LI,343,359,16,738,194,2,37,908,1,945,20,691,municipality,2010
3664430,"Saddle Rock village, New York",36059,LI,265,275,10,608,49,6,14,777,7,791,13,702,municipality,2000
3664430,"Saddle Rock village, New York",36059,LI,267,280,13,596,54,3,14,816,2,830,23,734,municipality,2010
3664441,"Saddle Rock Estates CDP, New York",36059,LI,134,139,5,293,8,7,5,419,0,424,9,395,municipality,2000
3664441,"Saddle Rock Estates CDP, New York",36059,LI,140,142,2,312,11,0,2,464,3,466,8,442,municipality,2010
3664842,"Salisbury CDP, New York",36059,LI,4015,4052,37,9334,1101,118,1056,11285,33,12341,111,9922,municipality,2000
3664842,"Salisbury CDP, New York",36059,LI,4004,4098,94,9478,1521,211,1780,10313,54,12093,151,8376,municipality,2010
3665035,"Sands Point village, New York",36059,LI,878,902,24,2025,230,42,109,2677,13,2786,14,2378,municipality,2000
3665035,"Sands Point village, New York",36059,LI,872,934,62,1970,219,20,125,2550,13,2675,33,2265,municipality,2010
3666047,"Sea Cliff village, New York",36059,LI,2013,2082,69,3845,62,81,241,4825,12,5066,44,4626,municipality,2000
3666047,"Sea Cliff village, New York",36059,LI,1960,2049,89,3796,94,113,341,4654,13,4995,40,4394,municipality,2010
3666058,"Seaford CDP, New York",36059,LI,5257,5358,101,11804,259,38,586,15205,22,15791,67,14819,municipality,2000
3666058,"Seaford CDP, New York",36059,LI,5266,5395,129,11725,334,70,761,14533,27,15294,116,13986,municipality,2010
3666102,"Searingtown CDP, New York",36059,LI,1582,1606,24,3686,1297,49,144,4890,7,5034,122,3415,municipality,2000
3666102,"Searingtown CDP, New York",36059,LI,1563,1604,41,3779,1907,48,178,4737,8,4915,107,2667,municipality,2010
3669001,"South Farmingdale CDP, New York",36059,LI,4899,4950,51,11283,478,117,888,14173,33,15061,108,13437,municipality,2000
3669001,"South Farmingdale CDP, New York",36059,LI,4784,4888,104,11144,644,186,1454,13032,37,14486,140,12025,municipality,2010
3669023,"South Floral Park village, New York",36059,LI,456,462,6,1157,59,913,214,1364,17,1578,118,257,municipality,2000
3669023,"South Floral Park village, New York",36059,LI,530,569,39,1341,137,971,316,1448,30,1764,65,245,municipality,2010
3669188,"South Hempstead CDP, New York",36059,LI,1044,1075,31,2324,80,364,303,2885,7,3188,49,2385,municipality,2000
3669188,"South Hempstead CDP, New York",36059,LI,1047,1076,29,2468,78,410,601,2642,24,3243,34,2096,municipality,2010
3669892,"South Valley Stream CDP, New York",36059,LI,2025,2045,20,4222,762,430,286,5352,40,5638,114,4006,municipality,2000
3669892,"South Valley Stream CDP, New York",36059,LI,1969,2043,74,4538,1079,1311,584,5378,102,5962,108,2778,municipality,2010
3671267,"Stewart Manor village, New York",36059,LI,718,726,8,1487,37,34,78,1857,5,1935,16,1765,municipality,2000
3671267,"Stewart Manor village, New York",36059,LI,699,711,12,1453,91,45,94,1802,0,1896,20,1646,municipality,2010
3672554,"Syosset CDP, New York",36059,LI,6281,6354,73,13723,2344,85,542,18002,32,18544,129,15412,municipality,2000
3672554,"Syosset CDP, New York",36059,LI,6188,6339,151,13791,4162,137,775,18054,49,18829,248,13458,municipality,2010
3673605,"Thomaston village, New York",36059,LI,973,1000,27,1996,350,18,207,2400,5,2607,39,1988,municipality,2000
3673605,"Thomaston village, New York",36059,LI,958,1004,46,1948,731,25,137,2480,5,2617,52,1667,municipality,2010
3676089,"Uniondale CDP, New York",36059,LI,6301,6496,195,17585,484,12897,5392,18598,178,23990,681,4358,municipality,2000
3676089,"Uniondale CDP, New York",36059,LI,7296,7652,356,24632,774,12618,10173,20794,233,30967,496,6673,municipality,2010
3676287,"University Gardens CDP, New York",36059,LI,1660,1696,36,3199,550,96,314,3824,6,4138,40,3132,municipality,2000
3676287,"University Gardens CDP, New York",36059,LI,1645,1695,50,3298,1246,71,318,3908,19,4226,68,2504,municipality,2010
3676331,"Upper Brookville village, New York",36059,LI,568,599,31,1285,130,94,96,1705,2,1801,42,1437,municipality,2000
3676331,"Upper Brookville village, New York",36059,LI,569,611,42,1318,161,16,80,1618,5,1698,31,1405,municipality,2010
3676705,"Valley Stream village, New York",36059,LI,12484,12688,204,27809,2469,2603,4463,31905,245,36368,607,25981,municipality,2000
3676705,"Valley Stream village, New York",36059,LI,12189,12625,436,28854,4237,6544,8344,29167,475,37511,670,17241,municipality,2010
3678146,"Wantagh CDP, New York",36059,LI,6179,6250,71,13798,357,35,619,18352,25,18971,106,17829,municipality,2000
3678146,"Wantagh CDP, New York",36059,LI,6126,6250,124,13790,372,51,889,17982,36,18871,143,17380,municipality,2010
3679444,"Westbury village, New York",36059,LI,4638,4714,76,11089,673,3107,2689,11574,66,14263,370,7358,municipality,2000
3679444,"Westbury village, New York",36059,LI,5078,5271,193,12099,898,3127,4128,11018,94,15146,254,6645,municipality,2010
3680225,"West Hempstead CDP, New York",36059,LI,6024,6110,86,13808,940,1012,1860,16853,77,18713,332,14492,municipality,2000
3680225,"West Hempstead CDP, New York",36059,LI,5939,6130,191,14097,1129,1807,3098,15764,99,18862,305,12424,municipality,2010
3682117,"Williston Park village, New York",36059,LI,2612,2668,56,5571,505,24,313,6948,10,7261,50,6359,municipality,2000
3682117,"Williston Park village, New York",36059,LI,2668,2743,75,5656,852,55,442,6845,22,7287,99,5817,municipality,2010
3682744,"Woodbury CDP, New York",36059,LI,2851,2895,44,6784,630,84,128,8882,9,9010,56,8103,municipality,2000
3682744,"Woodbury CDP, New York",36059,LI,3054,3178,124,6932,912,114,199,8708,12,8907,84,7586,municipality,2010
3682942,"Woodmere CDP, New York",36059,LI,5349,5462,113,11847,604,269,587,15860,33,16447,100,14854,municipality,2000
3682942,"Woodmere CDP, New York",36059,LI,5336,5570,234,12210,786,687,790,16331,38,17121,82,14738,municipality,2010
3682986,"Woodsburgh village, New York",36059,LI,257,268,11,556,6,2,18,813,2,831,1,802,municipality,2000
3682986,"Woodsburgh village, New York",36059,LI,267,300,33,594,22,7,23,755,6,778,5,715,municipality,2010
3605929113,"Glen Cove city, Nassau County, New York",36059,LI,18922,19468,546,41958,2164,3228,10672,42572,154,53244,738,36288,municipality,2000
3605929113,"Glen Cove city, Nassau County, New York",36059,LI,9764,10352,588,21403,1235,1728,7513,19451,123,26964,352,16013,municipality,2010
3605934000,"Hempstead town, Nassau County, New York",36059,LI,493656,504572,10916,1127146,52854,215858,173314,1338534,6328,1511848,20790,1042704,municipality,2000
3605934000,"Hempstead town, Nassau County, New York",36059,LI,246456,256734,10278,580059,39084,119480,132154,627603,4338,759757,9818,454883,municipality,2010
3605943335,"Long Beach city, Nassau County, New York",36059,LI,29846,32256,2410,57770,1628,4142,9080,61844,518,70924,900,54656,municipality,2000
3605943335,"Long Beach city, Nassau County, New York",36059,LI,14809,16450,1641,27853,881,1958,4691,28584,226,33275,402,25117,municipality,2010
3605953000,"North Hempstead town, Nassau County, New York",36059,LI,153640,157854,4214,340372,40418,27302,43744,401478,1258,445222,6976,325524,municipality,2000
3605953000,"North Hempstead town, Nassau County, New York",36059,LI,78080,81961,3881,173311,33747,11971,29074,197248,898,226322,3872,146760,municipality,2010
3605956000,"Oyster Bay town, Nassau County, New York",36059,LI,198710,202152,3442,443684,28424,9190,29754,558096,936,587850,4824,514722,municipality,2000
3605956000,"Oyster Bay town, Nassau County, New York",36059,LI,99419,102849,3430,225326,26611,6168,21923,271291,731,293214,3245,234536,municipality,2010
3606144919,"Manhattan borough, New York County, New York",36061,NYC,1477288,1596288,119000,2558558,286582,469396,835632,2238758,17146,3074390,57888,1407746,municipality,2000
3606144919,"Manhattan borough, New York County, New York",36061,NYC,763846,847090,83244,1351438,177624,205340,403577,1182296,7882,1585873,29957,761493,municipality,2010
3607107003,"Blooming Grove town, Orange County, New York",36071,MHV,11672,13118,1446,24248,470,1198,3112,31590,210,34702,420,29292,municipality,2000
3607107003,"Blooming Grove town, Orange County, New York",36071,MHV,6284,6954,670,13464,392,953,2709,15319,88,18028,309,13577,municipality,2010
3607115308,"Chester town, Orange County, New York",36071,MHV,7696,7968,272,17638,638,1536,2462,21818,116,24280,190,19338,municipality,2000
3607115308,"Chester town, Orange County, New York",36071,MHV,4135,4372,237,8813,490,812,1669,10312,62,11981,253,8695,municipality,2010
3607118300,"Cornwall town, Orange County, New York",36071,MHV,9250,9704,454,17742,300,288,1258,23356,60,24614,256,22452,municipality,2000
3607118300,"Cornwall town, Orange County, New York",36071,MHV,4742,5136,394,9411,212,221,1046,11600,44,12646,207,10916,municipality,2010
3607118916,"Crawford town, Orange County, New York",36071,MHV,5414,5702,288,10976,114,178,808,14942,24,15750,146,14480,municipality,2000
3607118916,"Crawford town, Orange County, New York",36071,MHV,3279,3475,196,6879,139,303,924,8392,43,9316,171,7736,municipality,2010
3607119961,"Deerpark town, Orange County, New York",36071,MHV,5812,6664,852,11398,90,234,600,15116,46,15716,152,14594,municipality,2000
3607119961,"Deerpark town, Orange County, New York",36071,MHV,2988,3484,496,6081,89,174,547,7354,32,7901,160,6899,municipality,2010
3607129553,"Goshen town, Orange County, New York",36071,MHV,8148,8640,492,19512,438,1602,1900,23926,62,25826,148,21676,municipality,2000
3607129553,"Goshen town, Orange County, New York",36071,MHV,4536,4921,385,10490,347,888,1867,11820,72,13687,196,10317,municipality,2010
3607130631,"Greenville town, Orange County, New York",36071,MHV,2486,2730,244,5294,80,94,340,7260,12,7600,60,7014,municipality,2000
3607130631,"Greenville town, Orange County, New York",36071,MHV,1504,1653,149,3342,66,113,425,4191,12,4616,81,3919,municipality,2010
3607131907,"Hamptonburgh town, Orange County, New York",36071,MHV,2934,3064,130,6652,138,176,414,8958,28,9372,126,8490,municipality,2000
3607131907,"Hamptonburgh town, Orange County, New York",36071,MHV,1739,1819,80,4086,167,202,484,5077,26,5561,87,4595,municipality,2010
3607134550,"Highlands town, Orange County, New York",36071,MHV,6460,6836,376,19270,648,2128,1924,23044,184,24968,562,19522,municipality,2000
3607134550,"Highlands town, Orange County, New York",36071,MHV,3026,3487,461,10123,416,934,1585,10907,104,12492,433,9020,municipality,2010
3607147042,"Middletown city, Orange County, New York",36071,MHV,18932,20248,1316,36666,846,6700,12750,38026,386,50776,1248,28846,municipality,2000
3607147042,"Middletown city, Orange County, New York",36071,MHV,9976,10866,890,20429,503,5075,11158,16928,179,28086,751,10420,municipality,2010
3607147713,"Minisink town, Orange County, New York",36071,MHV,2364,2490,126,5032,42,74,330,6840,4,7170,38,6682,municipality,2000
3607147713,"Minisink town, Orange County, New York",36071,MHV,1485,1561,76,3217,49,105,410,4080,17,4490,57,3852,municipality,2010
3607147999,"Monroe town, Orange County, New York",36071,MHV,16456,17034,578,36726,850,738,3086,59728,176,62814,468,57496,municipality,2000
3607147999,"Monroe town, Orange County, New York",36071,MHV,10312,11144,832,22279,980,772,3365,36547,84,39912,371,34340,municipality,2010
3607148153,"Montgomery town, Orange County, New York",36071,MHV,14546,15286,740,29524,274,1388,3240,38542,140,41782,464,36276,municipality,2000
3607148153,"Montgomery town, Orange County, New York",36071,MHV,8000,8523,523,16797,318,1378,3167,19439,82,22606,411,17250,municipality,2010
3607148857,"Mount Hope town, Orange County, New York",36071,MHV,3164,3428,264,10544,194,1978,1940,11338,40,13278,98,9028,municipality,2000
3607148857,"Mount Hope town, Orange County, New York",36071,MHV,1770,1955,185,5604,109,1025,1121,5897,49,7018,86,4628,municipality,2010
3607150034,"Newburgh city, Orange County, New York",36071,MHV,18288,20952,2664,37760,404,17922,20514,36004,250,56518,1490,15938,municipality,2000
3607150034,"Newburgh city, Orange County, New York",36071,MHV,9030,10505,1475,20003,257,8071,13814,15052,169,28866,675,5880,municipality,2010
3607150045,"Newburgh town, Orange County, New York",36071,MHV,19530,20244,714,40708,1114,3746,5288,49848,156,55136,742,44090,municipality,2000
3607150045,"Newburgh town, Orange County, New York",36071,MHV,10762,11313,551,23043,865,3289,4664,25137,141,29801,512,20330,municipality,2010
3607150848,"New Windsor town, Orange County, New York",36071,MHV,16792,17518,726,33604,778,2892,5076,40656,188,45732,704,36094,municipality,2000
3607150848,"New Windsor town, Orange County, New York",36071,MHV,9291,9862,571,19103,840,2599,4920,20324,88,25244,493,16304,municipality,2010
3607159388,"Port Jervis city, Orange County, New York",36071,MHV,7066,7702,636,12798,114,666,1320,16400,120,17720,322,15178,municipality,2000
3607159388,"Port Jervis city, Orange County, New York",36071,MHV,3570,3957,387,6596,108,565,1054,7774,70,8828,296,6735,municipality,2010
3607175781,"Tuxedo town, Orange County, New York",36071,MHV,2674,2914,240,5224,206,78,284,6384,32,6668,82,5986,municipality,2000
3607175781,"Tuxedo town, Orange County, New York",36071,MHV,1457,1691,234,2867,190,73,258,3366,13,3624,61,3029,municipality,2010
3607177992,"Wallkill town, Orange County, New York",36071,MHV,17732,18566,834,36384,1168,4290,6608,42710,206,49318,1006,36040,municipality,2000
3607177992,"Wallkill town, Orange County, New York",36071,MHV,10133,10777,644,20877,855,3939,6162,21264,201,27426,623,15646,municipality,2010
3607178366,"Warwick town, Orange County, New York",36071,MHV,21736,23636,1900,44798,518,2468,3982,57546,250,61528,660,53650,municipality,2000
3607178366,"Warwick town, Orange County, New York",36071,MHV,11835,12982,1147,24563,463,1425,3279,28786,144,32065,446,26308,municipality,2010
3607178839,"Wawayanda town, Orange County, New York",36071,MHV,4190,4348,158,8842,202,214,738,11808,42,12546,138,11212,municipality,2000
3607178839,"Wawayanda town, Orange County, New York",36071,MHV,2444,2630,186,5300,139,331,883,6383,15,7266,110,5788,municipality,2010
3607182755,"Woodbury town, Orange County, New York",36071,MHV,6234,6716,482,13082,482,546,1502,17418,48,18920,196,16146,municipality,2000
3607182755,"Woodbury town, Orange County, New York",36071,MHV,3627,3958,331,7917,691,648,1674,9679,50,11353,215,8075,municipality,2010
3607912529,"Carmel town, Putnam County, New York",36079,LHV,21694,22566,872,48018,772,650,3910,62102,132,66012,672,59876,municipality,2000
3607912529,"Carmel town, Putnam County, New York",36079,LHV,11672,12348,676,25664,588,545,3469,30836,85,34305,315,29303,municipality,2010
3607939331,"Kent town, Putnam County, New York",36079,LHV,9736,10706,970,20656,332,386,1616,26402,86,28018,312,25286,municipality,2000
3607939331,"Kent town, Putnam County, New York",36079,LHV,4888,5508,620,10502,245,308,1755,11752,53,13507,167,10979,municipality,2010
3607956748,"Patterson town, Putnam County, New York",36079,LHV,7058,7492,434,16572,280,760,1584,21028,58,22612,318,19612,municipality,2000
3607956748,"Patterson town, Putnam County, New York",36079,LHV,3905,4272,367,9264,209,480,1555,10468,58,12023,167,9554,municipality,2010
3607957584,"Philipstown town, Putnam County, New York",36079,LHV,7198,7966,768,14328,196,172,714,18130,52,18844,152,17558,municipality,2000
3607957584,"Philipstown town, Putnam County, New York",36079,LHV,3685,4164,479,7501,134,148,671,8991,36,9662,151,8522,municipality,2010
3607960147,"Putnam Valley town, Putnam County, New York",36079,LHV,7352,8506,1154,15668,168,298,1342,20030,98,21372,240,19226,municipality,2000
3607960147,"Putnam Valley town, Putnam County, New York",36079,LHV,4216,4837,621,8957,207,239,1159,10650,30,11809,177,9997,municipality,2010
3607968924,"Southeast town, Putnam County, New York",36079,LHV,12368,12824,456,25500,566,608,2786,31846,62,34632,222,30388,municipality,2000
3607968924,"Southeast town, Putnam County, New York",36079,LHV,6675,7095,420,14172,449,327,3052,15352,44,18404,178,14354,municipality,2010
3608160323,"Queens borough, Queens County, New York",36081,NYC,1565328,1634500,69172,3440310,778606,845662,1113210,3345548,70468,4458758,185022,1465790,municipality,2000
3608160323,"Queens borough, Queens County, New York",36081,NYC,780117,835127,55010,1768821,508334,395881,613750,1616972,39923,2230722,56107,616727,municipality,2010
3608570915,"Staten Island borough, Richmond County, New York",36085,NYC,312682,327986,15304,660940,49572,79408,107100,780356,3150,887456,15594,632632,municipality,2000
3608570915,"Staten Island borough, Richmond County, New York",36085,NYC,165516,176656,11140,359529,34697,44313,81051,387679,1860,468730,6640,300169,municipality,2010
3608715968,"Clarkstown town, Rockland County, New York",36087,LHV,55394,56440,1046,123536,12884,12356,11366,152798,454,164164,2402,124702,municipality,2000
3608715968,"Clarkstown town, Rockland County, New York",36087,LHV,29234,30314,1080,64483,8748,7598,9831,74356,314,84187,1327,56369,municipality,2010
3608732765,"Haverstraw town, Rockland County, New York",36087,LHV,22510,23106,596,49838,2124,6292,21458,46164,298,67622,1184,36266,municipality,2000
3608732765,"Haverstraw town, Rockland County, New York",36087,LHV,12170,12809,639,27769,1559,4627,15012,21622,122,36634,608,14706,municipality,2010
3608755211,"Orangetown town, Rockland County, New York",36087,LHV,34660,35654,994,73914,6112,5374,5746,89676,250,95422,1512,76428,municipality,2000
3608755211,"Orangetown town, Rockland County, New York",36087,LHV,17826,18611,785,38585,3386,2742,4782,44430,143,49212,669,37490,municipality,2010
3608760510,"Ramapo town, Rockland County, New York",36087,LHV,63122,64844,1722,144594,9928,35930,17846,199964,1120,217810,4588,148398,municipality,2000
3608760510,"Ramapo town, Rockland County, New York",36087,LHV,34731,36754,2023,81772,5013,19173,17223,109372,523,126595,1569,83094,municipality,2010
3608771674,"Stony Point town, Rockland County, New York",36087,LHV,9664,9902,238,21052,366,326,1948,26540,78,28488,258,25512,municipality,2000
3608771674,"Stony Point town, Rockland County, New York",36087,LHV,5281,5569,288,11498,393,483,1935,13124,37,15059,200,12011,municipality,2010
3601594,"Amagansett CDP, New York",36103,LI,493,1664,1171,863,4,18,43,1024,6,1067,8,988,municipality,2000
3601594,"Amagansett CDP, New York",36103,LI,513,1790,1277,963,22,13,119,1046,2,1165,5,1004,municipality,2010
3602044,"Amityville village, New York",36103,LI,3434,3577,143,7375,119,759,867,8574,26,9441,140,7530,municipality,2000
3602044,"Amityville village, New York",36103,LI,3690,3997,307,7840,166,874,1249,8274,30,9523,108,7096,municipality,2010
3602374,"Aquebogue CDP, New York",36103,LI,872,1013,141,1727,7,118,73,2181,2,2254,23,2031,municipality,2000
3602374,"Aquebogue CDP, New York",36103,LI,932,1127,195,1973,5,102,290,2148,1,2438,13,2027,municipality,2010
3602737,"Asharoken village, New York",36103,LI,254,307,53,512,17,1,12,613,1,625,0,594,municipality,2000
3602737,"Asharoken village, New York",36103,LI,255,302,47,532,13,0,20,634,0,654,9,612,municipality,2010
3603408,"Babylon village, New York",36103,LI,4554,4680,126,9377,183,315,644,11971,33,12615,196,11244,municipality,2000
3603408,"Babylon village, New York",36103,LI,4585,4768,183,9392,263,221,817,11349,37,12166,170,10658,municipality,2010
3604055,"Baiting Hollow CDP, New York",36103,LI,600,962,362,1175,8,19,58,1391,0,1449,4,1360,municipality,2000
3604055,"Baiting Hollow CDP, New York",36103,LI,719,1208,489,1387,12,15,98,1544,2,1642,6,1509,municipality,2010
3604913,"Bayport CDP, New York",36103,LI,3222,3325,103,6444,102,69,340,8322,10,8662,61,8080,municipality,2000
3604913,"Bayport CDP, New York",36103,LI,3346,3515,169,6679,151,115,470,8426,10,8896,78,8072,municipality,2010
3604935,"Bay Shore CDP, New York",36103,LI,8194,8639,445,17682,554,3857,4738,19114,134,23852,551,14018,municipality,2000
3604935,"Bay Shore CDP, New York",36103,LI,9064,9663,599,19871,845,4590,8101,18236,173,26337,573,12055,municipality,2010
3605039,"Baywood CDP, New York",36103,LI,2252,2317,65,5511,124,693,1759,5812,28,7571,162,4805,municipality,2000
3605039,"Baywood CDP, New York",36103,LI,2162,2272,110,5573,288,976,2548,4802,50,7350,116,3372,municipality,2010
3605672,"Belle Terre village, New York",36103,LI,286,297,11,626,42,9,16,816,4,832,13,748,municipality,2000
3605672,"Belle Terre village, New York",36103,LI,286,308,22,596,26,10,31,761,0,792,11,714,municipality,2010
3605771,"Bellport village, New York",36103,LI,993,1139,146,1921,39,30,42,2321,11,2363,25,2216,municipality,2000
3605771,"Bellport village, New York",36103,LI,921,1170,249,1725,27,32,87,1997,8,2084,34,1896,municipality,2010
3607069,"Blue Point CDP, New York",36103,LI,1571,1664,93,3228,47,22,192,4215,9,4407,15,4122,municipality,2000
3607069,"Blue Point CDP, New York",36103,LI,1680,1747,67,3608,78,36,200,4573,22,4773,35,4402,municipality,2010
3607157,"Bohemia CDP, New York",36103,LI,3326,3387,61,7578,233,78,435,9436,12,9871,72,9041,municipality,2000
3607157,"Bohemia CDP, New York",36103,LI,3606,3731,125,7942,232,91,723,9457,9,10180,64,9061,municipality,2010
3608026,"Brentwood CDP, New York",36103,LI,12580,13039,459,37805,1046,8654,29251,24666,358,53917,1169,13439,municipality,2000
3608026,"Brentwood CDP, New York",36103,LI,13654,14202,548,44122,1101,8344,41529,19135,361,60664,775,8554,municipality,2010
3608136,"Bridgehampton CDP, New York",36103,LI,627,1494,867,1137,11,239,45,1336,10,1381,14,1062,municipality,2000
3608136,"Bridgehampton CDP, New York",36103,LI,748,2431,1683,1440,21,232,256,1500,8,1756,18,1221,municipality,2010
3608323,"Brightwaters village, New York",36103,LI,1127,1144,17,2360,41,49,132,3116,4,3248,28,2994,municipality,2000
3608323,"Brightwaters village, New York",36103,LI,1126,1156,30,2301,48,38,159,2944,6,3103,42,2810,municipality,2010
3609000,"Brookhaven CDP, New York",36103,LI,1101,1167,66,2669,23,339,228,3342,11,3570,56,2913,municipality,2000
3609000,"Brookhaven CDP, New York",36103,LI,1176,1268,92,2765,24,214,212,3239,11,3451,28,2962,municipality,2010
3611781,"Calverton CDP, New York",36103,LI,2539,2735,196,4548,54,409,346,5358,28,5704,91,4776,municipality,2000
3611781,"Calverton CDP, New York",36103,LI,2965,3224,259,5344,57,493,453,6057,16,6510,73,5418,municipality,2010
3613376,"Centereach CDP, New York",36103,LI,8176,8329,153,19903,862,501,1932,25353,70,27285,262,23658,municipality,2000
3613376,"Centereach CDP, New York",36103,LI,10026,10408,382,23886,1950,834,3575,28003,66,31578,404,24749,municipality,2010
3613420,"Center Moriches CDP, New York",36103,LI,2319,2465,146,4983,66,339,440,6215,8,6655,81,5721,municipality,2000
3613420,"Center Moriches CDP, New York",36103,LI,2597,2818,221,5679,105,248,776,6804,16,7580,122,6313,municipality,2010
3613442,"Centerport CDP, New York",36103,LI,2022,2094,72,4084,64,12,117,5329,9,5446,15,5229,municipality,2000
3613442,"Centerport CDP, New York",36103,LI,2032,2120,88,4055,102,26,194,5314,2,5508,57,5127,municipality,2010
3613552,"Central Islip CDP, New York",36103,LI,8792,9189,397,22621,971,8244,11452,20498,297,31950,824,10162,municipality,2000
3613552,"Central Islip CDP, New York",36103,LI,9365,9961,596,25283,1112,7740,17938,16512,269,34450,708,6683,municipality,2010
3616958,"Cold Spring Harbor CDP, New York",36103,LI,1753,1790,37,3649,65,21,98,4877,5,4975,46,4740,municipality,2000
3616958,"Cold Spring Harbor CDP, New York",36103,LI,1749,1809,60,3698,113,34,194,4876,4,5070,42,4683,municipality,2010
3617530,"Commack CDP, New York",36103,LI,11697,11824,127,26786,1364,214,1055,35312,59,36367,185,33490,municipality,2000
3617530,"Commack CDP, New York",36103,LI,11907,12138,231,26741,1951,297,1722,34402,84,36124,320,31750,municipality,2010
3618146,"Copiague CDP, New York",36103,LI,7210,7415,205,16824,377,843,4489,17433,79,21922,285,15849,municipality,2000
3618146,"Copiague CDP, New York",36103,LI,7535,7919,384,18111,464,1455,7523,15470,100,22993,284,13167,municipality,2010
3618157,"Coram CDP, New York",36103,LI,12530,12880,350,26170,1148,2869,3314,31609,143,34923,552,26897,municipality,2000
3618157,"Coram CDP, New York",36103,LI,14632,15437,805,30369,1952,3842,5307,33806,155,39113,784,27073,municipality,2010
3619466,"Cutchogue CDP, New York",36103,LI,1120,1680,560,2237,15,69,162,2687,1,2849,22,2580,municipality,2000
3619466,"Cutchogue CDP, New York",36103,LI,1347,2062,715,2695,27,47,242,3107,3,3349,17,3013,municipality,2010
3619972,"Deer Park CDP, New York",36103,LI,9516,9698,182,21179,811,2500,2139,26177,98,28316,469,22299,municipality,2000
3619972,"Deer Park CDP, New York",36103,LI,9383,9715,332,21319,1871,3182,3364,24381,107,27745,466,18755,municipality,2010
3620379,"Dering Harbor village, New York",36103,LI,6,32,26,11,0,0,0,13,1,13,0,12,municipality,2000
3620379,"Dering Harbor village, New York",36103,LI,5,35,30,11,0,0,0,11,0,11,0,11,municipality,2010
3620687,"Dix Hills CDP, New York",36103,LI,7952,8057,105,18619,1913,819,995,25029,56,26024,408,21833,municipality,2000
3620687,"Dix Hills CDP, New York",36103,LI,8319,8529,210,19520,2990,1385,1533,25359,83,26892,468,20433,municipality,2010
3621985,"East Farmingdale CDP, New York",36103,LI,1693,1723,30,3997,219,750,687,4713,18,5400,102,3624,municipality,2000
3621985,"East Farmingdale CDP, New York",36103,LI,2002,2114,112,5052,332,775,1353,5131,40,6484,109,3875,municipality,2010
3622183,"East Hampton village, New York",36103,LI,635,1745,1110,1142,25,19,119,1215,7,1334,17,1147,municipality,2000
3622183,"East Hampton village, New York",36103,LI,533,1836,1303,930,12,8,128,955,0,1083,4,931,municipality,2010
3622200,"East Hampton North CDP, New York",36103,LI,1445,2251,806,2787,58,262,596,2991,27,3587,69,2575,municipality,2000
3622200,"East Hampton North CDP, New York",36103,LI,1536,2545,1009,3252,44,244,1594,2548,23,4142,58,2179,municipality,2010
3622315,"East Islip CDP, New York",36103,LI,4578,4661,83,10066,198,71,547,13531,34,14078,86,13142,municipality,2000
3622315,"East Islip CDP, New York",36103,LI,4803,4942,139,10815,223,143,903,13572,24,14475,129,13053,municipality,2010
3622447,"East Marion CDP, New York",36103,LI,329,744,415,616,7,7,22,734,5,756,8,707,municipality,2000
3622447,"East Marion CDP, New York",36103,LI,409,953,544,790,8,7,62,864,0,926,17,832,municipality,2010
3622546,"East Moriches CDP, New York",36103,LI,1510,1668,158,3348,66,71,235,4315,14,4550,36,4128,municipality,2000
3622546,"East Moriches CDP, New York",36103,LI,1896,2163,267,4030,46,75,312,4937,11,5249,63,4742,municipality,2010
3622612,"East Northport CDP, New York",36103,LI,6967,7086,119,15527,471,181,814,20031,38,20845,207,19134,municipality,2000
3622612,"East Northport CDP, New York",36103,LI,7114,7288,174,15071,564,158,1354,18863,40,20217,213,17888,municipality,2010
3622733,"East Patchogue CDP, New York",36103,LI,7493,7760,267,16008,404,625,1895,18929,69,20824,271,17560,municipality,2000
3622733,"East Patchogue CDP, New York",36103,LI,8294,8685,391,17777,518,903,3951,18518,80,22469,304,16713,municipality,2010
3622810,"Eastport CDP, New York",36103,LI,554,637,83,1106,16,12,136,1318,4,1454,11,1275,municipality,2000
3622810,"Eastport CDP, New York",36103,LI,702,865,163,1438,11,23,160,1671,0,1831,17,1620,municipality,2010
3622832,"East Quogue CDP, New York",36103,LI,1660,2465,805,3232,30,28,230,4035,6,4265,30,3941,municipality,2000
3622832,"East Quogue CDP, New York",36103,LI,1832,3069,1237,3597,61,63,425,4332,17,4757,35,4156,municipality,2010
3622980,"East Shoreham CDP, New York",36103,LI,1787,1827,40,4073,88,67,235,5574,6,5809,37,5376,municipality,2000
3622980,"East Shoreham CDP, New York",36103,LI,2047,2104,57,4802,155,86,364,6302,12,6666,44,6005,municipality,2010
3623316,"Eatons Neck CDP, New York",36103,LI,512,554,42,1053,14,3,16,1372,1,1388,3,1351,municipality,2000
3623316,"Eatons Neck CDP, New York",36103,LI,519,575,56,1070,13,2,36,1370,2,1406,17,1336,municipality,2010
3624405,"Elwood CDP, New York",36103,LI,3435,3493,58,8072,610,586,550,10366,49,10916,98,9023,municipality,2000
3624405,"Elwood CDP, New York",36103,LI,3512,3585,73,8179,887,674,918,10259,36,11177,118,8544,municipality,2010
3625417,"Farmingville CDP, New York",36103,LI,5041,5170,129,11796,282,187,1336,15122,28,16458,174,14451,municipality,2000
3625417,"Farmingville CDP, New York",36103,LI,4707,4884,177,11631,571,339,1942,13539,64,15481,201,12364,municipality,2010
3625839,"Fire Island CDP, New York",36103,LI,138,3157,3019,246,2,0,9,301,1,310,5,293,municipality,2000
3625839,"Fire Island CDP, New York",36103,LI,131,3395,3264,239,1,12,23,269,0,292,3,253,municipality,2010
3625923,"Fishers Island CDP, New York",36103,LI,138,625,487,226,3,3,4,285,0,289,6,273,municipality,2000
3625923,"Fishers Island CDP, New York",36103,LI,120,660,540,196,2,2,2,234,1,236,4,225,municipality,2010
3626121,"Flanders CDP, New York",36103,LI,1260,1521,261,2633,21,676,502,3144,57,3646,73,2317,municipality,2000
3626121,"Flanders CDP, New York",36103,LI,1345,1684,339,3320,46,597,1677,2795,41,4472,91,2020,municipality,2010
3626946,"Fort Salonga CDP, New York",36103,LI,3225,3310,85,7139,164,59,217,9417,6,9634,42,9146,municipality,2000
3626946,"Fort Salonga CDP, New York",36103,LI,3370,3484,114,7365,216,84,388,9620,33,10008,73,9214,municipality,2010
3628997,"Gilgo-Oak Beach-Captree CDP, New York",36103,LI,161,305,144,288,9,1,6,327,0,333,0,317,municipality,2000
3628997,"Gilgo-Oak Beach-Captree CDP, New York",36103,LI,182,376,194,346,3,1,26,391,0,417,3,384,municipality,2010
3629509,"Gordon Heights CDP, New York",36103,LI,856,945,89,2004,59,1846,449,2645,37,3094,104,599,municipality,2000
3629509,"Gordon Heights CDP, New York",36103,LI,1070,1182,112,2867,75,1971,1012,3030,75,4042,126,783,municipality,2010
3630235,"Great River CDP, New York",36103,LI,509,519,10,1098,9,0,29,1517,5,1546,10,1493,municipality,2000
3630235,"Great River CDP, New York",36103,LI,503,517,14,1131,23,8,62,1427,0,1489,7,1389,municipality,2010
3630543,"Greenlawn CDP, New York",36103,LI,4499,4644,145,9830,368,1967,905,12381,55,13286,199,9792,municipality,2000
3630543,"Greenlawn CDP, New York",36103,LI,4560,4722,162,10220,555,1841,1724,12018,47,13742,237,9338,municipality,2010
3630576,"Greenport village, New York",36103,LI,776,1075,299,1572,6,288,353,1695,5,2048,48,1348,municipality,2000
3630576,"Greenport village, New York",36103,LI,820,1191,371,1791,11,219,746,1451,12,2197,32,1177,municipality,2010
3630581,"Greenport West CDP, New York",36103,LI,750,1283,533,1353,6,87,100,1579,6,1679,23,1457,municipality,2000
3630581,"Greenport West CDP, New York",36103,LI,960,1651,691,1814,16,100,328,1796,9,2124,25,1646,municipality,2010
3631445,"Halesite CDP, New York",36103,LI,1014,1049,35,2034,24,40,80,2502,4,2582,21,2413,municipality,2000
3631445,"Halesite CDP, New York",36103,LI,1008,1070,62,1994,38,17,106,2392,7,2498,18,2312,municipality,2010
3631896,"Hampton Bays CDP, New York",36103,LI,4877,6875,1998,9696,82,92,1529,10707,36,12236,95,10402,municipality,2000
3631896,"Hampton Bays CDP, New York",36103,LI,5079,7873,2794,10666,108,161,3895,9708,56,13603,109,9274,municipality,2010
3632732,"Hauppauge CDP, New York",36103,LI,7006,7153,147,15268,710,216,887,19213,37,20100,198,18052,municipality,2000
3632732,"Hauppauge CDP, New York",36103,LI,7333,7566,233,15921,1226,389,1479,19403,53,20882,187,17548,municipality,2010
3632963,"Head of the Harbor village, New York",36103,LI,484,501,17,1056,45,17,20,1427,0,1447,7,1358,municipality,2000
3632963,"Head of the Harbor village, New York",36103,LI,511,551,40,1097,38,10,46,1426,3,1472,12,1363,municipality,2010
3635056,"Holbrook CDP, New York",36103,LI,9019,9157,138,20437,780,341,1616,25896,45,27512,219,24511,municipality,2000
3635056,"Holbrook CDP, New York",36103,LI,9550,9820,270,20951,1008,401,2311,24884,60,27195,233,23182,municipality,2010
3635254,"Holtsville CDP, New York",36103,LI,5316,5418,102,12205,296,174,1200,15806,33,17006,162,15141,municipality,2000
3635254,"Holtsville CDP, New York",36103,LI,6725,6929,204,14873,859,326,1990,17724,54,19714,176,16309,municipality,2010
3636233,"Huntington CDP, New York",36103,LI,7052,7273,221,14143,327,379,658,17745,32,18403,174,16833,municipality,2000
3636233,"Huntington CDP, New York",36103,LI,7170,7482,312,14096,390,382,906,17140,35,18046,191,16142,municipality,2010
3637022,"Huntington Bay village, New York",36103,LI,539,560,21,1141,14,1,19,1477,0,1496,8,1454,municipality,2000
3637022,"Huntington Bay village, New York",36103,LI,534,578,44,1120,26,6,49,1376,0,1425,15,1329,municipality,2010
3637044,"Huntington Station CDP, New York",36103,LI,9731,10028,297,22206,917,3296,6802,23108,123,29910,585,18187,municipality,2000
3637044,"Huntington Station CDP, New York",36103,LI,10067,10523,456,24868,1154,3299,12109,20920,140,33029,605,15722,municipality,2010
3637840,"Islandia village, New York",36103,LI,1007,1031,24,2303,184,353,584,2473,3,3057,63,1870,municipality,2000
3637840,"Islandia village, New York",36103,LI,1026,1088,62,2672,204,429,944,2391,11,3335,57,1690,municipality,2010
3637869,"Islip CDP, New York",36103,LI,6868,7026,158,14935,410,937,2195,18380,37,20575,275,16721,municipality,2000
3637869,"Islip CDP, New York",36103,LI,6437,6664,227,14188,461,760,2580,16109,70,18689,248,14570,municipality,2010
3638022,"Islip Terrace CDP, New York",36103,LI,1755,1784,29,3976,84,28,373,5268,4,5641,25,5127,municipality,2000
3638022,"Islip Terrace CDP, New York",36103,LI,1703,1764,61,4015,124,90,478,4911,15,5389,55,4627,municipality,2010
3638253,"Jamesport CDP, New York",36103,LI,605,959,354,1211,8,9,97,1429,0,1526,6,1406,municipality,2000
3638253,"Jamesport CDP, New York",36103,LI,715,1169,454,1427,7,18,142,1568,0,1710,13,1530,municipality,2010
3639672,"Kings Park CDP, New York",36103,LI,5480,5574,94,12071,304,131,538,15608,34,16146,139,15000,municipality,2000
3639672,"Kings Park CDP, New York",36103,LI,6212,6469,257,13249,406,183,915,16367,31,17282,166,15581,municipality,2010
3640530,"Lake Grove village, New York",36103,LI,3419,3509,90,7554,504,141,496,9754,28,10250,91,8990,municipality,2000
3640530,"Lake Grove village, New York",36103,LI,3814,3956,142,8457,737,215,866,10297,37,11163,103,9205,municipality,2010
3640838,"Lake Ronkonkoma CDP, New York",36103,LI,6700,6949,249,14842,471,237,1153,18548,46,19701,176,17618,municipality,2000
3640838,"Lake Ronkonkoma CDP, New York",36103,LI,6932,7199,267,15363,904,423,2008,18147,53,20155,256,16511,municipality,2010
3641465,"Laurel CDP, New York",36103,LI,452,686,234,912,0,15,28,1160,3,1188,13,1129,municipality,2000
3641465,"Laurel CDP, New York",36103,LI,524,810,286,1067,6,24,124,1270,0,1394,23,1217,municipality,2010
3642554,"Lindenhurst village, New York",36103,LI,9061,9277,216,20387,379,220,1813,26006,57,27819,374,24976,municipality,2000
3642554,"Lindenhurst village, New York",36103,LI,9316,9665,349,21117,518,341,2656,24597,71,27253,286,23381,municipality,2010
3643005,"Lloyd Harbor village, New York",36103,LI,1147,1188,41,2524,69,23,85,3590,3,3675,23,3472,municipality,2000
3643005,"Lloyd Harbor village, New York",36103,LI,1162,1262,100,2577,80,34,120,3540,9,3660,39,3378,municipality,2010
3645139,"Manorville CDP, New York",36103,LI,4122,4243,121,8063,71,120,461,10670,33,11131,72,10374,municipality,2000
3645139,"Manorville CDP, New York",36103,LI,5000,5303,303,10364,249,222,938,13376,38,14314,124,12743,municipality,2010
3646074,"Mastic CDP, New York",36103,LI,4451,4732,281,10390,162,856,1875,13561,283,15436,261,11999,municipality,2000
3646074,"Mastic CDP, New York",36103,LI,4526,4847,321,11106,323,1247,3378,12103,77,15481,394,10062,municipality,2010
3646085,"Mastic Beach CDP, New York",36103,LI,3755,4375,620,7873,103,544,1222,10321,56,11543,230,9388,municipality,2000
3646085,"Mastic Beach CDP, New York",36103,LI,4231,4889,658,9340,186,1120,2019,10911,69,12930,285,9251,municipality,2010
3646140,"Mattituck CDP, New York",36103,LI,1651,2313,662,3222,22,46,107,4091,8,4198,34,3981,municipality,2000
3646140,"Mattituck CDP, New York",36103,LI,1693,2495,802,3356,37,54,288,3931,10,4219,56,3774,municipality,2010
3646404,"Medford CDP, New York",36103,LI,6791,6939,148,15896,301,812,2373,19612,87,21985,268,18144,municipality,2000
3646404,"Medford CDP, New York",36103,LI,7821,8171,350,18421,620,1328,4306,19836,114,24142,303,17471,municipality,2010
3646514,"Melville CDP, New York",36103,LI,4930,5141,211,10823,785,294,540,13993,33,14533,170,12711,municipality,2000
3646514,"Melville CDP, New York",36103,LI,6908,7194,286,14543,1372,607,955,18030,70,18985,247,15734,municipality,2010
3646976,"Middle Island CDP, New York",36103,LI,3720,3900,180,7517,237,697,667,9035,46,9702,190,7865,municipality,2000
3646976,"Middle Island CDP, New York",36103,LI,4217,4479,262,8380,361,786,974,9509,54,10483,174,8134,municipality,2010
3647306,"Miller Place CDP, New York",36103,LI,3397,3512,115,7382,141,38,339,10241,31,10580,68,9963,municipality,2000
3647306,"Miller Place CDP, New York",36103,LI,4000,4141,141,8924,359,191,621,11718,40,12339,93,11035,municipality,2010
3648054,"Montauk CDP, New York",36103,LI,1593,4815,3222,3081,32,27,921,2930,9,3851,32,2830,municipality,2000
3648054,"Montauk CDP, New York",36103,LI,1422,4666,3244,2764,30,74,537,2789,11,3326,30,2644,municipality,2010
3648450,"Moriches CDP, New York",36103,LI,1116,1212,96,2052,42,28,92,2227,4,2319,25,2128,municipality,2000
3648450,"Moriches CDP, New York",36103,LI,1322,1475,153,2396,79,72,247,2591,8,2838,32,2400,municipality,2010
3649066,"Mount Sinai CDP, New York",36103,LI,2671,2740,69,6110,130,105,364,8370,14,8734,62,8059,municipality,2000
3649066,"Mount Sinai CDP, New York",36103,LI,4080,4285,205,8966,486,165,706,11412,28,12118,113,10620,municipality,2010
3649424,"Napeague CDP, New York",36103,LI,105,624,519,189,0,2,15,208,3,223,1,202,municipality,2000
3649424,"Napeague CDP, New York",36103,LI,107,762,655,171,3,1,6,194,1,200,2,187,municipality,2010
3649825,"Nesconset CDP, New York",36103,LI,3964,4227,263,8915,371,111,403,11589,27,11992,74,11006,municipality,2000
3649825,"Nesconset CDP, New York",36103,LI,4564,4711,147,9941,651,159,825,12562,23,13387,89,11640,municipality,2010
3650727,"New Suffolk CDP, New York",36103,LI,172,298,126,294,1,4,12,325,5,337,1,314,municipality,2000
3650727,"New Suffolk CDP, New York",36103,LI,177,307,130,310,0,1,22,327,1,349,0,325,municipality,2010
3651286,"Nissequogue village, New York",36103,LI,533,570,37,1148,15,1,45,1498,0,1543,18,1464,municipality,2000
3651286,"Nissequogue village, New York",36103,LI,573,646,73,1275,87,11,60,1689,2,1749,19,1570,municipality,2010
3651396,"North Amityville CDP, New York",36103,LI,5045,5308,263,11632,173,11071,2242,14330,220,16572,587,2279,municipality,2000
3651396,"North Amityville CDP, New York",36103,LI,5333,5636,303,13036,167,10076,5093,12769,209,17862,410,1907,municipality,2010
3651418,"Northampton CDP, New York",36103,LI,158,205,47,331,4,207,39,429,4,468,23,191,municipality,2000
3651418,"Northampton CDP, New York",36103,LI,191,239,48,461,2,157,112,458,2,570,12,285,municipality,2010
3651440,"North Babylon CDP, New York",36103,LI,6146,6271,125,13668,372,352,1313,16564,50,17877,198,15592,municipality,2000
3651440,"North Babylon CDP, New York",36103,LI,6136,6378,242,13671,696,1009,2221,15288,61,17509,212,13310,municipality,2010
3651495,"North Bay Shore CDP, New York",36103,LI,3794,3992,198,10534,300,2632,7608,7384,94,14992,456,3902,municipality,2000
3651495,"North Bay Shore CDP, New York",36103,LI,4395,4627,232,13805,697,2894,12310,6634,136,18944,322,2585,municipality,2010
3651528,"North Bellport CDP, New York",36103,LI,2349,2520,171,5985,166,2640,1841,7166,132,9007,260,3968,municipality,2000
3651528,"North Bellport CDP, New York",36103,LI,3362,3652,290,8080,288,2868,3382,8163,151,11545,421,4435,municipality,2010
3652078,"North Great River CDP, New York",36103,LI,1156,1167,11,2834,49,56,248,3681,6,3929,39,3531,municipality,2000
3652078,"North Great River CDP, New York",36103,LI,1264,1367,103,3077,82,109,470,3531,13,4001,23,3304,municipality,2010
3652188,"North Haven village, New York",36103,LI,337,578,241,614,5,3,11,732,0,743,2,722,municipality,2000
3652188,"North Haven village, New York",36103,LI,332,739,407,633,12,1,24,809,0,833,4,792,municipality,2010
3653198,"North Lindenhurst CDP, New York",36103,LI,3808,3883,75,8758,244,416,1372,10395,35,11767,135,9565,municipality,2000
3653198,"North Lindenhurst CDP, New York",36103,LI,3787,3898,111,8888,362,564,2246,9406,49,11652,145,8286,municipality,2010
3653319,"North Patchogue CDP, New York",36103,LI,2694,2781,87,5753,82,99,686,7139,8,7825,95,6855,municipality,2000
3653319,"North Patchogue CDP, New York",36103,LI,2300,2432,132,5479,127,155,1491,5755,15,7246,75,5383,municipality,2010
3653396,"Northport village, New York",36103,LI,2952,3052,100,5766,95,44,159,7447,8,7606,40,7260,municipality,2000
3653396,"Northport village, New York",36103,LI,2921,3066,145,5658,121,40,267,7134,11,7401,46,6916,municipality,2010
3653561,"North Sea CDP, New York",36103,LI,1880,3265,1385,3572,43,61,238,4255,19,4493,29,4103,municipality,2000
3653561,"North Sea CDP, New York",36103,LI,1771,3477,1706,3573,69,40,748,3710,13,4458,52,3536,municipality,2010
3653775,"Northville CDP, New York",36103,LI,296,401,105,622,2,30,39,762,1,801,13,716,municipality,2000
3653775,"Northville CDP, New York",36103,LI,531,772,241,1102,10,14,78,1262,2,1340,14,1222,municipality,2010
3653852,"Northwest Harbor CDP, New York",36103,LI,1181,3008,1827,2287,32,103,280,2779,24,3059,56,2564,municipality,2000
3653852,"Northwest Harbor CDP, New York",36103,LI,1313,3394,2081,2649,56,83,605,2712,13,3317,34,2526,municipality,2010
3654056,"Noyack CDP, New York",36103,LI,1158,1993,835,2121,22,25,124,2572,10,2696,15,2500,municipality,2000
3654056,"Noyack CDP, New York",36103,LI,1510,2881,1371,2820,52,43,334,3234,15,3568,25,3099,municipality,2010
3654144,"Oakdale CDP, New York",36103,LI,3035,3207,172,6285,53,113,243,7832,6,8075,30,7630,municipality,2000
3654144,"Oakdale CDP, New York",36103,LI,3116,3280,164,6361,102,81,314,7660,7,7974,43,7427,municipality,2010
3654430,"Ocean Beach village, New York",36103,LI,61,595,534,108,2,0,3,135,0,138,0,133,municipality,2000
3654430,"Ocean Beach village, New York",36103,LI,39,607,568,71,0,0,1,78,0,79,0,78,municipality,2010
3654617,"Old Field village, New York",36103,LI,313,346,33,663,34,7,22,925,5,947,5,874,municipality,2000
3654617,"Old Field village, New York",36103,LI,325,369,44,713,58,8,26,892,16,918,11,799,municipality,2010
3655321,"Orient CDP, New York",36103,LI,330,673,343,581,7,4,7,702,3,709,1,687,municipality,2000
3655321,"Orient CDP, New York",36103,LI,353,772,419,633,6,8,16,727,2,743,7,704,municipality,2010
3656660,"Patchogue village, New York",36103,LI,4636,4902,266,9236,163,408,2842,9077,70,11919,205,8231,municipality,2000
3656660,"Patchogue village, New York",36103,LI,4694,5023,329,9345,185,620,3488,8310,47,11798,162,7296,municipality,2010
3656968,"Peconic CDP, New York",36103,LI,426,682,256,833,12,10,39,1042,3,1081,9,1008,municipality,2000
3656968,"Peconic CDP, New York",36103,LI,273,479,206,561,1,22,70,613,0,683,3,587,municipality,2010
3659157,"Poquott village, New York",36103,LI,350,378,28,719,40,14,43,932,0,975,9,869,municipality,2000
3659157,"Poquott village, New York",36103,LI,353,380,27,728,63,18,40,913,4,953,17,811,municipality,2010
3659355,"Port Jefferson village, New York",36103,LI,2985,3074,89,6266,261,126,408,7429,29,7837,63,6950,municipality,2000
3659355,"Port Jefferson village, New York",36103,LI,3090,3270,180,6143,470,117,500,7250,25,7750,82,6556,municipality,2010
3659377,"Port Jefferson Station CDP, New York",36103,LI,2600,2656,56,5631,278,139,685,6842,18,7527,77,6330,municipality,2000
3659377,"Port Jefferson Station CDP, New York",36103,LI,2812,2949,137,6123,416,183,1158,6680,17,7838,66,5998,municipality,2010
3660408,"Quiogue CDP, New York",36103,LI,336,545,209,622,15,88,115,685,6,800,28,548,municipality,2000
3660408,"Quiogue CDP, New York",36103,LI,307,583,276,612,17,67,155,661,14,816,22,541,municipality,2010
3660422,"Quogue village, New York",36103,LI,453,1322,869,838,4,45,28,990,5,1018,14,922,municipality,2000
3660422,"Quogue village, New York",36103,LI,424,1623,1199,803,10,17,58,909,2,967,21,859,municipality,2010
3661142,"Remsenburg-Speonk CDP, New York",36103,LI,960,1401,441,2038,17,47,140,2535,7,2675,23,2441,municipality,2000
3661142,"Remsenburg-Speonk CDP, New York",36103,LI,984,1624,640,2003,19,33,209,2433,3,2642,30,2348,municipality,2010
3661665,"Ridge CDP, New York",36103,LI,5545,5922,377,10270,120,441,469,12911,54,13380,191,12105,municipality,2000
3661665,"Ridge CDP, New York",36103,LI,5714,6235,521,10825,241,601,749,12587,28,13336,147,11570,municipality,2010
3661973,"Riverhead CDP, New York",36103,LI,3878,4167,289,7980,119,2470,949,9564,65,10513,168,6742,municipality,2000
3661973,"Riverhead CDP, New York",36103,LI,4827,5295,468,10568,220,2033,3369,9930,57,13299,295,7325,municipality,2010
3662066,"Riverside CDP, New York",36103,LI,846,926,80,2457,21,989,278,2597,31,2875,38,1518,municipality,2000
3662066,"Riverside CDP, New York",36103,LI,716,840,124,2521,7,706,872,2039,29,2911,61,1236,municipality,2010
3663319,"Rocky Point CDP, New York",36103,LI,3557,3949,392,7103,117,60,511,9674,17,10185,116,9364,municipality,2000
3663319,"Rocky Point CDP, New York",36103,LI,4820,5366,546,10201,222,187,978,13036,41,14014,155,12431,municipality,2010
3663473,"Ronkonkoma CDP, New York",36103,LI,6550,6660,110,14863,476,153,1269,18760,49,20029,247,17835,municipality,2000
3663473,"Ronkonkoma CDP, New York",36103,LI,6512,6724,212,14608,882,342,1944,17138,74,19082,205,15635,municipality,2010
3664452,"Sagaponack village, New York",36103,LI,249,734,485,469,15,14,20,562,0,582,3,530,municipality,2000
3664452,"Sagaponack village, New York",36103,LI,146,676,530,269,2,4,7,306,2,313,3,295,municipality,2010
3664485,"Sag Harbor village, New York",36103,LI,1120,1942,822,1932,22,169,169,2144,24,2313,44,1885,municipality,2000
3664485,"Sag Harbor village, New York",36103,LI,1000,1941,941,1796,31,157,285,1884,12,2169,30,1654,municipality,2010
3664584,"St. James CDP, New York",36103,LI,4555,4674,119,9835,163,34,458,12810,13,13268,57,12543,municipality,2000
3664584,"St. James CDP, New York",36103,LI,4535,4741,206,9977,261,65,750,12588,30,13338,99,12133,municipality,2010
3664881,"Saltaire village, New York",36103,LI,14,401,387,27,4,0,1,42,0,43,5,33,municipality,2000
3664881,"Saltaire village, New York",36103,LI,15,459,444,32,0,0,0,37,0,37,0,37,municipality,2010
3665409,"Sayville CDP, New York",36103,LI,5603,5721,118,12185,336,107,505,16230,16,16735,118,15653,municipality,2000
3665409,"Sayville CDP, New York",36103,LI,5983,6220,237,12814,307,161,814,16039,26,16853,130,15415,municipality,2010
3666212,"Selden CDP, New York",36103,LI,6809,7083,274,15663,535,349,1799,20062,43,21861,272,18863,municipality,2000
3666212,"Selden CDP, New York",36103,LI,6446,6739,293,14966,866,568,2750,17101,81,19851,243,15343,municipality,2010
3666481,"Setauket-East Setauket CDP, New York",36103,LI,5521,5632,111,11649,1398,194,546,15385,63,15931,167,13563,municipality,2000
3666481,"Setauket-East Setauket CDP, New York",36103,LI,5391,5589,198,11502,1137,156,807,14670,54,15477,195,13128,municipality,2010
3666828,"Shelter Island CDP, New York",36103,LI,531,964,433,978,7,8,40,1194,0,1234,18,1161,municipality,2000
3666828,"Shelter Island CDP, New York",36103,LI,598,1136,538,1064,6,12,75,1258,6,1333,12,1222,municipality,2010
3666850,"Shelter Island Heights CDP, New York",36103,LI,459,1374,915,835,4,3,13,968,0,981,11,950,municipality,2000
3666850,"Shelter Island Heights CDP, New York",36103,LI,525,1583,1058,906,4,13,41,1007,3,1048,21,966,municipality,2010
3667048,"Shinnecock Hills CDP, New York",36103,LI,502,928,426,1507,17,73,182,1567,16,1749,22,1439,municipality,2000
3667048,"Shinnecock Hills CDP, New York",36103,LI,744,1500,756,1736,23,40,655,1533,14,2188,20,1436,municipality,2010
3667070,"Shirley CDP, New York",36103,LI,7353,7774,421,17478,304,788,2749,22646,121,25395,438,20995,municipality,2000
3667070,"Shirley CDP, New York",36103,LI,8353,9022,669,20493,701,1768,4781,23073,105,27854,533,19966,municipality,2010
3667191,"Shoreham village, New York",36103,LI,145,163,18,302,10,0,12,405,0,417,1,394,municipality,2000
3667191,"Shoreham village, New York",36103,LI,192,229,37,405,16,7,15,516,0,531,3,490,municipality,2010
3667851,"Smithtown CDP, New York",36103,LI,8815,8956,141,19892,474,143,910,25991,23,26901,153,25198,municipality,2000
3667851,"Smithtown CDP, New York",36103,LI,8773,9031,258,19510,754,272,1361,25109,37,26470,221,23825,municipality,2010
3668374,"Sound Beach CDP, New York",36103,LI,3358,3640,282,6995,114,60,341,9466,25,9807,89,9178,municipality,2000
3668374,"Sound Beach CDP, New York",36103,LI,2729,3001,272,5649,134,89,475,7137,27,7612,106,6781,municipality,2010
3668462,"Southampton village, New York",36103,LI,1651,2936,1285,3190,41,502,359,3606,21,3965,48,2994,municipality,2000
3668462,"Southampton village, New York",36103,LI,1263,3314,2051,2621,51,297,503,2606,34,3109,37,2187,municipality,2010
3669254,"South Huntington CDP, New York",36103,LI,3299,3379,80,7343,334,76,356,9109,10,9465,91,8598,municipality,2000
3669254,"South Huntington CDP, New York",36103,LI,3378,3500,122,7364,549,212,756,8666,20,9422,144,7741,municipality,2010
3669452,"Southold CDP, New York",36103,LI,2317,3710,1393,4332,11,46,148,5317,12,5465,45,5203,municipality,2000
3669452,"Southold CDP, New York",36103,LI,2414,3996,1582,4616,47,43,482,5266,7,5748,46,5123,municipality,2010
3670387,"Springs CDP, New York",36103,LI,1924,3878,1954,3844,72,67,804,4146,19,4950,98,3890,municipality,2000
3670387,"Springs CDP, New York",36103,LI,2318,4340,2022,5154,97,94,2410,4182,16,6592,30,3945,municipality,2010
3671608,"Stony Brook CDP, New York",36103,LI,4758,4970,212,10029,779,158,334,13393,19,13727,117,12320,municipality,2000
3671608,"Stony Brook CDP, New York",36103,LI,4846,5042,196,10436,1029,215,603,13137,28,13740,147,11718,municipality,2010
3671620,"Stony Brook University CDP, New York",36103,LI,26,26,0,9151,1883,1247,612,8604,61,9216,109,5304,municipality,2010
3673352,"Terryville CDP, New York",36103,LI,3313,3437,124,7684,242,154,1007,9582,20,10589,102,9064,municipality,2000
3673352,"Terryville CDP, New York",36103,LI,3827,3971,144,8779,364,266,1831,10018,60,11849,92,9236,municipality,2010
3675572,"Tuckahoe CDP, New York",36103,LI,687,1092,405,1360,13,122,321,1420,24,1741,13,1248,municipality,2000
3675572,"Tuckahoe CDP, New York",36103,LI,480,865,385,1041,18,128,366,1007,9,1373,36,816,municipality,2010
3677519,"Village of the Branch village, New York",36103,LI,605,611,6,1446,49,3,57,1838,1,1895,6,1779,municipality,2000
3677519,"Village of the Branch village, New York",36103,LI,625,645,20,1317,39,21,51,1756,2,1807,23,1671,municipality,2010
3677772,"Wading River CDP, New York",36103,LI,2370,2713,343,4867,65,121,246,6422,14,6668,52,6170,municipality,2000
3677772,"Wading River CDP, New York",36103,LI,2716,3090,374,5683,71,150,349,7370,17,7719,101,7031,municipality,2010
3677805,"Wainscott CDP, New York",36103,LI,260,764,504,511,2,25,44,584,2,628,17,538,municipality,2000
3677805,"Wainscott CDP, New York",36103,LI,264,876,612,509,3,15,93,557,9,650,10,520,municipality,2010
3678575,"Water Mill CDP, New York",36103,LI,722,1461,739,1377,12,37,57,1667,1,1724,6,1611,municipality,2000
3678575,"Water Mill CDP, New York",36103,LI,652,2085,1433,1271,22,15,109,1450,1,1559,16,1396,municipality,2010
3679246,"West Babylon CDP, New York",36103,LI,14268,14571,303,32339,818,4333,3344,40108,121,43452,583,34253,municipality,2000
3679246,"West Babylon CDP, New York",36103,LI,14537,15091,554,33507,1163,4622,5262,37951,200,43213,644,31322,municipality,2010
3679301,"West Bay Shore CDP, New York",36103,LI,1721,1789,68,3664,100,42,195,4580,10,4775,37,4391,municipality,2000
3679301,"West Bay Shore CDP, New York",36103,LI,1720,1818,98,3669,101,100,343,4305,7,4648,70,4027,municipality,2010
3680170,"Westhampton CDP, New York",36103,LI,1070,1601,531,2107,35,124,157,2712,6,2869,42,2505,municipality,2000
3680170,"Westhampton CDP, New York",36103,LI,1045,2120,1075,2418,35,109,380,2699,13,3079,38,2504,municipality,2010
3680181,"Westhampton Beach village, New York",36103,LI,805,2279,1474,1513,22,88,146,1756,12,1902,16,1618,municipality,2000
3680181,"Westhampton Beach village, New York",36103,LI,691,2376,1685,1371,17,46,340,1381,0,1721,19,1299,municipality,2010
3680186,"West Hampton Dunes village, New York",36103,LI,7,172,165,11,1,0,0,11,0,11,0,10,municipality,2000
3680186,"West Hampton Dunes village, New York",36103,LI,24,272,248,47,1,0,2,53,0,55,0,52,municipality,2010
3680258,"West Hills CDP, New York",36103,LI,1978,2008,30,4279,191,48,135,5472,10,5607,39,5184,municipality,2000
3680258,"West Hills CDP, New York",36103,LI,1974,2037,63,4362,300,60,304,5288,11,5592,67,4850,municipality,2010
3680302,"West Islip CDP, New York",36103,LI,8883,9044,161,20682,314,108,1018,27889,37,28907,239,27191,municipality,2000
3680302,"West Islip CDP, New York",36103,LI,9040,9266,226,21082,477,166,1557,26778,22,28335,244,25869,municipality,2010
3680885,"West Sayville CDP, New York",36103,LI,1735,2014,279,3680,61,20,105,4898,8,5003,16,4793,municipality,2000
3680885,"West Sayville CDP, New York",36103,LI,1771,2124,353,3837,55,35,183,4828,16,5011,29,4693,municipality,2010
3681419,"Wheatley Heights CDP, New York",36103,LI,1455,1494,39,3496,171,2344,585,4428,41,5013,138,1734,municipality,2000
3681419,"Wheatley Heights CDP, New York",36103,LI,1480,1517,37,3706,285,2701,692,4438,44,5130,171,1237,municipality,2010
3683294,"Wyandanch CDP, New York",36103,LI,2525,2776,251,6793,58,7949,1724,8822,91,10546,315,409,municipality,2000
3683294,"Wyandanch CDP, New York",36103,LI,2926,3157,231,8185,121,7326,3286,8361,101,11647,234,579,municipality,2010
3683426,"Yaphank CDP, New York",36103,LI,1566,1650,84,3926,52,550,369,4656,12,5025,53,3989,municipality,2000
3683426,"Yaphank CDP, New York",36103,LI,1872,1961,89,4788,105,389,677,5268,15,5945,52,4707,municipality,2010
3610304000,"Babylon town, Suffolk County, New York",36103,LI,138096,142372,4276,313306,7950,63890,42550,381034,1748,423584,7086,300360,municipality,2000
3610304000,"Babylon town, Suffolk County, New York",36103,LI,70894,74233,3339,164175,6411,33147,35793,177810,1049,213603,3242,133961,municipality,2010
3610310000,"Brookhaven town, Suffolk County, New York",36103,LI,293656,310812,17156,657254,25824,36392,72082,824414,3084,896496,11370,747744,municipality,2000
3610310000,"Brookhaven town, Suffolk County, New York",36103,LI,162884,175026,12142,369968,18880,24428,60270,425770,1863,486040,6817,373782,municipality,2010
3610322194,"East Hampton town, Suffolk County, New York",36103,LI,16202,39280,23078,31062,472,1362,5828,33610,232,39438,650,30894,municipality,2000
3610322194,"East Hampton town, Suffolk County, New York",36103,LI,8410,21038,12628,17186,278,678,5660,15797,85,21457,192,14564,municipality,2010
3610337000,"Huntington town, Suffolk County, New York",36103,LI,131834,135416,3582,291140,13624,15868,25688,364890,912,390578,4432,330054,municipality,2000
3610337000,"Huntington town, Suffolk County, New York",36103,LI,69311,71948,2637,152755,10009,8933,22362,180902,563,203264,2707,158690,municipality,2010
3610338000,"Islip town, Suffolk County, New York",36103,LI,197872,208556,10684,468614,13744,53654,130062,515162,2434,645224,9724,435606,municipality,2000
3610338000,"Islip town, Suffolk County, New York",36103,LI,103631,110665,7034,251805,9358,27898,97371,238172,1385,335543,4248,195283,municipality,2010
3610359106,"Poospatuck Reservation, Suffolk County, New York",36103,LI,186,200,14,344,0,70,26,516,410,542,28,8,municipality,2000
3610359106,"Poospatuck Reservation, Suffolk County, New York",36103,LI,110,124,14,245,3,53,27,297,139,324,62,40,municipality,2010
3610361984,"Riverhead town, Suffolk County, New York",36103,LI,21498,24958,3460,42616,498,5724,3356,52004,188,55360,608,44986,municipality,2000
3610361984,"Riverhead town, Suffolk County, New York",36103,LI,12990,15424,2434,26668,367,2501,4649,28857,88,33506,480,25421,municipality,2010
3610366839,"Shelter Island town, Suffolk County, New York",36103,LI,1992,4740,2748,3648,22,22,106,4350,2,4456,58,4246,municipality,2000
3610366839,"Shelter Island town, Suffolk County, New York",36103,LI,1128,2754,1626,1981,10,25,116,2276,9,2392,33,2199,municipality,2010
3610367059,"Shinnecock Reservation, Suffolk County, New York",36103,LI,358,388,30,694,2,24,50,958,882,1008,10,40,municipality,2000
3610367059,"Shinnecock Reservation, Suffolk County, New York",36103,LI,226,256,30,500,3,29,42,620,483,662,72,33,municipality,2010
3610368000,"Smithtown town, Suffolk County, New York",36103,LI,76974,78714,1740,171248,5486,1378,7710,223720,360,231430,1422,215074,municipality,2000
3610368000,"Smithtown town, Suffolk County, New York",36103,LI,40055,41381,1326,87705,4197,1122,6272,111529,238,117801,996,104976,municipality,2010
3610368473,"Southampton town, Suffolk County, New York",36103,LI,43008,71672,28664,86294,908,6982,9400,100024,562,109424,1148,90424,municipality,2000
3610368473,"Southampton town, Suffolk County, New York",36103,LI,21193,41759,20566,44863,618,2776,11295,45495,275,56790,670,41156,municipality,2010
3610369463,"Southold town, Suffolk County, New York",36103,LI,16922,27538,10616,32356,180,1158,1964,39234,102,41198,420,37374,municipality,2000
3610369463,"Southold town, Suffolk County, New York",36103,LI,9090,15377,6287,17829,161,527,2382,19586,45,21968,230,18623,municipality,2010
3610506310,"Bethel town, Sullivan County, New York",36105,MHV,3298,7282,3984,6820,44,378,984,7740,24,8724,74,7220,municipality,2000
3610506310,"Bethel town, Sullivan County, New York",36105,MHV,1733,3954,2221,3495,36,139,485,3770,21,4255,68,3506,municipality,2010
3610511759,"Callicoon town, Sullivan County, New York",36105,MHV,2444,3594,1150,4692,42,36,278,5826,20,6104,50,5678,municipality,2000
3610511759,"Callicoon town, Sullivan County, New York",36105,MHV,1288,2003,715,2445,51,34,126,2931,10,3057,33,2803,municipality,2010
3610516661,"Cochecton town, Sullivan County, New York",36105,MHV,1110,1910,800,2058,16,24,44,2612,12,2656,24,2536,municipality,2000
3610516661,"Cochecton town, Sullivan County, New York",36105,MHV,604,1114,510,1143,10,29,57,1315,4,1372,6,1266,municipality,2010
3610520104,"Delaware town, Sullivan County, New York",36105,MHV,1912,2674,762,3980,44,506,344,5094,16,5438,34,4494,municipality,2000
3610520104,"Delaware town, Sullivan County, New York",36105,MHV,996,1535,539,2149,11,313,185,2485,6,2670,25,2130,municipality,2010
3610525241,"Fallsburg town, Sullivan County, New York",36105,MHV,7522,13322,5800,18774,278,3560,3554,20914,162,24468,314,16600,municipality,2000
3610525241,"Fallsburg town, Sullivan County, New York",36105,MHV,4225,8497,4272,9677,176,1654,2823,10047,91,12870,262,7864,municipality,2010
3610526528,"Forestburgh town, Sullivan County, New York",36105,MHV,654,1000,346,1298,0,34,80,1586,0,1666,6,1546,municipality,2000
3610526528,"Forestburgh town, Sullivan County, New York",36105,MHV,355,550,195,680,7,35,36,783,12,819,10,719,municipality,2010
3610527573,"Fremont town, Sullivan County, New York",36105,MHV,1126,2364,1238,2070,26,44,34,2748,20,2782,38,2620,municipality,2000
3610527573,"Fremont town, Sullivan County, New York",36105,MHV,607,1323,716,1116,12,31,48,1333,8,1381,26,1256,municipality,2010
3610534473,"Highland town, Sullivan County, New York",36105,MHV,1902,3116,1214,3736,20,146,190,4618,26,4808,36,4390,municipality,2000
3610534473,"Highland town, Sullivan County, New York",36105,MHV,1049,1766,717,2054,22,81,148,2382,1,2530,42,2236,municipality,2010
3610542235,"Liberty town, Sullivan County, New York",36105,MHV,7422,10700,3278,14504,266,1650,2100,17164,104,19264,188,14956,municipality,2000
3610542235,"Liberty town, Sullivan County, New York",36105,MHV,3883,5495,1612,7743,146,817,1862,8023,75,9885,170,6815,municipality,2010
3610543786,"Lumberland town, Sullivan County, New York",36105,MHV,1562,2838,1276,2884,32,8,74,3804,22,3878,36,3706,municipality,2000
3610543786,"Lumberland town, Sullivan County, New York",36105,MHV,967,1630,663,1922,23,34,126,2342,9,2468,36,2240,municipality,2010
3610544809,"Mamakating town, Sullivan County, New York",36105,MHV,8306,11258,2952,16084,224,430,1050,20954,110,22004,280,19910,municipality,2000
3610544809,"Mamakating town, Sullivan County, New York",36105,MHV,4738,6251,1513,9268,135,390,1027,11058,52,12085,220,10261,municipality,2010
3610549847,"Neversink town, Sullivan County, New York",36105,MHV,2692,3920,1228,5108,16,40,156,6950,26,7106,86,6782,municipality,2000
3610549847,"Neversink town, Sullivan County, New York",36105,MHV,1464,2045,581,2763,21,45,129,3428,14,3557,42,3306,municipality,2010
3610563176,"Rockland town, Sullivan County, New York",36105,MHV,3120,4950,1830,5836,70,214,556,7270,10,7826,94,6882,municipality,2000
3610563176,"Rockland town, Sullivan County, New York",36105,MHV,1596,2755,1159,2952,50,92,322,3453,18,3775,58,3235,municipality,2010
3610573627,"Thompson town, Sullivan County, New York",36105,MHV,11086,18516,7430,20986,520,4536,4132,24246,106,28378,418,18666,municipality,2000
3610573627,"Thompson town, Sullivan County, New York",36105,MHV,5982,9130,3148,11330,319,2590,3102,12206,99,15308,372,8826,municipality,2010
3610575759,"Tusten town, Sullivan County, New York",36105,MHV,1166,2016,850,2198,22,188,102,2728,6,2830,48,2464,municipality,2000
3610575759,"Tusten town, Sullivan County, New York",36105,MHV,652,1138,486,1234,14,65,78,1437,11,1515,30,1317,municipality,2010
3611120247,"Denning town, Ulster County, New York",36111,MHV,430,1034,604,852,2,0,16,1016,10,1032,30,974,municipality,2000
3611120247,"Denning town, Ulster County, New York",36111,MHV,234,531,297,454,1,6,7,544,4,551,15,518,municipality,2010
3611124691,"Esopus town, Ulster County, New York",36111,MHV,6878,7448,570,13930,176,390,356,18306,52,18662,244,17444,municipality,2000
3611124691,"Esopus town, Ulster County, New York",36111,MHV,3492,3969,477,7121,125,395,487,8554,38,9041,202,7794,municipality,2010
3611128255,"Gardiner town, Ulster County, New York",36111,MHV,3994,4510,516,7752,78,162,480,9996,48,10476,140,9568,municipality,2000
3611128255,"Gardiner town, Ulster County, New York",36111,MHV,2229,2610,381,4440,60,78,381,5332,13,5713,79,5102,municipality,2010
3611132116,"Hardenburgh town, Ulster County, New York",36111,MHV,190,550,360,352,10,2,4,412,4,416,0,396,municipality,2000
3611132116,"Hardenburgh town, Ulster County, New York",36111,MHV,112,344,232,194,5,0,7,231,10,238,3,213,municipality,2010
3611137143,"Hurley town, Ulster County, New York",36111,MHV,5388,5892,504,10202,160,174,250,12878,28,13128,116,12400,municipality,2000
3611137143,"Hurley town, Ulster County, New York",36111,MHV,2693,3069,376,5088,91,96,181,6133,26,6314,86,5834,municipality,2010
3611139727,"Kingston city, Ulster County, New York",36111,MHV,19742,21274,1532,35698,712,5640,3032,43880,198,46912,1178,36152,municipality,2000
3611139727,"Kingston city, Ulster County, New York",36111,MHV,10217,11147,930,18686,426,3214,3203,20690,124,23893,861,16065,municipality,2010
3611139738,"Kingston town, Ulster County, New York",36111,MHV,712,796,84,1400,8,32,30,1786,4,1816,30,1712,municipality,2000
3611139738,"Kingston town, Ulster County, New York",36111,MHV,380,432,52,733,11,27,28,861,4,889,6,813,municipality,2010
3611142994,"Lloyd town, Ulster County, New York",36111,MHV,7252,7636,384,14774,234,968,1008,18874,74,19882,272,17326,municipality,2000
3611142994,"Lloyd town, Ulster County, New York",36111,MHV,4112,4419,307,8333,309,658,793,10070,36,10863,201,8866,municipality,2010
3611145458,"Marbletown town, Ulster County, New York",36111,MHV,4772,5692,920,8994,82,150,242,11466,44,11708,178,11012,municipality,2000
3611145458,"Marbletown town, Ulster County, New York",36111,MHV,2400,2989,589,4606,68,81,155,5452,23,5607,84,5196,municipality,2010
3611145722,"Marlborough town, Ulster County, New York",36111,MHV,6040,6352,312,12140,54,448,658,15868,32,16526,176,15158,municipality,2000
3611145722,"Marlborough town, Ulster County, New York",36111,MHV,3335,3644,309,6782,77,334,769,8039,34,8808,119,7475,municipality,2010
3611150562,"New Paltz town, Ulster County, New York",36111,MHV,8910,9358,448,21332,1028,1418,2108,23552,278,25660,536,20292,municipality,2000
3611150562,"New Paltz town, Ulster County, New York",36111,MHV,4515,4877,362,12020,605,612,1233,12770,76,14003,277,11200,municipality,2010
3611154749,"Olive town, Ulster County, New York",36111,MHV,3738,4612,874,6942,84,48,230,8928,62,9158,84,8650,municipality,2000
3611154749,"Olive town, Ulster County, New York",36111,MHV,1960,2498,538,3606,57,53,139,4280,19,4419,87,4064,municipality,2010
3611158552,"Plattekill town, Ulster County, New York",36111,MHV,7298,7776,478,14332,124,812,3166,16618,76,19784,312,15294,municipality,2000
3611158552,"Plattekill town, Ulster County, New York",36111,MHV,3861,4242,381,7947,84,534,1934,8565,30,10499,144,7773,municipality,2010
3611163011,"Rochester town, Ulster County, New York",36111,MHV,5376,7500,2124,10326,64,304,678,13358,64,14036,230,12696,municipality,2000
3611163011,"Rochester town, Ulster County, New York",36111,MHV,2936,4019,1083,5682,64,151,410,6903,40,7313,144,6504,municipality,2010
3611163737,"Rosendale town, Ulster County, New York",36111,MHV,5174,5714,540,9578,56,222,334,12370,64,12704,144,11884,municipality,2000
3611163737,"Rosendale town, Ulster County, New York",36111,MHV,2572,2897,325,4871,46,100,304,5771,19,6075,106,5500,municipality,2010
3611165299,"Saugerties town, Ulster County, New York",36111,MHV,14956,16514,1558,30320,304,1542,1832,37904,122,39736,408,35528,municipality,2000
3611165299,"Saugerties town, Ulster County, New York",36111,MHV,8163,9106,943,15404,198,309,979,18503,59,19482,325,17612,municipality,2010
3611166597,"Shandaken town, Ulster County, New York",36111,MHV,2926,5332,2406,5160,76,66,198,6272,52,6470,108,5970,municipality,2000
3611166597,"Shandaken town, Ulster County, New York",36111,MHV,1505,2776,1271,2598,47,28,153,2932,17,3085,60,2780,municipality,2010
3611166674,"Shawangunk town, Ulster County, New York",36111,MHV,6866,7508,642,18648,214,1890,1674,22370,82,24044,234,19950,municipality,2000
3611166674,"Shawangunk town, Ulster County, New York",36111,MHV,3887,4333,446,11639,222,1078,1310,13022,52,14332,148,11522,municipality,2010
3611175935,"Ulster town, Ulster County, New York",36111,MHV,9700,10478,778,19184,384,698,614,24474,62,25088,342,22988,municipality,2000
3611175935,"Ulster town, Ulster County, New York",36111,MHV,4961,5368,407,9950,269,359,662,11665,39,12327,259,10739,municipality,2010
3611178828,"Wawarsing town, Ulster County, New York",36111,MHV,8764,11642,2878,19804,294,2966,4652,21126,152,25778,510,17204,municipality,2000
3611178828,"Wawarsing town, Ulster County, New York",36111,MHV,4509,6211,1702,10486,180,1784,2538,10619,110,13157,316,8229,municipality,2010
3611183052,"Woodstock town, Ulster County, New York",36111,MHV,5892,7694,1802,10236,194,156,320,12162,80,12482,202,11530,municipality,2000
3611183052,"Woodstock town, Ulster County, New York",36111,MHV,2976,4157,1181,5037,115,85,236,5648,14,5884,134,5300,municipality,2010
3611905320,"Bedford town, Westchester County, New York",36119,LHV,11462,12040,578,26680,716,2334,2744,33522,88,36266,268,30116,municipality,2000
3611905320,"Bedford town, Westchester County, New York",36119,LHV,5765,6326,561,12686,507,855,2104,15231,55,17335,197,13617,municipality,2010
3611918410,"Cortlandt town, Westchester County, New York",36119,LHV,27034,28130,1096,56528,1956,3344,5532,71402,262,76934,900,64940,municipality,2000
3611918410,"Cortlandt town, Westchester County, New York",36119,LHV,14987,15962,975,31331,1479,1994,5324,36268,149,41592,670,31976,municipality,2010
3611921820,"Eastchester town, Westchester County, New York",36119,LHV,25252,26070,818,47700,4270,1650,2804,59832,142,62636,768,53002,municipality,2000
3611921820,"Eastchester town, Westchester County, New York",36119,LHV,12946,13747,801,24270,2355,967,2335,30028,93,32363,447,26166,municipality,2010
3611930367,"Greenburgh town, Westchester County, New York",36119,LHV,66086,68168,2082,132408,15174,21986,15650,157878,670,173528,3148,116900,municipality,2000
3611930367,"Greenburgh town, Westchester County, New York",36119,LHV,33495,35452,1957,68042,9155,10377,12366,76034,402,88400,1561,54539,municipality,2010
3611932413,"Harrison town, Westchester County, New York",36119,LHV,16788,17360,572,36476,2618,616,3236,45072,92,48308,578,41168,municipality,2000
3611932413,"Harrison town, Westchester County, New York",36119,LHV,8375,8956,581,21249,2062,563,3202,24270,92,27472,420,21133,municipality,2010
3611942136,"Lewisboro town, Westchester County, New York",36119,LHV,8436,8930,494,16854,514,288,612,24036,66,24648,206,22962,municipality,2000
3611942136,"Lewisboro town, Westchester County, New York",36119,LHV,4453,4854,401,8998,294,153,552,11859,36,12411,189,11187,municipality,2010
3611944842,"Mamaroneck town, Westchester County, New York",36119,LHV,21858,22510,652,42828,1792,1502,6328,51606,134,57934,690,47488,municipality,2000
3611944842,"Mamaroneck town, Westchester County, New York",36119,LHV,10849,11562,713,21280,1131,775,4524,24632,126,29156,429,22171,municipality,2010
3611948895,"Mount Kisco town, Westchester County, New York",36119,LHV,7986,8206,220,15546,842,1102,4900,15066,84,19966,264,12774,municipality,2000
3611948895,"Mount Kisco town, Westchester County, New York",36119,LHV,4102,4289,187,8505,515,500,3818,7059,51,10877,131,5862,municipality,2010
3611949011,"Mount Pleasant town, Westchester County, New York",36119,LHV,27474,27970,496,64004,2802,3924,12114,74328,126,86442,716,66760,municipality,2000
3611949011,"Mount Pleasant town, Westchester County, New York",36119,LHV,14306,14826,520,32801,2093,2076,7859,35865,139,43724,483,31074,municipality,2010
3611949121,"Mount Vernon city, Westchester County, New York",36119,LHV,51458,54096,2638,102126,2866,79778,14166,122596,1718,136762,4880,33354,municipality,2000
3611949121,"Mount Vernon city, Westchester County, New York",36119,LHV,26260,28990,2730,51883,1206,41226,9592,57700,1149,67292,1670,12449,municipality,2010
3611950078,"New Castle town, Westchester County, New York",36119,LHV,11464,11686,222,23834,1938,462,974,34008,46,34982,312,31250,municipality,2000
3611950078,"New Castle town, Westchester County, New York",36119,LHV,5786,6037,251,11949,1282,263,710,16859,47,17569,254,15013,municipality,2010
3611950617,"New Rochelle city, Westchester County, New York",36119,LHV,52378,53990,1612,109662,4608,26778,28984,115380,732,144364,2718,80544,municipality,2000
3611950617,"New Rochelle city, Westchester County, New York",36119,LHV,27953,29586,1633,59554,3212,13956,21452,55610,356,77062,1138,36948,municipality,2010
3611951693,"North Castle town, Westchester County, New York",36119,LHV,7166,7412,246,15250,860,364,898,20800,24,21698,188,19364,municipality,2000
3611951693,"North Castle town, Westchester County, New York",36119,LHV,3913,4135,222,8321,586,179,906,10935,32,11841,144,9994,municipality,2010
3611953517,"North Salem town, Westchester County, New York",36119,LHV,3528,3958,430,7640,100,74,378,9968,68,10346,134,9592,municipality,2000
3611953517,"North Salem town, Westchester County, New York",36119,LHV,1811,2082,271,3880,84,60,382,4722,22,5104,45,4511,municipality,2010
3611955541,"Ossining town, Westchester County, New York",36119,LHV,24710,25466,756,57164,3274,9938,14564,58504,220,73068,1008,44064,municipality,2000
3611955541,"Ossining town, Westchester County, New York",36119,LHV,12706,13386,680,29560,1834,4345,11403,26271,158,37674,476,19458,municipality,2010
3611956979,"Peekskill city, Westchester County, New York",36119,LHV,17392,18106,714,33940,1058,10966,9840,35042,270,44882,1196,21552,municipality,2000
3611956979,"Peekskill city, Westchester County, New York",36119,LHV,9060,9709,649,18290,682,5052,8713,14870,113,23583,584,8439,municipality,2010
3611957012,"Pelham town, Westchester County, New York",36119,LHV,8298,8492,194,16942,936,1038,1428,22304,102,23732,404,19824,municipality,2000
3611957012,"Pelham town, Westchester County, New York",36119,LHV,4247,4483,236,8701,642,729,1243,11153,67,12396,258,9457,municipality,2010
3611959685,"Pound Ridge town, Westchester County, New York",36119,LHV,3398,3736,338,6982,156,106,232,9220,10,9452,102,8846,municipality,2000
3611959685,"Pound Ridge town, Westchester County, New York",36119,LHV,1844,2108,264,3695,96,64,233,4871,8,5104,88,4615,municipality,2010
3611964309,"Rye city, Westchester County, New York",36119,LHV,10754,11118,364,21006,1928,362,1436,28474,72,29910,298,25814,municipality,2000
3611964309,"Rye city, Westchester County, New York",36119,LHV,5520,5957,437,10592,932,207,1014,14706,35,15720,203,13329,municipality,2010
3611964320,"Rye town, Westchester County, New York",36119,LHV,30778,31626,848,67142,2504,4138,28528,59232,430,87760,1352,50808,municipality,2000
3611964320,"Rye town, Westchester County, New York",36119,LHV,15469,16556,1087,35078,1470,1884,19477,26451,329,45928,474,22294,municipality,2010
3611965442,"Scarsdale town, Westchester County, New York",36119,LHV,11324,11590,266,23970,4482,526,934,34712,80,35646,436,29188,municipality,2000
3611965442,"Scarsdale town, Westchester County, New York",36119,LHV,5418,5647,229,11389,2220,242,671,16495,88,17166,297,13648,municipality,2010
3611968308,"Somers town, Westchester County, New York",36119,LHV,13604,14196,592,27646,682,586,1086,35606,40,36692,286,34012,municipality,2000
3611968308,"Somers town, Westchester County, New York",36119,LHV,7623,7982,359,15365,640,304,1010,19424,46,20434,206,18228,municipality,2010
3611981677,"White Plains city, Westchester County, New York",36119,LHV,41842,43152,1310,83630,4742,16276,24952,81202,606,106154,2092,57486,municipality,2000
3611981677,"White Plains city, Westchester County, New York",36119,LHV,22910,24382,1472,45382,3587,7502,16839,40014,259,56853,861,27805,municipality,2010
3611984000,"Yonkers city, Westchester County, New York",36119,LHV,148702,155178,6476,296744,18580,60328,101704,290468,2514,392172,10354,198692,municipality,2000
3611984000,"Yonkers city, Westchester County, New York",36119,LHV,74550,80389,5839,151277,11370,31297,67927,128049,1154,195976,3065,81163,municipality,2010
3611984077,"Yorktown town, Westchester County, New York",36119,LHV,25112,25704,592,52622,2484,1988,4224,68412,174,72636,714,63052,municipality,2000
3611984077,"Yorktown town, Westchester County, New York",36119,LHV,12884,13418,534,27035,1689,1015,3376,32705,110,36081,404,29487,municipality,2010
36005CS,BX Central and South,36005,NYC,148853,158913,10060,309840,15078,119031,236419,202201,4715,438620,8984,54393,municipality,2000
36005CS,BX Central and South,36005,NYC,156721,165740,9019,339686,22186,122382,265843,195443,5096,461286,5467,40312,municipality,2010
36005NE,BX North and East,36005,NYC,94854,99908,5054,186922,4473,117431,50118,198037,1778,248155,6018,68337,municipality,2000
36005NE,BX North and East,36005,NYC,96791,102562,5771,194973,5609,121515,68901,184473,2733,253374,3722,50894,municipality,2010
36005W,BX West,36005,NYC,219505,231838,12333,438516,19007,179876,358168,287707,5696,645875,12207,70921,municipality,2000
36005W,BX West,36005,NYC,229937,243594,13657,482253,19540,172798,406669,263779,4665,670448,6773,60003,municipality,2010
36047C,BK Central,36047,NYC,201610,213139,11529,418470,11348,413337,44928,530958,4012,575886,14230,88031,municipality,2000
36047C,BK Central,36047,NYC,204464,218751,14287,429955,13366,394809,49672,509846,3636,559518,9762,88273,municipality,2010
36047E,BK East,36047,NYC,85177,92283,7106,174228,6441,155780,81201,182446,3592,263647,7084,9549,municipality,2000
36047E,BK East,36047,NYC,92886,100608,7722,195131,9622,164346,84875,189244,3983,274119,4128,7165,municipality,2010
36047N,BK North,36047,NYC,128716,140487,11771,264364,9929,124682,153255,230607,5682,383862,9002,81312,municipality,2000
36047N,BK North,36047,NYC,150039,165611,15572,308924,15963,112659,147533,263514,2506,411047,5461,126925,municipality,2010
36047S,BK Southern,36047,NYC,324145,336444,12299,664838,116417,90150,94095,787906,5164,882001,27509,548666,municipality,2000
36047S,BK Southern,36047,NYC,323559,357209,33650,677252,160096,79237,114375,773686,3679,888061,12205,518469,municipality,2010
36047W,BK West,36047,NYC,141079,148513,7434,280927,40156,64634,114399,245531,2904,359930,10863,126974,municipality,2000
36047W,BK West,36047,NYC,145908,158114,12206,299060,61082,48015,99830,272125,2100,371955,8454,152474,municipality,2010
36061E,MN East Side,36061,NYC,212494,232127,19633,323522,29113,12356,23002,337502,1430,360504,5882,288721,municipality,2000
36061E,MN East Side,36061,NYC,206971,234068,27097,328647,40137,12266,26956,343974,1511,370930,6833,283227,municipality,2010
36061L,MN Lower,36061,NYC,138123,146707,8584,252113,76240,16247,52259,239687,1843,291946,6237,139120,municipality,2000
36061L,MN Lower,36061,NYC,152412,166325,13913,276214,78234,15539,50634,263637,1461,314271,6926,161477,municipality,2010
36061U,MN Upper,36061,NYC,210107,226337,16230,424325,15198,181739,294053,276238,3425,570291,10161,65715,municipality,2000
s,MN Upper,36061,NYC,216933,233344,16411,448303,23354,155467,278755,283361,3256,562116,9135,92149,municipality,2010
36061WM,MN West Side and Midtown,36061,NYC,177920,192973,15053,279319,22740,24356,48502,265952,1875,314454,6664,210317,municipality,2000
36061WM,MN West Side and Midtown,36061,NYC,187530,213353,25823,298274,35899,22068,47232,291324,1654,338556,7063,224640,municipality,2010
36081NE,QN Northeast,36081,NYC,188358,194808,6450,404782,154038,30795,75682,433469,3981,509151,15909,228746,municipality,2000
36081NE,QN Northeast,36081,NYC,188278,199124,10846,422530,216089,28051,79640,439557,3565,519197,10471,181381,municipality,2010
36081NW,QN Northwest,36081,NYC,338979,350623,11644,730833,164231,49575,334561,592309,7835,926870,31554,339114,municipality,2000
36081NW,QN Northwest,36081,NYC,337909,362407,24498,741046,189619,39603,362648,557243,6741,919891,14905,306375,municipality,2010
36081SE,QN Southeast,36081,NYC,168275,180465,12190,382219,31621,311244,68892,453267,9440,522159,20406,80556,municipality,2000
36081SE,QN Southeast,36081,NYC,169682,183794,14112,400297,49124,295216,84386,440799,12803,525185,14917,68739,municipality,2010
36081SW,QN Southwest,36081,NYC,87052,91354,4302,202321,39413,31217,77470,193729,13978,271199,24642,84479,municipality,2000
36081SW,QN Southwest,36081,NYC,84248,89802,5554,204948,53502,33011,87076,179373,16814,266449,15814,60232,municipality,2010
36085C,SI Central,36085,NYC,45882,47705,1823,98148,11286,3198,12406,115771,445,128177,2077,98765,municipality,2000
36085C,SI Central,36085,NYC,47772,50814,3042,104928,14989,4027,17665,115456,533,133121,1853,94054,municipality,2010
36085N,SI North,36085,NYC,57306,60986,3680,117744,8496,35189,32192,130417,881,162609,4587,81264,municipality,2000
36085N,SI North,36085,NYC,60652,65422,4770,130805,13111,38620,50055,125701,986,175756,3459,69525,municipality,2010
36085S,SI South,36085,NYC,53153,55302,2149,114578,5004,1317,8952,143990,249,152942,1133,136287,municipality,2000
36085S,SI South,36085,NYC,57092,60420,3328,123796,6597,1666,13331,146522,341,159853,1328,136590,municipality,2010