,id,name,stco,subreg,H_Occ,H_Tot,H_Vac,P_Asian,P_Black,P_Hisp,P_NonHisp,P_Other,P_Tot,P_White,geotype,yr
1,09001,Fairfield County,09001,CT,354084,378479,24395,50751,99992,205351,752068,49200,957419,552125,county,2020
3,09005,Litchfield County,09005,CT,77502,87615,10113,3434,2957,14580,170606,8614,185186,155601,county,2020
5,09009,New Haven County,09009,CT,343437,369178,25741,36995,110273,170081,694754,37798,864835,509688,county,2020
3,36005,Bronx County,36005,NYC,522450,547030,24580,67766,419393,806463,666191,48236,1472654,130796,county,2020
14,36027,Dutchess County,36027,MHV,111927,122009,10082,10635,30126,42224,253687,14431,295911,198495,county,2020
24,36047,Kings County,36047,NYC,1009804,1077654,67850,370776,729696,516426,2219648,150749,2736074,968427,county,2020
30,36059,Nassau County,36059,LI,455482,476732,21250,163165,147216,256425,1139349,49514,1395774,779454,county,2020
31,36061,New York County,36061,NYC,817782,913926,96144,219624,199592,402640,1291611,79101,1694251,793294,county,2020
36,36071,Orange County,36071,MHV,135746,146879,11133,11665,41341,89744,311566,26712,401310,231848,county,2020
40,36079,Putnam County,36079,LHV,35329,38308,2979,2146,2425,17760,79908,3395,97668,71942,county,2020
41,36081,Queens County,36081,NYC,847210,896333,49123,656583,381375,667861,1737603,150287,2405464,549358,county,2020
43,36085,Richmond County,36085,NYC,173202,183692,10490,58753,46835,96960,398787,15218,495747,277981,county,2020
44,36087,Rockland County,36087,LHV,102948,108068,5120,20413,33775,66451,271878,11577,338329,206113,county,2020
52,36103,Suffolk County,36103,LI,516872,578940,62068,65019,107268,332959,1192961,53344,1525920,967330,county,2020
53,36105,Sullivan County,36105,MHV,30183,49125,18942,1569,6069,14007,64617,4288,78624,52691,county,2020
56,36111,Ulster County,36111,MHV,73321,85853,12532,3778,10152,21119,160732,10107,181851,136695,county,2020
60,36119,Westchester County,36119,LHV,367296,388963,21667,64907,131010,269334,735123,41522,1004457,497684,county,2020
2,34003,Bergen County,34003,INJ,350664,367383,16719,157500,49909,204683,751049,31721,955732,511919,county,2020
7,34013,Essex County,34013,INJ,312913,334896,21983,46957,324081,210353,653375,47212,863728,235125,county,2020
9,34017,Hudson County,34017,INJ,289408,312706,23298,123424,71385,293019,431835,30496,724854,206530,county,2020
10,34019,Hunterdon County,34019,ONJ,48978,51687,2709,5677,3030,10929,118018,4644,128947,104667,county,2020
11,34021,Mercer County,34021,ONJ,139361,150442,11081,48330,72364,84177,303163,13889,387340,168580,county,2020
12,34023,Middlesex County,34023,INJ,300547,315521,14974,227973,78719,193687,669475,29625,863162,333158,county,2020
13,34025,Monmouth County,34025,ONJ,244630,268912,24282,36008,39178,80730,562885,26874,643615,460825,county,2020
14,34027,Morris County,34027,INJ,188496,197722,9226,57700,15586,76661,432624,18163,509285,341175,county,2020
15,34029,Ocean County,34029,ONJ,238812,294429,55617,11339,17649,66329,570900,21334,637229,520578,county,2020
16,34031,Passaic County,34031,INJ,177075,185367,8292,30209,51859,224030,300088,14478,524118,203542,county,2020
18,34035,Somerset County,34035,INJ,125598,131822,6224,67098,30480,57379,287982,12993,345361,177411,county,2020
19,34037,Sussex County,34037,ONJ,55915,62709,6794,2918,2858,14310,129911,5888,144221,118247,county,2020
20,34039,Union County,34039,INJ,200372,209908,9536,31963,112261,195519,379826,24357,575345,211245,county,2020
21,34041,Warren County,34041,ONJ,43327,46457,3130,2886,5573,12225,97407,4693,109632,84255,county,2020
0,CT,Connecticut,,CT,775023,835272,60249,91180,213222,390012,1617428,95612,2007440,1217414,subregion,2020
1,INJ,Inner New Jersey,,INJ,1945073,2055325,110252,742824,734280,1455331,3906254,209045,5361585,2220105,subregion,2020
2,LHV,Lower Hudson Valley,,LHV,505573,535339,29766,87466,167210,353545,1086909,56494,1440454,775739,subregion,2020
3,LI,Long Island,,LI,972354,1055672,83318,228184,254484,589384,2332310,102858,2921694,1746784,subregion,2020
4,MHV,Mid Hudsonn Valley,,MHV,351177,403866,52689,27647,87688,167094,790602,55538,957696,619729,subregion,2020
5,NYC,New York City,,NYC,3370448,3618635,248187,1373502,1776891,2490350,6313840,443591,8804190,2719856,subregion,2020
6,ONJ,Outer New Jersey,,ONJ,771023,874636,103613,107158,140652,268700,1782284,77322,2050984,1457152,subregion,2020
0,36005CS,BX Central and South,36005,NYC,169664,176934,7270,38360,121583,275049,213671,17523,488720,36205,municipality,2020
1,36005NE,BX North and East,36005,NYC,102721,108236,5515,8026,125441,87739,184807,11008,272546,40332,municipality,2020
2,36005W,BX West,36005,NYC,250065,261860,11795,21380,172369,443675,267713,19705,711388,54259,municipality,2020
3,36047C,BK Central,36047,NYC,219831,233830,13999,22709,360365,58718,536659,41234,595377,112351,municipality,2020
4,36047E,BK East,36047,NYC,105312,111587,6275,16180,162190,96051,207726,19426,303777,9930,municipality,2020
5,36047N,BK North,36047,NYC,181849,196281,14432,27094,90632,135560,330752,24571,466312,188455,municipality,2020
6,36047S,BK Southern,36047,NYC,333754,353658,19904,222461,72951,129656,817911,43187,947567,479312,municipality,2020
7,36047W,BK West,36047,NYC,169058,182298,13240,82332,43558,96441,326600,22331,423041,178379,municipality,2020
8,36061E,MN East Side,36061,NYC,213958,243538,29580,55392,12077,33055,362767,18228,395822,277070,municipality,2020
9,36061L,MN Lower,36061,NYC,163598,182984,19386,76373,18011,52885,281091,16384,333976,170323,municipality,2020
10,36061U,MN Upper,36061,NYC,232977,247817,14840,33681,142810,258287,313746,24627,572033,112628,municipality,2020
11,36061WM,MN West Side and Midtown,36061,NYC,207249,239587,32338,54178,26694,58413,334007,19862,392420,233273,municipality,2020
12,36081NE,QN Northeast,36081,NYC,200522,211569,11047,276442,27810,93934,464143,17568,558077,142323,municipality,2020
13,36081NW,QN Northwest,36081,NYC,371899,394292,22393,235705,40649,381069,609265,37445,990334,295466,municipality,2020
14,36081SE,QN Southeast,36081,NYC,185459,196342,10883,77796,284721,98648,476151,50818,574799,62816,municipality,2020
15,36081SW,QN Southwest,36081,NYC,89330,94130,4800,66640,28195,94210,188044,44456,282254,48753,municipality,2020
16,36085C,SI Central,36085,NYC,48976,51972,2996,25915,4948,20379,121197,3915,141576,86419,municipality,2020
17,36085N,SI North,36085,NYC,64940,69066,4126,20632,40093,58955,130708,7423,189663,62560,municipality,2020
18,36085S,SI South,36085,NYC,59286,62654,3368,12206,1794,17626,146882,3880,164508,129002,municipality,2020
0,900104720,"Bethel town, Fairfield County, Connecticut",9001,CT,7653,7980,327,1213,565,2622,17736,1549,20358,14409,municipality,2020
1,900108070,"Bridgeport town, Fairfield County, Connecticut",9001,CT,54261,58874,4613,4024,48690,62853,85801,8683,148654,24404,municipality,2020
2,900108980,"Brookfield town, Fairfield County, Connecticut",9001,CT,6695,7116,421,946,299,1470,16058,1028,17528,13785,municipality,2020
3,900118500,"Danbury town, Fairfield County, Connecticut",9001,CT,31762,33562,1800,5339,5630,28690,57828,8896,86518,37963,municipality,2020
4,900118850,"Darien town, Fairfield County, Connecticut",9001,CT,6814,7265,451,1197,148,1234,20265,904,21499,18016,municipality,2020
5,900123890,"Easton town, Fairfield County, Connecticut",9001,CT,2605,2756,151,328,106,444,7161,319,7605,6408,municipality,2020
6,900126620,"Fairfield town, Fairfield County, Connecticut",9001,CT,20820,21982,1162,2906,1110,4806,56706,2655,61512,50035,municipality,2020
7,900133620,"Greenwich town, Fairfield County, Connecticut",9001,CT,23316,25677,2361,4726,1157,8135,55383,3623,63518,45877,municipality,2020
8,900148620,"Monroe town, Fairfield County, Connecticut",9001,CT,6690,6918,228,660,400,1470,17355,747,18825,15548,municipality,2020
9,900150580,"New Canaan town, Fairfield County, Connecticut",9001,CT,6923,7502,579,1159,244,1121,19501,929,20622,17169,municipality,2020
10,900150860,"New Fairfield town, Fairfield County, Connecticut",9001,CT,4948,5635,687,230,153,1201,12378,557,13579,11438,municipality,2020
11,900152980,"Newtown town, Fairfield County, Connecticut",9001,CT,9766,10322,556,734,592,1757,25416,1140,27173,22950,municipality,2020
12,900156060,"Norwalk town, Fairfield County, Connecticut",9001,CT,36078,38152,2074,4772,11074,27629,63555,3395,91184,44314,municipality,2020
13,900163480,"Redding town, Fairfield County, Connecticut",9001,CT,3356,3664,308,243,75,465,8300,402,8765,7580,municipality,2020
14,900163970,"Ridgefield town, Fairfield County, Connecticut",9001,CT,8968,9506,538,1261,214,1506,23527,1096,25033,20956,municipality,2020
15,900168170,"Shelton town, Fairfield County, Connecticut",9001,CT,16356,17174,818,1800,1812,4080,36789,1476,40869,31701,municipality,2020
16,900168310,"Sherman town, Fairfield County, Connecticut",9001,CT,1425,1834,409,51,25,159,3368,143,3527,3149,municipality,2020
17,900173070,"Stamford town, Fairfield County, Connecticut",9001,CT,53241,56953,3712,11453,16201,37958,97512,4982,135470,64876,municipality,2020
18,900174190,"Stratford town, Fairfield County, Connecticut",9001,CT,20435,21643,1208,1310,9136,11107,41248,2395,52355,28407,municipality,2020
19,900177200,"Trumbull town, Fairfield County, Connecticut",9001,CT,12622,13159,537,2509,1642,3505,33322,1519,36827,27652,municipality,2020
20,900183430,"Weston town, Fairfield County, Connecticut",9001,CT,3420,3671,251,575,143,631,9723,562,10354,8443,municipality,2020
21,900183500,"Westport town, Fairfield County, Connecticut",9001,CT,9720,10567,847,1703,375,1592,25549,1302,27141,22169,municipality,2020
22,900186370,"Wilton town, Fairfield County, Connecticut",9001,CT,6210,6567,357,1612,201,916,17587,898,18503,14876,municipality,2020
23,900502760,"Barkhamsted town, Litchfield County, Connecticut",9005,CT,1457,1566,109,26,11,84,3563,144,3647,3382,municipality,2020
24,900504930,"Bethlehem town, Litchfield County, Connecticut",9005,CT,1398,1605,207,22,31,104,3281,124,3385,3104,municipality,2020
25,900508210,"Bridgewater town, Litchfield County, Connecticut",9005,CT,728,863,135,10,14,41,1621,77,1662,1520,municipality,2020
26,900510940,"Canaan town, Litchfield County, Connecticut",9005,CT,480,639,159,1,15,56,1024,33,1080,975,municipality,2020
27,900516050,"Colebrook town, Litchfield County, Connecticut",9005,CT,584,694,110,4,5,31,1330,64,1361,1257,municipality,2020
28,900517240,"Cornwall town, Litchfield County, Connecticut",9005,CT,732,1002,270,24,4,61,1506,45,1567,1433,municipality,2020
29,900532290,"Goshen town, Litchfield County, Connecticut",9005,CT,1285,1708,423,32,16,120,3030,113,3150,2869,municipality,2020
30,900537280,"Harwinton town, Litchfield County, Connecticut",9005,CT,2179,2313,134,31,35,172,5312,201,5484,5045,municipality,2020
31,900540290,"Kent town, Litchfield County, Connecticut",9005,CT,1285,1687,402,85,31,156,2863,161,3019,2586,municipality,2020
32,900543370,"Litchfield town, Litchfield County, Connecticut",9005,CT,3467,3966,499,114,51,276,7916,288,8192,7463,municipality,2020
33,900549460,"Morris town, Litchfield County, Connecticut",9005,CT,933,1253,320,14,12,67,2189,70,2256,2093,municipality,2020
34,900551350,"New Hartford town, Litchfield County, Connecticut",9005,CT,2681,2968,287,75,18,177,6481,283,6658,6105,municipality,2020
35,900552630,"New Milford town, Litchfield County, Connecticut",9005,CT,10994,11928,934,958,639,3241,24874,1762,28115,21515,municipality,2020
36,900553470,"Norfolk town, Litchfield County, Connecticut",9005,CT,715,932,217,18,8,48,1540,65,1588,1449,municipality,2020
37,900554030,"North Canaan town, Litchfield County, Connecticut",9005,CT,1399,1582,183,15,36,266,2945,147,3211,2747,municipality,2020
38,900560750,"Plymouth town, Litchfield County, Connecticut",9005,CT,4856,5151,295,145,141,739,10932,589,11671,10057,municipality,2020
39,900565930,"Roxbury town, Litchfield County, Connecticut",9005,CT,979,1163,184,29,9,70,2190,99,2260,2053,municipality,2020
40,900566420,"Salisbury town, Litchfield County, Connecticut",9005,CT,1717,2519,802,78,80,197,3997,196,4194,3643,municipality,2020
41,900567960,"Sharon town, Litchfield County, Connecticut",9005,CT,1238,1724,486,44,35,98,2582,113,2680,2390,municipality,2020
42,900575730,"Thomaston town, Litchfield County, Connecticut",9005,CT,3145,3340,195,91,58,340,7102,316,7442,6637,municipality,2020
43,900576570,"Torrington town, Litchfield County, Connecticut",9005,CT,15490,17040,1550,891,1060,5433,30082,1823,35515,26308,municipality,2020
44,900579510,"Warren town, Litchfield County, Connecticut",9005,CT,580,790,210,14,1,56,1295,69,1351,1211,municipality,2020
45,900579720,"Washington town, Litchfield County, Connecticut",9005,CT,1526,2056,530,49,24,219,3427,137,3646,3217,municipality,2020
46,900580490,"Watertown town, Litchfield County, Connecticut",9005,CT,8742,9137,395,399,399,1390,20715,796,22105,19121,municipality,2020
47,900586440,"Winchester town, Litchfield County, Connecticut",9005,CT,4661,5405,744,124,116,684,9540,488,10224,8812,municipality,2020
48,900587910,"Woodbury town, Litchfield County, Connecticut",9005,CT,4251,4584,333,141,108,454,9269,411,9723,8609,municipality,2020
49,900900000,"County subdivisions not defined, New Haven County, Connecticut",9009,CT,0,0,0,0,0,0,0,0,0,0,municipality,2020
50,900901220,"Ansonia town, New Haven County, Connecticut",9009,CT,7570,8104,534,382,2474,4493,14425,881,18918,10688,municipality,2020
51,900903250,"Beacon Falls town, New Haven County, Connecticut",9009,CT,2485,2618,133,84,124,413,5587,253,6000,5126,municipality,2020
52,900904580,"Bethany town, New Haven County, Connecticut",9009,CT,1948,2039,91,248,101,182,5115,205,5297,4561,municipality,2020
53,900907310,"Branford town, New Haven County, Connecticut",9009,CT,13069,14180,1111,1311,654,1862,26411,1019,28273,23427,municipality,2020
54,900914160,"Cheshire town, New Haven County, Connecticut",9009,CT,10041,10401,360,1788,1226,1818,26915,1019,28733,22882,municipality,2020
55,900919550,"Derby town, New Haven County, Connecticut",9009,CT,5408,5759,351,336,1373,2544,9781,477,12325,7595,municipality,2020
56,900922910,"East Haven town, New Haven County, Connecticut",9009,CT,11635,12394,759,1066,1262,5054,22869,885,27923,19656,municipality,2020
57,900934950,"Guilford town, New Haven County, Connecticut",9009,CT,8813,9693,880,781,202,1135,20938,870,22073,19085,municipality,2020
58,900935650,"Hamden town, New Haven County, Connecticut",9009,CT,23988,25984,1996,3447,14834,7836,53333,2668,61169,32384,municipality,2020
59,900944560,"Madison town, New Haven County, Connecticut",9009,CT,6987,8060,1073,562,127,641,17050,656,17691,15705,municipality,2020
60,900946520,"Meriden town, New Haven County, Connecticut",9009,CT,24346,26177,1831,1311,5565,22295,38555,2575,60850,29104,municipality,2020
61,900946940,"Middlebury town, New Haven County, Connecticut",9009,CT,2859,3047,188,377,67,332,7242,238,7574,6560,municipality,2020
62,900947535,"Milford town, New Haven County, Connecticut",9009,CT,22338,23749,1411,2840,1531,4111,47933,2145,52044,41417,municipality,2020
63,900949950,"Naugatuck town, New Haven County, Connecticut",9009,CT,12432,13239,807,749,2195,4871,26648,2338,31519,21366,municipality,2020
64,900952070,"New Haven town, New Haven County, Connecticut",9009,CT,52263,57525,5262,9044,40788,41068,92955,6113,134023,37010,municipality,2020
65,900953890,"North Branford town, New Haven County, Connecticut",9009,CT,5323,5633,310,234,145,670,12874,358,13544,12137,municipality,2020
66,900954870,"North Haven town, New Haven County, Connecticut",9009,CT,9546,9981,435,1468,889,1490,22763,775,24253,19631,municipality,2020
67,900957600,"Orange town, New Haven County, Connecticut",9009,CT,5282,5480,198,1458,259,715,13565,522,14280,11326,municipality,2020
68,900958300,"Oxford town, New Haven County, Connecticut",9009,CT,4774,5022,248,218,128,681,12025,425,12706,11254,municipality,2020
69,900962290,"Prospect town, New Haven County, Connecticut",9009,CT,3627,3762,135,94,206,426,8975,344,9401,8331,municipality,2020
70,900967610,"Seymour town, New Haven County, Connecticut",9009,CT,6779,7112,333,421,668,1752,14996,609,16748,13298,municipality,2020
71,900969640,"Southbury town, New Haven County, Connecticut",9009,CT,8587,9270,683,556,200,830,19049,668,19879,17625,municipality,2020
72,900978740,"Wallingford town, New Haven County, Connecticut",9009,CT,18104,18938,834,1809,842,4770,39626,1578,44396,35397,municipality,2020
73,900980070,"Waterbury town, New Haven County, Connecticut",9009,CT,44425,48392,3967,2349,22269,45281,69122,6744,114403,37760,municipality,2020
74,900982870,"West Haven town, New Haven County, Connecticut",9009,CT,21409,22735,1326,2609,11485,13177,42407,2353,55584,25960,municipality,2020
75,900987560,"Wolcott town, New Haven County, Connecticut",9009,CT,6141,6408,267,250,395,1087,15055,632,16142,13778,municipality,2020
76,900987700,"Woodbridge town, New Haven County, Connecticut",9009,CT,3258,3476,218,1203,264,547,8540,448,9087,6625,municipality,2020
77,3628997,"Gilgo-Oak Beach-Captree CDP, New York",26103,,113,233,120,18,5,20,248,0,268,225,municipality,2020
78,3400300700,"Allendale borough, Bergen County, New Jersey",34003,INJ,2327,2450,123,837,42,456,6392,252,6848,5261,municipality,2020
79,3400301090,"Alpine borough, Bergen County, New Jersey",34003,INJ,587,676,89,593,54,121,1641,45,1762,949,municipality,2020
80,3400305170,"Bergenfield borough, Bergen County, New Jersey",34003,INJ,9097,9387,290,7222,1894,9121,19200,806,28321,9278,municipality,2020
81,3400306490,"Bogota borough, Bergen County, New Jersey",34003,INJ,2939,3026,87,748,585,4506,4272,325,8778,2614,municipality,2020
82,3400310480,"Carlstadt borough, Bergen County, New Jersey",34003,INJ,2429,2563,134,608,132,1582,4790,195,6372,3855,municipality,2020
83,3400313570,"Cliffside Park borough, Bergen County, New Jersey",34003,INJ,10735,11435,700,3784,656,8954,16739,1114,25693,11185,municipality,2020
84,3400313810,"Closter borough, Bergen County, New Jersey",34003,INJ,2762,2891,129,3009,83,725,7869,281,8594,4496,municipality,2020
85,3400315820,"Cresskill borough, Bergen County, New Jersey",34003,INJ,3015,3157,142,2865,90,630,8525,265,9155,5305,municipality,2020
86,3400317530,"Demarest borough, Bergen County, New Jersey",34003,INJ,1598,1680,82,1562,41,270,4711,167,4981,2941,municipality,2020
87,3400318400,"Dumont borough, Bergen County, New Jersey",34003,INJ,6408,6572,164,3081,503,3883,13980,549,17863,9847,municipality,2020
88,3400319510,"East Rutherford borough, Bergen County, New Jersey",34003,INJ,4306,4585,279,1612,456,2556,7466,370,10022,5028,municipality,2020
89,3400320020,"Edgewater borough, Bergen County, New Jersey",34003,INJ,6742,7315,573,5071,772,1959,12377,600,14336,5934,municipality,2020
90,3400321300,"Elmwood Park borough, Bergen County, New Jersey",34003,INJ,7652,7949,297,2367,1494,5898,15524,735,21422,10928,municipality,2020
91,3400321450,"Emerson borough, Bergen County, New Jersey",34003,INJ,2482,2600,118,709,108,948,6342,197,7290,5328,municipality,2020
92,3400321480,"Englewood city, Bergen County, New Jersey",34003,INJ,10909,11563,654,2863,7180,9639,19669,1129,29308,8497,municipality,2020
93,3400321510,"Englewood Cliffs borough, Bergen County, New Jersey",34003,INJ,1846,1961,115,2534,107,341,5001,159,5342,2201,municipality,2020
94,3400322470,"Fair Lawn borough, Bergen County, New Jersey",34003,INJ,12243,12649,406,4468,784,5369,29558,1001,34927,23305,municipality,2020
95,3400322560,"Fairview borough, Bergen County, New Jersey",34003,INJ,5021,5291,270,694,240,10018,5007,560,15025,3513,municipality,2020
96,3400324420,"Fort Lee borough, Bergen County, New Jersey",34003,INJ,18451,19861,1410,16949,1192,5376,34815,1186,40191,15488,municipality,2020
97,3400324990,"Franklin Lakes borough, Bergen County, New Jersey",34003,INJ,3722,4051,329,1051,172,786,10293,315,11079,8755,municipality,2020
98,3400325770,"Garfield city, Bergen County, New Jersey",34003,INJ,11773,12407,634,985,1684,12781,19874,807,32655,16398,municipality,2020
99,3400326640,"Glen Rock borough, Bergen County, New Jersey",34003,INJ,3934,4041,107,1617,163,848,11285,468,12133,9037,municipality,2020
100,3400328680,"Hackensack city, Bergen County, New Jersey",34003,INJ,19132,20290,1158,4734,9558,19220,26810,1465,46030,11053,municipality,2020
101,3400330150,"Harrington Park borough, Bergen County, New Jersey",34003,INJ,1594,1643,49,1049,35,299,4442,123,4741,3235,municipality,2020
102,3400330420,"Hasbrouck Heights borough, Bergen County, New Jersey",34003,INJ,4535,4715,180,1421,333,2551,9574,354,12125,7466,municipality,2020
103,3400330540,"Haworth borough, Bergen County, New Jersey",34003,INJ,1104,1148,44,545,51,191,3152,140,3343,2416,municipality,2020
104,3400331920,"Hillsdale borough, Bergen County, New Jersey",34003,INJ,3502,3635,133,742,115,1138,9005,287,10143,7861,municipality,2020
105,3400332310,"Ho-Ho-Kus borough, Bergen County, New Jersey",34003,INJ,1416,1473,57,321,26,302,3956,134,4258,3475,municipality,2020
106,3400340020,"Leonia borough, Bergen County, New Jersey",34003,INJ,3359,3476,117,3876,202,1669,7635,301,9304,3256,municipality,2020
107,3400340680,"Little Ferry borough, Bergen County, New Jersey",34003,INJ,4351,4527,176,2717,469,3468,7519,321,10987,4012,municipality,2020
108,3400341100,"Lodi borough, Bergen County, New Jersey",34003,INJ,9971,10414,443,2194,2020,10838,15368,741,26206,10413,municipality,2020
109,3400342090,"Lyndhurst township, Bergen County, New Jersey",34003,INJ,9069,9516,447,1587,688,6081,16438,775,22519,13388,municipality,2020
110,3400342750,"Mahwah township, Bergen County, New Jersey",34003,INJ,9727,10109,382,2830,686,2204,23283,927,25487,18840,municipality,2020
111,3400344880,"Maywood borough, Bergen County, New Jersey",34003,INJ,3717,3829,112,1442,605,2567,7513,323,10080,5143,municipality,2020
112,3400346110,"Midland Park borough, Bergen County, New Jersey",34003,INJ,2750,2887,137,241,70,734,6280,220,7014,5749,municipality,2020
113,3400347610,"Montvale borough, Bergen County, New Jersey",34003,INJ,3016,3115,99,1324,121,683,7753,239,8436,6069,municipality,2020
114,3400347700,"Moonachie borough, Bergen County, New Jersey",34003,INJ,1120,1149,29,351,20,1292,1841,79,3133,1391,municipality,2020
115,3400351660,"New Milford borough, Bergen County, New Jersey",34003,INJ,6276,6432,156,3420,796,3304,13619,573,16923,8830,municipality,2020
116,3400352320,"North Arlington borough, Bergen County, New Jersey",34003,INJ,6525,6749,224,1173,257,5109,11348,673,16457,9245,municipality,2020
117,3400353430,"Northvale borough, Bergen County, New Jersey",34003,INJ,1641,1700,59,1278,55,569,4192,145,4761,2714,municipality,2020
118,3400353610,"Norwood borough, Bergen County, New Jersey",34003,INJ,1943,2032,89,1809,74,418,5223,144,5641,3196,municipality,2020
119,3400353850,"Oakland borough, Bergen County, New Jersey",34003,INJ,4356,4561,205,605,119,1210,11538,444,12748,10370,municipality,2020
120,3400354870,"Old Tappan borough, Bergen County, New Jersey",34003,INJ,1982,2083,101,1600,59,380,5508,176,5888,3673,municipality,2020
121,3400354990,"Oradell borough, Bergen County, New Jersey",34003,INJ,2782,2850,68,1277,73,734,7510,271,8244,5889,municipality,2020
122,3400355770,"Palisades Park borough, Bergen County, New Jersey",34003,INJ,7314,7668,354,11900,262,4862,15430,365,20292,2903,municipality,2020
123,3400355950,"Paramus borough, Bergen County, New Jersey",34003,INJ,8448,8786,338,6966,459,2810,23888,907,26698,15556,municipality,2020
124,3400356130,"Park Ridge borough, Bergen County, New Jersey",34003,INJ,3310,3435,125,631,91,936,7947,253,8883,6972,municipality,2020
125,3400361680,"Ramsey borough, Bergen County, New Jersey",34003,INJ,5488,5670,182,1134,127,1374,13424,452,14798,11711,municipality,2020
126,3400362910,"Ridgefield borough, Bergen County, New Jersey",34003,INJ,4050,4237,187,3319,200,3343,8158,358,11501,4281,municipality,2020
127,3400362940,"Ridgefield Park village, Bergen County, New Jersey",34003,INJ,4986,5269,283,1460,649,6189,7035,449,13224,4477,municipality,2020
128,3400363000,"Ridgewood village, Bergen County, New Jersey",34003,INJ,8490,8814,324,4556,353,2069,23910,1215,25979,17786,municipality,2020
129,3400363360,"River Edge borough, Bergen County, New Jersey",34003,INJ,4191,4337,146,3434,283,1339,10710,344,12049,6649,municipality,2020
130,3400363690,"River Vale township, Bergen County, New Jersey",34003,INJ,3536,3644,108,993,117,731,9178,312,9909,7756,municipality,2020
131,3400363990,"Rochelle Park township, Bergen County, New Jersey",34003,INJ,2151,2227,76,602,208,1575,4239,175,5814,3254,municipality,2020
132,3400364170,"Rockleigh borough, Bergen County, New Jersey",34003,INJ,69,81,12,27,10,33,374,10,407,327,municipality,2020
133,3400365280,"Rutherford borough, Bergen County, New Jersey",34003,INJ,7061,7370,309,2688,631,3395,15439,878,18834,11242,municipality,2020
134,3400365340,"Saddle Brook township, Bergen County, New Jersey",34003,INJ,5378,5618,240,1219,442,2748,11546,331,14294,9554,municipality,2020
135,3400365400,"Saddle River borough, Bergen County, New Jersey",34003,INJ,1246,1458,212,451,65,181,3191,125,3372,2550,municipality,2020
136,3400368970,"South Hackensack township, Bergen County, New Jersey",34003,INJ,922,950,28,172,135,1256,1445,70,2701,1068,municipality,2020
137,3400372360,"Teaneck township, Bergen County, New Jersey",34003,INJ,13784,14430,646,4378,9180,8848,32398,1995,41246,16845,municipality,2020
138,3400372420,"Tenafly borough, Bergen County, New Jersey",34003,INJ,4913,5184,271,4711,240,1137,14272,602,15409,8719,municipality,2020
139,3400372480,"Teterboro borough, Bergen County, New Jersey",34003,INJ,25,26,1,1,7,25,36,2,61,26,municipality,2020
140,3400375140,"Upper Saddle River borough, Bergen County, New Jersey",34003,INJ,2658,2785,127,1240,129,579,7774,285,8353,6120,municipality,2020
141,3400376400,"Waldwick borough, Bergen County, New Jersey",34003,INJ,3577,3691,114,640,126,1315,8743,276,10058,7701,municipality,2020
142,3400376490,"Wallington borough, Bergen County, New Jersey",34003,INJ,4825,5108,283,694,320,2299,9569,269,11868,8286,municipality,2020
143,3400377135,"Washington township, Bergen County, New Jersey",34003,INJ,3278,3375,97,566,87,800,8485,247,9285,7585,municipality,2020
144,3400380270,"Westwood borough, Bergen County, New Jersey",34003,INJ,4515,4716,201,928,448,1651,9631,394,11282,7861,municipality,2020
145,3400382300,"Woodcliff Lake borough, Bergen County, New Jersey",34003,INJ,2114,2235,121,536,46,407,5721,184,6128,4955,municipality,2020
146,3400382570,"Wood-Ridge borough, Bergen County, New Jersey",34003,INJ,3920,4057,137,1617,337,1738,8399,304,10137,6141,municipality,2020
147,3400383050,"Wyckoff township, Bergen County, New Jersey",34003,INJ,5569,5769,200,872,93,1315,15270,538,16585,13767,municipality,2020
148,3401304695,"Belleville township, Essex County, New Jersey",34013,INJ,14282,14970,688,4201,3092,19181,19041,1438,38222,10310,municipality,2020
149,3401306260,"Bloomfield township, Essex County, New Jersey",34013,INJ,20810,21714,904,4495,9941,16197,36908,2804,53105,19668,municipality,2020
150,3401309250,"Caldwell borough, Essex County, New Jersey",34013,INJ,3538,3669,131,545,419,1313,7714,279,9027,6471,municipality,2020
151,3401311200,"Cedar Grove township, Essex County, New Jersey",34013,INJ,4754,5042,288,1016,305,1465,11515,440,12980,9754,municipality,2020
152,3401313045,"City of Orange township, Essex County, New Jersey",34013,INJ,12788,13590,802,262,21627,9983,24464,1502,34447,1073,municipality,2020
153,3401319390,"East Orange city, Essex County, New Jersey",34013,INJ,27410,30357,2947,501,54689,9032,60580,4002,69612,1388,municipality,2020
154,3401321840,"Essex Fells borough, Essex County, New Jersey",34013,INJ,750,806,56,104,24,137,2107,90,2244,1889,municipality,2020
155,3401322385,"Fairfield township, Essex County, New Jersey",34013,INJ,2747,2826,79,355,38,733,7139,184,7872,6562,municipality,2020
156,3401326610,"Glen Ridge borough, Essex County, New Jersey",34013,INJ,2529,2592,63,587,289,558,7244,543,7802,5825,municipality,2020
157,3401334450,"Irvington township, Essex County, New Jersey",34013,INJ,22638,24984,2346,413,48208,8985,52191,2587,61176,983,municipality,2020
158,3401340890,"Livingston township, Essex County, New Jersey",34013,INJ,10337,10719,382,9014,953,1583,29747,968,31330,18812,municipality,2020
159,3401343800,"Maplewood township, Essex County, New Jersey",34013,INJ,8866,9269,403,951,7740,2182,23502,1641,25684,13170,municipality,2020
160,3401346380,"Millburn township, Essex County, New Jersey",34013,INJ,6908,7241,333,7123,458,973,20737,1009,21710,12147,municipality,2020
161,3401347500,"Montclair township, Essex County, New Jersey",34013,INJ,15555,16304,749,2045,9008,4304,36617,2971,40921,22593,municipality,2020
162,3401351000,"Newark city, Essex County, New Jersey",34013,INJ,108789,118163,9374,4871,147905,113374,198175,20483,311549,24916,municipality,2020
163,3401352620,"North Caldwell borough, Essex County, New Jersey",34013,INJ,2258,2364,106,518,85,405,6289,210,6694,5476,municipality,2020
164,3401353680,"Nutley township, Essex County, New Jersey",34013,INJ,11887,12340,453,3518,928,5858,24285,975,30143,18864,municipality,2020
165,3401364590,"Roseland borough, Essex County, New Jersey",34013,INJ,2523,2607,84,551,192,437,5862,215,6299,4904,municipality,2020
166,3401369274,"South Orange Village township, Essex County, New Jersey",34013,INJ,5940,6306,366,1228,3803,1604,16880,1339,18484,10510,municipality,2020
167,3401375815,"Verona township, Essex County, New Jersey",34013,INJ,5862,6150,288,696,323,1431,13141,531,14572,11591,municipality,2020
168,3401378510,"West Caldwell township, Essex County, New Jersey",34013,INJ,4004,4137,133,440,138,971,10041,399,11012,9064,municipality,2020
169,3401379800,"West Orange township, Essex County, New Jersey",34013,INJ,17738,18746,1008,3523,13916,9647,39196,2602,48843,19155,municipality,2020
170,3401703580,"Bayonne city, Hudson County, New Jersey",34017,INJ,27867,29727,1860,7011,7116,22101,49585,2761,71686,32697,municipality,2020
171,3401719360,"East Newark borough, Hudson County, New Jersey",34017,INJ,889,920,31,257,54,1619,975,153,2594,511,municipality,2020
172,3401728650,"Guttenberg town, Hudson County, New Jersey",34017,INJ,4920,5142,222,1064,343,7868,4149,316,12017,2426,municipality,2020
173,3401730210,"Harrison town, Hudson County, New Jersey",34017,INJ,8111,8594,483,4946,722,7759,11691,1333,19450,4690,municipality,2020
174,3401732250,"Hoboken city, Hudson County, New Jersey",34017,INJ,28175,30202,2027,6518,2106,8542,51877,2596,60419,40657,municipality,2020
175,3401736000,"Jersey City city, Hudson County, New Jersey",34017,INJ,119517,130992,11475,81425,54199,72777,219672,14424,292449,69624,municipality,2020
176,3401736510,"Kearny town, Hudson County, New Jersey",34017,INJ,14639,15392,753,2034,1246,20465,21534,3365,41999,14889,municipality,2020
177,3401752470,"North Bergen township, Hudson County, New Jersey",34017,INJ,23426,25079,1653,4269,1403,44900,18461,1554,63361,11235,municipality,2020
178,3401766570,"Secaucus town, Hudson County, New Jersey",34017,INJ,8840,9316,476,7167,922,4700,17481,632,22181,8760,municipality,2020
179,3401774630,"Union City city, Hudson County, New Jersey",34017,INJ,24511,26455,1944,2394,1355,56509,12080,1476,68589,6855,municipality,2020
180,3401777930,"Weehawken township, Hudson County, New Jersey",34017,INJ,7969,9089,1120,2594,685,5665,11532,716,17197,7537,municipality,2020
181,3401779610,"West New York town, Hudson County, New Jersey",34017,INJ,20544,21798,1254,3745,1234,40114,12798,1170,52912,6649,municipality,2020
182,3401900550,"Alexandria township, Hunterdon County, New Jersey",34019,ONJ,1751,1857,106,105,65,287,4522,184,4809,4168,municipality,2020
183,3401905650,"Bethlehem township, Hunterdon County, New Jersey",34019,ONJ,1347,1406,59,92,40,209,3536,137,3745,3267,municipality,2020
184,3401906370,"Bloomsbury borough, Hunterdon County, New Jersey",34019,ONJ,340,371,31,13,25,54,738,29,792,671,municipality,2020
185,3401909280,"Califon borough, Hunterdon County, New Jersey",34019,ONJ,404,429,25,15,1,41,964,47,1005,901,municipality,2020
186,3401913720,"Clinton town, Hunterdon County, New Jersey",34019,ONJ,1114,1157,43,235,50,281,2492,92,2773,2115,municipality,2020
187,3401913750,"Clinton township, Hunterdon County, New Jersey",34019,ONJ,4658,4888,230,768,757,1071,12434,518,13505,10391,municipality,2020
188,3401917170,"Delaware township, Hunterdon County, New Jersey",34019,ONJ,1795,1952,157,64,39,264,4296,187,4560,4006,municipality,2020
189,3401918820,"East Amwell township, Hunterdon County, New Jersey",34019,ONJ,1548,1628,80,64,35,217,3700,134,3917,3467,municipality,2020
190,3401923700,"Flemington borough, Hunterdon County, New Jersey",34019,ONJ,1853,1974,121,317,133,1928,2948,148,4876,2350,municipality,2020
191,3401924870,"Franklin township, Hunterdon County, New Jersey",34019,ONJ,1172,1257,85,58,28,214,3053,139,3267,2828,municipality,2020
192,3401925350,"Frenchtown borough, Hunterdon County, New Jersey",34019,ONJ,629,677,48,23,16,104,1266,71,1370,1156,municipality,2020
193,3401926550,"Glen Gardner borough, Hunterdon County, New Jersey",34019,ONJ,785,835,50,18,62,141,1541,63,1682,1398,municipality,2020
194,3401929460,"Hampton borough, Hunterdon County, New Jersey",34019,ONJ,612,650,38,34,31,126,1312,61,1438,1186,municipality,2020
195,3401931320,"High Bridge borough, Hunterdon County, New Jersey",34019,ONJ,1424,1517,93,113,51,340,3206,114,3546,2928,municipality,2020
196,3401932460,"Holland township, Hunterdon County, New Jersey",34019,ONJ,2001,2099,98,44,31,220,4957,188,5177,4694,municipality,2020
197,3401937065,"Kingwood township, Hunterdon County, New Jersey",34019,ONJ,1476,1606,130,40,42,143,3659,141,3802,3436,municipality,2020
198,3401938610,"Lambertville city, Hunterdon County, New Jersey",34019,ONJ,2093,2265,172,62,75,525,3614,140,4139,3337,municipality,2020
199,3401939630,"Lebanon borough, Hunterdon County, New Jersey",34019,ONJ,795,828,33,70,70,144,1521,53,1665,1328,municipality,2020
200,3401939660,"Lebanon township, Hunterdon County, New Jersey",34019,ONJ,2368,2505,137,123,64,356,5839,230,6195,5422,municipality,2020
201,3401946260,"Milford borough, Hunterdon County, New Jersey",34019,ONJ,524,556,32,12,17,83,1149,38,1232,1082,municipality,2020
202,3401961920,"Raritan township, Hunterdon County, New Jersey",34019,ONJ,8613,8911,298,2104,588,1899,21548,867,23447,17989,municipality,2020
203,3401962250,"Readington township, Hunterdon County, New Jersey",34019,ONJ,6271,6552,281,744,213,1217,14911,511,16128,13443,municipality,2020
204,3401970980,"Stockton borough, Hunterdon County, New Jersey",34019,ONJ,233,255,22,8,0,10,485,14,495,463,municipality,2020
205,3401972510,"Tewksbury township, Hunterdon County, New Jersey",34019,ONJ,2185,2386,201,232,54,332,5538,233,5870,5019,municipality,2020
206,3401974420,"Union township, Hunterdon County, New Jersey",34019,ONJ,1840,1917,77,258,481,543,5964,199,6507,5026,municipality,2020
207,3401978230,"West Amwell township, Hunterdon County, New Jersey",34019,ONJ,1147,1209,62,61,62,180,2825,106,3005,2596,municipality,2020
208,3402119780,"East Windsor township, Mercer County, New Jersey",34021,ONJ,11158,11690,532,6780,2653,7750,22295,952,30045,11910,municipality,2020
209,3402122185,"Ewing township, Mercer County, New Jersey",34021,ONJ,13889,15637,1748,1938,11364,4868,32396,1507,37264,17587,municipality,2020
210,3402129310,"Hamilton township, Mercer County, New Jersey",34021,ONJ,36125,37716,1591,4121,11724,18279,74018,2974,92297,55199,municipality,2020
211,3402131620,"Hightstown borough, Mercer County, New Jersey",34021,ONJ,2097,2216,119,333,402,2166,3734,260,5900,2739,municipality,2020
212,3402133150,"Hopewell borough, Mercer County, New Jersey",34021,ONJ,787,828,41,27,32,84,1834,90,1918,1685,municipality,2020
213,3402133180,"Hopewell township, Mercer County, New Jersey",34021,ONJ,6367,6748,381,2035,586,1039,16452,723,17491,13108,municipality,2020
214,3402139510,"Lawrence township, Mercer County, New Jersey",34021,ONJ,12550,13268,718,5883,3755,3687,29390,1382,33077,18370,municipality,2020
215,3402157600,"Pennington borough, Mercer County, New Jersey",34021,ONJ,1028,1088,60,83,45,88,2714,120,2802,2466,municipality,2020
216,3402160900,"Princeton borough, Mercer County, New Jersey",34021,ONJ,9373,10380,1007,6732,1742,3014,27667,1747,30681,17446,municipality,2020
217,3402163850,"Robbinsville township, Mercer County, New Jersey",34021,ONJ,5479,5687,208,4307,469,790,14686,574,15476,9336,municipality,2020
218,3402174000,"Trenton city, Mercer County, New Jersey",34021,ONJ,30139,34322,4183,592,38386,40905,49966,2478,90871,8510,municipality,2020
219,3402180240,"West Windsor township, Mercer County, New Jersey",34021,ONJ,10369,10862,493,15499,1206,1507,28011,1082,29518,10224,municipality,2020
220,3402310750,"Carteret borough, Middlesex County, New Jersey",34023,INJ,8387,8809,422,5756,3820,9340,15986,824,25326,5586,municipality,2020
221,3402315550,"Cranbury township, Middlesex County, New Jersey",34023,INJ,1323,1388,65,803,108,183,3659,136,3842,2612,municipality,2020
222,3402318490,"Dunellen borough, Middlesex County, New Jersey",34023,INJ,2620,2727,107,430,669,2820,4817,328,7637,3390,municipality,2020
223,3402319000,"East Brunswick township, Middlesex County, New Jersey",34023,INJ,17302,18088,786,13894,2113,4758,44957,1765,49715,27185,municipality,2020
224,3402320230,"Edison township, Middlesex County, New Jersey",34023,INJ,36852,38493,1641,57687,7764,10771,96817,3062,107588,28304,municipality,2020
225,3402330840,"Helmetta borough, Middlesex County, New Jersey",34023,INJ,1052,1091,39,119,99,282,2173,109,2455,1846,municipality,2020
226,3402331470,"Highland Park borough, Middlesex County, New Jersey",34023,INJ,6320,6669,349,2643,1258,2251,12821,708,15072,8212,municipality,2020
227,3402334890,"Jamesburg borough, Middlesex County, New Jersey",34023,INJ,2115,2228,113,267,401,1843,3940,229,5783,3043,municipality,2020
228,3402345690,"Metuchen borough, Middlesex County, New Jersey",34023,INJ,5822,6053,231,2825,645,1510,13539,810,15049,9259,municipality,2020
229,3402345900,"Middlesex borough, Middlesex County, New Jersey",34023,INJ,5302,5472,170,1159,902,3751,10885,493,14636,8331,municipality,2020
230,3402346620,"Milltown borough, Middlesex County, New Jersey",34023,INJ,2613,2707,94,246,178,810,6227,248,7037,5555,municipality,2020
231,3402347280,"Monroe township, Middlesex County, New Jersey",34023,INJ,20289,21504,1215,12892,1655,2746,45848,1116,48594,30185,municipality,2020
232,3402351210,"New Brunswick city, Middlesex County, New Jersey",34023,INJ,15387,17509,2122,5722,6278,31376,23890,1568,55266,10322,municipality,2020
233,3402352560,"North Brunswick township, Middlesex County, New Jersey",34023,INJ,15025,15585,560,11212,7737,10676,33229,1666,43905,12614,municipality,2020
234,3402354705,"Old Bridge township, Middlesex County, New Jersey",34023,INJ,25059,26067,1008,10119,4671,9276,57600,2416,66876,40394,municipality,2020
235,3402358200,"Perth Amboy city, Middlesex County, New Jersey",34023,INJ,17136,17855,719,610,3483,46149,9287,1041,55436,4153,municipality,2020
236,3402359010,"Piscataway township, Middlesex County, New Jersey",34023,INJ,18071,18904,833,23973,11771,8276,52528,2533,60804,14251,municipality,2020
237,3402359280,"Plainsboro township, Middlesex County, New Jersey",34023,INJ,9720,10281,561,13578,1579,1449,22635,782,24084,6696,municipality,2020
238,3402365790,"Sayreville borough, Middlesex County, New Jersey",34023,INJ,16910,17695,785,7611,5743,7868,37477,1757,45345,22366,municipality,2020
239,3402368550,"South Amboy city, Middlesex County, New Jersey",34023,INJ,3740,3906,166,470,529,2093,7318,371,9411,5948,municipality,2020
240,3402368790,"South Brunswick township, Middlesex County, New Jersey",34023,INJ,16014,16647,633,22604,3405,3510,43533,1426,47043,16098,municipality,2020
241,3402369390,"South Plainfield borough, Middlesex County, New Jersey",34023,INJ,8217,8432,215,4579,2496,4555,19783,1120,24338,11588,municipality,2020
242,3402369420,"South River borough, Middlesex County, New Jersey",34023,INJ,5694,5977,283,826,1000,4198,11920,1290,16118,8804,municipality,2020
243,3402369810,"Spotswood borough, Middlesex County, New Jersey",34023,INJ,3196,3297,101,523,272,917,7246,307,8163,6144,municipality,2020
244,3402382000,"Woodbridge township, Middlesex County, New Jersey",34023,INJ,36381,38137,1756,27425,10143,22279,81360,3520,103639,40272,municipality,2020
245,3402500000,"County subdivisions not defined, Monmouth County, New Jersey",34025,ONJ,0,0,0,0,0,0,0,0,0,0,municipality,2020
246,3402500070,"Aberdeen township, Monmouth County, New Jersey",34025,ONJ,7697,7967,270,1116,1883,2642,16687,868,19329,12820,municipality,2020
247,3402500730,"Allenhurst borough, Monmouth County, New Jersey",34025,ONJ,199,369,170,3,4,19,453,11,472,435,municipality,2020
248,3402500760,"Allentown borough, Monmouth County, New Jersey",34025,ONJ,694,724,30,28,64,92,1642,73,1734,1477,municipality,2020
249,3402501960,"Asbury Park city, Monmouth County, New Jersey",34025,ONJ,7087,8274,1187,162,5059,4079,11109,604,15188,5284,municipality,2020
250,3402502110,"Atlantic Highlands borough, Monmouth County, New Jersey",34025,ONJ,1949,2092,143,78,54,363,4051,171,4414,3748,municipality,2020
251,3402502440,"Avon-by-the-Sea borough, Monmouth County, New Jersey",34025,ONJ,902,1334,432,20,22,141,1792,48,1933,1702,municipality,2020
252,3402504930,"Belmar borough, Monmouth County, New Jersey",34025,ONJ,2867,4066,1199,71,100,963,4944,168,5907,4605,municipality,2020
253,3402506970,"Bradley Beach borough, Monmouth County, New Jersey",34025,ONJ,2157,3221,1064,57,82,880,3402,144,4282,3119,municipality,2020
254,3402507750,"Brielle borough, Monmouth County, New Jersey",34025,ONJ,1949,2176,227,34,69,226,4756,153,4982,4500,municipality,2020
255,3402514560,"Colts Neck township, Monmouth County, New Jersey",34025,ONJ,3307,3451,144,495,105,614,9343,274,9957,8469,municipality,2020
256,3402516660,"Deal borough, Monmouth County, New Jersey",34025,ONJ,347,925,578,6,6,120,780,37,900,731,municipality,2020
257,3402519840,"Eatontown borough, Monmouth County, New Jersey",34025,ONJ,5842,6182,340,1316,1644,2005,11592,1060,13597,7572,municipality,2020
258,3402521570,"Englishtown borough, Monmouth County, New Jersey",34025,ONJ,789,820,31,207,66,368,1978,75,2346,1630,municipality,2020
259,3402522440,"Fair Haven borough, Monmouth County, New Jersey",34025,ONJ,1994,2074,80,92,66,241,6028,206,6269,5664,municipality,2020
260,3402522950,"Farmingdale borough, Monmouth County, New Jersey",34025,ONJ,616,630,14,40,80,167,1337,69,1504,1148,municipality,2020
261,3402525200,"Freehold borough, Monmouth County, New Jersey",34025,ONJ,4143,4394,251,330,1110,6649,5889,389,12538,4060,municipality,2020
262,3402525230,"Freehold township, Monmouth County, New Jersey",34025,ONJ,12897,13500,603,2585,1506,3636,31733,1243,35369,26399,municipality,2020
263,3402530690,"Hazlet township, Monmouth County, New Jersey",34025,ONJ,7179,7492,313,682,330,2292,17833,648,20125,16173,municipality,2020
264,3402531500,"Highlands borough, Monmouth County, New Jersey",34025,ONJ,2425,2931,506,55,80,343,4278,215,4621,3928,municipality,2020
265,3402532640,"Holmdel township, Monmouth County, New Jersey",34025,ONJ,5787,6038,251,3555,189,989,16411,673,17400,11994,municipality,2020
266,3402533300,"Howell township, Monmouth County, New Jersey",34025,ONJ,18906,19694,788,2621,1958,6359,47178,2054,53537,40545,municipality,2020
267,3402534200,"Interlaken borough, Monmouth County, New Jersey",34025,ONJ,362,400,38,4,1,19,809,36,828,768,municipality,2020
268,3402536480,"Keansburg borough, Monmouth County, New Jersey",34025,ONJ,3808,4361,553,265,921,1932,7823,501,9755,6136,municipality,2020
269,3402536810,"Keyport borough, Monmouth County, New Jersey",34025,ONJ,3202,3427,225,226,387,1572,5632,265,7204,4754,municipality,2020
270,3402537560,"Lake Como borough, Monmouth County, New Jersey",34025,ONJ,778,1081,303,33,73,336,1361,56,1697,1199,municipality,2020
271,3402540770,"Little Silver borough, Monmouth County, New Jersey",34025,ONJ,2196,2323,127,138,25,261,5870,203,6131,5504,municipality,2020
272,3402541010,"Loch Arbour village, Monmouth County, New Jersey",34025,ONJ,94,154,60,6,0,8,216,4,224,206,municipality,2020
273,3402541310,"Long Branch city, Monmouth County, New Jersey",34025,ONJ,12391,14944,2553,588,3177,10332,21335,4437,31667,13133,municipality,2020
274,3402542990,"Manalapan township, Monmouth County, New Jersey",34025,ONJ,14325,14850,525,3561,876,3188,37717,1140,40905,32140,municipality,2020
275,3402543050,"Manasquan borough, Monmouth County, New Jersey",34025,ONJ,2462,3412,950,48,10,417,5521,128,5938,5335,municipality,2020
276,3402544070,"Marlboro township, Monmouth County, New Jersey",34025,ONJ,13774,14215,441,9020,728,2323,39179,998,41502,28433,municipality,2020
277,3402544520,"Matawan borough, Monmouth County, New Jersey",34025,ONJ,3849,4010,161,594,725,1431,8134,456,9565,6359,municipality,2020
278,3402545990,"Middletown township, Monmouth County, New Jersey",34025,ONJ,24710,25859,1149,1867,823,5112,61994,2162,67106,57142,municipality,2020
279,3402546560,"Millstone township, Monmouth County, New Jersey",34025,ONJ,3324,3428,104,627,415,844,9532,379,10376,8111,municipality,2020
280,3402547130,"Monmouth Beach borough, Monmouth County, New Jersey",34025,ONJ,1452,2006,554,36,9,122,3052,99,3174,2908,municipality,2020
281,3402549890,"Neptune township, Monmouth County, New Jersey",34025,ONJ,11466,13278,1812,770,9419,4052,24009,1262,28061,12558,municipality,2020
282,3402549920,"Neptune City borough, Monmouth County, New Jersey",34025,ONJ,2109,2251,142,92,627,644,3982,222,4626,3041,municipality,2020
283,3402554270,"Ocean township, Monmouth County, New Jersey",34025,ONJ,11249,12257,1008,1636,2507,3007,24665,1252,27672,19270,municipality,2020
284,3402554570,"Oceanport borough, Monmouth County, New Jersey",34025,ONJ,2346,2469,123,70,85,611,5539,229,6150,5155,municipality,2020
285,3402562430,"Red Bank borough, Monmouth County, New Jersey",34025,ONJ,5423,5863,440,231,966,4890,8046,391,12936,6458,municipality,2020
286,3402564410,"Roosevelt borough, Monmouth County, New Jersey",34025,ONJ,307,331,24,12,23,103,705,40,808,630,municipality,2020
287,3402565130,"Rumson borough, Monmouth County, New Jersey",34025,ONJ,2398,2624,226,106,21,308,7035,273,7343,6635,municipality,2020
288,3402566240,"Sea Bright borough, Monmouth County, New Jersey",34025,ONJ,793,1200,407,34,13,78,1371,53,1449,1271,municipality,2020
289,3402566330,"Sea Girt borough, Monmouth County, New Jersey",34025,ONJ,786,1305,519,4,9,56,1810,26,1866,1771,municipality,2020
290,3402567350,"Shrewsbury borough, Monmouth County, New Jersey",34025,ONJ,1456,1509,53,97,61,165,4019,161,4184,3700,municipality,2020
291,3402567365,"Shrewsbury township, Monmouth County, New Jersey",34025,ONJ,505,544,39,88,148,217,859,66,1076,557,municipality,2020
292,3402570110,"Spring Lake borough, Monmouth County, New Jersey",34025,ONJ,1225,2107,882,36,11,86,2703,65,2789,2591,municipality,2020
293,3402570140,"Spring Lake Heights borough, Monmouth County, New Jersey",34025,ONJ,2428,2998,570,54,23,221,4669,129,4890,4463,municipality,2020
294,3402573020,"Tinton Falls borough, Monmouth County, New Jersey",34025,ONJ,8500,8972,472,1041,1610,1694,17487,751,19181,14085,municipality,2020
295,3402574540,"Union Beach borough, Monmouth County, New Jersey",34025,ONJ,2036,2183,147,125,111,726,4997,262,5723,4499,municipality,2020
296,3402574900,"Upper Freehold township, Monmouth County, New Jersey",34025,ONJ,2471,2604,133,460,161,454,6819,248,7273,5950,municipality,2020
297,3402576460,"Wall township, Monmouth County, New Jersey",34025,ONJ,10121,10838,717,443,461,1559,24966,820,26525,23242,municipality,2020
298,3402579310,"West Long Branch borough, Monmouth County, New Jersey",34025,ONJ,2551,2755,204,143,275,774,7813,577,8587,6818,municipality,2020
299,3402706610,"Boonton town, Morris County, New Jersey",34027,INJ,3412,3555,143,953,444,1409,7406,409,8815,5600,municipality,2020
300,3402706640,"Boonton township, Morris County, New Jersey",34027,INJ,1504,1583,79,275,47,275,4105,157,4380,3626,municipality,2020
301,3402709040,"Butler borough, Morris County, New Jersey",34027,INJ,3258,3403,145,284,123,1409,6638,244,8047,5987,municipality,2020
302,3402712100,"Chatham borough, Morris County, New Jersey",34027,INJ,3057,3224,167,847,89,675,8537,442,9212,7159,municipality,2020
303,3402712130,"Chatham township, Morris County, New Jersey",34027,INJ,3963,4155,192,1387,81,514,10469,452,10983,8549,municipality,2020
304,3402712580,"Chester borough, Morris County, New Jersey",34027,INJ,633,660,27,60,5,281,1400,59,1681,1276,municipality,2020
305,3402712610,"Chester township, Morris County, New Jersey",34027,INJ,2575,2736,161,381,90,539,7174,326,7713,6377,municipality,2020
306,3402717650,"Denville township, Morris County, New Jersey",34027,INJ,6442,6834,392,1351,317,1280,15827,674,17107,13485,municipality,2020
307,3402718070,"Dover town, Morris County, New Jersey",34027,INJ,5752,5972,220,423,783,14209,4251,319,18460,2726,municipality,2020
308,3402719210,"East Hanover township, Morris County, New Jersey",34027,INJ,3935,4040,105,1425,141,876,10229,213,11105,8450,municipality,2020
309,3402723910,"Florham Park borough, Morris County, New Jersey",34027,INJ,4468,4768,300,1075,725,929,11656,446,12585,9410,municipality,2020
310,3402729550,"Hanover township, Morris County, New Jersey",34027,INJ,5694,5928,234,1948,325,1046,13631,478,14677,10880,municipality,2020
311,3402729700,"Harding township, Morris County, New Jersey",34027,INJ,1419,1569,150,180,41,179,3692,166,3871,3305,municipality,2020
312,3402734980,"Jefferson township, Morris County, New Jersey",34027,INJ,7840,8566,726,860,356,1998,18540,719,20538,16605,municipality,2020
313,3402737110,"Kinnelon borough, Morris County, New Jersey",34027,INJ,3405,3571,166,610,91,728,9238,345,9966,8192,municipality,2020
314,3402740290,"Lincoln Park borough, Morris County, New Jersey",34027,INJ,4063,4181,118,719,332,1469,9446,355,10915,8040,municipality,2020
315,3402741362,"Long Hill township, Morris County, New Jersey",34027,INJ,3118,3240,122,693,73,912,7717,375,8629,6576,municipality,2020
316,3402742510,"Madison borough, Morris County, New Jersey",34027,INJ,5705,5989,284,1262,463,2004,14933,726,16937,12482,municipality,2020
317,3402745330,"Mendham borough, Morris County, New Jersey",34027,INJ,1762,1867,105,161,29,293,4688,177,4981,4321,municipality,2020
318,3402745360,"Mendham township, Morris County, New Jersey",34027,INJ,1986,2105,119,347,93,330,5686,317,6016,4929,municipality,2020
319,3402746860,"Mine Hill township, Morris County, New Jersey",34027,INJ,1477,1523,46,210,191,1283,2732,153,4015,2178,municipality,2020
320,3402747670,"Montville township, Morris County, New Jersey",34027,INJ,7901,8206,305,4811,319,1578,20872,733,22450,15009,municipality,2020
321,3402748090,"Morris township, Morris County, New Jersey",34027,INJ,8587,8993,406,1368,1019,2378,20596,956,22974,17253,municipality,2020
322,3402748210,"Morris Plains borough, Morris County, New Jersey",34027,INJ,2432,2527,95,487,219,590,5563,182,6153,4675,municipality,2020
323,3402748300,"Morristown town, Morris County, New Jersey",34027,INJ,8482,9213,731,961,1961,7367,12813,693,20180,9198,municipality,2020
324,3402748480,"Mountain Lakes borough, Morris County, New Jersey",34027,INJ,1376,1429,53,694,19,247,4225,227,4472,3285,municipality,2020
325,3402748690,"Mount Arlington borough, Morris County, New Jersey",34027,INJ,2651,2915,264,334,197,719,5190,181,5909,4478,municipality,2020
326,3402749080,"Mount Olive township, Morris County, New Jersey",34027,INJ,11079,11597,518,3025,1807,4460,24426,1195,28886,18399,municipality,2020
327,3402750130,"Netcong borough, Morris County, New Jersey",34027,INJ,1434,1490,56,118,151,817,2558,127,3375,2162,municipality,2020
328,3402756460,"Parsippany-Troy Hills township, Morris County, New Jersey",34027,INJ,21346,22146,800,21694,1911,5631,50531,1966,56162,24960,municipality,2020
329,3402758110,"Pequannock township, Morris County, New Jersey",34027,INJ,6379,6688,309,395,98,1224,14347,393,15571,13461,municipality,2020
330,3402761890,"Randolph township, Morris County, New Jersey",34027,INJ,9354,9676,322,3185,740,3791,22713,1038,26504,17750,municipality,2020
331,3402763300,"Riverdale borough, Morris County, New Jersey",34027,INJ,1929,2009,80,219,88,411,3696,120,4107,3269,municipality,2020
332,3402764050,"Rockaway borough, Morris County, New Jersey",34027,INJ,2561,2645,84,553,187,1355,5243,230,6598,4273,municipality,2020
333,3402764080,"Rockaway township, Morris County, New Jersey",34027,INJ,9643,10140,497,1918,731,3995,21346,893,25341,17804,municipality,2020
334,3402764980,"Roxbury township, Morris County, New Jersey",34027,INJ,8356,8682,326,1292,647,3340,19610,806,22950,16865,municipality,2020
335,3402775890,"Victory Gardens borough, Morris County, New Jersey",34027,INJ,571,584,13,41,142,1185,397,37,1582,177,municipality,2020
336,3402777240,"Washington township, Morris County, New Jersey",34027,INJ,6343,6577,234,760,286,1359,16838,583,18197,15209,municipality,2020
337,3402780390,"Wharton borough, Morris County, New Jersey",34027,INJ,2604,2736,132,394,225,3576,3665,251,7241,2795,municipality,2020
338,3402900000,"County subdivisions not defined, Ocean County, New Jersey",34029,ONJ,0,0,0,0,0,0,0,0,0,0,municipality,2020
339,3402903050,"Barnegat township, Ocean County, New Jersey",34029,ONJ,9758,10724,966,471,987,2460,21836,917,24296,19461,municipality,2020
340,3402903130,"Barnegat Light borough, Ocean County, New Jersey",34029,ONJ,321,1257,936,1,0,21,619,17,640,601,municipality,2020
341,3402903520,"Bay Head borough, Ocean County, New Jersey",34029,ONJ,434,1024,590,11,5,27,903,22,930,865,municipality,2020
342,3402903940,"Beach Haven borough, Ocean County, New Jersey",34029,ONJ,485,2600,2115,0,2,102,925,17,1027,906,municipality,2020
343,3402904180,"Beachwood borough, Ocean County, New Jersey",34029,ONJ,3719,3860,141,147,239,1290,9569,418,10859,8765,municipality,2020
344,3402905305,"Berkeley township, Ocean County, New Jersey",34029,ONJ,21040,24629,3589,637,1079,3680,40074,1302,43754,37056,municipality,2020
345,3402907420,"Brick township, Ocean County, New Jersey",34029,ONJ,30119,33863,3744,1347,2071,8218,65402,2646,73620,59338,municipality,2020
346,3402918670,"Eagleswood township, Ocean County, New Jersey",34029,ONJ,676,797,121,10,8,116,1606,69,1722,1519,municipality,2020
347,3402930390,"Harvey Cedars borough, Ocean County, New Jersey",34029,ONJ,198,1178,980,2,0,6,385,2,391,381,municipality,2020
348,3402934530,"Island Heights borough, Ocean County, New Jersey",34029,ONJ,722,841,119,14,8,55,1595,86,1650,1487,municipality,2020
349,3402934680,"Jackson township, Ocean County, New Jersey",34029,ONJ,20470,21626,1156,1558,2769,7543,51001,2279,58544,44395,municipality,2020
350,3402937380,"Lacey township, Ocean County, New Jersey",34029,ONJ,11086,12483,1397,334,223,2000,26655,1007,28655,25091,municipality,2020
351,3402937770,"Lakehurst borough, Ocean County, New Jersey",34029,ONJ,908,979,71,76,236,505,2131,139,2636,1680,municipality,2020
352,3402938550,"Lakewood township, Ocean County, New Jersey",34029,ONJ,31850,34726,2876,699,3290,15768,119390,4013,135158,111388,municipality,2020
353,3402939390,"Lavallette borough, Ocean County, New Jersey",34029,ONJ,924,3078,2154,7,8,60,1727,55,1787,1657,municipality,2020
354,3402940560,"Little Egg Harbor township, Ocean County, New Jersey",34029,ONJ,8715,10812,2097,225,367,1541,19243,792,20784,17859,municipality,2020
355,3402941250,"Long Beach township, Ocean County, New Jersey",34029,ONJ,1593,8832,7239,29,2,102,3051,67,3153,2953,municipality,2020
356,3402943140,"Manchester township, Ocean County, New Jersey",34029,ONJ,24287,26764,2477,1017,1845,3503,41612,1308,45115,37442,municipality,2020
357,3402943380,"Mantoloking borough, Ocean County, New Jersey",34029,ONJ,158,498,340,4,1,15,316,6,331,305,municipality,2020
358,3402954300,"Ocean township, Ocean County, New Jersey",34029,ONJ,3979,4715,736,71,72,407,8428,281,8835,8004,municipality,2020
359,3402954450,"Ocean Gate borough, Ocean County, New Jersey",34029,ONJ,851,1153,302,5,46,156,1776,102,1932,1623,municipality,2020
360,3402958590,"Pine Beach borough, Ocean County, New Jersey",34029,ONJ,840,931,91,29,17,133,2006,84,2139,1876,municipality,2020
361,3402959790,"Plumsted township, Ocean County, New Jersey",34029,ONJ,2996,3139,143,58,107,677,7395,398,8072,6832,municipality,2020
362,3402959880,"Point Pleasant borough, Ocean County, New Jersey",34029,ONJ,7506,8485,979,154,58,1327,17614,510,18941,16892,municipality,2020
363,3402959910,"Point Pleasant Beach borough, Ocean County, New Jersey",34029,ONJ,2045,3397,1352,57,28,475,4291,122,4766,4084,municipality,2020
364,3402966450,"Seaside Heights borough, Ocean County, New Jersey",34029,ONJ,1148,2870,1722,36,136,566,1874,129,2440,1573,municipality,2020
365,3402966480,"Seaside Park borough, Ocean County, New Jersey",34029,ONJ,772,2586,1814,9,4,55,1381,36,1436,1332,municipality,2020
366,3402967110,"Ship Bottom borough, Ocean County, New Jersey",34029,ONJ,549,1938,1389,11,1,72,1026,26,1098,988,municipality,2020
367,3402969510,"South Toms River borough, Ocean County, New Jersey",34029,ONJ,1081,1141,60,75,528,1040,2603,222,3643,1778,municipality,2020
368,3402970320,"Stafford township, Ocean County, New Jersey",34029,ONJ,11073,14399,3326,420,316,2468,26149,871,28617,24542,municipality,2020
369,3402971640,"Surf City borough, Ocean County, New Jersey",34029,ONJ,644,2468,1824,8,1,44,1199,21,1243,1169,municipality,2020
370,3402973125,"Toms River township, Ocean County, New Jersey",34029,ONJ,36291,44526,8235,3780,3155,11593,83845,3239,95438,73671,municipality,2020
371,3402974210,"Tuckerton borough, Ocean County, New Jersey",34029,ONJ,1574,2110,536,37,40,304,3273,131,3577,3065,municipality,2020
372,3403106340,"Bloomingdale borough, Passaic County, New Jersey",34031,INJ,3112,3267,155,273,114,1186,6591,290,7777,5914,municipality,2020
373,3403113690,"Clifton city, Passaic County, New Jersey",34031,INJ,31968,33325,1357,8414,3899,36159,54137,2574,90296,39250,municipality,2020
374,3403129070,"Haledon borough, Passaic County, New Jersey",34031,INJ,3017,3117,100,631,1063,4476,4576,288,9052,2594,municipality,2020
375,3403130570,"Hawthorne borough, Passaic County, New Jersey",34031,INJ,7624,7946,322,532,591,4778,14859,607,19637,13129,municipality,2020
376,3403140620,"Little Falls township, Passaic County, New Jersey",34031,INJ,4721,4947,226,723,834,2264,11096,423,13360,9116,municipality,2020
377,3403153040,"North Haledon borough, Passaic County, New Jersey",34031,INJ,3054,3141,87,349,290,1129,7798,233,8927,6926,municipality,2020
378,3403156550,"Passaic city, Passaic County, New Jersey",34031,INJ,20595,21513,918,2599,4005,51584,18953,1531,70537,10818,municipality,2020
379,3403157000,"Paterson city, Passaic County, New Jersey",34031,INJ,50326,52885,2559,7991,36667,98863,60869,3688,159732,12523,municipality,2020
380,3403160090,"Pompton Lakes borough, Passaic County, New Jersey",34031,INJ,4200,4349,149,594,170,2174,8953,405,11127,7784,municipality,2020
381,3403161170,"Prospect Park borough, Passaic County, New Jersey",34031,INJ,1932,2017,85,294,1023,3752,2620,150,6372,1153,municipality,2020
382,3403163150,"Ringwood borough, Passaic County, New Jersey",34031,INJ,4180,4364,184,196,167,1084,10651,588,11735,9700,municipality,2020
383,3403173140,"Totowa borough, Passaic County, New Jersey",34031,INJ,3899,4026,127,838,247,2408,8657,275,11065,7297,municipality,2020
384,3403176730,"Wanaque borough, Passaic County, New Jersey",34031,INJ,4392,4597,205,543,305,1659,9658,439,11317,8371,municipality,2020
385,3403177840,"Wayne township, Passaic County, New Jersey",34031,INJ,19165,19808,643,5167,1639,6439,48399,1596,54838,39997,municipality,2020
386,3403179460,"West Milford township, Passaic County, New Jersey",34031,INJ,9638,10570,932,378,320,2259,22603,1010,24862,20895,municipality,2020
387,3403182423,"Woodland Park borough, Passaic County, New Jersey",34031,INJ,5252,5495,243,687,525,3816,9668,381,13484,8075,municipality,2020
388,3403504450,"Bedminster township, Somerset County, New Jersey",34035,INJ,4222,4483,261,882,153,804,7468,273,8272,6160,municipality,2020
389,3403505560,"Bernards township, Somerset County, New Jersey",34035,INJ,10197,10665,468,6708,447,1595,26235,1040,27830,18040,municipality,2020
390,3403505590,"Bernardsville borough, Somerset County, New Jersey",34035,INJ,2756,2953,197,343,49,1272,6621,302,7893,5927,municipality,2020
391,3403506790,"Bound Brook borough, Somerset County, New Jersey",34035,INJ,4181,4389,208,483,976,6374,5614,513,11988,3642,municipality,2020
392,3403507180,"Branchburg township, Somerset County, New Jersey",34035,INJ,5660,5843,183,1609,438,1116,13824,556,14940,11221,municipality,2020
393,3403507720,"Bridgewater township, Somerset County, New Jersey",34035,INJ,16044,16739,695,11080,1268,4517,41460,1565,45977,27547,municipality,2020
394,3403522890,"Far Hills borough, Somerset County, New Jersey",34035,INJ,372,418,46,42,8,107,817,22,924,745,municipality,2020
395,3403524900,"Franklin township, Somerset County, New Jersey",34035,INJ,25860,27335,1475,15835,16531,11938,56426,2655,68364,21405,municipality,2020
396,3403527510,"Green Brook township, Somerset County, New Jersey",34035,INJ,2436,2510,74,1743,313,843,6438,248,7281,4134,municipality,2020
397,3403531890,"Hillsborough township, Somerset County, New Jersey",34035,INJ,15296,15955,659,9889,2040,4067,39209,1655,43276,25625,municipality,2020
398,3403543620,"Manville borough, Somerset County, New Jersey",34035,INJ,4092,4290,198,337,514,3464,7489,383,10953,6255,municipality,2020
399,3403546590,"Millstone borough, Somerset County, New Jersey",34035,INJ,153,168,15,9,7,34,414,18,448,380,municipality,2020
400,3403547580,"Montgomery township, Somerset County, New Jersey",34035,INJ,8003,8390,387,9352,721,1314,22376,912,23690,11391,municipality,2020
401,3403553280,"North Plainfield borough, Somerset County, New Jersey",34035,INJ,7715,8055,340,1064,4390,11548,11260,808,22808,4998,municipality,2020
402,3403557300,"Peapack and Gladstone borough, Somerset County, New Jersey",34035,INJ,887,937,50,50,60,319,2239,68,2558,2061,municipality,2020
403,3403561980,"Raritan borough, Somerset County, New Jersey",34035,INJ,2993,3167,174,1558,247,1672,6163,238,7835,4120,municipality,2020
404,3403564320,"Rocky Hill borough, Somerset County, New Jersey",34035,INJ,278,298,20,36,3,70,673,30,743,604,municipality,2020
405,3403568460,"Somerville borough, Somerset County, New Jersey",34035,INJ,5050,5387,337,1433,1201,3113,9233,526,12346,6073,municipality,2020
406,3403568730,"South Bound Brook borough, Somerset County, New Jersey",34035,INJ,1854,1941,87,395,528,1537,3326,191,4863,2212,municipality,2020
407,3403576940,"Warren township, Somerset County, New Jersey",34035,INJ,5374,5614,240,3249,277,1156,14767,672,15923,10569,municipality,2020
408,3403577600,"Watchung borough, Somerset County, New Jersey",34035,INJ,2175,2285,110,1001,309,519,5930,318,6449,4302,municipality,2020
409,3403701330,"Andover borough, Sussex County, New Jersey",34037,ONJ,254,277,23,5,17,59,536,30,595,484,municipality,2020
410,3403701360,"Andover township, Sussex County, New Jersey",34037,ONJ,2102,2219,117,211,187,530,5466,241,5996,4827,municipality,2020
411,3403707300,"Branchville borough, Sussex County, New Jersey",34037,ONJ,334,372,38,17,8,53,738,31,791,682,municipality,2020
412,3403709160,"Byram township, Sussex County, New Jersey",34037,ONJ,2946,3292,346,128,132,683,7345,329,8028,6756,municipality,2020
413,3403724810,"Frankford township, Sussex County, New Jersey",34037,ONJ,2084,2550,466,75,42,297,5005,203,5302,4685,municipality,2020
414,3403724930,"Franklin borough, Sussex County, New Jersey",34037,ONJ,2047,2177,130,78,108,661,4251,243,4912,3822,municipality,2020
415,3403725140,"Fredon township, Sussex County, New Jersey",34037,ONJ,1192,1256,64,58,20,181,3054,110,3235,2866,municipality,2020
416,3403727420,"Green township, Sussex County, New Jersey",34037,ONJ,1244,1291,47,62,65,306,3321,123,3627,3071,municipality,2020
417,3403729220,"Hamburg borough, Sussex County, New Jersey",34037,ONJ,1452,1539,87,94,98,318,2948,153,3266,2603,municipality,2020
418,3403729490,"Hampton township, Sussex County, New Jersey",34037,ONJ,1996,2186,190,79,26,267,4626,186,4893,4335,municipality,2020
419,3403729850,"Hardyston township, Sussex County, New Jersey",34037,ONJ,3371,3847,476,215,244,647,7478,314,8125,6705,municipality,2020
420,3403732910,"Hopatcong borough, Sussex County, New Jersey",34037,ONJ,5724,6393,669,353,423,2544,11818,555,14362,10487,municipality,2020
421,3403737440,"Lafayette township, Sussex County, New Jersey",34037,ONJ,881,921,40,13,20,164,2194,78,2358,2083,municipality,2020
422,3403747430,"Montague township, Sussex County, New Jersey",34037,ONJ,1560,1832,272,69,71,370,3422,174,3792,3108,municipality,2020
423,3403751930,"Newton town, Sussex County, New Jersey",34037,ONJ,3400,3687,287,292,432,1363,7011,393,8374,5894,municipality,2020
424,3403754660,"Ogdensburg borough, Sussex County, New Jersey",34037,ONJ,873,927,54,28,20,265,1993,110,2258,1835,municipality,2020
425,3403765700,"Sandyston township, Sussex County, New Jersey",34037,ONJ,806,979,173,31,9,101,1876,81,1977,1755,municipality,2020
426,3403769690,"Sparta township, Sussex County, New Jersey",34037,ONJ,7032,7614,582,620,309,1570,18030,802,19600,16299,municipality,2020
427,3403770380,"Stanhope borough, Sussex County, New Jersey",34037,ONJ,1432,1507,75,93,74,492,3034,143,3526,2724,municipality,2020
428,3403770890,"Stillwater township, Sussex County, New Jersey",34037,ONJ,1609,1943,334,38,23,202,3802,132,4004,3609,municipality,2020
429,3403771670,"Sussex borough, Sussex County, New Jersey",34037,ONJ,901,1013,112,26,47,284,1740,91,2024,1576,municipality,2020
430,3403775740,"Vernon township, Sussex County, New Jersey",34037,ONJ,8612,10538,1926,206,331,2163,20195,896,22358,18762,municipality,2020
431,3403776640,"Walpack township, Sussex County, New Jersey",34037,ONJ,5,5,0,0,0,2,5,0,7,5,municipality,2020
432,3403776790,"Wantage township, Sussex County, New Jersey",34037,ONJ,4058,4344,286,127,152,788,10023,470,10811,9274,municipality,2020
433,3403905320,"Berkeley Heights township, Union County, New Jersey",34039,INJ,4484,4660,176,2065,242,1140,12145,560,13285,9278,municipality,2020
434,3403913150,"Clark township, Union County, New Jersey",34039,INJ,5919,6114,195,644,231,1945,13599,378,15544,12346,municipality,2020
435,3403915640,"Cranford township, Union County, New Jersey",34039,INJ,8891,9264,373,903,653,2443,21404,902,23847,18946,municipality,2020
436,3403921000,"Elizabeth city, Union County, New Jersey",34039,INJ,46314,48439,2125,2757,22261,90233,47065,5494,137298,16553,municipality,2020
437,3403922860,"Fanwood borough, Union County, New Jersey",34039,INJ,2725,2829,104,713,386,729,7045,342,7774,5604,municipality,2020
438,3403925800,"Garwood borough, Union County, New Jersey",34039,INJ,1920,2016,96,119,69,670,3784,160,4454,3436,municipality,2020
439,3403931980,"Hillside township, Union County, New Jersey",34039,INJ,7517,7844,327,498,11327,5189,17267,1655,22456,3787,municipality,2020
440,3403936690,"Kenilworth borough, Union County, New Jersey",34039,INJ,2932,3019,87,435,219,1933,6494,316,8427,5524,municipality,2020
441,3403940350,"Linden city, Union County, New Jersey",34039,INJ,15609,16452,843,1484,11722,15055,28683,1733,43738,13744,municipality,2020
442,3403948510,"Mountainside borough, Union County, New Jersey",34039,INJ,2399,2564,165,466,134,667,6353,255,7020,5498,municipality,2020
443,3403951810,"New Providence borough, Union County, New Jersey",34039,INJ,5071,5497,426,2171,241,1251,12399,558,13650,9429,municipality,2020
444,3403959190,"Plainfield city, Union County, New Jersey",34039,INJ,16308,17125,817,500,19034,29792,24794,1877,54586,3383,municipality,2020
445,3403961530,"Rahway city, Union County, New Jersey",34039,INJ,11544,12363,819,1622,8892,8867,20689,1262,29556,8913,municipality,2020
446,3403964620,"Roselle borough, Union County, New Jersey",34039,INJ,8008,8431,423,580,10800,7900,14795,941,22695,2474,municipality,2020
447,3403964650,"Roselle Park borough, Union County, New Jersey",34039,INJ,5213,5346,133,1271,1186,5293,8674,492,13967,5725,municipality,2020
448,3403966060,"Scotch Plains township, Union County, New Jersey",34039,INJ,8807,9103,296,2610,2365,2579,22389,1117,24968,16297,municipality,2020
449,3403970020,"Springfield township, Union County, New Jersey",34039,INJ,6820,7105,285,1541,1504,2235,14943,758,17178,11140,municipality,2020
450,3403971430,"Summit city, Union County, New Jersey",34039,INJ,7905,8365,460,2371,895,3313,19406,1124,22719,15016,municipality,2020
451,3403974480,"Union township, Union County, New Jersey",34039,INJ,20672,21571,899,6472,19296,11899,47829,2915,59728,19146,municipality,2020
452,3403979040,"Westfield town, Union County, New Jersey",34039,INJ,10622,11095,473,2735,790,2247,28785,1441,31032,23819,municipality,2020
453,3403981650,"Winfield township, Union County, New Jersey",34039,INJ,692,706,14,6,14,139,1284,77,1423,1187,municipality,2020
454,3404100670,"Allamuchy township, Warren County, New Jersey",34041,ONJ,2358,2467,109,181,227,465,4870,204,5335,4258,municipality,2020
455,3404101030,"Alpha borough, Warren County, New Jersey",34041,ONJ,972,1047,75,41,65,211,2117,76,2328,1935,municipality,2020
456,3404104990,"Belvidere town, Warren County, New Jersey",34041,ONJ,1031,1143,112,20,28,198,2322,108,2520,2166,municipality,2020
457,3404106160,"Blairstown township, Warren County, New Jersey",34041,ONJ,2106,2245,139,74,67,332,5372,245,5704,4986,municipality,2020
458,3404124960,"Franklin township, Warren County, New Jersey",34041,ONJ,1124,1219,95,92,54,174,2794,129,2968,2519,municipality,2020
459,3404125320,"Frelinghuysen township, Warren County, New Jersey",34041,ONJ,780,833,53,11,26,124,2075,82,2199,1956,municipality,2020
460,3404128260,"Greenwich township, Warren County, New Jersey",34041,ONJ,1798,1868,70,416,474,546,4927,245,5473,3792,municipality,2020
461,3404128710,"Hackettstown town, Warren County, New Jersey",34041,ONJ,3769,3945,176,402,341,2393,7855,331,10248,6781,municipality,2020
462,3404129820,"Hardwick township, Warren County, New Jersey",34041,ONJ,578,612,34,11,12,105,1493,56,1598,1414,municipality,2020
463,3404130090,"Harmony township, Warren County, New Jersey",34041,ONJ,993,1066,73,21,29,57,2446,91,2503,2305,municipality,2020
464,3404133060,"Hope township, Warren County, New Jersey",34041,ONJ,743,806,63,16,8,139,1696,78,1835,1594,municipality,2020
465,3404133930,"Independence township, Warren County, New Jersey",34041,ONJ,2325,2439,114,122,143,444,5025,217,5469,4543,municipality,2020
466,3404137320,"Knowlton township, Warren County, New Jersey",34041,ONJ,1103,1197,94,37,22,197,2697,169,2894,2469,municipality,2020
467,3404140110,"Liberty township, Warren County, New Jersey",34041,ONJ,1022,1144,122,41,40,156,2514,110,2670,2323,municipality,2020
468,3404141490,"Lopatcong township, Warren County, New Jersey",34041,ONJ,3588,3859,271,440,714,803,7973,323,8776,6496,municipality,2020
469,3404143320,"Mansfield township, Warren County, New Jersey",34041,ONJ,3139,3351,212,251,408,1153,6628,370,7781,5599,municipality,2020
470,3404155530,"Oxford township, Warren County, New Jersey",34041,ONJ,967,1040,73,24,47,186,2258,132,2444,2055,municipality,2020
471,3404158350,"Phillipsburg town, Warren County, New Jersey",34041,ONJ,6024,6659,635,219,1907,2552,12697,885,15249,9686,municipality,2020
472,3404159820,"Pohatcong township, Warren County, New Jersey",34041,ONJ,1310,1428,118,43,89,215,3026,163,3241,2731,municipality,2020
473,3404177270,"Washington borough, Warren County, New Jersey",34041,ONJ,3002,3219,217,230,540,1002,6297,329,7299,5198,municipality,2020
474,3404177300,"Washington township, Warren County, New Jersey",34041,ONJ,2426,2553,127,153,238,533,5959,241,6492,5327,municipality,2020
475,3404180570,"White township, Warren County, New Jersey",34041,ONJ,2169,2317,148,41,94,240,4366,109,4606,4122,municipality,2020
476,3600508510,"Bronx borough, Bronx County, New York",36005,NYC,522450,547030,24580,67766,419393,806463,666191,48236,1472654,130796,municipality,2020
477,3602701693,"Amenia town, Dutchess County, New York",36027,MHV,1622,1962,340,70,87,425,3344,213,3769,2974,municipality,2020
478,3602705100,"Beacon city, Dutchess County, New York",36027,MHV,5780,6262,482,290,1741,2686,11083,848,13769,8204,municipality,2020
479,3602705452,"Beekman town, Dutchess County, New York",36027,MHV,4409,4874,465,356,1485,1881,12291,498,14172,9952,municipality,2020
480,3602716408,"Clinton town, Dutchess County, New York",36027,MHV,1593,1901,308,56,75,196,3841,189,4037,3521,municipality,2020
481,3602720819,"Dover town, Dutchess County, New York",36027,MHV,3182,3505,323,266,372,1638,6777,403,8415,5736,municipality,2020
482,3602721996,"East Fishkill town, Dutchess County, New York",36027,MHV,10206,10829,623,1254,1130,3679,26028,1241,29707,22403,municipality,2020
483,3602725978,"Fishkill town, Dutchess County, New York",36027,MHV,9039,9521,482,1180,3160,3822,20404,926,24226,15138,municipality,2020
484,3602737209,"Hyde Park town, Dutchess County, New York",36027,MHV,7921,8433,512,810,1594,1989,19032,1223,21021,15405,municipality,2020
485,3602740299,"La Grange town, Dutchess County, New York",36027,MHV,5617,5897,280,707,842,1783,14192,791,15975,11852,municipality,2020
486,3602747207,"Milan town, Dutchess County, New York",36027,MHV,957,1202,245,30,32,131,2114,140,2245,1912,municipality,2020
487,3602751891,"North East town, Dutchess County, New York",36027,MHV,1223,1543,320,53,48,419,2552,133,2971,2318,municipality,2020
488,3602756825,"Pawling town, Dutchess County, New York",36027,MHV,3117,3518,401,133,201,1178,6834,304,8012,6196,municipality,2020
489,3602758156,"Pine Plains town, Dutchess County, New York",36027,MHV,946,1175,229,30,18,126,2092,123,2218,1921,municipality,2020
490,3602758695,"Pleasant Valley town, Dutchess County, New York",36027,MHV,3921,4151,230,184,384,866,8933,548,9799,7817,municipality,2020
491,3602759641,"Poughkeepsie city, Dutchess County, New York",36027,MHV,13139,14604,1465,505,11165,7105,24472,1949,31577,10853,municipality,2020
492,3602759652,"Poughkeepsie town, Dutchess County, New York",36027,MHV,15857,16878,1021,2802,5115,6794,38677,2354,45471,28406,municipality,2020
493,3602760905,"Red Hook town, Dutchess County, New York",36027,MHV,3926,4415,489,299,148,733,9220,392,9953,8381,municipality,2020
494,3602761357,"Rhinebeck town, Dutchess County, New York",36027,MHV,3320,3787,467,154,97,506,7090,329,7596,6510,municipality,2020
495,3602770662,"Stanford town, Dutchess County, New York",36027,MHV,1494,1859,365,43,135,277,3405,154,3682,3073,municipality,2020
496,3602776166,"Union Vale town, Dutchess County, New York",36027,MHV,1587,1766,179,78,74,312,4246,168,4558,3926,municipality,2020
497,3602778157,"Wappinger town, Dutchess County, New York",36027,MHV,11183,11657,474,1270,2120,5228,22988,1267,28216,18331,municipality,2020
498,3602778388,"Washington town, Dutchess County, New York",36027,MHV,1888,2270,382,65,103,450,4072,238,4522,3666,municipality,2020
499,3604710022,"Brooklyn borough, Kings County, New York",36047,NYC,1009804,1077654,67850,370776,729696,516426,2219648,150749,2736074,968427,municipality,2020
500,3601011,"Albertson CDP, New York",36059,LI,1795,1857,62,1700,25,468,4752,160,5220,2867,municipality,2020
501,3602968,"Atlantic Beach village, New York",36059,LI,763,1046,283,28,3,83,1624,60,1707,1533,municipality,2020
502,3604143,"Baldwin CDP, New York",36059,LI,10702,11092,390,1576,12989,7588,26331,1935,33919,9831,municipality,2020
503,3604550,"Barnum Island CDP, New York",36059,LI,1026,1062,36,156,69,504,2086,99,2590,1762,municipality,2020
504,3604803,"Baxter Estates village, New York",36059,LI,394,425,31,74,7,173,818,37,991,700,municipality,2020
505,3604891,"Bay Park CDP, New York",36059,LI,845,888,43,28,42,228,1889,53,2117,1766,municipality,2020
506,3605034,"Bayville village, New York",36059,LI,2518,2691,173,140,32,704,6044,181,6748,5691,municipality,2020
507,3605639,"Bellerose village, New York",36059,LI,384,388,4,62,36,121,1052,58,1173,896,municipality,2020
508,3605661,"Bellerose Terrace CDP, New York",36059,LI,670,692,22,782,151,655,1674,140,2329,601,municipality,2020
509,3605738,"Bellmore CDP, New York",36059,LI,5572,5776,204,737,242,1570,14727,511,16297,13237,municipality,2020
510,3606387,"Bethpage CDP, New York",36059,LI,5810,6072,262,2066,151,1735,14923,414,16658,12292,municipality,2020
511,3610132,"Brookville village, New York",36059,LI,625,661,36,390,45,152,2787,79,2939,2273,municipality,2020
512,3612419,"Carle Place CDP, New York",36059,LI,1825,1908,83,488,148,740,4265,195,5005,3434,municipality,2020
513,3613233,"Cedarhurst village, New York",36059,LI,2265,2413,148,189,151,1040,6334,191,7374,5803,municipality,2020
514,3613618,"Centre Island village, New York",36059,LI,160,229,69,19,2,31,376,4,407,351,municipality,2020
515,3618597,"Cove Neck village, New York",36059,LI,125,138,13,0,0,18,275,11,293,264,municipality,2020
516,3621578,"East Atlantic Beach CDP, New York",36059,LI,860,994,134,18,8,128,1973,49,2101,1898,municipality,2020
517,3622260,"East Hills village, New York",36059,LI,2218,2294,76,888,85,303,6981,200,7284,5808,municipality,2020
518,3622480,"East Massapequa CDP, New York",36059,LI,6884,7112,228,486,2415,2775,17079,704,19854,13474,municipality,2020
519,3622502,"East Meadow CDP, New York",36059,LI,12361,12951,590,6758,1668,6048,31748,1283,37796,22039,municipality,2020
520,3622623,"East Norwich CDP, New York",36059,LI,968,998,30,111,26,222,2570,71,2792,2362,municipality,2020
521,3622876,"East Rockaway village, New York",36059,LI,3814,4000,186,327,296,1451,8708,296,10159,7789,municipality,2020
522,3623217,"East Williston village, New York",36059,LI,828,864,36,340,5,150,2495,90,2645,2060,municipality,2020
523,3624273,"Elmont CDP, New York",36059,LI,9896,10270,374,5290,15460,8024,27241,2209,35265,4282,municipality,2020
524,3625384,"Farmingdale village, New York",36059,LI,3627,3868,241,618,280,1291,7175,258,8466,6019,municipality,2020
525,3626264,"Floral Park village, New York",36059,LI,5746,5961,215,1889,262,2067,14105,459,16172,11495,municipality,2020
526,3626352,"Flower Hill village, New York",36059,LI,1473,1529,56,904,32,280,4514,155,4794,3423,municipality,2020
527,3627309,"Franklin Square CDP, New York",36059,LI,9903,10231,328,3947,1385,5979,24924,988,30903,18604,municipality,2020
528,3627485,"Freeport village, New York",36059,LI,13501,14137,636,792,12830,21312,23160,1906,44472,7632,municipality,2020
529,3628178,"Garden City village, New York",36059,LI,7513,7715,202,1589,212,1486,21786,641,23272,19344,municipality,2020
530,3628189,"Garden City Park CDP, New York",36059,LI,2499,2592,93,3742,223,999,6986,319,7985,2702,municipality,2020
531,3628200,"Garden City South CDP, New York",36059,LI,1401,1454,53,348,42,475,3644,94,4119,3160,municipality,2020
532,3629113,"Glen Cove city, New York",36059,LI,10099,10793,694,1449,1595,9752,18613,794,28365,14775,municipality,2020
533,3629245,"Glen Head CDP, New York",36059,LI,1718,1787,69,330,32,546,4291,143,4837,3786,municipality,2020
534,3629421,"Glenwood Landing CDP, New York",36059,LI,1375,1422,47,236,25,355,3593,120,3948,3212,municipality,2020
535,3630169,"Great Neck village, New York",36059,LI,3620,3883,263,1497,145,1204,9941,532,11145,7767,municipality,2020
536,3630191,"Great Neck Estates village, New York",36059,LI,879,937,58,563,16,122,2868,130,2990,2159,municipality,2020
537,3630202,"Great Neck Gardens CDP, New York",36059,LI,380,397,17,390,3,30,1238,33,1268,812,municipality,2020
538,3630213,"Great Neck Plaza village, New York",36059,LI,3702,3954,252,1960,135,626,6856,238,7482,4523,municipality,2020
539,3630598,"Greenvale CDP, New York",36059,LI,344,373,29,270,8,118,951,51,1069,622,municipality,2020
540,3632094,"Harbor Hills CDP, New York",36059,LI,177,188,11,45,0,5,557,24,562,488,municipality,2020
541,3632105,"Harbor Isle CDP, New York",36059,LI,473,497,24,22,26,145,1291,42,1436,1201,municipality,2020
542,3633139,"Hempstead village, New York",36059,LI,16299,16954,655,1242,23041,29640,29529,2179,59169,3067,municipality,2020
543,3634198,"Herricks CDP, New York",36059,LI,1330,1380,50,2522,27,196,4202,166,4398,1487,municipality,2020
544,3634286,"Hewlett CDP, New York",36059,LI,2532,2698,166,630,303,1086,6176,254,7262,4989,municipality,2020
545,3634297,"Hewlett Bay Park village, New York",36059,LI,140,144,4,40,7,20,474,27,494,400,municipality,2020
546,3634308,"Hewlett Harbor village, New York",36059,LI,418,442,24,59,13,59,1231,35,1290,1124,municipality,2020
547,3634319,"Hewlett Neck village, New York",36059,LI,149,161,12,22,12,30,539,14,569,491,municipality,2020
548,3634374,"Hicksville CDP, New York",36059,LI,13477,13889,412,14178,1129,8003,35866,1486,43869,19073,municipality,2020
549,3637583,"Inwood CDP, New York",36059,LI,3180,3355,175,431,1920,5997,5343,312,11340,2680,municipality,2020
550,3637847,"Island Park village, New York",36059,LI,1725,1851,126,203,149,1645,3283,202,4928,2729,municipality,2020
551,3638539,"Jericho CDP, New York",36059,LI,4597,4818,221,7168,301,595,14213,375,14808,6369,municipality,2020
552,3639309,"Kensington village, New York",36059,LI,430,457,27,282,4,15,1211,48,1226,877,municipality,2020
553,3639694,"Kings Point village, New York",36059,LI,1293,1416,123,307,88,214,5405,330,5619,4680,municipality,2020
554,3640937,"Lake Success village, New York",36059,LI,820,858,38,1587,12,103,2725,87,2828,1039,municipality,2020
555,3641003,"Lakeview CDP, New York",36059,LI,1567,1625,58,157,4249,1123,4954,396,6077,152,municipality,2020
556,3641432,"Lattingtown village, New York",36059,LI,614,708,94,81,5,117,1764,65,1881,1613,municipality,2020
557,3641487,"Laurel Hollow village, New York",36059,LI,594,630,36,168,15,92,1848,62,1940,1603,municipality,2020
558,3641553,"Lawrence village, New York",36059,LI,2185,2432,247,93,85,308,6501,228,6809,6095,municipality,2020
559,3642081,"Levittown CDP, New York",36059,LI,16634,17123,489,5900,675,8617,43141,1713,51758,34853,municipality,2020
560,3642279,"Lido Beach CDP, New York",36059,LI,1161,1302,141,52,10,148,2571,55,2719,2454,municipality,2020
561,3643192,"Locust Valley CDP, New York",36059,LI,1268,1339,71,124,90,861,2710,88,3571,2408,municipality,2020
562,3643335,"Long Beach city, New York",36059,LI,15360,16771,1411,1107,1820,5370,29659,1201,35029,25531,municipality,2020
563,3643874,"Lynbrook village, New York",36059,LI,7459,7798,339,1270,1345,3847,16591,766,20438,13210,municipality,2020
564,3644787,"Malverne village, New York",36059,LI,3068,3159,91,488,464,1116,7444,329,8560,6163,municipality,2020
565,3644792,"Malverne Park Oaks CDP, New York",36059,LI,186,194,8,47,60,63,475,34,538,334,municipality,2020
566,3644897,"Manhasset CDP, New York",36059,LI,2790,2947,157,1863,597,868,7308,242,8176,4606,municipality,2020
567,3644908,"Manhasset Hills CDP, New York",36059,LI,1119,1154,35,1974,32,237,3412,119,3649,1287,municipality,2020
568,3645106,"Manorhaven village, New York",36059,LI,2534,2699,165,995,106,2487,4469,173,6956,3195,municipality,2020
569,3645986,"Massapequa CDP, New York",36059,LI,7152,7375,223,432,112,1586,19769,564,21355,18661,municipality,2020
570,3645997,"Massapequa Park village, New York",36059,LI,5759,5913,154,306,78,1235,15874,385,17109,15105,municipality,2020
571,3646107,"Matinecock village, New York",36059,LI,284,323,39,46,1,77,770,13,847,710,municipality,2020
572,3646668,"Merrick CDP, New York",36059,LI,7436,7672,236,928,339,2066,19974,633,22040,18074,municipality,2020
573,3647405,"Mill Neck village, New York",36059,LI,349,414,65,67,20,132,922,33,1054,802,municipality,2020
574,3647636,"Mineola village, New York",36059,LI,8311,8776,465,2860,528,4071,16729,841,20800,12500,municipality,2020
575,3649231,"Munsey Park village, New York",36059,LI,821,842,21,378,29,149,2660,112,2809,2141,municipality,2020
576,3649330,"Muttontown village, New York",36059,LI,1057,1141,84,1189,54,159,3353,83,3512,2027,municipality,2020
577,3650067,"New Cassel CDP, New York",36059,LI,3185,3402,217,422,4895,7917,6282,298,14199,667,municipality,2020
578,3650397,"New Hyde Park village, New York",36059,LI,3260,3376,116,4063,176,1413,8844,352,10257,4253,municipality,2020
579,3651517,"North Bellmore CDP, New York",36059,LI,6723,6866,143,1470,645,2374,18209,651,20583,15443,municipality,2020
580,3653022,"North Hills village, New York",36059,LI,2290,2500,210,1878,53,151,5313,137,5464,3245,municipality,2020
581,3653231,"North Lynbrook CDP, New York",36059,LI,233,234,1,68,70,113,634,28,747,468,municipality,2020
582,3653253,"North Massapequa CDP, New York",36059,LI,5963,6103,140,459,107,1541,16288,353,17829,15369,municipality,2020
583,3653264,"North Merrick CDP, New York",36059,LI,4023,4137,114,668,305,1332,10906,367,12238,9566,municipality,2020
584,3653275,"North New Hyde Park CDP, New York",36059,LI,4887,5024,137,7238,108,1230,14427,493,15657,6588,municipality,2020
585,3653748,"North Valley Stream CDP, New York",36059,LI,5447,5638,191,3515,8111,2677,15520,1259,18197,2635,municipality,2020
586,3653792,"North Wantagh CDP, New York",36059,LI,4174,4282,108,375,138,1416,10515,329,11931,9673,municipality,2020
587,3654441,"Oceanside CDP, New York",36059,LI,11212,11552,340,1181,658,4529,28108,1010,32637,25259,municipality,2020
588,3654551,"Old Bethpage CDP, New York",36059,LI,2390,2836,446,597,17,340,6063,156,6403,5293,municipality,2020
589,3654562,"Old Brookville village, New York",36059,LI,692,718,26,260,31,120,1900,51,2020,1558,municipality,2020
590,3654705,"Old Westbury village, New York",36059,LI,1080,1209,129,977,586,318,3971,174,4289,2234,municipality,2020
591,3655992,"Oyster Bay CDP, New York",36059,LI,2831,2964,133,236,228,1396,5653,196,7049,4993,municipality,2020
592,3656011,"Oyster Bay Cove village, New York",36059,LI,695,759,64,270,22,113,2152,86,2265,1774,municipality,2020
593,3658409,"Plainedge CDP, New York",36059,LI,2863,2941,78,815,172,1093,8424,260,9517,7177,municipality,2020
594,3658442,"Plainview CDP, New York",36059,LI,8861,9207,346,5548,131,1598,25502,689,27100,19134,municipality,2020
595,3658475,"Plandome village, New York",36059,LI,411,445,34,165,9,67,1381,38,1448,1169,municipality,2020
596,3658486,"Plandome Heights village, New York",36059,LI,327,333,6,185,0,71,938,35,1009,718,municipality,2020
597,3658497,"Plandome Manor village, New York",36059,LI,252,272,20,91,2,50,743,12,793,638,municipality,2020
598,3658849,"Point Lookout CDP, New York",36059,LI,668,855,187,18,8,62,1465,32,1527,1407,municipality,2020
599,3659520,"Port Washington CDP, New York",36059,LI,5925,6269,344,1502,312,2524,14229,668,16753,11747,municipality,2020
600,3659531,"Port Washington North village, New York",36059,LI,1324,1377,53,296,28,297,2863,104,3160,2435,municipality,2020
601,3663264,"Rockville Centre village, New York",36059,LI,9669,9991,322,617,1314,3029,22987,737,26016,20319,municipality,2020
602,3663506,"Roosevelt CDP, New York",36059,LI,4242,4441,199,169,8519,8406,9660,629,18066,343,municipality,2020
603,3663770,"Roslyn village, New York",36059,LI,1309,1441,132,465,44,513,2475,94,2988,1872,municipality,2020
604,3663792,"Roslyn Estates village, New York",36059,LI,391,407,16,169,10,42,1276,35,1318,1062,municipality,2020
605,3663803,"Roslyn Harbor village, New York",36059,LI,330,379,49,196,4,63,1004,48,1067,756,municipality,2020
606,3663814,"Roslyn Heights CDP, New York",36059,LI,2108,2218,110,2239,375,700,6047,230,6747,3203,municipality,2020
607,3664232,"Russell Gardens village, New York",36059,LI,314,339,25,418,3,30,948,35,978,492,municipality,2020
608,3664430,"Saddle Rock village, New York",36059,LI,281,293,12,94,1,18,971,36,989,840,municipality,2020
609,3664441,"Saddle Rock Estates CDP, New York",36059,LI,130,139,9,41,3,1,427,28,428,355,municipality,2020
610,3664842,"Salisbury CDP, New York",36059,LI,3989,4106,117,2383,321,2484,10134,436,12618,6994,municipality,2020
611,3665035,"Sands Point village, New York",36059,LI,878,947,69,261,32,117,2595,53,2712,2249,municipality,2020
612,3666047,"Sea Cliff village, New York",36059,LI,1954,2086,132,148,82,475,4587,197,5062,4160,municipality,2020
613,3666058,"Seaford CDP, New York",36059,LI,5293,5475,182,428,111,1239,14012,422,15251,13051,municipality,2020
614,3666102,"Searingtown CDP, New York",36059,LI,1556,1607,51,2647,58,197,4847,156,5044,1986,municipality,2020
615,3669001,"South Farmingdale CDP, New York",36059,LI,4765,4902,137,773,284,2078,12267,388,14345,10822,municipality,2020
616,3669023,"South Floral Park village, New York",36059,LI,507,534,27,240,834,384,1357,125,1741,158,municipality,2020
617,3669188,"South Hempstead CDP, New York",36059,LI,1029,1074,45,79,506,836,2570,133,3406,1852,municipality,2020
618,3669892,"South Valley Stream CDP, New York",36059,LI,1995,2063,68,1376,1674,793,5593,418,6386,2125,municipality,2020
619,3671267,"Stewart Manor village, New York",36059,LI,691,709,18,149,39,256,1736,68,1992,1480,municipality,2020
620,3672554,"Syosset CDP, New York",36059,LI,6033,6293,260,6944,118,971,18288,581,19259,10645,municipality,2020
621,3673605,"Thomaston village, New York",36059,LI,984,1024,40,1265,37,121,2638,91,2759,1245,municipality,2020
622,3676089,"Uniondale CDP, New York",36059,LI,7850,8255,405,1119,11543,12934,19539,1233,32473,5644,municipality,2020
623,3676287,"University Gardens CDP, New York",36059,LI,1642,1706,64,2119,60,323,4035,154,4358,1702,municipality,2020
624,3676331,"Upper Brookville village, New York",36059,LI,557,612,55,278,31,87,1699,67,1786,1323,municipality,2020
625,3676705,"Valley Stream village, New York",36059,LI,12494,12925,431,6503,9343,10672,29962,2666,40634,11450,municipality,2020
626,3678146,"Wantagh CDP, New York",36059,LI,6062,6228,166,495,59,1399,17214,449,18613,16211,municipality,2020
627,3679444,"Westbury village, New York",36059,LI,5083,5265,182,1481,2741,5143,10721,624,15864,5875,municipality,2020
628,3680225,"West Hempstead CDP, New York",36059,LI,6093,6315,222,1438,2249,3956,15879,870,19835,11322,municipality,2020
629,3682117,"Williston Park village, New York",36059,LI,2691,2787,96,1448,81,753,6838,284,7591,5025,municipality,2020
630,3682744,"Woodbury CDP, New York",36059,LI,3155,3402,247,1611,127,532,8803,184,9335,6881,municipality,2020
631,3682942,"Woodmere CDP, New York",36059,LI,5199,5485,286,586,757,960,17709,575,18669,15791,municipality,2020
632,3682986,"Woodsburgh village, New York",36059,LI,293,306,13,33,3,28,869,22,897,811,municipality,2020
633,3605929113,"Glen Cove city, Nassau County, New York",36059,LI,10099,10793,694,1449,1595,9752,18613,794,28365,14775,municipality,2020
634,3605934000,"Hempstead town, Nassau County, New York",36059,LI,250261,260524,10263,59525,125839,174883,618526,30696,793409,402466,municipality,2020
635,3605943335,"Long Beach city, Nassau County, New York",36059,LI,15360,16771,1411,1107,1820,5370,29659,1201,35029,25531,municipality,2020
636,3605953000,"North Hempstead town, Nassau County, New York",36059,LI,79546,83729,4183,54700,11312,35083,202556,8376,237639,128168,municipality,2020
637,3605956000,"Oyster Bay town, Nassau County, New York",36059,LI,100216,104915,4699,46384,6650,31337,269995,8447,301332,208514,municipality,2020
638,3606144919,"Manhattan borough, New York County, New York",36061,NYC,817782,913926,96144,219624,199592,402640,1291611,79101,1694251,793294,municipality,2020
639,3607107003,"Blooming Grove town, Orange County, New York",36071,MHV,6253,6944,691,401,1387,3913,14898,1129,18811,11981,municipality,2020
640,3607115308,"Chester town, Orange County, New York",36071,MHV,4356,4590,234,498,1058,2446,10200,579,12646,8065,municipality,2020
641,3607118300,"Cornwall town, Orange County, New York",36071,MHV,4923,5240,317,408,414,1664,11220,637,12884,9761,municipality,2020
642,3607118916,"Crawford town, Orange County, New York",36071,MHV,3339,3549,210,138,346,1370,7760,429,9130,6847,municipality,2020
643,3607119961,"Deerpark town, Orange County, New York",36071,MHV,2954,3319,365,328,211,657,6852,462,7509,5851,municipality,2020
644,3607129553,"Goshen town, Orange County, New York",36071,MHV,4832,5226,394,473,888,3133,11438,473,14571,9604,municipality,2020
645,3607130631,"Greenville town, Orange County, New York",36071,MHV,1613,1725,112,54,144,626,4063,213,4689,3652,municipality,2020
646,3607131907,"Hamptonburgh town, Orange County, New York",36071,MHV,1778,1877,99,203,175,797,4692,228,5489,4086,municipality,2020
647,3607134550,"Highlands town, Orange County, New York",36071,MHV,3156,3554,398,598,1333,2066,10873,707,12939,8235,municipality,2020
648,3607147042,"Middletown city, Orange County, New York",36071,MHV,11011,11980,969,1130,6304,13243,17102,1432,30345,8236,municipality,2020
649,3607147713,"Minisink town, Orange County, New York",36071,MHV,1579,1659,80,45,127,618,4003,174,4621,3657,municipality,2020
650,3607147999,"Monroe town, Orange County, New York",36071,MHV,12853,13628,775,1199,1588,5807,48534,10289,54341,35458,municipality,2020
651,3607148153,"Montgomery town, Orange County, New York",36071,MHV,8367,8920,553,389,1663,4320,19002,1153,23322,15797,municipality,2020
652,3607148857,"Mount Hope town, Orange County, New York",36071,MHV,1869,2059,190,298,756,1143,5394,261,6537,4079,municipality,2020
653,3607150034,"Newburgh city, Orange County, New York",36071,MHV,9771,11099,1328,246,7545,15085,13771,1147,28856,4833,municipality,2020
654,3607150045,"Newburgh town, Orange County, New York",36071,MHV,11745,12406,661,929,4095,7066,24919,1485,31985,18410,municipality,2020
655,3607150848,"New Windsor town, Orange County, New York",36071,MHV,10500,11156,656,1059,3969,7100,20705,1209,27805,14468,municipality,2020
656,3607159388,"Port Jervis city, Orange County, New York",36071,MHV,3542,3992,450,181,727,1311,7464,713,8775,5843,municipality,2020
657,3607175781,"Tuxedo town, Orange County, New York",36071,MHV,1441,1660,219,191,182,466,3345,141,3811,2831,municipality,2020
658,3607177992,"Wallkill town, Orange County, New York",36071,MHV,11371,12047,676,1289,5709,8492,21994,1532,30486,13464,municipality,2020
659,3607178366,"Warwick town, Orange County, New York",36071,MHV,12115,13315,1200,622,1268,4429,27598,1295,32027,24413,municipality,2020
660,3607178839,"Wawayanda town, Orange County, New York",36071,MHV,2593,2758,165,190,451,1335,6199,286,7534,5272,municipality,2020
661,3607182755,"Woodbury town, Orange County, New York",36071,MHV,3785,4176,391,796,1001,2657,9540,738,12197,7005,municipality,2020
662,3607912529,"Carmel town, Putnam County, New York",36079,LHV,11897,12578,681,698,752,5301,28275,994,33576,25831,municipality,2020
663,3607939331,"Kent town, Putnam County, New York",36079,LHV,4866,5429,563,270,359,2818,10082,490,12900,8963,municipality,2020
664,3607956748,"Patterson town, Putnam County, New York",36079,LHV,3786,4101,315,253,447,2557,8984,412,11541,7872,municipality,2020
665,3607957584,"Philipstown town, Putnam County, New York",36079,LHV,3847,4325,478,208,150,916,8915,470,9831,8087,municipality,2020
666,3607960147,"Putnam Valley town, Putnam County, New York",36079,LHV,4237,4817,580,251,292,1852,9910,508,11762,8859,municipality,2020
667,3607968924,"Southeast town, Putnam County, New York",36079,LHV,6696,7058,362,466,425,4316,13742,521,18058,12330,municipality,2020
668,3608160323,"Queens borough, Queens County, New York",36081,NYC,847210,896333,49123,656583,381375,667861,1737603,150287,2405464,549358,municipality,2020
669,3608570915,"Staten Island borough, Richmond County, New York",36085,NYC,173202,183692,10490,58753,46835,96960,398787,15218,495747,277981,municipality,2020
670,3608715968,"Clarkstown town, Rockland County, New York",36087,LHV,29489,30629,1140,10152,8298,16275,70580,2849,86855,49281,municipality,2020
671,3608732765,"Haverstraw town, Rockland County, New York",36087,LHV,12646,13178,532,1713,5434,18556,20531,1044,39087,12340,municipality,2020
672,3608755211,"Orangetown town, Rockland County, New York",36087,LHV,17945,18986,1041,3480,2577,6428,42227,1708,48655,34462,municipality,2020
673,3608760510,"Ramapo town, Rockland County, New York",36087,LHV,37722,39869,2147,4563,16555,21984,126935,5480,148919,100337,municipality,2020
674,3608771674,"Stony Point town, Rockland County, New York",36087,LHV,5146,5406,260,505,911,3208,11605,496,14813,9693,municipality,2020
675,3601594,"Amagansett CDP, New York",36103,LI,770,1776,1006,18,35,186,1638,63,1824,1522,municipality,2020
676,3602044,"Amityville village, New York",36103,LI,3846,4015,169,163,876,1761,7739,297,9500,6403,municipality,2020
677,3602374,"Aquebogue CDP, New York",36103,LI,969,1164,195,26,52,476,2071,74,2547,1919,municipality,2020
678,3602737,"Asharoken village, New York",36103,LI,231,296,65,6,2,31,561,21,592,532,municipality,2020
679,3603408,"Babylon village, New York",36103,LI,4544,4732,188,294,199,1067,11121,407,12188,10221,municipality,2020
680,3604055,"Baiting Hollow CDP, New York",36103,LI,1081,1656,575,21,67,309,2454,76,2763,2290,municipality,2020
681,3604913,"Bayport CDP, New York",36103,LI,3245,3506,261,142,161,754,7855,251,8609,7301,municipality,2020
682,3604935,"Bay Shore CDP, New York",36103,LI,9667,10126,459,1236,5044,11127,18117,1177,29244,10660,municipality,2020
683,3605039,"Baywood CDP, New York",36103,LI,2210,2266,56,301,1019,3470,4256,375,7726,2561,municipality,2020
684,3605672,"Belle Terre village, New York",36103,LI,287,312,25,42,8,54,754,32,808,672,municipality,2020
685,3605771,"Bellport village, New York",36103,LI,938,1170,232,34,46,118,2085,81,2203,1924,municipality,2020
686,3607069,"Blue Point CDP, New York",36103,LI,2029,2132,103,87,42,287,4869,141,5156,4599,municipality,2020
687,3607157,"Bohemia CDP, New York",36103,LI,3581,3720,139,349,170,1040,8812,219,9852,8074,municipality,2020
688,3608026,"Brentwood CDP, New York",36103,LI,13658,14127,469,1134,6766,47072,15315,1599,62387,5816,municipality,2020
689,3608136,"Bridgehampton CDP, New York",36103,LI,1136,2632,1496,71,199,417,2536,106,2953,2160,municipality,2020
690,3608323,"Brightwaters village, New York",36103,LI,1135,1160,25,46,82,250,2931,85,3181,2718,municipality,2020
691,3609000,"Brookhaven CDP, New York",36103,LI,1097,1177,80,34,190,303,3027,117,3330,2686,municipality,2020
692,3611781,"Calverton CDP, New York",36103,LI,2779,3016,237,47,414,1095,4839,175,5934,4203,municipality,2020
693,3613376,"Centereach CDP, New York",36103,LI,10008,10405,397,2658,964,5147,25833,1036,30980,21175,municipality,2020
694,3613420,"Center Moriches CDP, New York",36103,LI,2770,2960,190,109,243,1129,6917,257,8046,6308,municipality,2020
695,3613442,"Centerport CDP, New York",36103,LI,2171,2272,101,108,20,306,5516,207,5822,5181,municipality,2020
696,3613552,"Central Islip CDP, New York",36103,LI,9870,10344,474,1085,7005,21856,14858,1354,36714,5414,municipality,2020
697,3616958,"Cold Spring Harbor CDP, New York",36103,LI,975,1020,45,119,10,203,2861,111,3064,2621,municipality,2020
698,3617530,"Commack CDP, New York",36103,LI,12009,12312,303,2536,632,2914,33622,986,36536,29468,municipality,2020
699,3618146,"Copiague CDP, New York",36103,LI,7684,8024,340,524,1836,9634,13795,692,23429,10743,municipality,2020
700,3618157,"Coram CDP, New York",36103,LI,15234,16060,826,2197,4703,7454,32766,1703,40220,24163,municipality,2020
701,3619466,"Cutchogue CDP, New York",36103,LI,1400,2121,721,28,36,417,3020,70,3437,2886,municipality,2020
702,3619972,"Deer Park CDP, New York",36103,LI,9510,9839,329,3322,3982,5206,23631,1127,28837,15200,municipality,2020
703,3620379,"Dering Harbor village, New York",36103,LI,17,34,17,4,0,16,34,6,50,24,municipality,2020
704,3620687,"Dix Hills CDP, New York",36103,LI,8016,8315,299,4397,1410,2224,23956,1050,26180,17099,municipality,2020
705,3621985,"East Farmingdale CDP, New York",36103,LI,2177,2275,98,528,785,1706,4911,214,6617,3384,municipality,2020
706,3622183,"East Hampton village, New York",36103,LI,668,1774,1106,24,24,177,1340,39,1517,1253,municipality,2020
707,3622200,"East Hampton North CDP, New York",36103,LI,1889,2856,967,75,219,2396,2981,163,5377,2524,municipality,2020
708,3622315,"East Islip CDP, New York",36103,LI,4769,4918,149,302,209,1454,12477,399,13931,11567,municipality,2020
709,3622447,"East Marion CDP, New York",36103,LI,494,946,452,11,11,109,939,36,1048,881,municipality,2020
710,3622546,"East Moriches CDP, New York",36103,LI,2120,2349,229,84,112,571,5375,178,5946,5001,municipality,2020
711,3622612,"East Northport CDP, New York",36103,LI,6996,7246,250,591,205,2120,17928,593,20048,16539,municipality,2020
712,3622733,"East Patchogue CDP, New York",36103,LI,8221,8612,391,522,982,4975,16605,804,21580,14297,municipality,2020
713,3622810,"Eastport CDP, New York",36103,LI,907,1015,108,19,32,300,1919,82,2219,1786,municipality,2020
714,3622832,"East Quogue CDP, New York",36103,LI,2152,3104,952,77,36,1029,4528,147,5557,4268,municipality,2020
715,3622980,"East Shoreham CDP, New York",36103,LI,2181,2248,67,183,121,647,6194,270,6841,5620,municipality,2020
716,3623316,"Eatons Neck CDP, New York",36103,LI,507,570,63,22,5,60,1274,30,1334,1217,municipality,2020
717,3624405,"Elwood CDP, New York",36103,LI,3730,3846,116,941,535,1387,10039,373,11426,8190,municipality,2020
718,3625417,"Farmingville CDP, New York",36103,LI,4706,4845,139,709,510,2659,12324,585,14983,10520,municipality,2020
719,3625839,"Fire Island CDP, New York",36103,LI,393,3357,2964,17,29,99,678,47,777,585,municipality,2020
720,3625923,"Fishers Island CDP, New York",36103,LI,180,609,429,11,3,32,392,26,424,352,municipality,2020
721,3626121,"Flanders CDP, New York",36103,LI,1492,1714,222,37,421,2764,2334,169,5098,1707,municipality,2020
722,3626946,"Fort Salonga CDP, New York",36103,LI,3299,3430,131,227,75,619,9033,281,9652,8450,municipality,2020
723,3628997,"Gilgo-Oak Beach-Captree CDP, New York",36103,LI,111,172,61,2,2,6,227,7,233,216,municipality,2020
724,3629509,"Gordon Heights CDP, New York",36103,LI,1059,1131,72,91,1478,1479,2502,284,3981,649,municipality,2020
725,3630235,"Great River CDP, New York",36103,LI,798,842,44,36,29,155,1850,33,2005,1752,municipality,2020
726,3630543,"Greenlawn CDP, New York",36103,LI,4524,4669,145,773,1660,2420,11241,479,13661,8329,municipality,2020
727,3630576,"Greenport village, New York",36103,LI,950,1277,327,25,197,957,1626,104,2583,1300,municipality,2020
728,3630581,"Greenport West CDP, New York",36103,LI,1056,1658,602,29,85,388,1894,51,2282,1729,municipality,2020
729,3631445,"Halesite CDP, New York",36103,LI,1034,1099,65,60,41,176,2351,81,2527,2169,municipality,2020
730,3631896,"Hampton Bays CDP, New York",36103,LI,5669,7879,2210,177,167,5715,9513,410,15228,8759,municipality,2020
731,3632732,"Hauppauge CDP, New York",36103,LI,7180,7384,204,1481,503,2080,18003,579,20083,15440,municipality,2020
732,3632963,"Head of the Harbor village, New York",36103,LI,475,537,62,59,4,177,1343,68,1520,1212,municipality,2020
733,3635056,"Holbrook CDP, New York",36103,LI,9439,9714,275,1194,701,3166,23321,703,26487,20723,municipality,2020
734,3635254,"Holtsville CDP, New York",36103,LI,6448,6646,198,1040,455,2728,16209,584,18937,14130,municipality,2020
735,3636233,"Huntington CDP, New York",36103,LI,7920,8341,421,568,368,1458,18187,639,19645,16612,municipality,2020
736,3637022,"Huntington Bay village, New York",36103,LI,552,593,41,29,5,56,1390,55,1446,1301,municipality,2020
737,3637044,"Huntington Station CDP, New York",36103,LI,10517,10943,426,1588,3012,15793,19085,1097,34878,13388,municipality,2020
738,3637840,"Islandia village, New York",36103,LI,1044,1087,43,219,437,1135,2432,125,3567,1651,municipality,2020
739,3637869,"Islip CDP, New York",36103,LI,6407,6605,198,635,889,3574,14844,617,18418,12703,municipality,2020
740,3638022,"Islip Terrace CDP, New York",36103,LI,1698,1774,76,147,146,836,4487,171,5323,4023,municipality,2020
741,3638253,"Jamesport CDP, New York",36103,LI,689,1126,437,7,22,177,1432,22,1609,1381,municipality,2020
742,3639672,"Kings Park CDP, New York",36103,LI,6311,6564,253,554,179,1414,15671,439,17085,14499,municipality,2020
743,3640530,"Lake Grove village, New York",36103,LI,3910,4078,168,920,277,1252,9820,324,11072,8299,municipality,2020
744,3640838,"Lake Ronkonkoma CDP, New York",36103,LI,6645,7223,578,1086,687,2588,16031,698,18619,13560,municipality,2020
745,3641465,"Laurel CDP, New York",36103,LI,550,800,250,15,6,249,1246,43,1495,1182,municipality,2020
746,3642554,"Lindenhurst village, New York",36103,LI,9260,9712,452,729,629,4458,22690,784,27148,20548,municipality,2020
747,3643005,"Lloyd Harbor village, New York",36103,LI,1150,1246,96,136,9,206,3365,120,3571,3100,municipality,2020
748,3645139,"Manorville CDP, New York",36103,LI,5159,5364,205,253,326,1428,12889,496,14317,11814,municipality,2020
749,3646074,"Mastic CDP, New York",36103,LI,4557,4792,235,390,1440,4605,10799,778,15404,8191,municipality,2020
750,3646085,"Mastic Beach CDP, New York",36103,LI,4677,5198,521,208,1771,3160,11039,866,14199,8194,municipality,2020
751,3646140,"Mattituck CDP, New York",36103,LI,1805,2527,722,39,65,516,3806,116,4322,3586,municipality,2020
752,3646404,"Medford CDP, New York",36103,LI,8095,8416,321,758,1545,5973,18274,891,24247,15080,municipality,2020
753,3646514,"Melville CDP, New York",36103,LI,7368,7777,409,1997,794,1288,17996,551,19284,14654,municipality,2020
754,3646976,"Middle Island CDP, New York",36103,LI,4375,4588,213,282,1308,1290,9256,440,10546,7226,municipality,2020
755,3647306,"Miller Place CDP, New York",36103,LI,4001,4157,156,348,178,882,10841,324,11723,9991,municipality,2020
756,3648054,"Montauk CDP, New York",36103,LI,1804,4487,2683,62,86,804,3514,171,4318,3195,municipality,2020
757,3648450,"Moriches CDP, New York",36103,LI,1361,1460,99,54,321,390,2636,160,3026,2101,municipality,2020
758,3649066,"Mount Sinai CDP, New York",36103,LI,4131,4339,208,599,157,984,10639,327,11623,9556,municipality,2020
759,3649424,"Napeague CDP, New York",36103,LI,179,480,301,11,7,29,339,14,368,307,municipality,2020
760,3649825,"Nesconset CDP, New York",36103,LI,4560,4707,147,838,208,1186,12021,400,13207,10575,municipality,2020
761,3650727,"New Suffolk CDP, New York",36103,LI,187,316,129,2,1,38,365,8,403,354,municipality,2020
762,3651286,"Nissequogue village, New York",36103,LI,578,625,47,40,6,78,1486,48,1564,1392,municipality,2020
763,3651396,"North Amityville CDP, New York",36103,LI,5304,5628,324,280,8834,6899,11744,952,18643,1678,municipality,2020
764,3651418,"Northampton CDP, New York",36103,LI,227,246,19,10,141,324,439,26,763,262,municipality,2020
765,3651440,"North Babylon CDP, New York",36103,LI,6229,6430,201,1007,1732,3381,14546,653,17927,11154,municipality,2020
766,3651495,"North Bay Shore CDP, New York",36103,LI,4579,4742,163,940,2663,13376,6243,608,19619,2032,municipality,2020
767,3651528,"North Bellport CDP, New York",36103,LI,3484,3670,186,322,2532,4451,7449,712,11900,3883,municipality,2020
768,3652078,"North Great River CDP, New York",36103,LI,1505,1535,30,94,137,728,3538,110,4266,3197,municipality,2020
769,3652188,"North Haven village, New York",36103,LI,464,732,268,18,8,47,1115,27,1162,1062,municipality,2020
770,3653198,"North Lindenhurst CDP, New York",36103,LI,3861,4016,155,445,719,3390,8610,406,12000,7040,municipality,2020
771,3653319,"North Patchogue CDP, New York",36103,LI,2314,2421,107,131,179,1792,4959,202,6751,4447,municipality,2020
772,3653396,"Northport village, New York",36103,LI,2983,3128,145,146,53,401,6946,184,7347,6563,municipality,2020
773,3653561,"North Sea CDP, New York",36103,LI,2158,3587,1429,125,60,1080,4381,250,5461,3946,municipality,2020
774,3653775,"Northville CDP, New York",36103,LI,620,813,193,18,19,224,1342,35,1566,1270,municipality,2020
775,3653852,"Northwest Harbor CDP, New York",36103,LI,1912,3512,1600,110,83,863,3774,203,4637,3378,municipality,2020
776,3654056,"Noyack CDP, New York",36103,LI,1797,2832,1035,76,60,578,3747,130,4325,3481,municipality,2020
777,3654144,"Oakdale CDP, New York",36103,LI,3109,3240,131,103,86,517,6913,174,7430,6550,municipality,2020
778,3654430,"Ocean Beach village, New York",36103,LI,76,591,515,0,2,10,143,8,153,133,municipality,2020
779,3654617,"Old Field village, New York",36103,LI,334,365,31,74,2,42,851,37,893,738,municipality,2020
780,3655321,"Orient CDP, New York",36103,LI,470,800,330,10,2,41,958,26,999,920,municipality,2020
781,3656660,"Patchogue village, New York",36103,LI,5456,5776,320,242,662,3520,8888,380,12408,7604,municipality,2020
782,3656968,"Peconic CDP, New York",36103,LI,300,495,195,6,13,83,609,22,692,568,municipality,2020
783,3659157,"Poquott village, New York",36103,LI,364,374,10,91,8,43,860,18,903,743,municipality,2020
784,3659355,"Port Jefferson village, New York",36103,LI,3291,3471,180,537,109,712,7250,346,7962,6258,municipality,2020
785,3659377,"Port Jefferson Station CDP, New York",36103,LI,2859,2985,126,512,302,1570,6380,289,7950,5277,municipality,2020
786,3660408,"Quiogue CDP, New York",36103,LI,364,625,261,20,40,279,734,45,1013,629,municipality,2020
787,3660422,"Quogue village, New York",36103,LI,688,1613,925,58,41,134,1528,61,1662,1368,municipality,2020
788,3661142,"Remsenburg-Speonk CDP, New York",36103,LI,1200,1644,444,35,36,351,2759,89,3110,2599,municipality,2020
789,3661665,"Ridge CDP, New York",36103,LI,5877,6336,459,333,723,1145,12126,409,13271,10661,municipality,2020
790,3661973,"Riverhead CDP, New York",36103,LI,5365,5763,398,225,1716,5674,9319,525,14993,6853,municipality,2020
791,3662066,"Riverside CDP, New York",36103,LI,838,910,72,26,539,1176,1706,87,2882,1054,municipality,2020
792,3663319,"Rocky Point CDP, New York",36103,LI,4826,5285,459,239,171,1651,11982,499,13633,11073,municipality,2020
793,3663473,"Ronkonkoma CDP, New York",36103,LI,6496,6701,205,1166,548,2814,16141,786,18955,13641,municipality,2020
794,3664452,"Sagaponack village, New York",36103,LI,305,718,413,28,9,60,710,49,770,624,municipality,2020
795,3664485,"Sag Harbor village, New York",36103,LI,1202,2013,811,35,206,301,2471,130,2772,2100,municipality,2020
796,3664584,"St. James CDP, New York",36103,LI,4729,4921,192,513,117,1037,12450,320,13487,11500,municipality,2020
797,3664881,"Saltaire village, New York",36103,LI,31,432,401,2,0,3,110,3,113,105,municipality,2020
798,3665409,"Sayville CDP, New York",36103,LI,5935,6228,293,283,186,1148,15421,463,16569,14489,municipality,2020
799,3666212,"Selden CDP, New York",36103,LI,6838,7167,329,1495,885,4129,17133,740,21262,14013,municipality,2020
800,3666481,"Setauket-East Setauket CDP, New York",36103,LI,5304,5569,265,1562,177,1056,13928,557,14984,11632,municipality,2020
801,3666828,"Shelter Island CDP, New York",36103,LI,703,1145,442,18,13,181,1421,61,1602,1329,municipality,2020
802,3666850,"Shelter Island Heights CDP, New York",36103,LI,761,1552,791,24,8,92,1509,53,1601,1424,municipality,2020
803,3667048,"Shinnecock Hills CDP, New York",36103,LI,845,1537,692,51,45,702,1580,80,2282,1404,municipality,2020
804,3667070,"Shirley CDP, New York",36103,LI,8262,8782,520,724,1907,6200,20160,1261,26360,16268,municipality,2020
805,3667191,"Shoreham village, New York",36103,LI,188,232,44,13,11,45,516,25,561,467,municipality,2020
806,3667851,"Smithtown CDP, New York",36103,LI,8495,8800,305,1007,351,2484,23145,821,25629,20966,municipality,2020
807,3668374,"Sound Beach CDP, New York",36103,LI,2728,2943,215,136,125,758,6658,286,7416,6111,municipality,2020
808,3668462,"Southampton village, New York",36103,LI,1701,3438,1737,129,236,792,3758,175,4550,3218,municipality,2020
809,3669254,"South Huntington CDP, New York",36103,LI,3290,3418,128,773,210,1428,8133,286,9561,6864,municipality,2020
810,3669452,"Southold CDP, New York",36103,LI,2617,4222,1605,78,66,779,5261,176,6040,4941,municipality,2020
811,3670387,"Springs CDP, New York",36103,LI,2973,4482,1509,128,112,2728,5358,235,8086,4883,municipality,2020
812,3671608,"Stony Brook CDP, New York",36103,LI,4831,5033,202,1667,217,826,12641,447,13467,10310,municipality,2020
813,3671620,"Stony Brook University CDP, New York",36103,LI,72,115,43,1829,3516,1748,8661,658,10409,2658,municipality,2020
814,3673352,"Terryville CDP, New York",36103,LI,3853,4006,153,430,392,2411,9061,349,11472,7890,municipality,2020
815,3675572,"Tuckahoe CDP, New York",36103,LI,628,995,367,35,83,342,1163,58,1505,987,municipality,2020
816,3677519,"Village of the Branch village, New York",36103,LI,563,573,10,49,23,92,1643,50,1735,1521,municipality,2020
817,3677772,"Wading River CDP, New York",36103,LI,2789,3223,434,102,160,690,7041,267,7731,6512,municipality,2020
818,3677805,"Wainscott CDP, New York",36103,LI,386,916,530,23,17,142,762,34,904,688,municipality,2020
819,3678575,"Water Mill CDP, New York",36103,LI,958,2125,1167,93,28,189,2317,117,2506,2079,municipality,2020
820,3679246,"West Babylon CDP, New York",36103,LI,14523,15139,616,1455,5291,8202,35011,1538,43213,26727,municipality,2020
821,3679301,"West Bay Shore CDP, New York",36103,LI,1742,1809,67,137,133,495,4130,180,4625,3680,municipality,2020
822,3680170,"Westhampton CDP, New York",36103,LI,1291,2206,915,45,80,654,2967,105,3621,2737,municipality,2020
823,3680181,"Westhampton Beach village, New York",36103,LI,858,2455,1597,49,33,319,1831,55,2150,1694,municipality,2020
824,3680186,"West Hampton Dunes village, New York",36103,LI,28,271,243,2,0,5,121,0,126,119,municipality,2020
825,3680258,"West Hills CDP, New York",36103,LI,1968,2024,56,377,108,530,4855,139,5385,4231,municipality,2020
826,3680302,"West Islip CDP, New York",36103,LI,8763,9021,258,528,166,2659,24389,617,27048,23078,municipality,2020
827,3680885,"West Sayville CDP, New York",36103,LI,1765,2109,344,72,45,342,4530,131,4872,4282,municipality,2020
828,3681419,"Wheatley Heights CDP, New York",36103,LI,1442,1493,51,395,2619,878,4262,329,5140,919,municipality,2020
829,3683294,"Wyandanch CDP, New York",36103,LI,3290,3548,258,163,6352,5487,7503,537,12990,451,municipality,2020
830,3683426,"Yaphank CDP, New York",36103,LI,2280,2480,200,145,278,793,5181,283,5974,4475,municipality,2020
831,3610304000,"Babylon town, Suffolk County, New York",36103,LI,71907,75270,3363,9329,33874,52142,166081,7947,218223,114931,municipality,2020
832,3610310000,"Brookhaven town, Suffolk County, New York",36103,LI,167187,178581,11394,23108,30287,83528,402245,18851,485773,329999,municipality,2020
833,3610322194,"East Hampton town, Suffolk County, New York",36103,LI,11118,21163,10045,474,770,7531,20854,1003,28385,18607,municipality,2020
834,3610337000,"Huntington town, Suffolk County, New York",36103,LI,70014,73073,3059,13598,8667,31403,172724,6509,204127,143950,municipality,2020
835,3610338000,"Islip town, Suffolk County, New York",36103,LI,105002,111346,6344,11001,26931,118903,221035,10486,339938,172617,municipality,2020
836,3610359106,"Poospatuck Reservation, Suffolk County, New York",36103,LI,150,159,9,0,55,87,349,260,436,34,municipality,2020
837,3610361984,"Riverhead town, Suffolk County, New York",36103,LI,13879,16310,2431,436,2193,8262,27640,1130,35902,23881,municipality,2020
838,3610366839,"Shelter Island town, Suffolk County, New York",36103,LI,1481,2731,1250,46,21,289,2964,120,3253,2777,municipality,2020
839,3610367059,"Shinnecock Reservation, Suffolk County, New York",36103,LI,300,349,49,2,30,47,772,712,819,28,municipality,2020
840,3610368000,"Smithtown town, Suffolk County, New York",36103,LI,40018,41415,1397,5585,1662,9979,106317,3368,116296,95702,municipality,2020
841,3610368473,"Southampton town, Suffolk County, New York",36103,LI,25806,42770,16964,1185,2293,17178,51858,2276,69036,46104,municipality,2020
842,3610369463,"Southold town, Suffolk County, New York",36103,LI,10010,15773,5763,255,485,3610,20122,682,23732,18700,municipality,2020
843,3610506310,"Bethel town, Sullivan County, New York",36105,MHV,1766,3703,1937,32,94,503,3456,178,3959,3152,municipality,2020
844,3610511759,"Callicoon town, Sullivan County, New York",36105,MHV,1280,1852,572,63,31,232,2757,129,2989,2534,municipality,2020
845,3610516661,"Cochecton town, Sullivan County, New York",36105,MHV,653,1042,389,9,22,80,1368,65,1448,1272,municipality,2020
846,3610520104,"Delaware town, Sullivan County, New York",36105,MHV,927,1458,531,22,140,171,2032,91,2203,1779,municipality,2020
847,3610525241,"Fallsburg town, Sullivan County, New York",36105,MHV,4148,8830,4682,306,1811,3845,10347,644,14192,7586,municipality,2020
848,3610526528,"Forestburgh town, Sullivan County, New York",36105,MHV,347,552,205,23,18,38,770,34,808,695,municipality,2020
849,3610527573,"Fremont town, Sullivan County, New York",36105,MHV,537,1197,660,10,20,72,1089,45,1161,1014,municipality,2020
850,3610534473,"Highland town, Sullivan County, New York",36105,MHV,1004,1722,718,17,27,144,2052,90,2196,1918,municipality,2020
851,3610542235,"Liberty town, Sullivan County, New York",36105,MHV,3916,5450,1534,173,685,2789,7370,600,10159,5912,municipality,2020
852,3610543786,"Lumberland town, Sullivan County, New York",36105,MHV,911,1547,636,31,32,201,2042,135,2243,1844,municipality,2020
853,3610544809,"Mamakating town, Sullivan County, New York",36105,MHV,4731,6157,1426,189,428,1573,11082,832,12655,9633,municipality,2020
854,3610549847,"Neversink town, Sullivan County, New York",36105,MHV,1411,2020,609,41,43,222,3144,133,3366,2927,municipality,2020
855,3610563176,"Rockland town, Sullivan County, New York",36105,MHV,1420,2432,1012,54,49,322,2968,182,3290,2683,municipality,2020
856,3610573627,"Thompson town, Sullivan County, New York",36105,MHV,6478,10023,3545,572,2638,3719,12831,1076,16550,8545,municipality,2020
857,3610575759,"Tusten town, Sullivan County, New York",36105,MHV,654,1140,486,27,31,96,1309,54,1405,1197,municipality,2020
858,3611120247,"Denning town, Ulster County, New York",36111,MHV,219,501,282,3,12,30,463,48,493,400,municipality,2020
859,3611124691,"Esopus town, Ulster County, New York",36111,MHV,3668,4089,421,111,401,603,8945,519,9548,7914,municipality,2020
860,3611128255,"Gardiner town, Ulster County, New York",36111,MHV,2302,2672,370,96,83,452,5158,322,5610,4657,municipality,2020
861,3611132116,"Hardenburgh town, Ulster County, New York",36111,MHV,101,301,200,13,1,14,207,1,221,192,municipality,2020
862,3611137143,"Hurley town, Ulster County, New York",36111,MHV,2718,3079,361,114,107,356,5822,314,6178,5287,municipality,2020
863,3611139727,"Kingston city, Ulster County, New York",36111,MHV,10407,11571,1164,630,2956,4107,19962,1753,24069,14623,municipality,2020
864,3611139738,"Kingston town, Ulster County, New York",36111,MHV,422,477,55,9,10,64,869,54,933,796,municipality,2020
865,3611142994,"Lloyd town, Ulster County, New York",36111,MHV,4438,4785,347,324,681,1157,9976,542,11133,8429,municipality,2020
866,3611145458,"Marbletown town, Ulster County, New York",36111,MHV,2503,3080,577,112,66,310,5348,299,5658,4871,municipality,2020
867,3611145722,"Marlborough town, Ulster County, New York",36111,MHV,3426,3794,368,99,494,1022,7690,333,8712,6764,municipality,2020
868,3611150562,"New Paltz town, Ulster County, New York",36111,MHV,4906,5358,452,775,751,1835,12572,800,14407,10246,municipality,2020
869,3611154749,"Olive town, Ulster County, New York",36111,MHV,1923,2564,641,59,47,248,3978,232,4226,3640,municipality,2020
870,3611158552,"Plattekill town, Ulster County, New York",36111,MHV,4032,4412,380,87,521,2055,8369,594,10424,7167,municipality,2020
871,3611163011,"Rochester town, Ulster County, New York",36111,MHV,3046,4062,1016,107,130,495,6777,422,7272,6118,municipality,2020
872,3611163737,"Rosendale town, Ulster County, New York",36111,MHV,2570,2931,361,72,111,361,5421,325,5782,4913,municipality,2020
873,3611165299,"Saugerties town, Ulster County, New York",36111,MHV,8300,9370,1070,280,386,1468,17570,992,19038,15912,municipality,2020
874,3611166597,"Shandaken town, Ulster County, New York",36111,MHV,1419,2482,1063,51,36,230,2636,193,2866,2356,municipality,2020
875,3611166674,"Shawangunk town, Ulster County, New York",36111,MHV,4053,4418,365,165,1082,1863,11700,516,13563,9937,municipality,2020
876,3611175935,"Ulster town, Ulster County, New York",36111,MHV,5229,5714,485,320,592,1176,11484,725,12660,9847,municipality,2020
877,3611178828,"Wawarsing town, Ulster County, New York",36111,MHV,4504,5943,1439,193,1569,2925,9846,783,12771,7301,municipality,2020
878,3611183052,"Woodstock town, Ulster County, New York",36111,MHV,3135,4250,1115,158,116,348,5939,340,6287,5325,municipality,2020
879,3611905320,"Bedford town, Westchester County, New York",36119,LHV,5758,6314,556,589,726,2910,14399,660,17309,12424,municipality,2020
880,3611918410,"Cortlandt town, Westchester County, New York",36119,LHV,15288,16229,941,1679,2494,8547,33998,1884,42545,27941,municipality,2020
881,3611921820,"Eastchester town, Westchester County, New York",36119,LHV,13595,14410,815,3200,1036,3117,31524,1436,34641,25852,municipality,2020
882,3611930367,"Greenburgh town, Westchester County, New York",36119,LHV,35776,37565,1789,11602,10141,16821,78576,4533,95397,52300,municipality,2020
883,3611932413,"Harrison town, Westchester County, New York",36119,LHV,8747,9274,527,3231,745,4402,23816,1060,28218,18780,municipality,2020
884,3611942136,"Lewisboro town, Westchester County, New York",36119,LHV,4495,4867,372,435,191,969,11296,563,12265,10107,municipality,2020
885,3611944842,"Mamaroneck town, Westchester County, New York",36119,LHV,11423,11969,546,1544,921,5671,26087,1532,31758,22090,municipality,2020
886,3611948895,"Mount Kisco town, Westchester County, New York",36119,LHV,4271,4465,194,513,439,4569,6390,362,10959,5076,municipality,2020
887,3611949011,"Mount Pleasant town, Westchester County, New York",36119,LHV,14595,15221,626,2501,1260,9259,35177,1486,44436,29930,municipality,2020
888,3611949121,"Mount Vernon city, Westchester County, New York",36119,LHV,28286,30350,2064,1398,44655,14003,59890,4760,73893,9077,municipality,2020
889,3611950078,"New Castle town, Westchester County, New York",36119,LHV,5918,6160,242,2144,267,1243,17068,833,18311,13824,municipality,2020
890,3611950617,"New Rochelle city, Westchester County, New York",36119,LHV,28702,30531,1829,3859,14324,26257,53469,3277,79726,32009,municipality,2020
891,3611951693,"North Castle town, Westchester County, New York",36119,LHV,4098,4310,212,793,196,1448,10960,460,12408,9511,municipality,2020
892,3611953517,"North Salem town, Westchester County, New York",36119,LHV,1887,2126,239,120,83,594,4649,176,5243,4270,municipality,2020
893,3611955541,"Ossining town, Westchester County, New York",36119,LHV,14077,14975,898,2195,4096,14493,25568,1345,40061,17932,municipality,2020
894,3611956979,"Peekskill city, Westchester County, New York",36119,LHV,9813,10464,651,725,4693,11160,14271,1133,25431,7720,municipality,2020
895,3611957012,"Pelham town, Westchester County, New York",36119,LHV,4323,4490,167,844,717,1656,11422,831,13078,9030,municipality,2020
896,3611959685,"Pound Ridge town, Westchester County, New York",36119,LHV,1860,2076,216,165,65,344,4738,244,5082,4264,municipality,2020
897,3611964309,"Rye city, Westchester County, New York",36119,LHV,5654,6038,384,1185,189,1388,15204,778,16592,13052,municipality,2020
898,3611964320,"Rye town, Westchester County, New York",36119,LHV,16909,17678,769,1961,1757,23918,25695,1761,49613,20216,municipality,2020
899,3611965442,"Scarsdale town, Westchester County, New York",36119,LHV,5510,5747,237,3816,220,922,17331,1046,18253,12249,municipality,2020
900,3611968308,"Somers town, Westchester County, New York",36119,LHV,8457,9010,553,776,278,1907,19634,668,21541,17912,municipality,2020
901,3611981677,"White Plains city, Westchester County, New York",36119,LHV,24162,25494,1332,4747,6746,19426,40133,2398,59559,26242,municipality,2020
902,3611984000,"Yonkers city, Westchester County, New York",36119,LHV,80548,85528,4980,12915,33509,89065,122504,7110,211569,68970,municipality,2020
903,3611984077,"Yorktown town, Westchester County, New York",36119,LHV,13144,13672,528,1970,1262,5245,31324,1186,36569,26906,municipality,2020
0,0.0,United States,,,126817580,140498736,13681156,19618719,39940338,62080044,269369237,18112533,331449281,191697647,nation,2020
0,09001,"Fairfield County, Connecticut",09001,CT,324232,339466,15234,28473,84724,104835,777732,19383,882567,645152,county,2000
1,09005,"Litchfield County, Connecticut",09005,CT,71551,79267,7716,2107,1837,3894,178299,2201,182193,172154,county,2000
2,09009,"New Haven County, Connecticut",09009,CT,319040,340732,21692,19061,89286,83131,740877,15989,824008,616541,county,2000
3,34003,"Bergen County, New Jersey",34003,INJ,330817,339820,9003,93979,44149,91377,792741,15660,884118,638953,county,2000
4,34013,"Essex County, New Jersey",34013,INJ,283736,301011,17275,29141,319883,122347,671286,23554,793633,298708,county,2000
5,34017,"Hudson County, New Jersey",34017,INJ,230546,240618,10072,56370,74040,242123,366852,21226,608975,215216,county,2000
6,34019,"Hunterdon County, New Jersey",34019,ONJ,43678,45032,1354,2332,2638,3371,118618,1175,121989,112473,county,2000
7,34021,"Mercer County, New Jersey",34021,ONJ,125807,133280,7473,17250,67922,33898,316863,6407,350761,225284,county,2000
8,34023,"Middlesex County, New Jersey",34023,INJ,265815,273637,7822,103788,64435,101940,648222,15462,750162,464537,county,2000
9,34025,"Monmouth County, New Jersey",34025,ONJ,224236,240884,16648,24257,47745,38175,577126,9222,615301,495902,county,2000
10,34027,"Morris County, New Jersey",34027,INJ,169711,174379,4668,29310,12506,36626,433586,6188,470212,385582,county,2000
11,34029,"Ocean County, New Jersey",34029,ONJ,200402,248711,48309,6426,14431,25638,485278,5247,510916,459174,county,2000
12,34031,"Passaic County, New Jersey",34031,INJ,163856,170048,6192,17747,60528,146492,342557,12595,489049,251687,county,2000
13,34035,"Somerset County, New Jersey",34035,INJ,108984,112023,3039,24870,21571,25811,271679,4654,297490,220584,county,2000
14,34037,"Sussex County, New Jersey",34037,ONJ,50831,56528,5697,1723,1444,4822,139344,1553,144166,134624,county,2000
15,34039,"Union County, New Jersey",34039,INJ,186124,192945,6821,19789,104926,103011,419530,11470,522541,283345,county,2000
16,34041,"Warren County, New Jersey",34041,ONJ,38660,41157,2497,1235,1838,3751,98686,1208,102437,94405,county,2000
17,36005,"Bronx County, New York",36005,NYC,463212,490659,27447,38558,416338,644705,687945,39398,1332650,193651,county,2000
18,36027,"Dutchess County, New York",36027,MHV,99536,106103,6567,6990,25059,18060,262090,5128,280150,224913,county,2000
19,36047,"Kings County, New York",36047,NYC,880727,930866,50139,184291,848583,487878,1977448,90042,2465326,854532,county,2000
20,36059,"Nassau County, New York",36059,LI,447387,458151,10764,62744,129860,133282,1201262,21711,1334544,986947,county,2000
21,36061,"New York County, New York",36061,NYC,738644,798144,59500,143291,234698,417816,1119379,37517,1537195,703873,county,2000
22,36071,"Orange County, New York",36071,MHV,114788,122754,7966,5054,25567,39738,301629,6248,341367,264760,county,2000
23,36079,"Putnam County, New York",36079,LHV,32703,35030,2327,1157,1437,5976,89769,1202,95745,85973,county,2000
24,36081,"Queens County, New York",36081,NYC,782664,817250,34586,389303,422831,556605,1672774,127745,2229379,732895,county,2000
25,36085,"Richmond County, New York",36085,NYC,156341,163993,7652,24786,39704,53550,390178,9372,443728,316316,county,2000
26,36087,"Rockland County, New York",36087,LHV,92675,94973,2298,15707,30139,29182,257571,6072,286753,205653,county,2000
27,36103,"Suffolk County, New York",36103,LI,469299,522323,53024,34355,93262,149411,1269958,23936,1419369,1118405,county,2000
28,36105,"Sullivan County, New York",36105,MHV,27661,44730,17069,810,5897,6839,67127,1195,73966,59225,county,2000
29,36111,"Ulster County, New York",36111,MHV,67499,77656,10157,2169,9044,10941,166808,3531,177749,152064,county,2000
30,36119,"Westchester County, New York",36119,LHV,337142,349445,12303,40941,125227,144124,779335,21391,923459,591776,county,2000
31,09001,"Fairfield County, Connecticut",09001,CT,335545,361221,25676,41801,92705,155025,761804,20582,916829,606716,county,2010
32,09005,"Litchfield County, Connecticut",09005,CT,76640,87550,10910,2877,2206,8535,181392,2906,189927,173403,county,2010
33,09009,"New Haven County, Connecticut",09009,CT,334502,362004,27502,29933,101763,129743,732734,18654,862477,582384,county,2010
34,36047,"Kings County, New York",36047,NYC,916856,1000293,83437,260129,799066,496285,2008415,55914,2504700,893306,county,2010
35,36059,"Nassau County, New York",36059,LI,448528,468346,19818,101558,141305,195355,1144177,24005,1339532,877309,county,2010
36,36061,"New York County, New York",36061,NYC,763846,847090,83244,177624,205340,403577,1182296,37839,1585873,761493,county,2010
37,36079,"Putnam County, New York",36079,LHV,35041,38224,3183,1832,2047,11661,88049,1461,99710,82709,county,2010
38,36071,"Orange County, New York",36071,MHV,125925,137025,11100,8685,33895,67185,305628,8789,372813,254259,county,2010
39,36081,"Queens County, New York",36081,NYC,780117,835127,55010,508334,395881,613750,1616972,96030,2230722,616727,county,2010
40,36085,"Richmond County, New York",36085,NYC,165516,176656,11140,34697,44313,81051,387679,8500,468730,300169,county,2010
41,36087,"Rockland County, New York",36087,LHV,99242,104057,4815,19099,34623,48783,262904,5512,311687,203670,county,2010
42,36103,"Suffolk County, New York",36103,LI,499922,569985,70063,50295,102117,246239,1247111,25971,1493350,1068728,county,2010
43,36105,"Sullivan County, New York",36105,MHV,30139,49186,19047,1033,6349,10554,66993,1831,77547,57780,county,2010
44,36111,"Ulster County, New York",36111,MHV,71049,83638,12589,3060,9982,15909,166584,4443,182493,149099,county,2010
45,36119,"Westchester County, New York",36119,LHV,347232,370821,23589,51123,126585,207032,742081,19810,949113,544563,county,2010
46,34041,"Warren County, New Jersey",34041,ONJ,41480,44925,3445,2642,3592,7659,101033,1634,108692,93165,county,2010
47,34035,"Somerset County, New Jersey",34035,INJ,117759,123127,5368,45473,27480,42091,281353,6551,323444,201849,county,2010
48,34037,"Sussex County, New Jersey",34037,ONJ,54752,62057,7305,2605,2448,9617,139648,2111,149265,132484,county,2010
49,34039,"Union County, New Jersey",34039,INJ,188118,199489,11371,24496,111705,146704,389795,10282,536499,243312,county,2010
50,36005,"Bronx County, New York",36005,NYC,483449,511896,28447,47335,416695,741413,643695,28456,1385108,151209,county,2010
51,36027,"Dutchess County, New York",36027,MHV,107965,118638,10673,10330,27395,31267,266221,6684,297488,221812,county,2010
52,34021,"Mercer County, New Jersey",34021,ONJ,133155,143169,10014,32545,71378,55318,311195,7363,366513,199909,county,2010
53,34023,"Middlesex County, New Jersey",34023,INJ,281186,294800,13614,172534,71557,148975,660883,18068,809858,398724,county,2010
54,34025,"Monmouth County, New Jersey",34025,ONJ,233983,258410,24427,31018,43931,60939,569441,11057,630380,483435,county,2010
55,34027,"Morris County, New Jersey",34027,INJ,180534,189842,9308,43862,14134,56482,435794,8247,492276,369551,county,2010
56,34029,"Ocean County, New Jersey",34029,ONJ,221111,278052,56941,9924,16583,47783,528784,6743,576567,495534,county,2010
57,34003,"Bergen County, New Jersey",34003,INJ,335730,352388,16658,130491,46850,145281,759835,16441,905116,566053,county,2010
58,34019,"Hunterdon County, New Jersey",34019,ONJ,47169,49487,2318,4155,3233,6722,121627,1632,128349,112607,county,2010
59,34013,"Essex County, New Jersey",34013,INJ,283712,312954,29242,35292,308358,159117,624852,21025,783969,260177,county,2010
60,34017,"Hudson County, New Jersey",34017,INJ,246437,270335,23898,83825,71315,267853,366413,15763,634266,195510,county,2010
61,34031,"Passaic County, New Jersey",34031,INJ,166785,175966,9181,24556,55480,185677,315549,8369,501226,227144,county,2010
62,CT,Connecticut,0<NA>,CT,714823,759465,44642,49641,175847,191860,1696908,37573,1888768,1433847,subregion,2000
63,CT,Connecticut,0<NA>,CT,746687,810775,64088,74611,196674,293303,1675930,42142,1969233,1362503,subregion,2010
64,INJ,Inner New Jersey,0<NA>,INJ,1739589,1804481,64892,374994,702038,869727,3946453,110809,4816180,2758612,subregion,2000
65,INJ,Inner New Jersey,0<NA>,INJ,1800261,1918901,118640,560529,706879,1152180,3834474,104746,4986654,2462320,subregion,2010
66,LHV,Lower Hudson Valley,0<NA>,LHV,462520,479448,16928,57805,156803,179282,1126675,28665,1305957,883402,subregion,2000
67,LHV,Lower Hudson Valley,0<NA>,LHV,481515,513102,31587,72054,163255,267476,1093034,26783,1360510,830942,subregion,2010
68,LI,Long Island,0<NA>,LI,916686,980474,63788,97099,223122,282693,2471220,45647,2753913,2105352,subregion,2000
69,LI,Long Island,0<NA>,LI,948450,1038331,89881,151853,243422,441594,2391288,49976,2832882,1946037,subregion,2010
70,MHV,Mid Hudsonn Valley,0<NA>,MHV,309484,351243,41759,15023,65567,75578,797654,16102,873232,700962,subregion,2000
71,MHV,Mid Hudsonn Valley,0<NA>,MHV,335078,388487,53409,23108,77621,124915,805426,21747,930341,682950,subregion,2010
72,NYC,New York City,0<NA>,NYC,3021588,3200912,179324,780229,1962154,2160554,5847724,304074,8008278,2801267,subregion,2000
73,NYC,New York City,0<NA>,NYC,3109784,3371062,261278,1028119,1861295,2336076,5839057,226739,8175133,2722904,subregion,2010
74,ONJ,Outer New Jersey,0<NA>,ONJ,683614,765592,81978,53223,136018,109655,1735915,24812,1845570,1521862,subregion,2000
75,ONJ,Outer New Jersey,0<NA>,ONJ,731650,836100,104450,82889,141165,188038,1771728,30540,1959766,1517134,subregion,2010
76,us,United States,0<NA>,,105480101,115904641,10424540,10123169,33947837,35305818,246116088,7492308,281421906,194552774,nation,2000
77,us,United States,0<NA>,,116716292,131704730,14988438,14465124,37685848,50477594,258267944,9299420,308745538,196817552,nation,2010
78,900100000,"County subdivisions not defined, Fairfield County, Connecticut",09001,CT,0,0,0,0,0,0,0,0,0,0,municipality,2000
79,900100000,"County subdivisions not defined, Fairfield County, Connecticut",09001,CT,0,0,0,0,0,0,0,0,0,0,municipality,2010
80,900104720,"Bethel town, Fairfield County, Connecticut",09001,CT,6505,6653,148,631,219,669,17398,311,18067,16237,municipality,2000
81,900104720,"Bethel town, Fairfield County, Connecticut",09001,CT,6938,7310,372,820,315,1419,17165,432,18584,15598,municipality,2010
82,900108070,"Bridgeport town, Fairfield County, Connecticut",09001,CT,50307,54367,4060,4459,40974,44478,95051,6460,139529,43158,municipality,2000
83,900108070,"Bridgeport town, Fairfield County, Connecticut",09001,CT,51255,57012,5757,4781,46472,55100,89129,5082,144229,32794,municipality,2010
84,900108980,"Brookfield town, Fairfield County, Connecticut",09001,CT,5572,5781,209,387,114,372,15292,125,15664,14666,municipality,2000
85,900108980,"Brookfield town, Fairfield County, Connecticut",09001,CT,6129,6562,433,595,161,710,15742,220,16452,14766,municipality,2010
86,900118500,"Danbury town, Fairfield County, Connecticut",09001,CT,27183,28519,1336,4068,4743,11791,63057,3301,74848,50945,municipality,2000
87,900118500,"Danbury town, Fairfield County, Connecticut",09001,CT,28907,31154,2247,5399,5030,20185,60708,3970,80893,46309,municipality,2010
88,900118850,"Darien town, Fairfield County, Connecticut",09001,CT,6592,6792,200,474,83,429,19178,176,19607,18445,municipality,2000
89,900118850,"Darien town, Fairfield County, Connecticut",09001,CT,6698,7074,376,744,98,743,19989,249,20732,18898,municipality,2010
90,900123890,"Easton town, Fairfield County, Connecticut",09001,CT,2465,2511,46,147,15,128,7144,49,7272,6933,municipality,2000
91,900123890,"Easton town, Fairfield County, Connecticut",09001,CT,2577,2715,138,238,46,220,7270,94,7490,6892,municipality,2010
92,900126620,"Fairfield town, Fairfield County, Connecticut",09001,CT,20397,21029,632,1157,598,1340,56000,576,57340,53669,municipality,2000
93,900126620,"Fairfield town, Fairfield County, Connecticut",09001,CT,20457,21648,1191,2177,1015,2999,56405,935,59404,52278,municipality,2010
94,900133620,"Greenwich town, Fairfield County, Connecticut",09001,CT,23230,24511,1281,3161,990,3846,57255,875,61101,52229,municipality,2000
95,900133620,"Greenwich town, Fairfield County, Connecticut",09001,CT,23076,25631,2555,4017,1232,5964,55207,1151,61171,48807,municipality,2010
96,900148620,"Monroe town, Fairfield County, Connecticut",09001,CT,6481,6601,120,291,225,482,18765,168,19247,18081,municipality,2000
97,900148620,"Monroe town, Fairfield County, Connecticut",09001,CT,6735,6918,183,402,259,919,18560,254,19479,17645,municipality,2010
98,900150580,"New Canaan town, Fairfield County, Connecticut",09001,CT,6822,7141,319,443,196,338,19057,198,19395,18220,municipality,2000
99,900150580,"New Canaan town, Fairfield County, Connecticut",09001,CT,7010,7551,541,662,194,570,19168,280,19738,18032,municipality,2010
100,900150860,"New Fairfield town, Fairfield County, Connecticut",09001,CT,4638,5148,510,177,53,393,13560,118,13953,13212,municipality,2000
101,900150860,"New Fairfield town, Fairfield County, Connecticut",09001,CT,4802,5593,791,232,142,611,13270,202,13881,12694,municipality,2010
102,900152980,"Newtown town, Fairfield County, Connecticut",09001,CT,8325,8601,276,346,415,590,24441,239,25031,23441,municipality,2000
103,900152980,"Newtown town, Fairfield County, Connecticut",09001,CT,9459,10061,602,645,433,1033,26527,316,27560,25133,municipality,2010
104,900156060,"Norwalk town, Fairfield County, Connecticut",09001,CT,32711,33753,1042,2672,12231,12966,69985,1758,82951,53324,municipality,2000
105,900156060,"Norwalk town, Fairfield County, Connecticut",09001,CT,33217,35415,2198,4045,11472,20770,64833,1598,85603,47718,municipality,2010
106,900163480,"Redding town, Fairfield County, Connecticut",09001,CT,2918,3086,168,147,61,122,8148,85,8270,7855,municipality,2000
107,900163480,"Redding town, Fairfield County, Connecticut",09001,CT,3470,3811,341,195,60,237,8921,166,9158,8500,municipality,2010
108,900163970,"Ridgefield town, Fairfield County, Connecticut",09001,CT,8433,8877,444,490,133,465,23178,194,23643,22361,municipality,2000
109,900163970,"Ridgefield town, Fairfield County, Connecticut",09001,CT,8801,9420,619,780,174,941,23697,339,24638,22404,municipality,2010
110,900168170,"Shelton town, Fairfield County, Connecticut",09001,CT,14190,14707,517,787,393,1326,36775,492,38101,35103,municipality,2000
111,900168170,"Shelton town, Fairfield County, Connecticut",09001,CT,15325,16146,821,1522,865,2353,37206,486,39559,34333,municipality,2010
112,900168310,"Sherman town, Fairfield County, Connecticut",09001,CT,1434,1606,172,23,19,66,3761,30,3827,3689,municipality,2000
113,900168310,"Sherman town, Fairfield County, Connecticut",09001,CT,1388,1831,443,33,12,76,3505,45,3581,3415,municipality,2010
114,900173070,"Stamford town, Fairfield County, Connecticut",09001,CT,45399,47317,1918,5818,17421,19635,97448,2599,117083,71610,municipality,2000
115,900173070,"Stamford town, Fairfield County, Connecticut",09001,CT,47357,50573,3216,9604,16106,29188,93455,2339,122643,65406,municipality,2010
116,900174190,"Stratford town, Fairfield County, Connecticut",09001,CT,19898,20596,698,695,4765,3399,46577,790,49976,40327,municipality,2000
117,900174190,"Stratford town, Fairfield County, Connecticut",09001,CT,20095,21091,996,1199,6963,7114,44270,1068,51384,35040,municipality,2010
118,900177200,"Trumbull town, Fairfield County, Connecticut",09001,CT,11911,12160,249,813,613,923,33320,345,34243,31549,municipality,2000
119,900177200,"Trumbull town, Fairfield County, Connecticut",09001,CT,12725,13157,432,1559,1070,2068,33950,449,36018,30872,municipality,2010
120,900183430,"Weston town, Fairfield County, Connecticut",09001,CT,3312,3532,220,193,87,206,9831,108,10037,9443,municipality,2000
121,900183430,"Weston town, Fairfield County, Connecticut",09001,CT,3379,3674,295,293,130,336,9843,208,10179,9212,municipality,2010
122,900183500,"Westport town, Fairfield County, Connecticut",09001,CT,9586,10065,479,622,279,602,25147,231,25749,24015,municipality,2000
123,900183500,"Westport town, Fairfield County, Connecticut",09001,CT,9573,10399,826,1038,292,932,25459,414,26391,23715,municipality,2010
124,900186370,"Wilton town, Fairfield County, Connecticut",09001,CT,5923,6113,190,472,97,269,17364,155,17633,16640,municipality,2000
125,900186370,"Wilton town, Fairfield County, Connecticut",09001,CT,6172,6475,303,821,164,537,17525,285,18062,16255,municipality,2010
126,900502760,"Barkhamsted town, Litchfield County, Connecticut",09005,CT,1334,1436,102,14,2,31,3463,30,3494,3417,municipality,2000
127,900502760,"Barkhamsted town, Litchfield County, Connecticut",09005,CT,1452,1589,137,23,10,57,3742,47,3799,3662,municipality,2010
128,900504930,"Bethlehem town, Litchfield County, Connecticut",09005,CT,1246,1388,142,27,9,22,3400,44,3422,3320,municipality,2000
129,900504930,"Bethlehem town, Litchfield County, Connecticut",09005,CT,1411,1575,164,18,16,61,3546,35,3607,3477,municipality,2010
130,900508210,"Bridgewater town, Litchfield County, Connecticut",09005,CT,703,779,76,13,17,9,1815,13,1824,1772,municipality,2000
131,900508210,"Bridgewater town, Litchfield County, Connecticut",09005,CT,735,881,146,15,13,26,1701,12,1727,1661,municipality,2010
132,900510940,"Canaan town, Litchfield County, Connecticut",09005,CT,445,610,165,2,16,4,1077,13,1081,1046,municipality,2000
133,900510940,"Canaan town, Litchfield County, Connecticut",09005,CT,583,779,196,3,8,19,1215,18,1234,1186,municipality,2010
134,900516050,"Colebrook town, Litchfield County, Connecticut",09005,CT,566,656,90,9,10,36,1435,2,1471,1414,municipality,2000
135,900516050,"Colebrook town, Litchfield County, Connecticut",09005,CT,589,722,133,9,4,17,1468,15,1485,1440,municipality,2010
136,900517240,"Cornwall town, Litchfield County, Connecticut",09005,CT,615,873,258,10,2,21,1413,18,1434,1383,municipality,2000
137,900517240,"Cornwall town, Litchfield County, Connecticut",09005,CT,628,1007,379,9,2,34,1386,18,1420,1357,municipality,2010
138,900532290,"Goshen town, Litchfield County, Connecticut",09005,CT,1066,1482,416,20,13,33,2664,13,2697,2618,municipality,2000
139,900532290,"Goshen town, Litchfield County, Connecticut",09005,CT,1192,1664,472,36,9,67,2909,22,2976,2842,municipality,2010
140,900537280,"Harwinton town, Litchfield County, Connecticut",09005,CT,1958,2022,64,27,4,47,5236,34,5283,5171,municipality,2000
141,900537280,"Harwinton town, Litchfield County, Connecticut",09005,CT,2170,2282,112,48,12,80,5562,49,5642,5453,municipality,2010
142,900540290,"Kent town, Litchfield County, Connecticut",09005,CT,1143,1463,320,21,16,72,2786,48,2858,2701,municipality,2000
143,900540290,"Kent town, Litchfield County, Connecticut",09005,CT,1246,1665,419,49,34,94,2885,63,2979,2739,municipality,2010
144,900543370,"Litchfield town, Litchfield County, Connecticut",09005,CT,3310,3629,319,39,55,130,8186,92,8316,8000,municipality,2000
145,900543370,"Litchfield town, Litchfield County, Connecticut",09005,CT,3459,3975,516,76,49,173,8293,143,8466,8025,municipality,2010
146,900549460,"Morris town, Litchfield County, Connecticut",09005,CT,912,1181,269,19,16,20,2281,22,2301,2224,municipality,2000
147,900549460,"Morris town, Litchfield County, Connecticut",09005,CT,958,1314,356,18,11,50,2338,29,2388,2280,municipality,2010
148,900551350,"New Hartford town, Litchfield County, Connecticut",09005,CT,2228,2368,140,45,33,82,6006,37,6088,5891,municipality,2000
149,900551350,"New Hartford town, Litchfield County, Connecticut",09005,CT,2632,2923,291,79,18,124,6846,63,6970,6686,municipality,2010
150,900552630,"New Milford town, Litchfield County, Connecticut",09005,CT,10018,10710,692,515,371,751,26370,446,27121,25038,municipality,2000
151,900552630,"New Milford town, Litchfield County, Connecticut",09005,CT,10618,11731,1113,772,452,1693,26449,516,28142,24709,municipality,2010
152,900553470,"Norfolk town, Litchfield County, Connecticut",09005,CT,676,871,195,9,8,16,1644,25,1660,1602,municipality,2000
153,900553470,"Norfolk town, Litchfield County, Connecticut",09005,CT,720,967,247,11,12,30,1679,19,1709,1637,municipality,2010
154,900554030,"North Canaan town, Litchfield County, Connecticut",09005,CT,1343,1444,101,5,36,79,3271,34,3350,3196,municipality,2000
155,900554030,"North Canaan town, Litchfield County, Connecticut",09005,CT,1400,1587,187,8,39,195,3120,30,3315,3043,municipality,2010
156,900560750,"Plymouth town, Litchfield County, Connecticut",09005,CT,4453,4646,193,48,87,147,11487,137,11634,11215,municipality,2000
157,900560750,"Plymouth town, Litchfield County, Connecticut",09005,CT,4803,5109,306,98,94,370,11873,187,12243,11494,municipality,2010
158,900565930,"Roxbury town, Litchfield County, Connecticut",09005,CT,848,1018,170,20,5,28,2108,27,2136,2056,municipality,2000
159,900565930,"Roxbury town, Litchfield County, Connecticut",09005,CT,936,1167,231,18,13,48,2214,33,2262,2150,municipality,2010
160,900566420,"Salisbury town, Litchfield County, Connecticut",09005,CT,1737,2410,673,38,64,61,3916,48,3977,3766,municipality,2000
161,900566420,"Salisbury town, Litchfield County, Connecticut",09005,CT,1693,2593,900,41,52,107,3634,62,3741,3479,municipality,2010
162,900567960,"Sharon town, Litchfield County, Connecticut",09005,CT,1246,1617,371,17,28,58,2910,32,2968,2833,municipality,2000
163,900567960,"Sharon town, Litchfield County, Connecticut",09005,CT,1250,1775,525,20,44,56,2726,30,2782,2632,municipality,2010
164,900575730,"Thomaston town, Litchfield County, Connecticut",09005,CT,2916,3014,98,37,44,109,7394,45,7503,7268,municipality,2000
165,900575730,"Thomaston town, Litchfield County, Connecticut",09005,CT,3108,3276,168,58,27,202,7685,89,7887,7511,municipality,2010
166,900576570,"Torrington town, Litchfield County, Connecticut",09005,CT,14743,16147,1404,634,694,1162,34040,512,35202,32200,municipality,2000
167,900576570,"Torrington town, Litchfield County, Connecticut",09005,CT,15243,16761,1518,777,776,3193,33190,739,36383,30898,municipality,2010
168,900579510,"Warren town, Litchfield County, Connecticut",09005,CT,497,650,153,10,2,3,1251,13,1254,1226,municipality,2000
169,900579510,"Warren town, Litchfield County, Connecticut",09005,CT,601,811,210,20,8,31,1430,8,1461,1394,municipality,2010
170,900579720,"Washington town, Litchfield County, Connecticut",09005,CT,1416,1764,348,56,21,77,3519,53,3596,3389,municipality,2000
171,900579720,"Washington town, Litchfield County, Connecticut",09005,CT,1512,2124,612,26,20,142,3436,45,3578,3345,municipality,2010
172,900580490,"Watertown town, Litchfield County, Connecticut",09005,CT,8046,8298,252,273,149,406,21255,205,21661,20628,municipality,2000
173,900580490,"Watertown town, Litchfield County, Connecticut",09005,CT,8672,9096,424,376,292,838,21676,301,22514,20707,municipality,2010
174,900586440,"Winchester town, Litchfield County, Connecticut",09005,CT,4371,4922,551,98,89,338,10326,178,10664,9961,municipality,2000
175,900586440,"Winchester town, Litchfield County, Connecticut",09005,CT,4815,5613,798,102,136,583,10659,191,11242,10230,municipality,2010
176,900587910,"Woodbury town, Litchfield County, Connecticut",09005,CT,3715,3869,154,101,46,152,9046,80,9198,8819,municipality,2000
177,900587910,"Woodbury town, Litchfield County, Connecticut",09005,CT,4214,4564,350,167,55,245,9730,142,9975,9366,municipality,2010
178,900900000,"County subdivisions not defined, New Haven County, Connecticut",09009,CT,0,0,0,0,0,0,0,0,0,0,municipality,2000
179,900900000,"County subdivisions not defined, New Haven County, Connecticut",09009,CT,0,0,0,0,0,0,0,0,0,0,municipality,2010
180,900901220,"Ansonia town, New Haven County, Connecticut",09009,CT,7507,7937,430,209,1511,1376,17178,392,18554,15066,municipality,2000
181,900901220,"Ansonia town, New Haven County, Connecticut",09009,CT,7510,8148,638,365,2040,3212,16037,469,19249,13163,municipality,2010
182,900903250,"Beacon Falls town, New Haven County, Connecticut",09009,CT,2032,2104,72,54,34,112,5134,45,5246,5001,municipality,2000
183,900903250,"Beacon Falls town, New Haven County, Connecticut",09009,CT,2360,2509,149,70,87,300,5749,77,6049,5515,municipality,2010
184,900904580,"Bethany town, New Haven County, Connecticut",09009,CT,1755,1792,37,77,92,102,4938,56,5040,4713,municipality,2000
185,900904580,"Bethany town, New Haven County, Connecticut",09009,CT,1971,2044,73,268,102,137,5426,68,5563,4988,municipality,2010
186,900907310,"Branford town, New Haven County, Connecticut",09009,CT,12543,13342,799,778,374,737,27946,370,28683,26424,municipality,2000
187,900907310,"Branford town, New Haven County, Connecticut",09009,CT,12739,13972,1233,1020,507,1149,26877,395,28026,24955,municipality,2010
188,900914160,"Cheshire town, New Haven County, Connecticut",09009,CT,9349,9588,239,743,1270,1097,27446,328,28543,25105,municipality,2000
189,900914160,"Cheshire town, New Haven County, Connecticut",09009,CT,10041,10424,383,1477,1374,1375,27886,398,29261,24637,municipality,2010
190,900919550,"Derby town, New Haven County, Connecticut",09009,CT,5252,5568,316,212,441,950,11441,179,12391,10609,municipality,2000
191,900919550,"Derby town, New Haven County, Connecticut",09009,CT,5388,5849,461,323,891,1830,11072,259,12902,9599,municipality,2010
192,900922910,"East Haven town, New Haven County, Connecticut",09009,CT,11219,11698,479,537,377,1228,26961,293,28189,25754,municipality,2000
193,900922910,"East Haven town, New Haven County, Connecticut",09009,CT,11756,12533,777,954,771,3012,26245,366,29257,24154,municipality,2010
194,900934950,"Guilford town, New Haven County, Connecticut",09009,CT,8151,8724,573,351,192,455,20943,191,21398,20209,municipality,2000
195,900934950,"Guilford town, New Haven County, Connecticut",09009,CT,8715,9596,881,535,160,779,21596,261,22375,20640,municipality,2010
196,900935650,"Hamden town, New Haven County, Connecticut",09009,CT,22408,23464,1056,2000,8642,2425,54488,1034,56913,42812,municipality,2000
197,900935650,"Hamden town, New Haven County, Connecticut",09009,CT,23727,25114,1387,3304,11869,5327,55633,1374,60960,39086,municipality,2010
198,900944560,"Madison town, New Haven County, Connecticut",09009,CT,6515,7386,871,304,70,240,17618,174,17858,17070,municipality,2000
199,900944560,"Madison town, New Haven County, Connecticut",09009,CT,6971,8049,1078,405,100,375,17894,237,18269,17152,municipality,2010
200,900946520,"Meriden town, New Haven County, Connecticut",09009,CT,22951,24631,1680,783,3321,12296,45948,1135,58244,40709,municipality,2000
201,900946520,"Meriden town, New Haven County, Connecticut",09009,CT,23977,25892,1915,1250,4980,17590,43278,1239,60868,35809,municipality,2010
202,900946940,"Middlebury town, New Haven County, Connecticut",09009,CT,2398,2494,96,83,21,79,6372,61,6451,6207,municipality,2000
203,900946940,"Middlebury town, New Haven County, Connecticut",09009,CT,2748,2892,144,286,67,208,7367,89,7575,6925,municipality,2010
204,900947535,"Milford town, New Haven County, Connecticut",09009,CT,20900,21962,1062,1206,951,1750,50555,658,52305,47740,municipality,2000
205,900947535,"Milford town, New Haven County, Connecticut",09009,CT,21708,23074,1366,2801,1238,2756,50003,829,52759,45135,municipality,2010
206,900949950,"Naugatuck town, New Haven County, Connecticut",09009,CT,11829,12341,512,520,842,1386,29603,700,30989,27541,municipality,2000
207,900949950,"Naugatuck town, New Haven County, Connecticut",09009,CT,12339,13061,722,962,1427,2929,28933,777,31862,25767,municipality,2010
208,900952070,"New Haven town, New Haven County, Connecticut",09009,CT,47094,52941,5847,4776,44598,26443,97183,3830,123626,43979,municipality,2000
209,900952070,"New Haven town, New Haven County, Connecticut",09009,CT,48877,54967,6090,5864,43332,35591,94188,3762,129779,41230,municipality,2010
210,900953890,"North Branford town, New Haven County, Connecticut",09009,CT,5132,5246,114,124,163,250,13656,111,13906,13258,municipality,2000
211,900953890,"North Branford town, New Haven County, Connecticut",09009,CT,5441,5629,188,225,187,421,13986,144,14407,13430,municipality,2010
212,900954870,"North Haven town, New Haven County, Connecticut",09009,CT,8597,8773,176,768,502,433,22602,205,23035,21127,municipality,2000
213,900954870,"North Haven town, New Haven County, Connecticut",09009,CT,9135,9491,356,1121,693,929,23164,294,24093,21056,municipality,2010
214,900957600,"Orange town, New Haven County, Connecticut",09009,CT,4739,4870,131,508,100,190,13043,123,13233,12312,municipality,2000
215,900957600,"Orange town, New Haven County, Connecticut",09009,CT,5123,5345,222,1045,198,398,13558,195,13956,12120,municipality,2010
216,900958300,"Oxford town, New Haven County, Connecticut",09009,CT,3343,3420,77,65,50,180,9641,74,9821,9452,municipality,2000
217,900958300,"Oxford town, New Haven County, Connecticut",09009,CT,4504,4746,242,195,134,468,12215,141,12683,11745,municipality,2010
218,900962290,"Prospect town, New Haven County, Connecticut",09009,CT,3020,3094,74,63,122,168,8539,86,8707,8268,municipality,2000
219,900962290,"Prospect town, New Haven County, Connecticut",09009,CT,3357,3474,117,73,175,312,9093,105,9405,8740,municipality,2010
220,900967610,"Seymour town, New Haven County, Connecticut",09009,CT,6155,6356,201,270,204,470,14984,150,15454,14360,municipality,2000
221,900967610,"Seymour town, New Haven County, Connecticut",09009,CT,6654,6968,314,359,395,1064,15476,206,16540,14516,municipality,2010
222,900969640,"Southbury town, New Haven County, Connecticut",09009,CT,7225,7799,574,214,80,296,18271,133,18567,17844,municipality,2000
223,900969640,"Southbury town, New Haven County, Connecticut",09009,CT,8213,9091,878,531,156,523,19381,232,19904,18462,municipality,2010
224,900978740,"Wallingford town, New Haven County, Connecticut",09009,CT,16697,17306,609,749,417,1946,41080,456,43026,39458,municipality,2000
225,900978740,"Wallingford town, New Haven County, Connecticut",09009,CT,18032,18945,913,1526,587,3562,41573,581,45135,38879,municipality,2010
226,900980070,"Waterbury town, New Haven County, Connecticut",09009,CT,42622,46827,4205,1584,16335,23354,83917,3592,107271,62406,municipality,2000
227,900980070,"Waterbury town, New Haven County, Connecticut",09009,CT,42761,47991,5230,1933,19654,34446,75920,4252,110366,50081,municipality,2010
228,900982870,"West Haven town, New Haven County, Connecticut",09009,CT,21090,22336,1246,1512,8257,4757,47603,1313,52360,36521,municipality,2000
229,900982870,"West Haven town, New Haven County, Connecticut",09009,CT,21112,22446,1334,2056,10205,10155,45409,1513,55564,31635,municipality,2010
230,900987560,"Wolcott town, New Haven County, Connecticut",09009,CT,5414,5544,130,113,185,273,14942,158,15215,14486,municipality,2000
231,900987560,"Wolcott town, New Haven County, Connecticut",09009,CT,6007,6276,269,205,261,611,16069,243,16680,15360,municipality,2010
232,900987700,"Woodbridge town, New Haven County, Connecticut",09009,CT,3103,3189,86,458,135,138,8845,142,8983,8110,municipality,2000
233,900987700,"Woodbridge town, New Haven County, Connecticut",09009,CT,3336,3478,142,780,173,284,8706,148,8990,7605,municipality,2010
234,3400300700,"Allendale borough, Bergen County, New Jersey",34003,INJ,2110,2143,33,408,26,170,6529,46,6699,6049,municipality,2000
235,3400300700,"Allendale borough, Bergen County, New Jersey",34003,INJ,2236,2388,152,624,29,304,6201,98,6505,5450,municipality,2010
236,3400301090,"Alpine borough, Bergen County, New Jersey",34003,INJ,708,730,22,416,33,55,2128,32,2183,1647,municipality,2000
237,3400301090,"Alpine borough, Bergen County, New Jersey",34003,INJ,611,670,59,482,44,89,1760,37,1849,1197,municipality,2010
238,3400305170,"Bergenfield borough, Bergen County, New Jersey",34003,INJ,8981,9147,166,5327,1665,4474,21773,616,26247,14165,municipality,2000
239,3400305170,"Bergenfield borough, Bergen County, New Jersey",34003,INJ,8852,9200,348,6778,1724,7097,19667,619,26764,10546,municipality,2010
240,3400306490,"Bogota borough, Bergen County, New Jersey",34003,INJ,2874,2915,41,637,393,1759,6490,253,8249,5207,municipality,2000
241,3400306490,"Bogota borough, Bergen County, New Jersey",34003,INJ,2773,2888,115,795,582,3169,5018,230,8187,3411,municipality,2010
242,3400310480,"Carlstadt borough, Bergen County, New Jersey",34003,INJ,2393,2473,80,366,64,473,5444,44,5917,4970,municipality,2000
243,3400310480,"Carlstadt borough, Bergen County, New Jersey",34003,INJ,2378,2495,117,499,122,1104,5023,90,6127,4312,municipality,2010
244,3400313570,"Cliffside Park borough, Bergen County, New Jersey",34003,INJ,10027,10375,348,2755,356,4177,18830,457,23007,15262,municipality,2000
245,3400313570,"Cliffside Park borough, Bergen County, New Jersey",34003,INJ,9948,10665,717,3219,584,6704,16890,653,23594,12434,municipality,2010
246,3400313810,"Closter borough, Bergen County, New Jersey",34003,INJ,2789,2865,76,1800,76,343,8040,105,8383,6059,municipality,2000
247,3400313810,"Closter borough, Bergen County, New Jersey",34003,INJ,2747,2860,113,2649,100,501,7872,104,8373,5019,municipality,2010
248,3400315820,"Cresskill borough, Bergen County, New Jersey",34003,INJ,2630,2702,72,1441,70,309,7437,125,7746,5801,municipality,2000
249,3400315820,"Cresskill borough, Bergen County, New Jersey",34003,INJ,3002,3114,112,2367,57,537,8036,112,8573,5500,municipality,2010
250,3400317530,"Demarest borough, Bergen County, New Jersey",34003,INJ,1601,1634,33,977,23,167,4678,62,4845,3616,municipality,2000
251,3400317530,"Demarest borough, Bergen County, New Jersey",34003,INJ,1597,1659,62,1276,26,216,4665,90,4881,3273,municipality,2010
252,3400318400,"Dumont borough, Bergen County, New Jersey",34003,INJ,6370,6465,95,1915,222,1463,16040,211,17503,13692,municipality,2000
253,3400318400,"Dumont borough, Bergen County, New Jersey",34003,INJ,6364,6542,178,2599,375,2580,14899,284,17479,11641,municipality,2010
254,3400319510,"East Rutherford borough, Bergen County, New Jersey",34003,INJ,3644,3771,127,930,292,928,7788,156,8716,6410,municipality,2000
255,3400319510,"East Rutherford borough, Bergen County, New Jersey",34003,INJ,3792,4018,226,1237,336,1563,7350,161,8913,5616,municipality,2010
256,3400320020,"Edgewater borough, Bergen County, New Jersey",34003,INJ,3836,4277,441,1765,243,802,6875,206,7677,4661,municipality,2000
257,3400320020,"Edgewater borough, Bergen County, New Jersey",34003,INJ,5637,6282,645,4076,519,1278,10235,297,11513,5343,municipality,2010
258,3400321300,"Elmwood Park borough, Bergen County, New Jersey",34003,INJ,7089,7242,153,1474,379,2535,16390,399,18925,14138,municipality,2000
259,3400321300,"Elmwood Park borough, Bergen County, New Jersey",34003,INJ,7032,7385,353,2055,884,4117,15286,390,19403,11957,municipality,2010
260,3400321450,"Emerson borough, Bergen County, New Jersey",34003,INJ,2373,2398,25,568,47,332,6865,41,7197,6209,municipality,2000
261,3400321450,"Emerson borough, Bergen County, New Jersey",34003,INJ,2480,2552,72,629,64,619,6782,103,7401,5986,municipality,2010
262,3400321480,"Englewood city, Bergen County, New Jersey",34003,INJ,9273,9614,341,1356,9887,5703,20500,868,26203,8389,municipality,2000
263,3400321480,"Englewood city, Bergen County, New Jersey",34003,INJ,10057,10695,638,2169,8373,7460,19687,671,27147,8474,municipality,2010
264,3400321510,"Englewood Cliffs borough, Bergen County, New Jersey",34003,INJ,1818,1889,71,1580,72,260,5062,69,5322,3341,municipality,2000
265,3400321510,"Englewood Cliffs borough, Bergen County, New Jersey",34003,INJ,1824,1924,100,2027,93,316,4965,106,5281,2739,municipality,2010
266,3400322470,"Fair Lawn borough, Bergen County, New Jersey",34003,INJ,11806,12006,200,1549,208,1744,29893,399,31637,27737,municipality,2000
267,3400322470,"Fair Lawn borough, Bergen County, New Jersey",34003,INJ,11930,12266,336,3130,464,3296,29161,416,32457,25151,municipality,2010
268,3400322560,"Fairview borough, Bergen County, New Jersey",34003,INJ,4861,4988,127,656,161,4911,8344,655,13255,6872,municipality,2000
269,3400322560,"Fairview borough, Bergen County, New Jersey",34003,INJ,4853,5150,297,612,286,7558,6277,434,13835,4945,municipality,2010
270,3400324420,"Fort Lee borough, Bergen County, New Jersey",34003,INJ,16544,17446,902,11121,555,2791,32670,644,35461,20350,municipality,2000
271,3400324420,"Fort Lee borough, Bergen County, New Jersey",34003,INJ,16371,17818,1447,13552,805,3877,31468,597,35345,16514,municipality,2010
272,3400324990,"Franklin Lakes borough, Bergen County, New Jersey",34003,INJ,3322,3395,73,655,96,286,10136,100,10422,9285,municipality,2000
273,3400324990,"Franklin Lakes borough, Bergen County, New Jersey",34003,INJ,3527,3692,165,777,136,525,10065,135,10590,9017,municipality,2010
274,3400325770,"Garfield city, Bergen County, New Jersey",34003,INJ,11250,11698,448,787,778,5989,23797,672,29786,21560,municipality,2000
275,3400325770,"Garfield city, Bergen County, New Jersey",34003,INJ,11073,11788,715,659,1564,9830,20657,462,30487,17972,municipality,2010
276,3400326640,"Glen Rock borough, Bergen County, New Jersey",34003,INJ,3977,4024,47,748,206,314,11232,115,11546,10163,municipality,2000
277,3400326640,"Glen Rock borough, Bergen County, New Jersey",34003,INJ,3917,4016,99,1050,151,527,11074,182,11601,9691,municipality,2010
278,3400328680,"Hackensack city, Bergen County, New Jersey",34003,INJ,18113,18945,832,3163,10092,11061,31616,1348,42677,17013,municipality,2000
279,3400328680,"Hackensack city, Bergen County, New Jersey",34003,INJ,18142,19375,1233,4372,9693,15186,27824,914,43010,12845,municipality,2010
280,3400330150,"Harrington Park borough, Bergen County, New Jersey",34003,INJ,1563,1583,20,694,29,122,4618,26,4740,3869,municipality,2000
281,3400330150,"Harrington Park borough, Bergen County, New Jersey",34003,INJ,1592,1624,32,812,31,163,4501,66,4664,3592,municipality,2010
282,3400330420,"Hasbrouck Heights borough, Bergen County, New Jersey",34003,INJ,4521,4617,96,771,188,964,10698,128,11662,9611,municipality,2000
283,3400330420,"Hasbrouck Heights borough, Bergen County, New Jersey",34003,INJ,4433,4627,194,1169,293,1760,10082,175,11842,8445,municipality,2010
284,3400330540,"Haworth borough, Bergen County, New Jersey",34003,INJ,1134,1146,12,312,41,92,3298,36,3390,2909,municipality,2000
285,3400330540,"Haworth borough, Bergen County, New Jersey",34003,INJ,1110,1136,26,397,37,148,3234,65,3382,2735,municipality,2010
286,3400331920,"Hillsdale borough, Bergen County, New Jersey",34003,INJ,3502,3547,45,511,86,429,9658,78,10087,8983,municipality,2000
287,3400331920,"Hillsdale borough, Bergen County, New Jersey",34003,INJ,3493,3567,74,638,93,794,9425,104,10219,8590,municipality,2010
288,3400332310,"Ho-Ho-Kus borough, Bergen County, New Jersey",34003,INJ,1433,1465,32,212,20,80,3980,52,4060,3696,municipality,2000
289,3400332310,"Ho-Ho-Kus borough, Bergen County, New Jersey",34003,INJ,1401,1462,61,235,9,168,3910,66,4078,3600,municipality,2010
290,3400340020,"Leonia borough, Bergen County, New Jersey",34003,INJ,3271,3343,72,2317,185,1135,7779,154,8914,5123,municipality,2000
291,3400340020,"Leonia borough, Bergen County, New Jersey",34003,INJ,3284,3428,144,3122,169,1489,7448,216,8937,3941,municipality,2010
292,3400340680,"Little Ferry borough, Bergen County, New Jersey",34003,INJ,4366,4449,83,1842,487,1641,9159,326,10800,6504,municipality,2000
293,3400340680,"Little Ferry borough, Bergen County, New Jersey",34003,INJ,4239,4439,200,2550,366,2442,8184,252,10626,5016,municipality,2010
294,3400341100,"Lodi borough, Bergen County, New Jersey",34003,INJ,9528,9908,380,2111,769,4309,19662,505,23971,16277,municipality,2000
295,3400341100,"Lodi borough, Bergen County, New Jersey",34003,INJ,9471,10127,656,2036,1589,7360,16776,559,24136,12592,municipality,2010
296,3400342090,"Lyndhurst township, Bergen County, New Jersey",34003,INJ,7877,8103,226,1042,98,1744,17639,333,19383,16166,municipality,2000
297,3400342090,"Lyndhurst township, Bergen County, New Jersey",34003,INJ,8337,8787,450,1333,325,3769,16785,418,20554,14709,municipality,2010
298,3400342750,"Mahwah township, Bergen County, New Jersey",34003,INJ,9340,9577,237,1510,510,1028,23034,459,24062,20555,municipality,2000
299,3400342750,"Mahwah township, Bergen County, New Jersey",34003,INJ,9505,9868,363,2014,616,1622,24268,550,25890,21088,municipality,2010
300,3400344880,"Maywood borough, Bergen County, New Jersey",34003,INJ,3710,3777,67,679,247,1115,8408,152,9523,7330,municipality,2000
301,3400344880,"Maywood borough, Bergen County, New Jersey",34003,INJ,3649,3769,120,1042,460,1785,7770,187,9555,6081,municipality,2010
302,3400346110,"Midland Park borough, Bergen County, New Jersey",34003,INJ,2613,2650,37,154,29,256,6691,47,6947,6461,municipality,2000
303,3400346110,"Midland Park borough, Bergen County, New Jersey",34003,INJ,2756,2861,105,192,51,474,6654,109,7128,6302,municipality,2010
304,3400347610,"Montvale borough, Bergen County, New Jersey",34003,INJ,2509,2590,81,373,30,217,6817,56,7034,6358,municipality,2000
305,3400347610,"Montvale borough, Bergen County, New Jersey",34003,INJ,2778,2872,94,861,70,419,7425,99,7844,6395,municipality,2010
306,3400347700,"Moonachie borough, Bergen County, New Jersey",34003,INJ,1041,1074,33,175,22,349,2405,65,2754,2143,municipality,2000
307,3400347700,"Moonachie borough, Bergen County, New Jersey",34003,INJ,1005,1053,48,267,23,660,2048,50,2708,1708,municipality,2010
308,3400351660,"New Milford borough, Bergen County, New Jersey",34003,INJ,6346,6437,91,2402,396,1326,15074,268,16400,12008,municipality,2000
309,3400351660,"New Milford borough, Bergen County, New Jersey",34003,INJ,6141,6362,221,3163,507,2227,14114,284,16341,10160,municipality,2010
310,3400352320,"North Arlington borough, Bergen County, New Jersey",34003,INJ,6392,6529,137,841,58,1605,13576,239,15181,12438,municipality,2000
311,3400352320,"North Arlington borough, Bergen County, New Jersey",34003,INJ,6295,6573,278,1201,148,3211,12181,265,15392,10567,municipality,2010
312,3400353430,"Northvale borough, Bergen County, New Jersey",34003,INJ,1575,1596,21,626,32,211,4249,38,4460,3553,municipality,2000
313,3400353430,"Northvale borough, Bergen County, New Jersey",34003,INJ,1564,1635,71,1110,46,378,4262,67,4640,3039,municipality,2010
314,3400353610,"Norwood borough, Bergen County, New Jersey",34003,INJ,1857,1888,31,1092,48,172,5579,83,5751,4356,municipality,2000
315,3400353610,"Norwood borough, Bergen County, New Jersey",34003,INJ,1927,2007,80,1551,64,260,5451,70,5711,3766,municipality,2010
316,3400353850,"Oakland borough, Bergen County, New Jersey",34003,INJ,4255,4345,90,335,94,483,11983,113,12466,11441,municipality,2000
317,3400353850,"Oakland borough, Bergen County, New Jersey",34003,INJ,4335,4470,135,532,104,681,12073,164,12754,11273,municipality,2010
318,3400354870,"Old Tappan borough, Bergen County, New Jersey",34003,INJ,1778,1804,26,857,30,151,5331,32,5482,4412,municipality,2000
319,3400354870,"Old Tappan borough, Bergen County, New Jersey",34003,INJ,1931,1995,64,1276,40,288,5462,74,5750,4072,municipality,2010
320,3400354990,"Oradell borough, Bergen County, New Jersey",34003,INJ,2789,2833,44,649,34,249,7798,68,8047,7047,municipality,2000
321,3400354990,"Oradell borough, Bergen County, New Jersey",34003,INJ,2749,2831,82,895,46,397,7581,103,7978,6537,municipality,2010
322,3400355770,"Palisades Park borough, Bergen County, New Jersey",34003,INJ,6247,6386,139,7010,176,2813,14260,406,17073,6668,municipality,2000
323,3400355770,"Palisades Park borough, Bergen County, New Jersey",34003,INJ,6934,7362,428,11312,283,3575,16047,239,19622,4213,municipality,2010
324,3400355950,"Paramus borough, Bergen County, New Jersey",34003,INJ,8082,8209,127,4419,278,1253,24484,354,25737,19433,municipality,2000
325,3400355950,"Paramus borough, Bergen County, New Jersey",34003,INJ,8630,8915,285,5850,335,1913,24429,618,26342,17626,municipality,2010
326,3400356130,"Park Ridge borough, Bergen County, New Jersey",34003,INJ,3161,3258,97,336,67,463,8245,64,8708,7778,municipality,2000
327,3400356130,"Park Ridge borough, Bergen County, New Jersey",34003,INJ,3283,3428,145,524,80,669,7976,84,8645,7288,municipality,2010
328,3400361680,"Ramsey borough, Bergen County, New Jersey",34003,INJ,5313,5400,87,833,110,420,13931,142,14351,12846,municipality,2000
329,3400361680,"Ramsey borough, Bergen County, New Jersey",34003,INJ,5363,5550,187,959,90,866,13607,167,14473,12391,municipality,2010
330,3400362910,"Ridgefield borough, Bergen County, New Jersey",34003,INJ,4020,4120,100,1881,71,1494,9336,195,10830,7189,municipality,2000
331,3400362910,"Ridgefield borough, Bergen County, New Jersey",34003,INJ,3905,4145,240,3199,95,2362,8670,161,11032,5215,municipality,2010
332,3400362940,"Ridgefield Park village, Bergen County, New Jersey",34003,INJ,5012,5134,122,1007,446,2863,10010,219,12873,8338,municipality,2000
333,3400362940,"Ridgefield Park village, Bergen County, New Jersey",34003,INJ,4851,5164,313,1447,581,4605,8124,214,12729,5882,municipality,2010
334,3400363000,"Ridgewood village, Bergen County, New Jersey",34003,INJ,8603,8802,199,2155,395,942,23994,280,24936,21164,municipality,2000
335,3400363000,"Ridgewood village, Bergen County, New Jersey",34003,INJ,8456,8743,287,3237,373,1316,23642,471,24958,19561,municipality,2010
336,3400363360,"River Edge borough, Bergen County, New Jersey",34003,INJ,4165,4210,45,1378,108,581,10365,121,10946,8758,municipality,2000
337,3400363360,"River Edge borough, Bergen County, New Jersey",34003,INJ,4134,4261,127,2505,156,869,10471,141,11340,7669,municipality,2010
338,3400363690,"River Vale township, Bergen County, New Jersey",34003,INJ,3275,3312,37,556,50,304,9145,69,9449,8470,municipality,2000
339,3400363690,"River Vale township, Bergen County, New Jersey",34003,INJ,3421,3521,100,809,64,481,9178,119,9659,8186,municipality,2010
340,3400363990,"Rochelle Park township, Bergen County, New Jersey",34003,INJ,2061,2111,50,327,25,474,5054,52,5528,4650,municipality,2000
341,3400363990,"Rochelle Park township, Bergen County, New Jersey",34003,INJ,2087,2170,83,481,147,904,4626,80,5530,3918,municipality,2010
342,3400364170,"Rockleigh borough, Bergen County, New Jersey",34003,INJ,74,80,6,15,13,19,372,8,391,336,municipality,2000
343,3400364170,"Rockleigh borough, Bergen County, New Jersey",34003,INJ,75,86,11,8,10,20,511,6,531,487,municipality,2010
344,3400365280,"Rutherford borough, Bergen County, New Jersey",34003,INJ,7055,7214,159,2054,475,1555,16555,330,18110,13696,municipality,2000
345,3400365280,"Rutherford borough, Bergen County, New Jersey",34003,INJ,6949,7278,329,2340,454,2543,15518,426,18061,12298,municipality,2010
346,3400365340,"Saddle Brook township, Bergen County, New Jersey",34003,INJ,5062,5161,99,611,162,825,12330,157,13155,11400,municipality,2000
347,3400365340,"Saddle Brook township, Bergen County, New Jersey",34003,INJ,5286,5485,199,1102,268,1666,11993,205,13659,10418,municipality,2010
348,3400365400,"Saddle River borough, Bergen County, New Jersey",34003,INJ,1118,1183,65,229,24,82,3119,55,3201,2811,municipality,2000
349,3400365400,"Saddle River borough, Bergen County, New Jersey",34003,INJ,1216,1341,125,291,60,162,2990,69,3152,2570,municipality,2010
350,3400368970,"South Hackensack township, Bergen County, New Jersey",34003,INJ,811,830,19,129,47,339,1910,36,2249,1698,municipality,2000
351,3400368970,"South Hackensack township, Bergen County, New Jersey",34003,INJ,845,879,34,121,98,792,1586,41,2378,1326,municipality,2010
352,3400372360,"Teaneck township, Bergen County, New Jersey",34003,INJ,13418,13719,301,2791,10905,4103,35157,1224,39260,20237,municipality,2000
353,3400372360,"Teaneck township, Bergen County, New Jersey",34003,INJ,13470,14024,554,3574,10266,6575,33201,1015,39776,18346,municipality,2010
354,3400372420,"Tenafly borough, Bergen County, New Jersey",34003,INJ,4774,4897,123,2629,122,642,13164,237,13806,10176,municipality,2000
355,3400372420,"Tenafly borough, Bergen County, New Jersey",34003,INJ,4766,4980,214,3794,123,776,13712,320,14488,9475,municipality,2010
356,3400372480,"Teterboro borough, Bergen County, New Jersey",34003,INJ,7,8,1,0,0,0,18,3,18,15,municipality,2000
357,3400372480,"Teterboro borough, Bergen County, New Jersey",34003,INJ,25,27,2,2,2,24,43,8,67,31,municipality,2010
358,3400375140,"Upper Saddle River borough, Bergen County, New Jersey",34003,INJ,2497,2560,63,484,72,169,7572,80,7741,6936,municipality,2000
359,3400375140,"Upper Saddle River borough, Bergen County, New Jersey",34003,INJ,2639,2776,137,822,108,355,7853,114,8208,6809,municipality,2010
360,3400376400,"Waldwick borough, Bergen County, New Jersey",34003,INJ,3428,3495,67,434,57,511,9111,75,9622,8545,municipality,2000
361,3400376400,"Waldwick borough, Bergen County, New Jersey",34003,INJ,3420,3537,117,478,74,830,8795,121,9625,8122,municipality,2010
362,3400376490,"Wallington borough, Bergen County, New Jersey",34003,INJ,4752,4906,154,574,284,776,10807,216,11583,9733,municipality,2000
363,3400376490,"Wallington borough, Bergen County, New Jersey",34003,INJ,4637,4946,309,610,303,1225,10110,149,11335,9048,municipality,2010
364,3400377135,"Washington township, Bergen County, New Jersey",34003,INJ,3219,3245,26,496,78,299,8639,84,8938,7981,municipality,2000
365,3400377135,"Washington township, Bergen County, New Jersey",34003,INJ,3261,3341,80,581,93,495,8607,94,9102,7839,municipality,2010
366,3400380270,"Westwood borough, Bergen County, New Jersey",34003,INJ,4485,4610,125,482,624,660,10339,122,10999,9111,municipality,2000
367,3400380270,"Westwood borough, Bergen County, New Jersey",34003,INJ,4438,4636,198,802,466,1263,9645,132,10908,8245,municipality,2010
368,3400382300,"Woodcliff Lake borough, Bergen County, New Jersey",34003,INJ,1824,1842,18,257,49,134,5611,31,5745,5274,municipality,2000
369,3400382300,"Woodcliff Lake borough, Bergen County, New Jersey",34003,INJ,1916,1980,64,371,47,310,5420,56,5730,4946,municipality,2010
370,3400382570,"Wood-Ridge borough, Bergen County, New Jersey",34003,INJ,3024,3087,63,382,61,556,7088,83,7644,6562,municipality,2000
371,3400382570,"Wood-Ridge borough, Bergen County, New Jersey",34003,INJ,2939,3051,112,538,95,1000,6626,95,7626,5898,municipality,2010
372,3400383050,"Wyckoff township, Bergen County, New Jersey",34003,INJ,5541,5638,97,611,73,376,16132,136,16508,15312,municipality,2000
373,3400383050,"Wyckoff township, Bergen County, New Jersey",34003,INJ,5646,5827,181,705,81,737,15959,168,16696,15005,municipality,2010
374,3401304695,"Belleville township, Essex County, New Jersey",34013,INJ,13731,14144,413,4024,1708,8507,27421,1020,35928,20669,municipality,2000
375,3401304695,"Belleville township, Essex County, New Jersey",34013,INJ,13395,14327,932,4251,2794,14133,21793,880,35926,13868,municipality,2010
376,3401306260,"Bloomfield township, Essex County, New Jersey",34013,INJ,19017,19508,491,3980,5332,6901,40782,1434,47683,30036,municipality,2000
377,3401306260,"Bloomfield township, Essex County, New Jersey",34013,INJ,18387,19470,1083,3846,8092,11606,35709,1480,47315,22291,municipality,2010
378,3401309250,"Caldwell borough, Essex County, New Jersey",34013,INJ,3311,3396,85,308,165,352,7232,73,7584,6686,municipality,2000
379,3401309250,"Caldwell borough, Essex County, New Jersey",34013,INJ,3359,3510,151,366,233,786,7036,131,7822,6306,municipality,2010
380,3401311200,"Cedar Grove township, Essex County, New Jersey",34013,INJ,4403,4470,67,666,364,393,11907,100,12300,10777,municipality,2000
381,3401311200,"Cedar Grove township, Essex County, New Jersey",34013,INJ,4523,4661,138,800,294,727,11684,115,12411,10475,municipality,2010
382,3401313045,"City of Orange township, Essex County, New Jersey",34013,INJ,11885,12665,780,414,24318,4097,28771,1537,32868,2502,municipality,2000
383,3401313045,"City of Orange township, Essex County, New Jersey",34013,INJ,11202,12222,1020,448,21067,6531,23603,731,30134,1357,municipality,2010
384,3401319390,"East Orange city, Essex County, New Jersey",34013,INJ,26024,28485,2461,294,61604,3284,66540,2768,69824,1874,municipality,2000
385,3401319390,"East Orange city, Essex County, New Jersey",34013,INJ,24945,28803,3858,436,55702,5095,59175,1615,64270,1422,municipality,2010
386,3401321840,"Essex Fells borough, Essex County, New Jersey",34013,INJ,737,761,24,22,10,26,2136,30,2162,2074,municipality,2000
387,3401321840,"Essex Fells borough, Essex County, New Jersey",34013,INJ,728,758,30,43,20,42,2071,32,2113,1976,municipality,2010
388,3401322385,"Fairfield township, Essex County, New Jersey",34013,INJ,2296,2326,30,199,36,244,6819,40,7063,6544,municipality,2000
389,3401322385,"Fairfield township, Essex County, New Jersey",34013,INJ,2645,2723,78,183,46,384,7082,53,7466,6800,municipality,2010
390,3401326610,"Glen Ridge borough, Essex County, New Jersey",34013,INJ,2458,2490,32,241,342,251,7020,102,7271,6335,municipality,2000
391,3401326610,"Glen Ridge borough, Essex County, New Jersey",34013,INJ,2476,2541,65,348,356,377,7150,193,7527,6253,municipality,2010
392,3401334450,"Irvington township, Essex County, New Jersey",34013,INJ,22032,24116,2084,661,48852,5086,55609,2631,60695,3465,municipality,2000
393,3401334450,"Irvington township, Essex County, New Jersey",34013,INJ,20093,23196,3103,462,45285,5716,48210,1034,53926,1429,municipality,2010
394,3401340890,"Livingston township, Essex County, New Jersey",34013,INJ,9300,9457,157,3964,325,695,26696,257,27391,22150,municipality,2000
395,3401340890,"Livingston township, Essex County, New Jersey",34013,INJ,9990,10284,294,5609,632,1192,28174,398,29366,21535,municipality,2010
396,3401343800,"Maplewood township, Essex County, New Jersey",34013,INJ,8452,8615,163,660,7644,1248,22620,934,23868,13382,municipality,2000
397,3401343800,"Maplewood township, Essex County, New Jersey",34013,INJ,8240,8608,368,722,8189,1595,22272,776,23867,12585,municipality,2010
398,3401346380,"Millburn township, Essex County, New Jersey",34013,INJ,7015,7158,143,1658,212,404,19361,229,19765,17262,municipality,2000
399,3401346380,"Millburn township, Essex County, New Jersey",34013,INJ,6813,7106,293,3149,303,703,19446,407,20149,15587,municipality,2010
400,3401347500,"Montclair township, Essex County, New Jersey",34013,INJ,15020,15531,511,1214,12194,1995,36982,1306,38977,22268,municipality,2000
401,3401347500,"Montclair township, Essex County, New Jersey",34013,INJ,15089,15911,822,1416,9902,2810,34859,1621,37669,21920,municipality,2010
402,3401351000,"Newark city, Essex County, New Jersey",34013,INJ,91382,100141,8759,3138,142083,80622,192924,8753,273546,38950,municipality,2000
403,3401351000,"Newark city, Essex County, New Jersey",34013,INJ,94542,109520,14978,4318,138074,93746,183394,8880,277140,32122,municipality,2010
404,3401352620,"North Caldwell borough, Essex County, New Jersey",34013,INJ,2070,2108,38,347,1053,159,7216,62,7375,5754,municipality,2000
405,3401352620,"North Caldwell borough, Essex County, New Jersey",34013,INJ,2092,2134,42,350,41,260,5923,59,6183,5473,municipality,2010
406,3401353680,"Nutley township, Essex County, New Jersey",34013,INJ,10884,11118,234,1934,484,1830,25532,319,27362,22795,municipality,2000
407,3401353680,"Nutley township, Essex County, New Jersey",34013,INJ,11314,11789,475,2789,541,3354,25016,490,28370,21196,municipality,2010
408,3401364590,"Roseland borough, Essex County, New Jersey",34013,INJ,2142,2187,45,250,38,121,5177,42,5298,4847,municipality,2000
409,3401364590,"Roseland borough, Essex County, New Jersey",34013,INJ,2345,2432,87,333,101,262,5557,55,5819,5068,municipality,2010
410,3401369274,"South Orange Village township, Essex County, New Jersey",34013,INJ,5522,5671,149,659,5150,837,16127,447,16964,9871,municipality,2000
411,3401369274,"South Orange Village township, Essex County, New Jersey",34013,INJ,5516,5815,299,829,4484,993,15205,661,16198,9231,municipality,2010
412,3401375815,"Verona township, Essex County, New Jersey",34013,INJ,5585,5719,134,457,197,467,13066,152,13533,12260,municipality,2000
413,3401375815,"Verona township, Essex County, New Jersey",34013,INJ,5315,5523,208,535,239,795,12537,194,13332,11569,municipality,2010
414,3401378510,"West Caldwell township, Essex County, New Jersey",34013,INJ,3990,4044,54,432,100,314,10919,87,11233,10300,municipality,2000
415,3401378510,"West Caldwell township, Essex County, New Jersey",34013,INJ,3913,4009,96,418,122,523,10236,122,10759,9574,municipality,2010
416,3401379800,"West Orange township, Essex County, New Jersey",34013,INJ,16480,16901,421,3619,7672,4514,40429,1231,44943,27907,municipality,2000
417,3401379800,"West Orange township, Essex County, New Jersey",34013,INJ,16790,17612,822,3641,11841,7487,38720,1098,46207,22140,municipality,2010
418,3401703580,"Bayonne city, Hudson County, New Jersey",34017,INJ,25545,26826,1281,2529,3098,11015,50827,1983,61842,43217,municipality,2000
419,3401703580,"Bayonne city, Hudson County, New Jersey",34017,INJ,25237,27799,2562,4803,4730,16251,46773,1419,63024,35821,municipality,2010
420,3401719360,"East Newark borough, Hudson County, New Jersey",34017,INJ,767,799,32,59,22,1130,1247,108,2377,1058,municipality,2000
421,3401719360,"East Newark borough, Hudson County, New Jersey",34017,INJ,759,794,35,188,17,1477,929,56,2406,668,municipality,2010
422,3401728650,"Guttenberg town, Hudson County, New Jersey",34017,INJ,4493,4650,157,779,307,5871,4936,365,10807,3485,municipality,2000
423,3401728650,"Guttenberg town, Hudson County, New Jersey",34017,INJ,4473,4839,366,803,330,7245,3931,176,11176,2622,municipality,2010
424,3401730210,"Harrison town, Hudson County, New Jersey",34017,INJ,5136,5254,118,1700,87,5333,9091,548,14424,6756,municipality,2000
425,3401730210,"Harrison town, Hudson County, New Jersey",34017,INJ,4869,5228,359,2198,173,6017,7603,414,13620,4818,municipality,2010
426,3401732250,"Hoboken city, Hudson County, New Jersey",34017,INJ,19418,19915,497,1648,1299,7783,30794,651,38577,27196,municipality,2000
427,3401732250,"Hoboken city, Hudson County, New Jersey",34017,INJ,25041,26855,1814,3516,1289,7602,42403,991,50005,36607,municipality,2010
428,3401736000,"Jersey City city, Hudson County, New Jersey",34017,INJ,88632,93648,5016,38623,64389,67952,172103,12355,240055,56736,municipality,2000
429,3401736000,"Jersey City city, Hudson County, New Jersey",34017,INJ,96859,108720,11861,58106,59060,68256,179341,8939,247597,53236,municipality,2010
430,3401736510,"Kearny town, Hudson County, New Jersey",34017,INJ,13539,13872,333,2206,1442,11075,29438,1365,40513,24425,municipality,2000
431,3401736510,"Kearny town, Hudson County, New Jersey",34017,INJ,13462,14180,718,1746,1721,16253,24431,1148,40684,19816,municipality,2010
432,3401752470,"North Bergen township, Hudson County, New Jersey",34017,INJ,21236,22009,773,3711,900,33260,24832,1794,58092,18427,municipality,2000
433,3401752470,"North Bergen township, Hudson County, New Jersey",34017,INJ,22062,23912,1850,3835,1065,41569,19204,934,60773,13370,municipality,2010
434,3401766570,"Secaucus town, Hudson County, New Jersey",34017,INJ,6214,6385,171,1874,651,1953,13978,281,15931,11172,municipality,2000
435,3401766570,"Secaucus town, Hudson County, New Jersey",34017,INJ,6297,6846,549,3269,575,3025,13239,304,16264,9091,municipality,2010
436,3401774630,"Union City city, Hudson County, New Jersey",34017,INJ,22872,23741,869,1333,875,55226,11862,764,67088,8890,municipality,2000
437,3401774630,"Union City city, Hudson County, New Jersey",34017,INJ,22814,24931,2117,1447,1070,56291,10164,607,66455,7040,municipality,2010
438,3401777930,"Weehawken township, Hudson County, New Jersey",34017,INJ,5975,6159,184,616,312,5487,8014,320,13501,6766,municipality,2000
439,3401777930,"Weehawken township, Hudson County, New Jersey",34017,INJ,5712,6213,501,1010,412,5055,7499,227,12554,5850,municipality,2010
440,3401779610,"West New York town, Hudson County, New Jersey",34017,INJ,16719,17360,641,1292,658,36038,9730,692,45768,7088,municipality,2000
441,3401779610,"West New York town, Hudson County, New Jersey",34017,INJ,18852,20018,1166,2904,873,38812,10896,548,49708,6571,municipality,2010
442,3401900550,"Alexandria township, Hunterdon County, New Jersey",34019,ONJ,1535,1598,63,34,36,81,4617,38,4698,4509,municipality,2000
443,3401900550,"Alexandria township, Hunterdon County, New Jersey",34019,ONJ,1758,1865,107,90,98,159,4779,41,4938,4550,municipality,2010
444,3401905650,"Bethlehem township, Hunterdon County, New Jersey",34019,ONJ,1266,1303,37,39,31,62,3758,18,3820,3670,municipality,2000
445,3401905650,"Bethlehem township, Hunterdon County, New Jersey",34019,ONJ,1344,1386,42,75,39,160,3819,35,3979,3670,municipality,2010
446,3401906370,"Bloomsbury borough, Hunterdon County, New Jersey",34019,ONJ,322,342,20,3,3,13,873,6,886,861,municipality,2000
447,3401906370,"Bloomsbury borough, Hunterdon County, New Jersey",34019,ONJ,337,358,21,16,9,35,835,11,870,799,municipality,2010
448,3401909280,"Califon borough, Hunterdon County, New Jersey",34019,ONJ,401,410,9,8,0,5,1050,6,1055,1036,municipality,2000
449,3401909280,"Califon borough, Hunterdon County, New Jersey",34019,ONJ,394,419,25,9,3,14,1062,27,1076,1023,municipality,2010
450,3401913720,"Clinton town, Hunterdon County, New Jersey",34019,ONJ,1068,1095,27,98,35,108,2524,36,2632,2355,municipality,2000
451,3401913720,"Clinton town, Hunterdon County, New Jersey",34019,ONJ,1057,1098,41,181,36,169,2550,34,2719,2299,municipality,2010
452,3401913750,"Clinton township, Hunterdon County, New Jersey",34019,ONJ,4129,4234,105,303,858,507,12450,149,12957,11140,municipality,2000
453,3401913750,"Clinton township, Hunterdon County, New Jersey",34019,ONJ,4568,4737,169,523,734,755,12723,227,13478,11239,municipality,2010
454,3401917170,"Delaware township, Hunterdon County, New Jersey",34019,ONJ,1643,1701,58,46,18,51,4427,21,4478,4342,municipality,2000
455,3401917170,"Delaware township, Hunterdon County, New Jersey",34019,ONJ,1788,1927,139,41,26,112,4451,60,4563,4324,municipality,2010
456,3401918820,"East Amwell township, Hunterdon County, New Jersey",34019,ONJ,1581,1624,43,41,32,68,4387,36,4455,4278,municipality,2000
457,3401918820,"East Amwell township, Hunterdon County, New Jersey",34019,ONJ,1518,1580,62,57,50,113,3900,33,4013,3760,municipality,2010
458,3401923700,"Flemington borough, Hunterdon County, New Jersey",34019,ONJ,1804,1876,72,131,127,461,3739,73,4200,3408,municipality,2000
459,3401923700,"Flemington borough, Hunterdon County, New Jersey",34019,ONJ,1815,1926,111,257,159,1198,3383,104,4581,2863,municipality,2010
460,3401924870,"Franklin township, Hunterdon County, New Jersey",34019,ONJ,1091,1125,34,23,12,67,2923,21,2990,2867,municipality,2000
461,3401924870,"Franklin township, Hunterdon County, New Jersey",34019,ONJ,1137,1204,67,37,18,110,3085,22,3195,3008,municipality,2010
462,3401925350,"Frenchtown borough, Hunterdon County, New Jersey",34019,ONJ,613,630,17,18,6,39,1449,12,1488,1413,municipality,2000
463,3401925350,"Frenchtown borough, Hunterdon County, New Jersey",34019,ONJ,596,656,60,13,10,70,1303,12,1373,1268,municipality,2010
464,3401926550,"Glen Gardner borough, Hunterdon County, New Jersey",34019,ONJ,805,829,24,28,17,65,1837,23,1902,1769,municipality,2000
465,3401926550,"Glen Gardner borough, Hunterdon County, New Jersey",34019,ONJ,768,825,57,31,28,90,1614,21,1704,1534,municipality,2010
466,3401929460,"Hampton borough, Hunterdon County, New Jersey",34019,ONJ,559,574,15,15,73,44,1502,29,1546,1385,municipality,2000
467,3401929460,"Hampton borough, Hunterdon County, New Jersey",34019,ONJ,570,612,42,26,32,75,1326,21,1401,1247,municipality,2010
468,3401931320,"High Bridge borough, Hunterdon County, New Jersey",34019,ONJ,1428,1478,50,54,29,80,3696,34,3776,3579,municipality,2000
469,3401931320,"High Bridge borough, Hunterdon County, New Jersey",34019,ONJ,1418,1481,63,114,47,219,3429,41,3648,3227,municipality,2010
470,3401932460,"Holland township, Hunterdon County, New Jersey",34019,ONJ,1881,1942,61,22,22,87,5037,35,5124,4958,municipality,2000
471,3401932460,"Holland township, Hunterdon County, New Jersey",34019,ONJ,1972,2066,94,41,29,142,5149,33,5291,5046,municipality,2010
472,3401937065,"Kingwood township, Hunterdon County, New Jersey",34019,ONJ,1340,1422,82,29,23,70,3712,25,3782,3635,municipality,2000
473,3401937065,"Kingwood township, Hunterdon County, New Jersey",34019,ONJ,1446,1569,123,41,23,92,3753,48,3845,3641,municipality,2010
474,3401938610,"Lambertville city, Hunterdon County, New Jersey",34019,ONJ,1860,1961,101,32,74,120,3748,47,3868,3595,municipality,2000
475,3401938610,"Lambertville city, Hunterdon County, New Jersey",34019,ONJ,1958,2075,117,51,70,381,3525,35,3906,3369,municipality,2010
476,3401939630,"Lebanon borough, Hunterdon County, New Jersey",34019,ONJ,458,477,19,33,7,22,1043,5,1065,998,municipality,2000
477,3401939630,"Lebanon borough, Hunterdon County, New Jersey",34019,ONJ,602,664,62,71,22,68,1290,26,1358,1171,municipality,2010
478,3401939660,"Lebanon township, Hunterdon County, New Jersey",34019,ONJ,1963,2020,57,53,45,100,5716,43,5816,5575,municipality,2000
479,3401939660,"Lebanon township, Hunterdon County, New Jersey",34019,ONJ,2296,2439,143,97,107,205,6383,83,6588,6096,municipality,2010
480,3401946260,"Milford borough, Hunterdon County, New Jersey",34019,ONJ,469,484,15,5,2,24,1171,7,1195,1157,municipality,2000
481,3401946260,"Milford borough, Hunterdon County, New Jersey",34019,ONJ,520,552,32,12,3,27,1206,14,1233,1177,municipality,2010
482,3401961920,"Raritan township, Hunterdon County, New Jersey",34019,ONJ,6939,7094,155,692,237,552,19257,243,19809,18085,municipality,2000
483,3401961920,"Raritan township, Hunterdon County, New Jersey",34019,ONJ,8056,8288,232,1315,438,1138,21047,301,22185,18993,municipality,2010
484,3401962250,"Readington township, Hunterdon County, New Jersey",34019,ONJ,5676,5794,118,405,118,324,15479,149,15803,14807,municipality,2000
485,3401962250,"Readington township, Hunterdon County, New Jersey",34019,ONJ,5971,6191,220,578,205,633,15493,180,16126,14530,municipality,2010
486,3401970980,"Stockton borough, Hunterdon County, New Jersey",34019,ONJ,246,258,12,5,0,3,557,1,560,551,municipality,2000
487,3401970980,"Stockton borough, Hunterdon County, New Jersey",34019,ONJ,237,259,22,5,0,3,535,3,538,527,municipality,2010
488,3401972510,"Tewksbury township, Hunterdon County, New Jersey",34019,ONJ,1986,2052,66,102,27,85,5456,32,5541,5295,municipality,2000
489,3401972510,"Tewksbury township, Hunterdon County, New Jersey",34019,ONJ,2189,2323,134,175,48,209,5784,78,5993,5483,municipality,2010
490,3401974420,"Union township, Hunterdon County, New Jersey",34019,ONJ,1666,1725,59,97,791,316,5844,73,6160,4883,municipality,2000
491,3401974420,"Union township, Hunterdon County, New Jersey",34019,ONJ,1752,1830,78,244,502,359,5549,97,5908,4706,municipality,2010
492,3401978230,"West Amwell township, Hunterdon County, New Jersey",34019,ONJ,949,984,35,16,15,17,2366,13,2383,2322,municipality,2000
493,3401978230,"West Amwell township, Hunterdon County, New Jersey",34019,ONJ,1102,1157,55,55,497,186,3654,45,3840,3057,municipality,2010
494,3402119780,"East Windsor township, Mercer County, New Jersey",34021,ONJ,9448,9880,432,2365,2122,3559,21360,440,24919,16433,municipality,2000
495,3402119780,"East Windsor township, Mercer County, New Jersey",34021,ONJ,10224,10851,627,4786,2220,5340,21850,543,27190,14301,municipality,2010
496,3402122185,"Ewing township, Mercer County, New Jersey",34021,ONJ,12551,12924,373,805,8707,1586,34121,641,35707,23968,municipality,2000
497,3402122185,"Ewing township, Mercer County, New Jersey",34021,ONJ,13171,13926,755,1520,9586,2727,33063,769,35790,21188,municipality,2010
498,3402129310,"Hamilton township, Mercer County, New Jersey",34021,ONJ,33523,34535,1012,2226,6907,4471,82638,1387,87109,72118,municipality,2000
499,3402129310,"Hamilton township, Mercer County, New Jersey",34021,ONJ,34534,36170,1636,2890,10042,9613,78851,1389,88464,64530,municipality,2010
500,3402131620,"Hightstown borough, Mercer County, New Jersey",34021,ONJ,2001,2081,80,119,423,1046,4170,111,5216,3517,municipality,2000
501,3402131620,"Hightstown borough, Mercer County, New Jersey",34021,ONJ,1976,2108,132,218,413,1664,3830,111,5494,3088,municipality,2010
502,3402133150,"Hopewell borough, Mercer County, New Jersey",34021,ONJ,813,836,23,20,22,47,1988,26,2035,1920,municipality,2000
503,3402133150,"Hopewell borough, Mercer County, New Jersey",34021,ONJ,778,817,39,13,29,71,1851,23,1922,1786,municipality,2010
504,3402133180,"Hopewell township, Mercer County, New Jersey",34021,ONJ,5498,5629,131,639,905,395,15710,188,16105,13978,municipality,2000
505,3402133180,"Hopewell township, Mercer County, New Jersey",34021,ONJ,6282,6551,269,1532,354,573,16731,294,17304,14551,municipality,2010
506,3402139510,"Lawrence township, Mercer County, New Jersey",34021,ONJ,10797,11180,383,2297,2669,1344,27815,524,29159,22325,municipality,2000
507,3402139510,"Lawrence township, Mercer County, New Jersey",34021,ONJ,12524,13239,715,4711,3493,2503,30969,762,33472,22003,municipality,2010
508,3402157600,"Pennington borough, Mercer County, New Jersey",34021,ONJ,1013,1040,27,27,71,32,2664,20,2696,2546,municipality,2000
509,3402157600,"Pennington borough, Mercer County, New Jersey",34021,ONJ,1031,1083,52,46,45,37,2548,25,2585,2432,municipality,2010
510,3402160900,"Princeton borough, Mercer County, New Jersey",34021,ONJ,9370,9719,349,2654,1719,1856,28374,765,30230,23236,municipality,2000
511,3402160900,"Princeton borough, Mercer County, New Jersey",34021,ONJ,9521,10302,781,3955,1547,2392,26180,884,28572,19794,municipality,2010
512,3402163850,"Robbinsville township, Mercer County, New Jersey",34021,ONJ,4074,4163,89,440,293,279,9996,126,10275,9137,municipality,2000
513,3402163850,"Robbinsville township, Mercer County, New Jersey",34021,ONJ,5087,5277,190,1728,407,564,13078,235,13642,10708,municipality,2010
514,3402174000,"Trenton city, Mercer County, New Jersey",34021,ONJ,29437,33843,4406,684,43497,18391,67012,1809,85403,21022,municipality,2000
515,3402174000,"Trenton city, Mercer County, New Jersey",34021,ONJ,28578,33035,4457,923,42286,28621,56292,1641,84913,11442,municipality,2010
516,3402180240,"West Windsor township, Mercer County, New Jersey",34021,ONJ,7282,7450,168,4974,587,892,21015,370,21907,15084,municipality,2000
517,3402180240,"West Windsor township, Mercer County, New Jersey",34021,ONJ,9449,9810,361,10223,956,1213,25952,687,27165,14086,municipality,2010
518,3402310750,"Carteret borough, Middlesex County, New Jersey",34023,INJ,7039,7320,281,1705,1856,4839,15870,454,20709,11855,municipality,2000
519,3402310750,"Carteret borough, Middlesex County, New Jersey",34023,INJ,7591,8148,557,4308,3056,7066,15778,602,22844,7812,municipality,2010
520,3402315550,"Cranbury township, Middlesex County, New Jersey",34023,INJ,1091,1121,30,239,72,55,3172,40,3227,2821,municipality,2000
521,3402315550,"Cranbury township, Middlesex County, New Jersey",34023,INJ,1320,1371,51,530,130,99,3758,67,3857,3031,municipality,2010
522,3402318490,"Dunellen borough, Middlesex County, New Jersey",34023,INJ,2451,2520,69,242,241,1010,5813,103,6823,5227,municipality,2000
523,3402318490,"Dunellen borough, Middlesex County, New Jersey",34023,INJ,2566,2683,117,323,549,1933,5294,131,7227,4291,municipality,2010
524,3402319000,"East Brunswick township, Middlesex County, New Jersey",34023,INJ,16372,16640,268,7584,1282,1957,44799,929,46756,35004,municipality,2000
525,3402319000,"East Brunswick township, Middlesex County, New Jersey",34023,INJ,16810,17367,557,10812,1741,3184,44328,888,47512,30887,municipality,2010
526,3402320230,"Edison township, Middlesex County, New Jersey",34023,INJ,35136,36018,882,28541,6458,6226,91461,2001,97687,54461,municipality,2000
527,3402320230,"Edison township, Middlesex County, New Jersey",34023,INJ,34972,36302,1330,43092,6631,8112,91855,2555,99967,39577,municipality,2010
528,3402330840,"Helmetta borough, Middlesex County, New Jersey",34023,INJ,746,769,23,44,40,97,1728,13,1825,1631,municipality,2000
529,3402330840,"Helmetta borough, Middlesex County, New Jersey",34023,INJ,891,920,29,102,72,164,2014,30,2178,1810,municipality,2010
530,3402331470,"Highland Park borough, Middlesex County, New Jersey",34023,INJ,5899,6071,172,1903,1067,1145,12854,367,13999,9517,municipality,2000
531,3402331470,"Highland Park borough, Middlesex County, New Jersey",34023,INJ,5875,6203,328,2494,1018,1252,12730,332,13982,8886,municipality,2010
532,3402334890,"Jamesburg borough, Middlesex County, New Jersey",34023,INJ,2176,2240,64,133,515,606,5419,107,6025,4664,municipality,2000
533,3402334890,"Jamesburg borough, Middlesex County, New Jersey",34023,INJ,2172,2267,95,264,488,1324,4591,122,5915,3717,municipality,2010
534,3402345690,"Metuchen borough, Middlesex County, New Jersey",34023,INJ,4992,5104,112,922,668,508,12332,259,12840,10483,municipality,2000
535,3402345690,"Metuchen borough, Middlesex County, New Jersey",34023,INJ,5243,5440,197,1744,617,935,12639,326,13574,9952,municipality,2010
536,3402345900,"Middlesex borough, Middlesex County, New Jersey",34023,INJ,5048,5130,82,562,440,1235,12482,181,13717,11299,municipality,2000
537,3402345900,"Middlesex borough, Middlesex County, New Jersey",34023,INJ,4984,5148,164,804,645,2246,11389,192,13635,9748,municipality,2010
538,3402346620,"Milltown borough, Middlesex County, New Jersey",34023,INJ,2627,2670,43,215,45,261,6739,72,7000,6407,municipality,2000
539,3402346620,"Milltown borough, Middlesex County, New Jersey",34023,INJ,2599,2698,99,227,77,445,6448,70,6893,6074,municipality,2010
540,3402347280,"Monroe township, Middlesex County, New Jersey",34023,INJ,12536,13259,723,648,792,666,27333,200,27999,25693,municipality,2000
541,3402347280,"Monroe township, Middlesex County, New Jersey",34023,INJ,16497,18002,1505,4911,1486,1673,37459,486,39132,30576,municipality,2010
542,3402351210,"New Brunswick city, Middlesex County, New Jersey",34023,INJ,13057,13893,836,2544,10043,18947,29626,1075,48573,15964,municipality,2000
543,3402351210,"New Brunswick city, Middlesex County, New Jersey",34023,INJ,14119,15053,934,4122,7743,27553,27628,1002,55181,14761,municipality,2010
544,3402352560,"North Brunswick township, Middlesex County, New Jersey",34023,INJ,13635,13932,297,5142,5370,3775,32512,944,36287,21056,municipality,2000
545,3402352560,"North Brunswick township, Middlesex County, New Jersey",34023,INJ,14551,15045,494,9865,6625,7223,33519,1083,40742,15946,municipality,2010
546,3402354705,"Old Bridge township, Middlesex County, New Jersey",34023,INJ,21438,21896,458,6520,3052,4578,55878,1278,60456,45028,municipality,2000
547,3402354705,"Old Bridge township, Middlesex County, New Jersey",34023,INJ,23777,24638,861,9319,3770,7064,58311,1440,65375,43782,municipality,2010
548,3402358200,"Perth Amboy city, Middlesex County, New Jersey",34023,INJ,14562,15236,674,669,3790,33033,14270,892,47303,8919,municipality,2000
549,3402358200,"Perth Amboy city, Middlesex County, New Jersey",34023,INJ,15419,16556,1137,806,3742,39685,11129,477,50814,6104,municipality,2010
550,3402359010,"Piscataway township, Middlesex County, New Jersey",34023,INJ,16500,16946,446,12472,9985,4002,46480,1341,50482,22682,municipality,2000
551,3402359010,"Piscataway township, Middlesex County, New Jersey",34023,INJ,17050,17777,727,18654,11053,6289,49755,1777,56044,18271,municipality,2010
552,3402359280,"Plainsboro township, Middlesex County, New Jersey",34023,INJ,8742,9133,391,6143,1490,937,19278,433,20215,11212,municipality,2000
553,3402359280,"Plainsboro township, Middlesex County, New Jersey",34023,INJ,9402,10089,687,10608,1749,1429,21570,598,22999,8615,municipality,2010
554,3402365790,"Sayreville borough, Middlesex County, New Jersey",34023,INJ,14955,15235,280,4247,3334,2942,37435,786,40377,29068,municipality,2000
555,3402365790,"Sayreville borough, Middlesex County, New Jersey",34023,INJ,15636,16393,757,6841,4287,5258,37446,968,42704,25350,municipality,2010
556,3402368550,"South Amboy city, Middlesex County, New Jersey",34023,INJ,2967,3110,143,108,57,534,7379,93,7913,7121,municipality,2000
557,3402368550,"South Amboy city, Middlesex County, New Jersey",34023,INJ,3372,3576,204,345,347,1158,7473,143,8631,6638,municipality,2010
558,3402368790,"South Brunswick township, Middlesex County, New Jersey",34023,INJ,13428,13862,434,6799,2886,1918,35816,739,37734,25392,municipality,2000
559,3402368790,"South Brunswick township, Middlesex County, New Jersey",34023,INJ,15069,15708,639,15571,3172,2624,40793,1072,43417,20978,municipality,2010
560,3402369390,"South Plainfield borough, Middlesex County, New Jersey",34023,INJ,7151,7307,156,1632,1798,1888,19922,590,21810,15902,municipality,2000
561,3402369390,"South Plainfield borough, Middlesex County, New Jersey",34023,INJ,7876,8093,217,3422,2266,3097,20288,750,23385,13850,municipality,2010
562,3402369420,"South River borough, Middlesex County, New Jersey",34023,INJ,5606,5769,163,537,892,1480,13842,418,15322,11995,municipality,2000
563,3402369420,"South River borough, Middlesex County, New Jersey",34023,INJ,5652,5957,305,758,1028,2913,13095,572,16008,10737,municipality,2010
564,3402369810,"Spotswood borough, Middlesex County, New Jersey",34023,INJ,3099,3158,59,230,108,345,7535,60,7880,7137,municipality,2000
565,3402369810,"Spotswood borough, Middlesex County, New Jersey",34023,INJ,3128,3242,114,419,227,687,7570,124,8257,6800,municipality,2010
566,3402382000,"Woodbridge township, Middlesex County, New Jersey",34023,INJ,34562,35298,736,14007,8154,8956,88247,2087,97203,63999,municipality,2000
567,3402382000,"Woodbridge township, Middlesex County, New Jersey",34023,INJ,34615,36124,1509,22193,9038,15562,84023,2261,99585,50531,municipality,2010
568,3402500000,"County subdivisions not defined, Monmouth County, New Jersey",34025,ONJ,0,0,0,0,0,0,0,0,0,0,municipality,2000
569,3402500000,"County subdivisions not defined, Monmouth County, New Jersey",34025,ONJ,0,0,0,0,0,0,0,0,0,0,municipality,2010
570,3402500070,"Aberdeen township, Monmouth County, New Jersey",34025,ONJ,6421,6558,137,953,2040,1225,16229,293,17454,12943,municipality,2000
571,3402500070,"Aberdeen township, Monmouth County, New Jersey",34025,ONJ,6876,7102,226,1162,2041,1900,16310,350,18210,12757,municipality,2010
572,3402500730,"Allenhurst borough, Monmouth County, New Jersey",34025,ONJ,285,370,85,3,6,18,700,6,718,685,municipality,2000
573,3402500730,"Allenhurst borough, Monmouth County, New Jersey",34025,ONJ,217,365,148,5,5,22,474,3,496,461,municipality,2010
574,3402500760,"Allentown borough, Monmouth County, New Jersey",34025,ONJ,708,718,10,12,120,36,1846,33,1882,1681,municipality,2000
575,3402500760,"Allentown borough, Monmouth County, New Jersey",34025,ONJ,704,735,31,27,76,65,1763,31,1828,1629,municipality,2010
576,3402501960,"Asbury Park city, Monmouth County, New Jersey",34025,ONJ,6754,7744,990,118,10236,2637,14293,792,16930,3147,municipality,2000
577,3402501960,"Asbury Park city, Monmouth County, New Jersey",34025,ONJ,6725,8076,1351,72,7955,4115,12001,463,16116,3511,municipality,2010
578,3402502110,"Atlantic Highlands borough, Monmouth County, New Jersey",34025,ONJ,1969,2056,87,57,105,165,4540,46,4705,4332,municipality,2000
579,3402502110,"Atlantic Highlands borough, Monmouth County, New Jersey",34025,ONJ,1870,2002,132,91,62,225,4160,70,4385,3937,municipality,2010
580,3402502440,"Avon-by-the-Sea borough, Monmouth County, New Jersey",34025,ONJ,1043,1387,344,20,8,54,2190,13,2244,2149,municipality,2000
581,3402502440,"Avon-by-the-Sea borough, Monmouth County, New Jersey",34025,ONJ,901,1321,420,12,6,71,1830,18,1901,1794,municipality,2010
582,3402504930,"Belmar borough, Monmouth County, New Jersey",34025,ONJ,2946,3996,1050,61,200,414,5631,96,6045,5274,municipality,2000
583,3402504930,"Belmar borough, Monmouth County, New Jersey",34025,ONJ,2695,3931,1236,52,184,971,4823,67,5794,4520,municipality,2010
584,3402506970,"Bradley Beach borough, Monmouth County, New Jersey",34025,ONJ,2297,3132,835,69,167,615,4178,91,4793,3851,municipality,2000
585,3402506970,"Bradley Beach borough, Monmouth County, New Jersey",34025,ONJ,2098,3180,1082,78,189,840,3458,77,4298,3114,municipality,2010
586,3402507750,"Brielle borough, Monmouth County, New Jersey",34025,ONJ,1938,2123,185,33,170,162,4731,54,4893,4474,municipality,2000
587,3402507750,"Brielle borough, Monmouth County, New Jersey",34025,ONJ,1805,2034,229,43,121,152,4622,62,4774,4396,municipality,2010
588,3402514560,"Colts Neck township, Monmouth County, New Jersey",34025,ONJ,3513,3614,101,445,916,520,11811,161,12331,10289,municipality,2000
589,3402514560,"Colts Neck township, Monmouth County, New Jersey",34025,ONJ,3277,3735,458,463,163,359,9783,115,10142,9042,municipality,2010
590,3402516660,"Deal borough, Monmouth County, New Jersey",34025,ONJ,434,953,519,3,12,54,1016,16,1070,985,municipality,2000
591,3402516660,"Deal borough, Monmouth County, New Jersey",34025,ONJ,333,926,593,26,11,55,695,9,750,649,municipality,2010
592,3402519840,"Eatontown borough, Monmouth County, New Jersey",34025,ONJ,5780,6341,561,1301,1572,928,13080,401,14008,9806,municipality,2000
593,3402519840,"Eatontown borough, Monmouth County, New Jersey",34025,ONJ,5319,5723,404,1097,1475,1571,11138,437,12709,8129,municipality,2010
594,3402521570,"Englishtown borough, Monmouth County, New Jersey",34025,ONJ,643,680,37,77,67,110,1654,17,1764,1493,municipality,2000
595,3402521570,"Englishtown borough, Monmouth County, New Jersey",34025,ONJ,621,647,26,121,43,148,1699,22,1847,1513,municipality,2010
596,3402522440,"Fair Haven borough, Monmouth County, New Jersey",34025,ONJ,1998,2037,39,56,240,79,5858,51,5937,5511,municipality,2000
597,3402522440,"Fair Haven borough, Monmouth County, New Jersey",34025,ONJ,1970,2065,95,66,151,165,5956,78,6121,5661,municipality,2010
598,3402522950,"Farmingdale borough, Monmouth County, New Jersey",34025,ONJ,625,638,13,37,18,61,1526,13,1587,1458,municipality,2000
599,3402522950,"Farmingdale borough, Monmouth County, New Jersey",34025,ONJ,547,578,31,42,35,92,1237,28,1329,1132,municipality,2010
600,3402525200,"Freehold borough, Monmouth County, New Jersey",34025,ONJ,3695,3821,126,268,1635,3081,7895,139,10976,5853,municipality,2000
601,3402525200,"Freehold borough, Monmouth County, New Jersey",34025,ONJ,4006,4249,243,342,1391,5167,6885,195,12052,4957,municipality,2010
602,3402525230,"Freehold township, Monmouth County, New Jersey",34025,ONJ,10814,11032,218,1612,1550,1637,29900,367,31537,26371,municipality,2000
603,3402525230,"Freehold township, Monmouth County, New Jersey",34025,ONJ,12577,13140,563,2530,1860,2808,33376,559,36184,28427,municipality,2010
604,3402530690,"Hazlet township, Monmouth County, New Jersey",34025,ONJ,7244,7406,162,719,210,1254,20124,206,21378,18989,municipality,2000
605,3402530690,"Hazlet township, Monmouth County, New Jersey",34025,ONJ,7140,7417,277,675,279,1601,18733,229,20334,17550,municipality,2010
606,3402531500,"Highlands borough, Monmouth County, New Jersey",34025,ONJ,2450,2820,370,50,52,207,4890,72,5097,4716,municipality,2000
607,3402531500,"Highlands borough, Monmouth County, New Jersey",34025,ONJ,2623,3146,523,64,70,324,4681,86,5005,4461,municipality,2010
608,3402532640,"Holmdel township, Monmouth County, New Jersey",34025,ONJ,4947,5137,190,2748,101,387,15394,203,15781,12342,municipality,2000
609,3402532640,"Holmdel township, Monmouth County, New Jersey",34025,ONJ,5584,5792,208,3201,135,621,16152,318,16773,12498,municipality,2010
610,3402533300,"Howell township, Monmouth County, New Jersey",34025,ONJ,16063,16572,509,1735,1669,2610,46293,626,48903,42263,municipality,2000
611,3402533300,"Howell township, Monmouth County, New Jersey",34025,ONJ,17260,17979,719,2283,1767,4153,46922,784,51075,42088,municipality,2010
612,3402534200,"Interlaken borough, Monmouth County, New Jersey",34025,ONJ,386,397,11,2,0,10,890,7,900,881,municipality,2000
613,3402534200,"Interlaken borough, Monmouth County, New Jersey",34025,ONJ,361,393,32,4,0,14,806,5,820,797,municipality,2010
614,3402536480,"Keansburg borough, Monmouth County, New Jersey",34025,ONJ,3872,4269,397,131,207,853,9879,138,10732,9403,municipality,2000
615,3402536480,"Keansburg borough, Monmouth County, New Jersey",34025,ONJ,3805,4318,513,169,582,1493,8612,245,10105,7616,municipality,2010
616,3402536810,"Keyport borough, Monmouth County, New Jersey",34025,ONJ,3264,3400,136,162,501,839,6729,133,7568,5933,municipality,2000
617,3402536810,"Keyport borough, Monmouth County, New Jersey",34025,ONJ,3067,3272,205,171,479,1322,5918,126,7240,5142,municipality,2010
618,3402537560,"Lake Como borough, Monmouth County, New Jersey",34025,ONJ,824,1107,283,23,134,183,1623,40,1806,1426,municipality,2000
619,3402537560,"Lake Como borough, Monmouth County, New Jersey",34025,ONJ,785,1115,330,21,106,322,1437,33,1759,1277,municipality,2010
620,3402540770,"Little Silver borough, Monmouth County, New Jersey",34025,ONJ,2232,2288,56,93,19,81,6089,53,6170,5924,municipality,2000
621,3402540770,"Little Silver borough, Monmouth County, New Jersey",34025,ONJ,2146,2278,132,102,14,179,5771,78,5950,5577,municipality,2010
622,3402541010,"Loch Arbour village, Monmouth County, New Jersey",34025,ONJ,120,156,36,2,6,2,278,5,280,265,municipality,2000
623,3402541010,"Loch Arbour village, Monmouth County, New Jersey",34025,ONJ,82,159,77,3,3,7,187,3,194,178,municipality,2010
624,3402541310,"Long Branch city, Monmouth County, New Jersey",34025,ONJ,12594,13983,1389,504,5471,6477,24863,1057,31340,17831,municipality,2000
625,3402541310,"Long Branch city, Monmouth County, New Jersey",34025,ONJ,11753,14170,2417,633,3946,8624,22095,1577,30719,15939,municipality,2010
626,3402542990,"Manalapan township, Monmouth County, New Jersey",34025,ONJ,10781,11066,285,1503,641,1183,32240,333,33423,29763,municipality,2000
627,3402542990,"Manalapan township, Monmouth County, New Jersey",34025,ONJ,13263,13735,472,2670,872,2202,36670,443,38872,32685,municipality,2010
628,3402543050,"Manasquan borough, Monmouth County, New Jersey",34025,ONJ,2600,3531,931,28,25,283,6027,31,6310,5943,municipality,2000
629,3402543050,"Manasquan borough, Monmouth County, New Jersey",34025,ONJ,2374,3500,1126,36,14,414,5483,28,5897,5405,municipality,2010
630,3402544070,"Marlboro township, Monmouth County, New Jersey",34025,ONJ,11478,11896,418,4602,721,1051,35347,353,36398,29671,municipality,2000
631,3402544070,"Marlboro township, Monmouth County, New Jersey",34025,ONJ,13001,13436,435,6921,814,1619,38572,475,40191,30362,municipality,2010
632,3402544520,"Matawan borough, Monmouth County, New Jersey",34025,ONJ,3531,3640,109,708,553,575,8335,152,8910,6922,municipality,2000
633,3402544520,"Matawan borough, Monmouth County, New Jersey",34025,ONJ,3358,3606,248,557,576,949,7861,204,8810,6524,municipality,2010
634,3402545990,"Middletown township, Monmouth County, New Jersey",34025,ONJ,23236,23841,605,1703,769,2265,64062,523,66327,61067,municipality,2000
635,3402545990,"Middletown township, Monmouth County, New Jersey",34025,ONJ,23962,24959,997,1717,814,3569,62953,720,66522,59702,municipality,2010
636,3402546560,"Millstone township, Monmouth County, New Jersey",34025,ONJ,2708,2797,89,304,269,315,8655,85,8970,7997,municipality,2000
637,3402546560,"Millstone township, Monmouth County, New Jersey",34025,ONJ,3301,3434,133,472,363,579,9987,159,10566,8993,municipality,2010
638,3402547130,"Monmouth Beach borough, Monmouth County, New Jersey",34025,ONJ,1633,1969,336,31,19,68,3527,16,3595,3461,municipality,2000
639,3402547130,"Monmouth Beach borough, Monmouth County, New Jersey",34025,ONJ,1494,1981,487,24,11,62,3217,33,3279,3149,municipality,2010
640,3402549890,"Neptune township, Monmouth County, New Jersey",34025,ONJ,10907,12217,1310,322,10310,1537,26153,662,27690,14859,municipality,2000
641,3402549890,"Neptune township, Monmouth County, New Jersey",34025,ONJ,11201,12991,1790,628,10377,2607,25328,745,27935,13578,municipality,2010
642,3402549920,"Neptune City borough, Monmouth County, New Jersey",34025,ONJ,2221,2342,121,141,481,277,4941,107,5218,4212,municipality,2000
643,3402549920,"Neptune City borough, Monmouth County, New Jersey",34025,ONJ,2133,2312,179,213,490,491,4378,104,4869,3571,municipality,2010
644,3402554270,"Ocean township, Monmouth County, New Jersey",34025,ONJ,10254,10756,502,1683,1466,1215,25744,543,26959,22052,municipality,2000
645,3402554270,"Ocean township, Monmouth County, New Jersey",34025,ONJ,10611,11541,930,1775,2038,2453,24838,578,27291,20447,municipality,2010
646,3402554570,"Oceanport borough, Monmouth County, New Jersey",34025,ONJ,2043,2114,71,46,110,120,5687,50,5807,5481,municipality,2000
647,3402554570,"Oceanport borough, Monmouth County, New Jersey",34025,ONJ,2227,2390,163,88,161,236,5596,71,5832,5276,municipality,2010
648,3402562430,"Red Bank borough, Monmouth County, New Jersey",34025,ONJ,5201,5450,249,259,2287,2027,9817,208,11844,7063,municipality,2000
649,3402562430,"Red Bank borough, Monmouth County, New Jersey",34025,ONJ,4929,5381,452,223,1408,4198,8008,230,12206,6147,municipality,2010
650,3402564410,"Roosevelt borough, Monmouth County, New Jersey",34025,ONJ,337,351,14,19,23,42,891,44,933,805,municipality,2000
651,3402564410,"Roosevelt borough, Monmouth County, New Jersey",34025,ONJ,314,327,13,28,8,52,830,18,882,776,municipality,2010
652,3402565130,"Rumson borough, Monmouth County, New Jersey",34025,ONJ,2452,2610,158,76,17,99,7038,36,7137,6909,municipality,2000
653,3402565130,"Rumson borough, Monmouth County, New Jersey",34025,ONJ,2344,2585,241,88,18,173,6949,72,7122,6771,municipality,2010
654,3402566240,"Sea Bright borough, Monmouth County, New Jersey",34025,ONJ,1003,1202,199,41,31,82,1736,13,1818,1651,municipality,2000
655,3402566240,"Sea Bright borough, Monmouth County, New Jersey",34025,ONJ,792,1211,419,32,11,78,1334,12,1412,1279,municipality,2010
656,3402566330,"Sea Girt borough, Monmouth County, New Jersey",34025,ONJ,942,1285,343,2,2,30,2118,7,2148,2107,municipality,2000
657,3402566330,"Sea Girt borough, Monmouth County, New Jersey",34025,ONJ,823,1291,468,4,0,30,1798,8,1828,1786,municipality,2010
658,3402567350,"Shrewsbury borough, Monmouth County, New Jersey",34025,ONJ,1207,1223,16,59,11,69,3521,32,3590,3419,municipality,2000
659,3402567350,"Shrewsbury borough, Monmouth County, New Jersey",34025,ONJ,1261,1310,49,79,24,95,3714,38,3809,3573,municipality,2010
660,3402567365,"Shrewsbury township, Monmouth County, New Jersey",34025,ONJ,521,546,25,109,176,73,1025,43,1098,697,municipality,2000
661,3402567365,"Shrewsbury township, Monmouth County, New Jersey",34025,ONJ,583,648,65,75,147,161,980,31,1141,727,municipality,2010
662,3402570110,"Spring Lake borough, Monmouth County, New Jersey",34025,ONJ,1463,1930,467,10,12,26,3541,17,3567,3502,municipality,2000
663,3402570110,"Spring Lake borough, Monmouth County, New Jersey",34025,ONJ,1253,2048,795,30,8,57,2936,23,2993,2875,municipality,2010
664,3402570140,"Spring Lake Heights borough, Monmouth County, New Jersey",34025,ONJ,2511,2950,439,19,57,111,5116,27,5227,5013,municipality,2000
665,3402570140,"Spring Lake Heights borough, Monmouth County, New Jersey",34025,ONJ,2316,2972,656,51,25,155,4558,35,4713,4447,municipality,2010
666,3402573020,"Tinton Falls borough, Monmouth County, New Jersey",34025,ONJ,5883,6211,328,740,1916,707,14346,294,15053,11396,municipality,2000
667,3402573020,"Tinton Falls borough, Monmouth County, New Jersey",34025,ONJ,8355,8766,411,829,1610,1118,16774,332,17892,14003,municipality,2010
668,3402574540,"Union Beach borough, Monmouth County, New Jersey",34025,ONJ,2143,2229,86,80,52,538,6111,108,6649,5871,municipality,2000
669,3402574540,"Union Beach borough, Monmouth County, New Jersey",34025,ONJ,2143,2269,126,108,85,686,5559,139,6245,5227,municipality,2010
670,3402574900,"Upper Freehold township, Monmouth County, New Jersey",34025,ONJ,1437,1501,64,60,45,151,4131,80,4282,3946,municipality,2000
671,3402574900,"Upper Freehold township, Monmouth County, New Jersey",34025,ONJ,2363,2458,95,300,134,254,6648,98,6902,6116,municipality,2010
672,3402576460,"Wall township, Monmouth County, New Jersey",34025,ONJ,9437,9957,520,318,149,391,24870,177,25261,24226,municipality,2000
673,3402576460,"Wall township, Monmouth County, New Jersey",34025,ONJ,10051,10883,832,420,611,908,25256,300,26164,23925,municipality,2010
674,3402579310,"West Long Branch borough, Monmouth County, New Jersey",34025,ONJ,2448,2535,87,100,171,241,8017,152,8258,7594,municipality,2000
675,3402579310,"West Long Branch borough, Monmouth County, New Jersey",34025,ONJ,2384,2528,144,95,163,407,7690,93,8097,7339,municipality,2010
676,3402706610,"Boonton town, Morris County, New Jersey",34027,INJ,3272,3352,80,655,321,582,7914,245,8496,6693,municipality,2000
677,3402706610,"Boonton town, Morris County, New Jersey",34027,INJ,3235,3398,163,838,363,920,7427,258,8347,5968,municipality,2010
678,3402706640,"Boonton township, Morris County, New Jersey",34027,INJ,1476,1510,34,175,51,92,4195,48,4287,3921,municipality,2000
679,3402706640,"Boonton township, Morris County, New Jersey",34027,INJ,1575,1647,72,170,63,178,4085,54,4263,3798,municipality,2010
680,3402709040,"Butler borough, Morris County, New Jersey",34027,INJ,2868,2923,55,137,42,379,7041,70,7420,6792,municipality,2000
681,3402709040,"Butler borough, Morris County, New Jersey",34027,INJ,3031,3169,138,228,78,860,6679,107,7539,6266,municipality,2010
682,3402712100,"Chatham borough, Morris County, New Jersey",34027,INJ,3159,3232,73,238,11,223,8237,69,8460,7919,municipality,2000
683,3402712100,"Chatham borough, Morris County, New Jersey",34027,INJ,3073,3210,137,433,85,457,8505,162,8962,7825,municipality,2010
684,3402712130,"Chatham township, Morris County, New Jersey",34027,INJ,3920,4019,99,483,41,197,9889,83,10086,9282,municipality,2000
685,3402712130,"Chatham township, Morris County, New Jersey",34027,INJ,3915,4128,213,657,69,349,10103,180,10452,9197,municipality,2010
686,3402712580,"Chester borough, Morris County, New Jersey",34027,INJ,609,627,18,28,5,112,1523,13,1635,1477,municipality,2000
687,3402712580,"Chester borough, Morris County, New Jersey",34027,INJ,615,647,32,38,13,222,1427,32,1649,1344,municipality,2010
688,3402712610,"Chester township, Morris County, New Jersey",34027,INJ,2323,2377,54,171,72,188,7094,72,7282,6779,municipality,2000
689,3402712610,"Chester township, Morris County, New Jersey",34027,INJ,2592,2697,105,268,77,341,7497,118,7838,7034,municipality,2010
690,3402717650,"Denville township, Morris County, New Jersey",34027,INJ,5990,6178,188,734,169,418,15406,176,15824,14327,municipality,2000
691,3402717650,"Denville township, Morris County, New Jersey",34027,INJ,6432,6734,302,1081,220,883,15752,265,16635,14186,municipality,2010
692,3402718070,"Dover town, Morris County, New Jersey",34027,INJ,5436,5568,132,446,1035,10539,7649,231,18188,5937,municipality,2000
693,3402718070,"Dover town, Morris County, New Jersey",34027,INJ,5562,5783,221,447,845,12598,5559,196,18157,4071,municipality,2010
694,3402719210,"East Hanover township, Morris County, New Jersey",34027,INJ,3843,3895,52,1257,64,312,11081,92,11393,9668,municipality,2000
695,3402719210,"East Hanover township, Morris County, New Jersey",34027,INJ,3893,3976,83,1322,90,600,10557,103,11157,9042,municipality,2010
696,3402723910,"Florham Park borough, Morris County, New Jersey",34027,INJ,3239,3342,103,343,88,190,8667,54,8857,8182,municipality,2000
697,3402723910,"Florham Park borough, Morris County, New Jersey",34027,INJ,4003,4201,198,743,488,594,11102,207,11696,9664,municipality,2010
698,3402729550,"Hanover township, Morris County, New Jersey",34027,INJ,4745,4818,73,1123,127,452,12446,83,12898,11113,municipality,2000
699,3402729550,"Hanover township, Morris County, New Jersey",34027,INJ,5308,5526,218,1480,134,630,13082,171,13712,11297,municipality,2010
700,3402729700,"Harding township, Morris County, New Jersey",34027,INJ,1180,1243,63,34,13,57,3123,38,3180,3038,municipality,2000
701,3402729700,"Harding township, Morris County, New Jersey",34027,INJ,1474,1610,136,102,35,134,3704,64,3838,3503,municipality,2010
702,3402734980,"Jefferson township, Morris County, New Jersey",34027,INJ,7131,7527,396,209,153,672,19045,239,19717,18444,municipality,2000
703,3402734980,"Jefferson township, Morris County, New Jersey",34027,INJ,7830,8597,767,977,305,1382,19932,277,21314,18373,municipality,2010
704,3402737110,"Kinnelon borough, Morris County, New Jersey",34027,INJ,3062,3123,61,263,44,218,9147,65,9365,8775,municipality,2000
705,3402737110,"Kinnelon borough, Morris County, New Jersey",34027,INJ,3472,3600,128,433,86,418,9830,107,10248,9204,municipality,2010
706,3402740290,"Lincoln Park borough, Morris County, New Jersey",34027,INJ,4026,4110,84,575,177,633,10297,147,10930,9398,municipality,2000
707,3402740290,"Lincoln Park borough, Morris County, New Jersey",34027,INJ,4001,4145,144,775,165,1009,9512,173,10521,8399,municipality,2010
708,3402741362,"Long Hill township, Morris County, New Jersey",34027,INJ,3139,3206,67,420,31,303,8474,107,8777,7916,municipality,2000
709,3402741362,"Long Hill township, Morris County, New Jersey",34027,INJ,3105,3226,121,520,48,614,8088,135,8702,7385,municipality,2010
710,3402742510,"Madison borough, Morris County, New Jersey",34027,INJ,5520,5641,121,616,481,987,15543,274,16530,14172,municipality,2000
711,3402742510,"Madison borough, Morris County, New Jersey",34027,INJ,5485,5775,290,869,441,1406,14439,289,15845,12840,municipality,2010
712,3402745330,"Mendham borough, Morris County, New Jersey",34027,INJ,1781,1828,47,72,22,125,4972,32,5097,4846,municipality,2000
713,3402745330,"Mendham borough, Morris County, New Jersey",34027,INJ,1722,1798,76,101,51,135,4846,53,4981,4641,municipality,2010
714,3402745360,"Mendham township, Morris County, New Jersey",34027,INJ,1788,1849,61,109,48,82,5318,46,5400,5115,municipality,2000
715,3402745360,"Mendham township, Morris County, New Jersey",34027,INJ,1952,2062,110,199,76,211,5658,83,5869,5300,municipality,2010
716,3402746860,"Mine Hill township, Morris County, New Jersey",34027,INJ,1365,1388,23,89,118,319,3360,52,3679,3101,municipality,2000
717,3402746860,"Mine Hill township, Morris County, New Jersey",34027,INJ,1329,1380,51,177,148,840,2811,73,3651,2413,municipality,2010
718,3402747670,"Montville township, Morris County, New Jersey",34027,INJ,7380,7541,161,2612,188,531,20308,234,20839,17274,municipality,2000
719,3402747670,"Montville township, Morris County, New Jersey",34027,INJ,7485,7823,338,3885,252,900,20628,357,21528,16134,municipality,2010
720,3402748090,"Morris township, Morris County, New Jersey",34027,INJ,8116,8298,182,847,1154,830,20966,223,21796,18742,municipality,2000
721,3402748090,"Morris township, Morris County, New Jersey",34027,INJ,8128,8502,374,1136,1216,1683,20623,378,22306,17893,municipality,2010
722,3402748210,"Morris Plains borough, Morris County, New Jersey",34027,INJ,1955,1994,39,225,70,141,5095,53,5236,4747,municipality,2000
723,3402748210,"Morris Plains borough, Morris County, New Jersey",34027,INJ,2131,2197,66,275,135,314,5218,77,5532,4731,municipality,2010
724,3402748300,"Morristown town, Morris County, New Jersey",34027,INJ,7252,7615,363,694,3066,5034,13510,348,18544,9402,municipality,2000
725,3402748300,"Morristown town, Morris County, New Jersey",34027,INJ,7417,8172,755,794,2479,6277,12134,300,18411,8561,municipality,2010
726,3402748480,"Mountain Lakes borough, Morris County, New Jersey",34027,INJ,1330,1357,27,219,15,72,4184,42,4256,3908,municipality,2000
727,3402748480,"Mountain Lakes borough, Morris County, New Jersey",34027,INJ,1313,1363,50,318,15,106,4054,83,4160,3638,municipality,2010
728,3402748690,"Mount Arlington borough, Morris County, New Jersey",34027,INJ,1918,2039,121,173,84,212,4451,73,4663,4121,municipality,2000
729,3402748690,"Mount Arlington borough, Morris County, New Jersey",34027,INJ,2283,2545,262,179,115,415,4635,74,5050,4267,municipality,2010
730,3402749080,"Mount Olive township, Morris County, New Jersey",34027,INJ,9068,9311,243,1446,895,1445,22748,418,24193,19989,municipality,2000
731,3402749080,"Mount Olive township, Morris County, New Jersey",34027,INJ,10690,11244,554,2297,1514,3237,24880,547,28117,20522,municipality,2010
732,3402750130,"Netcong borough, Morris County, New Jersey",34027,INJ,1008,1043,35,43,31,184,2396,32,2580,2290,municipality,2000
733,3402750130,"Netcong borough, Morris County, New Jersey",34027,INJ,1381,1449,68,89,119,572,2660,42,3232,2410,municipality,2010
734,3402756460,"Parsippany-Troy Hills township, Morris County, New Jersey",34027,INJ,19624,20066,442,9124,1510,3535,47114,1197,50649,35283,municipality,2000
735,3402756460,"Parsippany-Troy Hills township, Morris County, New Jersey",34027,INJ,20279,21274,995,15443,1741,4430,48808,1410,53238,30214,municipality,2010
736,3402758110,"Pequannock township, Morris County, New Jersey",34027,INJ,5026,5097,71,265,39,408,13480,77,13888,13099,municipality,2000
737,3402758110,"Pequannock township, Morris County, New Jersey",34027,INJ,6471,6794,323,291,72,703,14837,132,15540,14342,municipality,2010
738,3402761890,"Randolph township, Morris County, New Jersey",34027,INJ,8679,8903,224,2265,555,1208,23639,362,24847,20457,municipality,2000
739,3402761890,"Randolph township, Morris County, New Jersey",34027,INJ,9013,9343,330,2674,638,2616,23118,430,25734,19376,municipality,2010
740,3402763300,"Riverdale borough, Morris County, New Jersey",34027,INJ,919,940,21,68,27,110,2388,28,2498,2265,municipality,2000
741,3402763300,"Riverdale borough, Morris County, New Jersey",34027,INJ,1547,1657,110,187,42,256,3303,60,3559,3014,municipality,2010
742,3402764050,"Rockaway borough, Morris County, New Jersey",34027,INJ,2445,2491,46,411,84,608,5865,57,6473,5313,municipality,2000
743,3402764050,"Rockaway borough, Morris County, New Jersey",34027,INJ,2443,2521,78,491,192,970,5468,82,6438,4703,municipality,2010
744,3402764080,"Rockaway township, Morris County, New Jersey",34027,INJ,8108,8506,398,1287,538,1440,21490,272,22930,19393,municipality,2000
745,3402764080,"Rockaway township, Morris County, New Jersey",34027,INJ,8983,9587,604,1605,552,2705,21451,375,24156,18919,municipality,2010
746,3402764980,"Roxbury township, Morris County, New Jersey",34027,INJ,8364,8550,186,847,432,1154,22729,239,23883,21211,municipality,2000
747,3402764980,"Roxbury township, Morris County, New Jersey",34027,INJ,8292,8582,290,1330,496,2083,21241,374,23324,19041,municipality,2010
748,3402775890,"Victory Gardens borough, Morris County, New Jersey",34027,INJ,564,588,24,84,318,783,763,31,1546,330,municipality,2000
749,3402775890,"Victory Gardens borough, Morris County, New Jersey",34027,INJ,533,566,33,35,210,957,563,30,1520,288,municipality,2010
750,3402777240,"Washington township, Morris County, New Jersey",34027,INJ,5755,5890,135,325,143,389,17203,125,17592,16610,municipality,2000
751,3402777240,"Washington township, Morris County, New Jersey",34027,INJ,6237,6488,251,607,239,847,17686,250,18533,16590,municipality,2010
752,3402780390,"Wharton borough, Morris County, New Jersey",34027,INJ,2328,2394,66,198,244,1462,4836,141,6298,4253,municipality,2000
753,3402780390,"Wharton borough, Morris County, New Jersey",34027,INJ,2304,2426,122,368,227,2630,3892,139,6522,3158,municipality,2010
754,3402900000,"County subdivisions not defined, Ocean County, New Jersey",34029,ONJ,0,0,0,0,0,0,0,0,0,0,municipality,2000
755,3402900000,"County subdivisions not defined, Ocean County, New Jersey",34029,ONJ,0,0,0,0,0,0,0,0,0,0,municipality,2010
756,3402903050,"Barnegat township, Ocean County, New Jersey",34029,ONJ,5493,6066,573,152,320,590,14680,158,15270,14050,municipality,2000
757,3402903050,"Barnegat township, Ocean County, New Jersey",34029,ONJ,8128,9085,957,360,607,1420,19516,334,20936,18215,municipality,2010
758,3402903130,"Barnegat Light borough, Ocean County, New Jersey",34029,ONJ,371,1207,836,2,3,6,758,4,764,749,municipality,2000
759,3402903130,"Barnegat Light borough, Ocean County, New Jersey",34029,ONJ,274,1282,1008,0,6,11,563,2,574,555,municipality,2010
760,3402903520,"Bay Head borough, Ocean County, New Jersey",34029,ONJ,584,1053,469,7,2,16,1222,10,1238,1203,municipality,2000
761,3402903520,"Bay Head borough, Ocean County, New Jersey",34029,ONJ,459,1023,564,7,5,10,958,2,968,944,municipality,2010
762,3402903940,"Beach Haven borough, Ocean County, New Jersey",34029,ONJ,586,2555,1969,7,1,60,1218,6,1278,1204,municipality,2000
763,3402903940,"Beach Haven borough, Ocean County, New Jersey",34029,ONJ,531,2667,2136,9,1,116,1054,4,1170,1040,municipality,2010
764,3402904180,"Beachwood borough, Ocean County, New Jersey",34029,ONJ,3475,3623,148,114,95,438,9937,93,10375,9635,municipality,2000
765,3402904180,"Beachwood borough, Ocean County, New Jersey",34029,ONJ,3682,3826,144,166,185,898,10147,117,11045,9679,municipality,2010
766,3402905305,"Berkeley township, Ocean County, New Jersey",34029,ONJ,19828,22288,2460,176,482,932,39059,248,39991,38153,municipality,2000
767,3402905305,"Berkeley township, Ocean County, New Jersey",34029,ONJ,20349,23818,3469,458,681,2028,39227,365,41255,37723,municipality,2010
768,3402907420,"Brick township, Ocean County, New Jersey",34029,ONJ,29511,32689,3178,883,705,2930,73189,741,76119,70860,municipality,2000
769,3402907420,"Brick township, Ocean County, New Jersey",34029,ONJ,29842,33677,3835,1144,1374,5301,69771,881,75072,66372,municipality,2010
770,3402918670,"Eagleswood township, Ocean County, New Jersey",34029,ONJ,546,693,147,3,1,16,1425,11,1441,1410,municipality,2000
771,3402918670,"Eagleswood township, Ocean County, New Jersey",34029,ONJ,621,760,139,10,13,54,1549,16,1603,1510,municipality,2010
772,3402930390,"Harvey Cedars borough, Ocean County, New Jersey",34029,ONJ,167,1205,1038,1,2,13,346,1,359,342,municipality,2000
773,3402930390,"Harvey Cedars borough, Ocean County, New Jersey",34029,ONJ,169,1214,1045,1,2,3,334,0,337,331,municipality,2010
774,3402934530,"Island Heights borough, Ocean County, New Jersey",34029,ONJ,705,807,102,11,2,24,1727,25,1751,1689,municipality,2000
775,3402934530,"Island Heights borough, Ocean County, New Jersey",34029,ONJ,683,831,148,23,2,40,1633,32,1673,1576,municipality,2010
776,3402934680,"Jackson township, Ocean County, New Jersey",34029,ONJ,14176,14640,464,858,1569,2474,40342,567,42816,37348,municipality,2000
777,3402934680,"Jackson township, Ocean County, New Jersey",34029,ONJ,19417,20342,925,1592,2460,4295,50561,877,54856,45632,municipality,2010
778,3402937380,"Lacey township, Ocean County, New Jersey",34029,ONJ,9336,10580,1244,135,89,545,24801,184,25346,24393,municipality,2000
779,3402937380,"Lacey township, Ocean County, New Jersey",34029,ONJ,10183,11573,1390,221,150,1310,26334,304,27644,25659,municipality,2010
780,3402937770,"Lakehurst borough, Ocean County, New Jersey",34029,ONJ,870,961,91,59,183,201,2321,49,2522,2030,municipality,2000
781,3402937770,"Lakehurst borough, Ocean County, New Jersey",34029,ONJ,881,943,62,56,264,347,2307,107,2654,1880,municipality,2010
782,3402938550,"Lakewood township, Ocean County, New Jersey",34029,ONJ,19876,21214,1338,799,6878,8935,51417,924,60352,42816,municipality,2000
783,3402938550,"Lakewood township, Ocean County, New Jersey",34029,ONJ,24283,26337,2054,737,5346,16062,76781,693,92843,70005,municipality,2010
784,3402939390,"Lavallette borough, Ocean County, New Jersey",34029,ONJ,1208,3210,2002,4,7,43,2622,20,2665,2591,municipality,2000
785,3402939390,"Lavallette borough, Ocean County, New Jersey",34029,ONJ,945,3207,2262,10,2,56,1819,7,1875,1800,municipality,2010
786,3402940560,"Little Egg Harbor township, Ocean County, New Jersey",34029,ONJ,6179,7931,1752,96,117,520,15425,182,15945,15030,municipality,2000
787,3402940560,"Little Egg Harbor township, Ocean County, New Jersey",34029,ONJ,8060,10324,2264,249,259,1047,19018,238,20065,18272,municipality,2010
788,3402941250,"Long Beach township, Ocean County, New Jersey",34029,ONJ,1664,9023,7359,12,5,70,3259,14,3329,3228,municipality,2000
789,3402941250,"Long Beach township, Ocean County, New Jersey",34029,ONJ,1539,9216,7677,15,7,126,2925,18,3051,2885,municipality,2010
790,3402943140,"Manchester township, Ocean County, New Jersey",34029,ONJ,20688,22681,1993,328,1153,1024,37904,352,38928,36071,municipality,2000
791,3402943140,"Manchester township, Ocean County, New Jersey",34029,ONJ,22840,25886,3046,754,1572,2062,41008,467,43070,38215,municipality,2010
792,3402943380,"Mantoloking borough, Ocean County, New Jersey",34029,ONJ,207,522,315,2,7,3,420,0,423,411,municipality,2000
793,3402943380,"Mantoloking borough, Ocean County, New Jersey",34029,ONJ,162,535,373,1,5,7,289,4,296,279,municipality,2010
794,3402954300,"Ocean township, Ocean County, New Jersey",34029,ONJ,2446,2981,535,27,38,200,6250,62,6450,6123,municipality,2000
795,3402954300,"Ocean township, Ocean County, New Jersey",34029,ONJ,3483,4291,808,89,49,230,8102,85,8332,7879,municipality,2010
796,3402954450,"Ocean Gate borough, Ocean County, New Jersey",34029,ONJ,832,1152,320,20,20,49,2027,24,2076,1963,municipality,2000
797,3402954450,"Ocean Gate borough, Ocean County, New Jersey",34029,ONJ,832,1203,371,4,26,128,1883,17,2011,1836,municipality,2010
798,3402958590,"Pine Beach borough, Ocean County, New Jersey",34029,ONJ,767,872,105,12,4,46,1904,6,1950,1882,municipality,2000
799,3402958590,"Pine Beach borough, Ocean County, New Jersey",34029,ONJ,818,903,85,30,7,79,2048,16,2127,1995,municipality,2010
800,3402959790,"Plumsted township, Ocean County, New Jersey",34029,ONJ,2510,2628,118,53,156,280,6995,96,7275,6690,municipality,2000
801,3402959790,"Plumsted township, Ocean County, New Jersey",34029,ONJ,2936,3067,131,73,131,498,7923,128,8421,7591,municipality,2010
802,3402959880,"Point Pleasant borough, Ocean County, New Jersey",34029,ONJ,7560,8350,790,103,47,465,18841,135,19306,18556,municipality,2000
803,3402959880,"Point Pleasant borough, Ocean County, New Jersey",34029,ONJ,7273,8331,1058,129,56,935,17457,139,18392,17133,municipality,2010
804,3402959910,"Point Pleasant Beach borough, Ocean County, New Jersey",34029,ONJ,2317,3558,1241,54,27,234,5080,39,5314,4960,municipality,2000
805,3402959910,"Point Pleasant Beach borough, Ocean County, New Jersey",34029,ONJ,1985,3373,1388,39,27,421,4244,46,4665,4132,municipality,2010
806,3402966450,"Seaside Heights borough, Ocean County, New Jersey",34029,ONJ,1408,2840,1432,19,114,306,2849,87,3155,2629,municipality,2000
807,3402966450,"Seaside Heights borough, Ocean County, New Jersey",34029,ONJ,1376,3003,1627,44,181,516,2371,84,2887,2062,municipality,2010
808,3402966480,"Seaside Park borough, Ocean County, New Jersey",34029,ONJ,1127,2811,1684,13,6,52,2211,16,2263,2176,municipality,2000
809,3402966480,"Seaside Park borough, Ocean County, New Jersey",34029,ONJ,833,2703,1870,6,15,54,1525,12,1579,1492,municipality,2010
810,3402967110,"Ship Bottom borough, Ocean County, New Jersey",34029,ONJ,664,2218,1554,12,4,80,1304,6,1384,1282,municipality,2000
811,3402967110,"Ship Bottom borough, Ocean County, New Jersey",34029,ONJ,555,2066,1511,5,6,106,1050,7,1156,1032,municipality,2010
812,3402969510,"South Toms River borough, Ocean County, New Jersey",34029,ONJ,1073,1123,50,25,731,337,3297,84,3634,2457,municipality,2000
813,3402969510,"South Toms River borough, Ocean County, New Jersey",34029,ONJ,1098,1160,62,23,649,718,2966,120,3684,2174,municipality,2010
814,3402970320,"Stafford township, Ocean County, New Jersey",34029,ONJ,8535,11522,2987,217,157,542,21990,205,22532,21411,municipality,2000
815,3402970320,"Stafford township, Ocean County, New Jersey",34029,ONJ,10096,13604,3508,393,243,1410,25125,261,26535,24228,municipality,2010
816,3402971640,"Surf City borough, Ocean County, New Jersey",34029,ONJ,706,2621,1915,5,2,28,1414,10,1442,1397,municipality,2000
817,3402971640,"Surf City borough, Ocean County, New Jersey",34029,ONJ,622,2566,1944,6,16,61,1144,9,1205,1113,municipality,2010
818,3402973125,"Toms River township, Ocean County, New Jersey",34029,ONJ,33510,41116,7606,2198,1490,4070,85636,855,89706,81093,municipality,2000
819,3402973125,"Toms River township, Ocean County, New Jersey",34029,ONJ,34760,43334,8574,3237,2213,7231,84008,1317,91239,77241,municipality,2010
820,3402974210,"Tuckerton borough, Ocean County, New Jersey",34029,ONJ,1477,1971,494,19,14,109,3408,33,3517,3342,municipality,2000
821,3402974210,"Tuckerton borough, Ocean County, New Jersey",34029,ONJ,1396,1902,506,33,23,203,3144,34,3347,3054,municipality,2010
822,3403106340,"Bloomingdale borough, Passaic County, New Jersey",34031,INJ,2847,2940,93,164,27,332,7278,77,7610,7010,municipality,2000
823,3403106340,"Bloomingdale borough, Passaic County, New Jersey",34031,INJ,2935,3089,154,188,82,714,6942,84,7656,6588,municipality,2010
824,3403113690,"Clifton city, Passaic County, New Jersey",34031,INJ,30244,31060,816,5028,2002,15608,63064,2828,78672,53206,municipality,2000
825,3403113690,"Clifton city, Passaic County, New Jersey",34031,INJ,30661,31946,1285,7401,3235,26854,57282,1776,84136,44870,municipality,2010
826,3403129070,"Haledon borough, Passaic County, New Jersey",34031,INJ,2820,2906,86,371,524,1865,6387,269,8252,5223,municipality,2000
827,3403129070,"Haledon borough, Passaic County, New Jersey",34031,INJ,2778,2932,154,505,806,3460,4858,154,8318,3393,municipality,2010
828,3403130570,"Hawthorne borough, Passaic County, New Jersey",34031,INJ,7260,7419,159,339,130,1354,16864,254,18218,16141,municipality,2000
829,3403130570,"Hawthorne borough, Passaic County, New Jersey",34031,INJ,7454,7756,302,524,355,2897,15894,223,18791,14792,municipality,2010
830,3403140620,"Little Falls township, Passaic County, New Jersey",34031,INJ,4687,4797,110,450,71,579,10276,162,10855,9593,municipality,2000
831,3403140620,"Little Falls township, Passaic County, New Jersey",34031,INJ,4740,4925,185,652,549,1428,13004,273,14432,11530,municipality,2010
832,3403153040,"North Haledon borough, Passaic County, New Jersey",34031,INJ,2626,2675,49,79,97,308,7612,91,7920,7345,municipality,2000
833,3403153040,"North Haledon borough, Passaic County, New Jersey",34031,INJ,3123,3213,90,318,136,628,7789,87,8417,7248,municipality,2010
834,3403156550,"Passaic city, Passaic County, New Jersey",34031,INJ,19458,20194,736,3617,8042,42387,25474,1410,67861,12405,municipality,2000
835,3403156550,"Passaic city, Passaic County, New Jersey",34031,INJ,19411,20432,1021,2924,5221,49557,20224,838,69781,11241,municipality,2010
836,3403157000,"Paterson city, Passaic County, New Jersey",34031,INJ,44710,47169,2459,2728,46882,74774,74448,5073,149222,19765,municipality,2000
837,3403157000,"Paterson city, Passaic County, New Jersey",34031,INJ,44329,47946,3617,4663,41431,84254,61945,2425,146199,13426,municipality,2010
838,3403160090,"Pompton Lakes borough, Passaic County, New Jersey",34031,INJ,3949,4024,75,316,127,611,10029,109,10640,9477,municipality,2000
839,3403160090,"Pompton Lakes borough, Passaic County, New Jersey",34031,INJ,4190,4341,151,595,127,1209,9888,147,11097,9019,municipality,2010
840,3403161170,"Prospect Park borough, Passaic County, New Jersey",34031,INJ,1822,1889,67,180,703,2211,3568,292,5779,2393,municipality,2000
841,3403161170,"Prospect Park borough, Passaic County, New Jersey",34031,INJ,1797,1931,134,176,1016,3055,2810,139,5865,1479,municipality,2010
842,3403163150,"Ringwood borough, Passaic County, New Jersey",34031,INJ,4108,4221,113,147,183,527,11869,283,12396,11256,municipality,2000
843,3403163150,"Ringwood borough, Passaic County, New Jersey",34031,INJ,4182,4331,149,209,148,707,11521,364,12228,10800,municipality,2010
844,3403173140,"Totowa borough, Passaic County, New Jersey",34031,INJ,3539,3630,91,223,109,630,9262,108,9892,8822,municipality,2000
845,3403173140,"Totowa borough, Passaic County, New Jersey",34031,INJ,3783,3918,135,639,220,1550,9254,146,10804,8249,municipality,2010
846,3403176730,"Wanaque borough, Passaic County, New Jersey",34031,INJ,3444,3500,56,368,147,554,9712,200,10266,8997,municipality,2000
847,3403176730,"Wanaque borough, Passaic County, New Jersey",34031,INJ,4018,4184,166,508,305,1075,10041,214,11116,9014,municipality,2010
848,3403177840,"Wayne township, Passaic County, New Jersey",34031,INJ,18755,19218,463,3056,843,2754,51315,650,54069,46766,municipality,2000
849,3403177840,"Wayne township, Passaic County, New Jersey",34031,INJ,19127,19768,641,4441,1124,4335,50382,787,54717,44030,municipality,2010
850,3403179460,"West Milford township, Passaic County, New Jersey",34031,INJ,9190,9909,719,262,314,893,25517,467,26410,24474,municipality,2000
851,3403179460,"West Milford township, Passaic County, New Jersey",34031,INJ,9625,10419,794,319,327,1512,24338,460,25850,23232,municipality,2010
852,3403182423,"Woodland Park borough, Passaic County, New Jersey",34031,INJ,4397,4497,100,419,327,1105,9882,322,10987,8814,municipality,2000
853,3403182423,"Woodland Park borough, Passaic County, New Jersey",34031,INJ,4632,4835,203,494,398,2442,9377,252,11819,8233,municipality,2010
854,3403504450,"Bedminster township, Somerset County, New Jersey",34035,INJ,4235,4467,232,531,143,319,7983,91,8302,7218,municipality,2000
855,3403504450,"Bedminster township, Somerset County, New Jersey",34035,INJ,4100,4349,249,707,157,519,7646,136,8165,6646,municipality,2010
856,3403505560,"Bernards township, Somerset County, New Jersey",34035,INJ,9242,9485,243,1928,341,646,23929,262,24575,21398,municipality,2000
857,3403505560,"Bernards township, Somerset County, New Jersey",34035,INJ,9783,10103,320,3670,478,1054,25598,504,26652,20946,municipality,2010
858,3403505590,"Bernardsville borough, Somerset County, New Jersey",34035,INJ,2723,2807,84,194,18,439,6906,84,7345,6610,municipality,2000
859,3403505590,"Bernardsville borough, Somerset County, New Jersey",34035,INJ,2685,2871,186,248,58,903,6804,96,7707,6402,municipality,2010
860,3403506790,"Bound Brook borough, Somerset County, New Jersey",34035,INJ,3615,3802,187,282,222,3541,6614,146,10155,5964,municipality,2000
861,3403506790,"Bound Brook borough, Somerset County, New Jersey",34035,INJ,3586,3816,230,264,522,5062,5340,171,10402,4383,municipality,2010
862,3403507180,"Branchburg township, Somerset County, New Jersey",34035,INJ,5272,5405,133,890,273,392,14174,155,14566,12856,municipality,2000
863,3403507180,"Branchburg township, Somerset County, New Jersey",34035,INJ,5271,5419,148,1210,313,643,13816,257,14459,12036,municipality,2010
864,3403507720,"Bridgewater township, Somerset County, New Jersey",34035,INJ,15561,15879,318,4509,899,2056,40884,481,42940,34995,municipality,2000
865,3403507720,"Bridgewater township, Somerset County, New Jersey",34035,INJ,16111,16657,546,7901,978,3004,41460,729,44464,31852,municipality,2010
866,3403522890,"Far Hills borough, Somerset County, New Jersey",34035,INJ,368,386,18,18,7,31,828,8,859,795,municipality,2000
867,3403522890,"Far Hills borough, Somerset County, New Jersey",34035,INJ,376,418,42,17,6,88,831,9,919,799,municipality,2010
868,3403524900,"Franklin township, Somerset County, New Jersey",34035,INJ,19355,19789,434,6475,12888,4127,46776,1187,50903,26226,municipality,2000
869,3403524900,"Franklin township, Somerset County, New Jersey",34035,INJ,23301,24426,1125,12410,15888,8050,54250,1754,62300,24198,municipality,2010
870,3403527510,"Green Brook township, Somerset County, New Jersey",34035,INJ,1893,1916,23,452,93,231,5423,60,5654,4818,municipality,2000
871,3403527510,"Green Brook township, Somerset County, New Jersey",34035,INJ,2375,2448,73,1453,238,494,6709,101,7203,4917,municipality,2010
872,3403531890,"Hillsborough township, Somerset County, New Jersey",34035,INJ,12649,12854,205,2672,1325,1740,34894,535,36634,30362,municipality,2000
873,3403531890,"Hillsborough township, Somerset County, New Jersey",34035,INJ,13573,14030,457,4723,1674,2893,35410,644,38303,28369,municipality,2010
874,3403543620,"Manville borough, Somerset County, New Jersey",34035,INJ,4115,4296,181,135,45,559,9784,80,10343,9524,municipality,2000
875,3403543620,"Manville borough, Somerset County, New Jersey",34035,INJ,4016,4277,261,205,259,1963,8381,162,10344,7755,municipality,2010
876,3403546590,"Millstone borough, Somerset County, New Jersey",34035,INJ,169,173,4,4,4,13,397,2,410,387,municipality,2000
877,3403546590,"Millstone borough, Somerset County, New Jersey",34035,INJ,162,167,5,7,5,15,403,4,418,387,municipality,2010
878,3403547580,"Montgomery township, Somerset County, New Jersey",34035,INJ,5803,6130,327,2010,350,387,17094,227,17481,14507,municipality,2000
879,3403547580,"Montgomery township, Somerset County, New Jersey",34035,INJ,7635,7902,267,5689,586,1017,21237,526,22254,14436,municipality,2010
880,3403553280,"North Plainfield borough, Somerset County, New Jersey",34035,INJ,7202,7393,191,1053,2580,6916,14187,531,21103,10023,municipality,2000
881,3403553280,"North Plainfield borough, Somerset County, New Jersey",34035,INJ,7448,7848,400,1260,3848,9699,12237,394,21936,6735,municipality,2010
882,3403557300,"Peapack and Gladstone borough, Somerset County, New Jersey",34035,INJ,840,871,31,30,76,92,2341,14,2433,2221,municipality,2000
883,3403557300,"Peapack and Gladstone borough, Somerset County, New Jersey",34035,INJ,887,949,62,47,99,281,2301,31,2582,2124,municipality,2010
884,3403561980,"Raritan borough, Somerset County, New Jersey",34035,INJ,2556,2644,88,518,47,533,5805,79,6338,5161,municipality,2000
885,3403561980,"Raritan borough, Somerset County, New Jersey",34035,INJ,2673,2847,174,975,128,1128,5753,143,6881,4507,municipality,2010
886,3403564320,"Rocky Hill borough, Somerset County, New Jersey",34035,INJ,284,295,11,3,9,26,636,16,662,608,municipality,2000
887,3403564320,"Rocky Hill borough, Somerset County, New Jersey",34035,INJ,280,292,12,16,10,33,649,23,682,600,municipality,2010
888,3403568460,"Somerville borough, Somerset County, New Jersey",34035,INJ,4743,4882,139,909,1548,2112,10311,322,12423,7532,municipality,2000
889,3403568460,"Somerville borough, Somerset County, New Jersey",34035,INJ,4591,4951,360,1359,1389,2873,9225,325,12098,6152,municipality,2010
890,3403568730,"South Bound Brook borough, Somerset County, New Jersey",34035,INJ,1632,1676,44,184,345,1028,3464,89,4492,2846,municipality,2000
891,3403568730,"South Bound Brook borough, Somerset County, New Jersey",34035,INJ,1733,1865,132,275,429,1245,3318,140,4563,2474,municipality,2010
892,3403576940,"Warren township, Somerset County, New Jersey",34035,INJ,4629,4718,89,1520,169,455,13804,197,14259,11918,municipality,2000
893,3403576940,"Warren township, Somerset County, New Jersey",34035,INJ,5059,5258,199,2304,225,820,14491,258,15311,11704,municipality,2010
894,3403577600,"Watchung borough, Somerset County, New Jersey",34035,INJ,2098,2155,57,553,189,168,5445,88,5613,4615,municipality,2000
895,3403577600,"Watchung borough, Somerset County, New Jersey",34035,INJ,2114,2234,120,733,190,307,5494,144,5801,4427,municipality,2010
896,3403701330,"Andover borough, Sussex County, New Jersey",34037,ONJ,261,273,12,15,13,17,641,12,658,601,municipality,2000
897,3403701330,"Andover borough, Sussex County, New Jersey",34037,ONJ,241,263,22,8,5,46,560,13,606,534,municipality,2010
898,3403701360,"Andover township, Sussex County, New Jersey",34037,ONJ,1889,1968,79,137,111,136,5897,46,6033,5603,municipality,2000
899,3403701360,"Andover township, Sussex County, New Jersey",34037,ONJ,2070,2181,111,164,202,325,5994,81,6319,5547,municipality,2010
900,3403707300,"Branchville borough, Sussex County, New Jersey",34037,ONJ,354,377,23,3,0,11,834,5,845,826,municipality,2000
901,3403707300,"Branchville borough, Sussex County, New Jersey",34037,ONJ,364,386,22,9,2,33,808,9,841,788,municipality,2010
902,3403709160,"Byram township, Sussex County, New Jersey",34037,ONJ,2833,3078,245,116,79,243,8011,94,8254,7722,municipality,2000
903,3403709160,"Byram township, Sussex County, New Jersey",34037,ONJ,2926,3207,281,173,113,417,7933,94,8350,7553,municipality,2010
904,3403724810,"Frankford township, Sussex County, New Jersey",34037,ONJ,1839,2295,456,21,21,96,5324,27,5420,5255,municipality,2000
905,3403724810,"Frankford township, Sussex County, New Jersey",34037,ONJ,2046,2520,474,46,53,176,5389,66,5565,5224,municipality,2010
906,3403724930,"Franklin borough, Sussex County, New Jersey",34037,ONJ,1898,1997,99,76,30,228,4932,71,5160,4755,municipality,2000
907,3403724930,"Franklin borough, Sussex County, New Jersey",34037,ONJ,1936,2136,200,88,95,395,4650,105,5045,4362,municipality,2010
908,3403725140,"Fredon township, Sussex County, New Jersey",34037,ONJ,982,1019,37,24,15,62,2798,19,2860,2740,municipality,2000
909,3403725140,"Fredon township, Sussex County, New Jersey",34037,ONJ,1207,1289,82,58,17,127,3310,32,3437,3203,municipality,2010
910,3403727420,"Green township, Sussex County, New Jersey",34037,ONJ,1046,1069,23,31,26,103,3117,29,3220,3031,municipality,2000
911,3403727420,"Green township, Sussex County, New Jersey",34037,ONJ,1181,1251,70,60,42,173,3428,39,3601,3287,municipality,2010
912,3403729220,"Hamburg borough, Sussex County, New Jersey",34037,ONJ,1173,1233,60,71,21,131,2974,63,3105,2819,municipality,2000
913,3403729220,"Hamburg borough, Sussex County, New Jersey",34037,ONJ,1364,1476,112,66,57,225,3052,74,3277,2855,municipality,2010
914,3403729490,"Hampton township, Sussex County, New Jersey",34037,ONJ,1857,2026,169,33,46,94,4849,37,4943,4733,municipality,2000
915,3403729490,"Hampton township, Sussex County, New Jersey",34037,ONJ,2021,2200,179,62,41,200,4996,46,5196,4847,municipality,2010
916,3403729850,"Hardyston township, Sussex County, New Jersey",34037,ONJ,2319,2690,371,95,51,199,5972,78,6171,5748,municipality,2000
917,3403729850,"Hardyston township, Sussex County, New Jersey",34037,ONJ,3255,3783,528,243,200,457,7756,114,8213,7199,municipality,2010
918,3403732910,"Hopatcong borough, Sussex County, New Jersey",34037,ONJ,5656,6190,534,282,296,952,14936,214,15888,14144,municipality,2000
919,3403732910,"Hopatcong borough, Sussex County, New Jersey",34037,ONJ,5653,6296,643,334,401,1714,13433,208,15147,12490,municipality,2010
920,3403737440,"Lafayette township, Sussex County, New Jersey",34037,ONJ,771,799,28,18,24,54,2246,16,2300,2188,municipality,2000
921,3403737440,"Lafayette township, Sussex County, New Jersey",34037,ONJ,875,919,44,19,36,129,2409,34,2538,2320,municipality,2010
922,3403747430,"Montague township, Sussex County, New Jersey",34037,ONJ,1286,1588,302,23,61,112,3300,44,3412,3172,municipality,2000
923,3403747430,"Montague township, Sussex County, New Jersey",34037,ONJ,1535,1802,267,39,83,246,3601,87,3847,3392,municipality,2010
924,3403751930,"Newton town, Sussex County, New Jersey",34037,ONJ,3258,3425,167,161,272,313,7931,107,8244,7391,municipality,2000
925,3403751930,"Newton town, Sussex County, New Jersey",34037,ONJ,3170,3479,309,233,361,987,7010,159,7997,6257,municipality,2010
926,3403754660,"Ogdensburg borough, Sussex County, New Jersey",34037,ONJ,881,903,22,19,4,110,2528,24,2638,2481,municipality,2000
927,3403754660,"Ogdensburg borough, Sussex County, New Jersey",34037,ONJ,864,905,41,44,8,151,2259,23,2410,2184,municipality,2010
928,3403765700,"Sandyston township, Sussex County, New Jersey",34037,ONJ,693,907,214,8,6,24,1801,18,1825,1769,municipality,2000
929,3403765700,"Sandyston township, Sussex County, New Jersey",34037,ONJ,788,988,200,11,8,68,1930,26,1998,1885,municipality,2010
930,3403769690,"Sparta township, Sussex County, New Jersey",34037,ONJ,6225,6590,365,251,50,459,17621,185,18080,17135,municipality,2000
931,3403769690,"Sparta township, Sussex County, New Jersey",34037,ONJ,6868,7423,555,490,187,1054,18668,276,19722,17715,municipality,2010
932,3403770380,"Stanhope borough, Sussex County, New Jersey",34037,ONJ,1384,1419,35,54,45,145,3439,85,3584,3255,municipality,2000
933,3403770380,"Stanhope borough, Sussex County, New Jersey",34037,ONJ,1396,1472,76,83,53,307,3303,60,3610,3107,municipality,2010
934,3403770890,"Stillwater township, Sussex County, New Jersey",34037,ONJ,1494,2030,536,18,7,89,4178,36,4267,4117,municipality,2000
935,3403770890,"Stillwater township, Sussex County, New Jersey",34037,ONJ,1553,1930,377,29,27,90,4009,50,4099,3903,municipality,2010
936,3403771670,"Sussex borough, Sussex County, New Jersey",34037,ONJ,903,961,58,26,22,55,2090,15,2145,2027,municipality,2000
937,3403771670,"Sussex borough, Sussex County, New Jersey",34037,ONJ,899,1005,106,49,39,169,1961,48,2130,1825,municipality,2010
938,3403775740,"Vernon township, Sussex County, New Jersey",34037,ONJ,8368,9994,1626,171,178,889,23797,234,24686,23214,municipality,2000
939,3403775740,"Vernon township, Sussex County, New Jersey",34037,ONJ,8622,10958,2336,185,292,1534,22409,308,23943,21624,municipality,2010
940,3403776640,"Walpack township, Sussex County, New Jersey",34037,ONJ,20,34,14,0,0,0,41,0,41,41,municipality,2000
941,3403776640,"Walpack township, Sussex County, New Jersey",34037,ONJ,8,15,7,0,0,0,16,1,16,15,municipality,2010
942,3403776790,"Wantage township, Sussex County, New Jersey",34037,ONJ,3441,3663,222,70,66,300,10087,94,10387,9857,municipality,2000
943,3403776790,"Wantage township, Sussex County, New Jersey",34037,ONJ,3910,4173,263,112,126,594,10764,158,11358,10368,municipality,2010
944,3403905320,"Berkeley Heights township, Union County, New Jersey",34039,INJ,4479,4562,83,1055,143,494,12913,104,13407,11611,municipality,2000
945,3403905320,"Berkeley Heights township, Union County, New Jersey",34039,INJ,4470,4596,126,1372,186,675,12508,190,13183,10760,municipality,2010
946,3403913150,"Clark township, Union County, New Jersey",34039,INJ,5637,5709,72,402,35,535,14062,91,14597,13534,municipality,2000
947,3403913150,"Clark township, Union County, New Jersey",34039,INJ,5562,5751,189,527,116,1107,13649,132,14756,12874,municipality,2010
948,3403915640,"Cranford township, Union County, New Jersey",34039,INJ,8397,8560,163,484,579,879,21699,172,22578,20464,municipality,2000
949,3403915640,"Cranford township, Union County, New Jersey",34039,INJ,8583,8816,233,635,563,1474,21151,318,22625,19635,municipality,2010
950,3403921000,"Elizabeth city, Union County, New Jersey",34039,INJ,40482,42838,2356,2745,22329,59627,60941,3529,120568,32338,municipality,2000
951,3403921000,"Elizabeth city, Union County, New Jersey",34039,INJ,41596,45516,3920,2521,23072,74353,50616,2318,124969,22705,municipality,2010
952,3403922860,"Fanwood borough, Union County, New Jersey",34039,INJ,2574,2615,41,315,364,268,6906,95,7174,6132,municipality,2000
953,3403922860,"Fanwood borough, Union County, New Jersey",34039,INJ,2627,2686,59,490,374,458,6860,143,7318,5853,municipality,2010
954,3403925800,"Garwood borough, Union County, New Jersey",34039,INJ,1731,1782,51,55,15,207,3946,25,4153,3851,municipality,2000
955,3403925800,"Garwood borough, Union County, New Jersey",34039,INJ,1778,1870,92,86,42,373,3853,59,4226,3666,municipality,2010
956,3403931980,"Hillside township, Union County, New Jersey",34039,INJ,7161,7388,227,744,9961,3153,18594,898,21747,6991,municipality,2000
957,3403931980,"Hillside township, Union County, New Jersey",34039,INJ,7112,7536,424,571,11091,3774,17630,594,21404,5374,municipality,2010
958,3403936690,"Kenilworth borough, Union County, New Jersey",34039,INJ,2854,2926,72,220,183,663,7012,70,7675,6539,municipality,2000
959,3403936690,"Kenilworth borough, Union County, New Jersey",34039,INJ,2841,2924,83,303,213,1228,6686,123,7914,6047,municipality,2010
960,3403940350,"Linden city, Union County, New Jersey",34039,INJ,15052,15567,515,914,8782,5674,33720,1197,39394,22827,municipality,2000
961,3403940350,"Linden city, Union County, New Jersey",34039,INJ,14909,15872,963,1066,10403,10095,30404,846,40499,18089,municipality,2010
962,3403948510,"Mountainside borough, Union County, New Jersey",34039,INJ,2434,2478,44,180,61,199,6403,51,6602,6111,municipality,2000
963,3403948510,"Mountainside borough, Union County, New Jersey",34039,INJ,2468,2558,90,323,121,407,6278,80,6685,5754,municipality,2010
964,3403951810,"New Providence borough, Union County, New Jersey",34039,INJ,4404,4485,81,903,104,417,11490,124,11907,10359,municipality,2000
965,3403951810,"New Providence borough, Union County, New Jersey",34039,INJ,4408,4537,129,1187,153,783,11388,178,12171,9870,municipality,2010
966,3403959190,"Plainfield city, Union County, New Jersey",34039,INJ,15137,16180,1043,428,28698,12033,35796,1162,47829,5508,municipality,2000
967,3403959190,"Plainfield city, Union County, New Jersey",34039,INJ,15180,16621,1441,439,24069,20105,29703,1056,49808,4139,municipality,2010
968,3403961530,"Rahway city, Union County, New Jersey",34039,INJ,10028,10381,353,925,7058,3675,22825,743,26500,14099,municipality,2000
969,3403961530,"Rahway city, Union County, New Jersey",34039,INJ,10533,11300,767,1148,8104,6433,20913,648,27346,11013,municipality,2010
970,3403964620,"Roselle borough, Union County, New Jersey",34039,INJ,7520,7870,350,573,10669,3641,17633,717,21274,5674,municipality,2000
971,3403964620,"Roselle borough, Union County, New Jersey",34039,INJ,7407,7939,532,464,11148,5644,15441,440,21085,3389,municipality,2010
972,3403964650,"Roselle Park borough, Union County, New Jersey",34039,INJ,5137,5258,121,1199,298,2170,11111,217,13281,9397,municipality,2000
973,3403964650,"Roselle Park borough, Union County, New Jersey",34039,INJ,5002,5231,229,1337,697,3809,9488,193,13297,7261,municipality,2010
974,3403966060,"Scotch Plains township, Union County, New Jersey",34039,INJ,8349,8479,130,1638,2532,895,21837,332,22732,17335,municipality,2000
975,3403966060,"Scotch Plains township, Union County, New Jersey",34039,INJ,8595,8896,301,1795,2519,1582,21928,493,23510,17121,municipality,2010
976,3403970020,"Springfield township, Union County, New Jersey",34039,INJ,6001,6204,203,675,536,597,13832,130,14429,12491,municipality,2000
977,3403970020,"Springfield township, Union County, New Jersey",34039,INJ,6511,6736,225,1196,968,1502,14315,229,15817,11922,municipality,2010
978,3403971430,"Summit city, Union County, New Jersey",34039,INJ,7897,8146,249,935,877,2150,18981,243,21131,16926,municipality,2000
979,3403971430,"Summit city, Union County, New Jersey",34039,INJ,7708,8190,482,1367,933,2851,18606,409,21457,15897,municipality,2010
980,3403974480,"Union township, Union County, New Jersey",34039,INJ,19534,20001,467,4191,10563,4861,49544,1129,54405,33661,municipality,2000
981,3403974480,"Union township, Union County, New Jersey",34039,INJ,19556,20250,694,5959,15979,8465,48177,1266,56642,24973,municipality,2010
982,3403979040,"Westfield town, Union County, New Jersey",34039,INJ,10622,10819,197,1206,1137,836,28808,418,29644,26047,municipality,2000
983,3403979040,"Westfield town, Union County, New Jersey",34039,INJ,10566,10950,384,1708,940,1492,28824,547,30316,25629,municipality,2010
984,3403981650,"Winfield township, Union County, New Jersey",34039,INJ,694,697,3,2,2,37,1477,23,1514,1450,municipality,2000
985,3403981650,"Winfield township, Union County, New Jersey",34039,INJ,706,714,8,2,14,94,1377,20,1471,1341,municipality,2010
986,3404100670,"Allamuchy township, Warren County, New Jersey",34041,ONJ,1692,1774,82,72,36,104,3773,33,3877,3632,municipality,2000
987,3404100670,"Allamuchy township, Warren County, New Jersey",34041,ONJ,1953,2096,143,118,75,194,4129,56,4323,3880,municipality,2010
988,3404101030,"Alpha borough, Warren County, New Jersey",34041,ONJ,989,1034,45,30,5,47,2435,26,2482,2374,municipality,2000
989,3404101030,"Alpha borough, Warren County, New Jersey",34041,ONJ,964,1032,68,36,55,125,2244,38,2369,2115,municipality,2010
990,3404104990,"Belvidere town, Warren County, New Jersey",34041,ONJ,1088,1165,77,14,14,64,2707,24,2771,2655,municipality,2000
991,3404104990,"Belvidere town, Warren County, New Jersey",34041,ONJ,1054,1140,86,21,38,97,2584,31,2681,2494,municipality,2010
992,3404106160,"Blairstown township, Warren County, New Jersey",34041,ONJ,2040,2136,96,32,15,114,5633,36,5747,5550,municipality,2000
993,3404106160,"Blairstown township, Warren County, New Jersey",34041,ONJ,2124,2272,148,68,63,226,5741,52,5967,5558,municipality,2010
994,3404124960,"Franklin township, Warren County, New Jersey",34041,ONJ,972,1019,47,24,22,55,2713,26,2768,2641,municipality,2000
995,3404124960,"Franklin township, Warren County, New Jersey",34041,ONJ,1122,1219,97,74,47,122,3054,46,3176,2887,municipality,2010
996,3404125320,"Frelinghuysen township, Warren County, New Jersey",34041,ONJ,722,755,33,8,7,55,2028,19,2083,1994,municipality,2000
997,3404125320,"Frelinghuysen township, Warren County, New Jersey",34041,ONJ,760,826,66,12,14,57,2173,22,2230,2125,municipality,2010
998,3404128260,"Greenwich township, Warren County, New Jersey",34041,ONJ,1421,1477,56,97,106,166,4199,40,4365,3956,municipality,2000
999,3404128260,"Greenwich township, Warren County, New Jersey",34041,ONJ,1808,1870,62,343,355,364,5348,94,5712,4556,municipality,2010
1000,3404128710,"Hackettstown town, Warren County, New Jersey",34041,ONJ,4134,4347,213,301,221,833,9570,234,10403,8814,municipality,2000
1001,3404128710,"Hackettstown town, Warren County, New Jersey",34041,ONJ,3575,3755,180,478,210,1474,8250,155,9724,7407,municipality,2010
1002,3404129820,"Hardwick township, Warren County, New Jersey",34041,ONJ,502,530,28,6,8,34,1430,10,1464,1406,municipality,2000
1003,3404129820,"Hardwick township, Warren County, New Jersey",34041,ONJ,573,619,46,11,14,67,1629,9,1696,1595,municipality,2010
1004,3404130090,"Harmony township, Warren County, New Jersey",34041,ONJ,1010,1076,66,11,19,35,2694,21,2729,2643,municipality,2000
1005,3404130090,"Harmony township, Warren County, New Jersey",34041,ONJ,1017,1109,92,5,18,35,2632,19,2667,2590,municipality,2010
1006,3404133060,"Hope township, Warren County, New Jersey",34041,ONJ,697,747,50,8,8,28,1863,14,1891,1833,municipality,2000
1007,3404133060,"Hope township, Warren County, New Jersey",34041,ONJ,741,809,68,31,23,80,1872,12,1952,1806,municipality,2010
1008,3404133930,"Independence township, Warren County, New Jersey",34041,ONJ,2146,2210,64,94,65,211,5392,67,5603,5166,municipality,2000
1009,3404133930,"Independence township, Warren County, New Jersey",34041,ONJ,2234,2325,91,126,64,307,5355,78,5662,5087,municipality,2010
1010,3404137320,"Knowlton township, Warren County, New Jersey",34041,ONJ,1028,1135,107,19,11,55,2922,29,2977,2863,municipality,2000
1011,3404137320,"Knowlton township, Warren County, New Jersey",34041,ONJ,1097,1212,115,28,27,111,2944,43,3055,2846,municipality,2010
1012,3404140110,"Liberty township, Warren County, New Jersey",34041,ONJ,980,1088,108,16,10,74,2691,28,2765,2637,municipality,2000
1013,3404140110,"Liberty township, Warren County, New Jersey",34041,ONJ,1047,1151,104,41,30,122,2820,34,2942,2715,municipality,2010
1014,3404141490,"Lopatcong township, Warren County, New Jersey",34041,ONJ,2143,2429,286,94,62,115,5650,30,5765,5464,municipality,2000
1015,3404141490,"Lopatcong township, Warren County, New Jersey",34041,ONJ,3136,3420,284,334,458,480,7534,112,8014,6630,municipality,2010
1016,3404143320,"Mansfield township, Warren County, New Jersey",34041,ONJ,2334,2415,81,81,281,291,6362,126,6653,5874,municipality,2000
1017,3404143320,"Mansfield township, Warren County, New Jersey",34041,ONJ,2972,3316,344,248,355,845,6880,139,7725,6138,municipality,2010
1018,3404155530,"Oxford township, Warren County, New Jersey",34041,ONJ,886,938,52,12,27,80,2227,12,2307,2176,municipality,2000
1019,3404155530,"Oxford township, Warren County, New Jersey",34041,ONJ,950,1033,83,38,40,95,2419,25,2514,2316,municipality,2010
1020,3404158350,"Phillipsburg town, Warren County, New Jersey",34041,ONJ,6044,6651,607,126,502,816,14350,227,15166,13495,municipality,2000
1021,3404158350,"Phillipsburg town, Warren County, New Jersey",34041,ONJ,5925,6607,682,222,1037,1767,13183,369,14950,11555,municipality,2010
1022,3404159820,"Pohatcong township, Warren County, New Jersey",34041,ONJ,1341,1411,70,10,15,69,3347,20,3416,3302,municipality,2000
1023,3404159820,"Pohatcong township, Warren County, New Jersey",34041,ONJ,1310,1420,110,30,53,116,3223,41,3339,3099,municipality,2010
1024,3404177270,"Washington borough, Warren County, New Jersey",34041,ONJ,2724,2876,152,96,250,280,6432,89,6712,5997,municipality,2000
1025,3404177270,"Washington borough, Warren County, New Jersey",34041,ONJ,2623,2897,274,217,372,549,5912,129,6461,5194,municipality,2010
1026,3404177300,"Washington township, Warren County, New Jersey",34041,ONJ,2099,2174,75,59,103,135,6113,41,6248,5910,municipality,2000
1027,3404177300,"Washington township, Warren County, New Jersey",34041,ONJ,2380,2493,113,126,152,292,6359,78,6651,6003,municipality,2010
1028,3404180570,"White township, Warren County, New Jersey",34041,ONJ,1668,1770,102,25,51,90,4155,56,4245,4023,municipality,2000
1029,3404180570,"White township, Warren County, New Jersey",34041,ONJ,2115,2304,189,35,92,134,4748,52,4882,4569,municipality,2010
1030,3600508510,"Bronx borough, Bronx County, New York",36005,NYC,463212,490659,27447,38558,416338,644705,687945,39398,1332650,193651,municipality,2000
1031,3600508510,"Bronx borough, Bronx County, New York",36005,NYC,483449,511896,28447,47335,416695,741413,643695,28456,1385108,151209,municipality,2010
1032,3602701693,"Amenia town, Dutchess County, New York",36027,MHV,1625,1814,189,19,117,136,3912,88,4048,3688,municipality,2000
1033,3602701693,"Amenia town, Dutchess County, New York",36027,MHV,1741,2045,304,61,172,376,4060,107,4436,3720,municipality,2010
1034,3602705100,"Beacon city, Dutchess County, New York",36027,MHV,5091,5406,315,175,2556,2334,11474,366,13808,8377,municipality,2000
1035,3602705100,"Beacon city, Dutchess County, New York",36027,MHV,5347,5715,368,250,3232,3219,12322,507,15541,8333,municipality,2010
1036,3602705452,"Beekman town, Dutchess County, New York",36027,MHV,3751,4180,429,194,264,616,10836,167,11452,10211,municipality,2000
1037,3602705452,"Beekman town, Dutchess County, New York",36027,MHV,4251,4797,546,387,1559,1332,13289,276,14621,11067,municipality,2010
1038,3602716408,"Clinton town, Dutchess County, New York",36027,MHV,1502,1734,232,40,58,70,3940,43,4010,3799,municipality,2000
1039,3602716408,"Clinton town, Dutchess County, New York",36027,MHV,1602,1915,313,50,97,161,4151,74,4312,3930,municipality,2010
1040,3602720819,"Dover town, Dutchess County, New York",36027,MHV,3034,3266,232,84,440,484,8081,180,8565,7377,municipality,2000
1041,3602720819,"Dover town, Dutchess County, New York",36027,MHV,3259,3637,378,115,379,1199,7500,178,8699,6828,municipality,2010
1042,3602721996,"East Fishkill town, Dutchess County, New York",36027,MHV,8233,8495,262,713,563,1035,24554,333,25589,22945,municipality,2000
1043,3602721996,"East Fishkill town, Dutchess County, New York",36027,MHV,9512,10039,527,1162,918,2224,26805,430,29029,24295,municipality,2010
1044,3602725978,"Fishkill town, Dutchess County, New York",36027,MHV,6856,7040,184,600,2734,2121,18137,207,20258,14596,municipality,2000
1045,3602725978,"Fishkill town, Dutchess County, New York",36027,MHV,8642,9246,604,1695,2083,2420,19687,430,22107,15479,municipality,2010
1046,3602737209,"Hyde Park town, Dutchess County, New York",36027,MHV,7395,7704,309,288,846,674,20177,415,20851,18628,municipality,2000
1047,3602737209,"Hyde Park town, Dutchess County, New York",36027,MHV,7829,8416,587,526,1210,1204,20367,488,21571,18143,municipality,2010
1048,3602740299,"La Grange town, Dutchess County, New York",36027,MHV,5085,5240,155,434,340,636,14292,218,14928,13300,municipality,2000
1049,3602740299,"La Grange town, Dutchess County, New York",36027,MHV,5440,5668,228,630,545,1116,14614,251,15730,13188,municipality,2010
1050,3602747207,"Milan town, Dutchess County, New York",36027,MHV,882,1090,208,34,1186,715,3844,64,4559,2560,municipality,2000
1051,3602747207,"Milan town, Dutchess County, New York",36027,MHV,964,1279,315,12,35,105,2265,29,2370,2189,municipality,2010
1052,3602751891,"North East town, Dutchess County, New York",36027,MHV,1146,1366,220,17,63,98,2904,31,3002,2793,municipality,2000
1053,3602751891,"North East town, Dutchess County, New York",36027,MHV,1259,1627,368,32,74,275,2756,56,3031,2594,municipality,2010
1054,3602756825,"Pawling town, Dutchess County, New York",36027,MHV,2823,3101,278,95,101,365,7156,83,7521,6877,municipality,2000
1055,3602756825,"Pawling town, Dutchess County, New York",36027,MHV,3093,3593,500,183,211,865,7598,102,8463,7102,municipality,2010
1056,3602758156,"Pine Plains town, Dutchess County, New York",36027,MHV,988,1161,173,17,23,35,2534,48,2569,2446,municipality,2000
1057,3602758156,"Pine Plains town, Dutchess County, New York",36027,MHV,1007,1284,277,26,29,172,2301,38,2473,2208,municipality,2010
1058,3602758695,"Pleasant Valley town, Dutchess County, New York",36027,MHV,3467,3614,147,58,166,240,8826,108,9066,8494,municipality,2000
1059,3602758695,"Pleasant Valley town, Dutchess County, New York",36027,MHV,3765,4049,284,109,264,452,9220,210,9672,8637,municipality,2010
1060,3602759641,"Poughkeepsie city, Dutchess County, New York",36027,MHV,12014,13153,1139,480,10354,3177,26694,1154,29871,14706,municipality,2000
1061,3602759641,"Poughkeepsie city, Dutchess County, New York",36027,MHV,12400,13984,1584,521,10407,6384,26352,1172,32736,14252,municipality,2010
1062,3602759652,"Poughkeepsie town, Dutchess County, New York",36027,MHV,14605,15132,527,2177,3326,2254,40523,789,42777,34231,municipality,2000
1063,3602759652,"Poughkeepsie town, Dutchess County, New York",36027,MHV,15276,16116,840,2614,3983,4233,39108,1257,43341,31254,municipality,2010
1064,3602760905,"Red Hook town, Dutchess County, New York",36027,MHV,3574,3840,266,215,135,276,10132,172,10408,9610,municipality,2000
1065,3602760905,"Red Hook town, Dutchess County, New York",36027,MHV,3942,4384,442,272,190,555,10764,213,11319,10089,municipality,2010
1066,3602761357,"Rhinebeck town, Dutchess County, New York",36027,MHV,3001,3255,254,106,267,306,7456,88,7762,6995,municipality,2000
1067,3602761357,"Rhinebeck town, Dutchess County, New York",36027,MHV,3158,3653,495,132,185,387,7161,106,7548,6738,municipality,2010
1068,3602770662,"Stanford town, Dutchess County, New York",36027,MHV,1398,1712,314,39,54,94,3450,58,3544,3299,municipality,2000
1069,3602770662,"Stanford town, Dutchess County, New York",36027,MHV,1496,1913,417,39,64,219,3604,78,3823,3423,municipality,2010
1070,3602776166,"Union Vale town, Dutchess County, New York",36027,MHV,1359,1464,105,54,107,156,4390,50,4546,4179,municipality,2000
1071,3602776166,"Union Vale town, Dutchess County, New York",36027,MHV,1708,1911,203,110,74,227,4650,60,4877,4406,municipality,2010
1072,3602778157,"Wappinger town, Dutchess County, New York",36027,MHV,9793,10144,351,1120,1235,2068,24206,419,26274,21432,municipality,2000
1073,3602778157,"Wappinger town, Dutchess County, New York",36027,MHV,10318,10908,590,1341,1564,3860,23188,542,27048,19741,municipality,2010
1074,3602778388,"Washington town, Dutchess County, New York",36027,MHV,1914,2192,278,31,124,170,4572,47,4742,4370,municipality,2000
1075,3602778388,"Washington town, Dutchess County, New York",36027,MHV,1956,2459,503,63,120,282,4459,80,4741,4196,municipality,2010
1076,3604710022,"Brooklyn borough, Kings County, New York",36047,NYC,880727,930866,50139,184291,848583,487878,1977448,90042,2465326,854532,municipality,2000
1077,3604710022,"Brooklyn borough, Kings County, New York",36047,NYC,916856,1000293,83437,260129,799066,496285,2008415,55914,2504700,893306,municipality,2010
1078,3601011,"Albertson CDP, New York",36059,LI,1789,1850,61,1256,12,377,4805,152,5182,3385,municipality,2010
1079,3602968,"Atlantic Beach village, New York",36059,LI,857,1091,234,18,12,74,1817,11,1891,1776,municipality,2010
1080,3604143,"Baldwin CDP, New York",36059,LI,10447,10783,336,1371,9941,5821,26314,998,32135,14004,municipality,2010
1081,3604550,"Barnum Island CDP, New York",36059,LI,843,889,46,64,22,377,2037,37,2414,1914,municipality,2010
1082,3604803,"Baxter Estates village, New York",36059,LI,382,411,29,60,12,168,831,16,999,743,municipality,2010
1083,3604891,"Bay Park CDP, New York",36059,LI,867,903,36,37,6,141,2071,14,2212,2014,municipality,2010
1084,3605034,"Bayville village, New York",36059,LI,2471,2651,180,112,18,433,6236,93,6669,6013,municipality,2010
1085,3605639,"Bellerose village, New York",36059,LI,375,378,3,52,35,113,1080,29,1193,964,municipality,2010
1086,3605661,"Bellerose Terrace CDP, New York",36059,LI,633,665,32,611,168,568,1630,87,2198,764,municipality,2010
1087,3605738,"Bellmore CDP, New York",36059,LI,5669,5807,138,477,158,922,15296,183,16218,14478,municipality,2010
1088,3606387,"Bethpage CDP, New York",36059,LI,5875,6051,176,895,90,1152,15277,197,16429,14095,municipality,2010
1089,3610132,"Brookville village, New York",36059,LI,612,663,51,351,372,219,3246,38,3465,2485,municipality,2010
1090,3612419,"Carle Place CDP, New York",36059,LI,1863,1932,69,391,90,552,4429,67,4981,3881,municipality,2010
1091,3613233,"Cedarhurst village, New York",36059,LI,2242,2375,133,236,134,705,5887,94,6592,5423,municipality,2010
1092,3613618,"Centre Island village, New York",36059,LI,168,232,64,15,0,30,380,3,410,362,municipality,2010
1093,3618597,"Cove Neck village, New York",36059,LI,104,148,44,4,1,14,272,3,286,264,municipality,2010
1094,3621578,"East Atlantic Beach CDP, New York",36059,LI,849,972,123,22,12,109,1940,17,2049,1889,municipality,2010
1095,3622260,"East Hills village, New York",36059,LI,2252,2301,49,513,66,156,6799,80,6955,6140,municipality,2010
1096,3622480,"East Massapequa CDP, New York",36059,LI,6599,6796,197,404,2298,1929,17140,340,19069,14098,municipality,2010
1097,3622502,"East Meadow CDP, New York",36059,LI,12410,12863,453,4400,1867,4653,33479,584,38132,26628,municipality,2010
1098,3622623,"East Norwich CDP, New York",36059,LI,943,966,23,92,19,118,2591,27,2709,2453,municipality,2010
1099,3622876,"East Rockaway village, New York",36059,LI,3825,3997,172,200,127,788,9030,86,9818,8617,municipality,2010
1100,3623217,"East Williston village, New York",36059,LI,842,864,22,99,8,110,2446,23,2556,2316,municipality,2010
1101,3624273,"Elmont CDP, New York",36059,LI,9847,10279,432,3609,14587,7236,25962,1272,33198,6494,municipality,2010
1102,3625384,"Farmingdale village, New York",36059,LI,3326,3482,156,445,199,1122,7067,108,8189,6315,municipality,2010
1103,3626264,"Floral Park village, New York",36059,LI,5680,5909,229,1086,198,1391,14472,250,15863,12938,municipality,2010
1104,3626352,"Flower Hill village, New York",36059,LI,1473,1523,50,591,34,271,4394,99,4665,3670,municipality,2010
1105,3627309,"Franklin Square CDP, New York",36059,LI,9941,10313,372,2100,845,3885,25435,478,29320,22012,municipality,2010
1106,3627485,"Freeport village, New York",36059,LI,13279,13865,586,669,13226,17858,25002,994,42860,10113,municipality,2010
1107,3628178,"Garden City village, New York",36059,LI,7366,7647,281,792,294,1003,21368,248,22371,20034,municipality,2010
1108,3628189,"Garden City Park CDP, New York",36059,LI,2533,2603,70,2578,282,942,6864,214,7806,3790,municipality,2010
1109,3628200,"Garden City South CDP, New York",36059,LI,1384,1429,45,229,33,317,3707,31,4024,3414,municipality,2010
1110,3629113,"Glen Cove city, New York",36059,LI,9764,10352,588,1235,1728,7513,19451,475,26964,16013,municipality,2010
1111,3629245,"Glen Head CDP, New York",36059,LI,1718,1784,66,158,36,380,4317,73,4697,4050,municipality,2010
1112,3629421,"Glenwood Landing CDP, New York",36059,LI,1336,1400,64,140,29,232,3547,45,3779,3333,municipality,2010
1113,3630169,"Great Neck village, New York",36059,LI,3473,3645,172,721,176,1015,8974,328,9989,7749,municipality,2010
1114,3630191,"Great Neck Estates village, New York",36059,LI,902,937,35,281,21,80,2681,43,2761,2336,municipality,2010
1115,3630202,"Great Neck Gardens CDP, New York",36059,LI,393,401,8,143,9,20,1166,46,1186,968,municipality,2010
1116,3630213,"Great Neck Plaza village, New York",36059,LI,3690,4052,362,769,88,526,6181,119,6707,5205,municipality,2010
1117,3630598,"Greenvale CDP, New York",36059,LI,358,373,15,206,20,149,945,32,1094,687,municipality,2010
1118,3632094,"Harbor Hills CDP, New York",36059,LI,180,190,10,30,0,11,564,4,575,530,municipality,2010
1119,3632105,"Harbor Isle CDP, New York",36059,LI,470,495,25,21,4,77,1224,21,1301,1178,municipality,2010
1120,3633139,"Hempstead village, New York",36059,LI,15234,16034,800,704,24724,23823,30068,1092,53891,3548,municipality,2010
1121,3634198,"Herricks CDP, New York",36059,LI,1343,1378,35,1854,19,169,4126,116,4295,2137,municipality,2010
1122,3634286,"Hewlett CDP, New York",36059,LI,2547,2708,161,480,152,727,6092,97,6819,5363,municipality,2010
1123,3634297,"Hewlett Bay Park village, New York",36059,LI,131,145,14,23,0,22,382,3,404,356,municipality,2010
1124,3634308,"Hewlett Harbor village, New York",36059,LI,418,442,24,49,10,30,1233,14,1263,1160,municipality,2010
1125,3634319,"Hewlett Neck village, New York",36059,LI,145,159,14,9,17,9,436,3,445,407,municipality,2010
1126,3634374,"Hicksville CDP, New York",36059,LI,13412,13761,349,8139,836,6043,35504,926,41547,25603,municipality,2010
1127,3637583,"Inwood CDP, New York",36059,LI,2964,3153,189,322,2258,4190,5602,236,9792,2786,municipality,2010
1128,3637847,"Island Park village, New York",36059,LI,1603,1715,112,115,64,1234,3421,72,4655,3170,municipality,2010
1129,3638539,"Jericho CDP, New York",36059,LI,4628,4782,154,3442,247,401,13166,180,13567,9297,municipality,2010
1130,3639309,"Kensington village, New York",36059,LI,411,448,37,101,8,26,1135,38,1161,988,municipality,2010
1131,3639694,"Kings Point village, New York",36059,LI,1293,1386,93,167,40,84,4921,199,5005,4515,municipality,2010
1132,3640937,"Lake Success village, New York",36059,LI,799,826,27,791,96,81,2853,46,2934,1920,municipality,2010
1133,3641003,"Lakeview CDP, New York",36059,LI,1487,1552,65,44,4399,853,4762,191,5615,128,municipality,2010
1134,3641432,"Lattingtown village, New York",36059,LI,614,707,93,47,8,41,1698,27,1739,1616,municipality,2010
1135,3641487,"Laurel Hollow village, New York",36059,LI,602,635,33,149,29,45,1907,21,1952,1708,municipality,2010
1136,3641553,"Lawrence village, New York",36059,LI,2045,2280,235,108,86,185,6298,29,6483,6075,municipality,2010
1137,3642081,"Levittown CDP, New York",36059,LI,16973,17287,314,2937,403,5979,45902,748,51881,41814,municipality,2010
1138,3642279,"Lido Beach CDP, New York",36059,LI,1192,1403,211,51,18,105,2792,33,2897,2690,municipality,2010
1139,3643192,"Locust Valley CDP, New York",36059,LI,1208,1281,73,82,99,600,2806,37,3406,2588,municipality,2010
1140,3643335,"Long Beach city, New York",36059,LI,14809,16450,1641,881,1958,4691,28584,628,33275,25117,municipality,2010
1141,3643874,"Lynbrook village, New York",36059,LI,7513,7921,408,867,648,2534,16893,288,19427,15090,municipality,2010
1142,3644787,"Malverne village, New York",36059,LI,3076,3146,70,354,260,736,7778,98,8514,7066,municipality,2010
1143,3644792,"Malverne Park Oaks CDP, New York",36059,LI,183,189,6,19,27,44,461,11,505,404,municipality,2010
1144,3644897,"Manhasset CDP, New York",36059,LI,2790,2893,103,877,744,711,7369,119,8080,5629,municipality,2010
1145,3644908,"Manhasset Hills CDP, New York",36059,LI,1184,1241,57,1412,22,210,3382,80,3592,1868,municipality,2010
1146,3645106,"Manorhaven village, New York",36059,LI,2442,2597,155,1150,90,1775,4781,94,6556,3447,municipality,2010
1147,3645986,"Massapequa CDP, New York",36059,LI,7226,7407,181,350,70,900,20785,167,21685,20198,municipality,2010
1148,3645997,"Massapequa Park village, New York",36059,LI,5731,5844,113,255,52,757,16251,86,17008,15858,municipality,2010
1149,3646107,"Matinecock village, New York",36059,LI,272,323,51,16,14,50,760,3,810,727,municipality,2010
1150,3646668,"Merrick CDP, New York",36059,LI,7448,7622,174,619,246,1301,20796,239,22097,19692,municipality,2010
1151,3647405,"Mill Neck village, New York",36059,LI,379,440,61,61,12,57,940,18,997,849,municipality,2010
1152,3647636,"Mineola village, New York",36059,LI,7396,7701,305,1579,321,3090,15709,367,18799,13442,municipality,2010
1153,3649231,"Munsey Park village, New York",36059,LI,819,840,21,173,11,87,2606,42,2693,2380,municipality,2010
1154,3649330,"Muttontown village, New York",36059,LI,1071,1125,54,794,54,119,3378,45,3497,2485,municipality,2010
1155,3650067,"New Cassel CDP, New York",36059,LI,2974,3174,200,174,5225,7577,6482,242,14059,841,municipality,2010
1156,3650397,"New Hyde Park village, New York",36059,LI,3271,3371,100,2521,104,1184,8528,261,9712,5642,municipality,2010
1157,3651517,"North Bellmore CDP, New York",36059,LI,6650,6818,168,904,492,1539,18402,302,19941,16704,municipality,2010
1158,3653022,"North Hills village, New York",36059,LI,2259,2438,179,1283,54,112,4963,96,5075,3530,municipality,2010
1159,3653231,"North Lynbrook CDP, New York",36059,LI,231,231,0,41,26,119,674,21,793,586,municipality,2010
1160,3653253,"North Massapequa CDP, New York",36059,LI,6084,6212,128,315,46,968,16918,127,17886,16430,municipality,2010
1161,3653264,"North Merrick CDP, New York",36059,LI,4044,4125,81,567,169,869,11403,130,12272,10537,municipality,2010
1162,3653275,"North New Hyde Park CDP, New York",36059,LI,4888,5016,128,4329,90,1078,13821,343,14899,9059,municipality,2010
1163,3653748,"North Valley Stream CDP, New York",36059,LI,5113,5548,435,2132,7720,2411,14217,600,16628,3765,municipality,2010
1164,3653792,"North Wantagh CDP, New York",36059,LI,4230,4321,91,294,77,897,11063,95,11960,10597,municipality,2010
1165,3654441,"Oceanside CDP, New York",36059,LI,11249,11604,355,879,356,2970,29139,308,32109,27596,municipality,2010
1166,3654551,"Old Bethpage CDP, New York",36059,LI,1894,1927,33,342,11,189,5334,55,5523,4926,municipality,2010
1167,3654562,"Old Brookville village, New York",36059,LI,669,720,51,238,42,122,2012,37,2134,1695,municipality,2010
1168,3654705,"Old Westbury village, New York",36059,LI,1073,1172,99,574,708,316,4355,123,4671,2950,municipality,2010
1169,3655992,"Oyster Bay CDP, New York",36059,LI,2758,2947,189,195,199,1119,5588,112,6707,5082,municipality,2010
1170,3656011,"Oyster Bay Cove village, New York",36059,LI,708,758,50,187,33,48,2149,19,2197,1910,municipality,2010
1171,3658409,"Plainedge CDP, New York",36059,LI,2875,2936,61,399,64,684,8133,86,8817,7584,municipality,2010
1172,3658442,"Plainview CDP, New York",36059,LI,9070,9281,211,2799,110,1046,25171,381,26217,21881,municipality,2010
1173,3658475,"Plandome village, New York",36059,LI,416,431,15,49,11,30,1319,7,1349,1252,municipality,2010
1174,3658486,"Plandome Heights village, New York",36059,LI,323,330,7,86,2,45,960,17,1005,855,municipality,2010
1175,3658497,"Plandome Manor village, New York",36059,LI,280,295,15,53,1,22,850,19,872,777,municipality,2010
1176,3658849,"Point Lookout CDP, New York",36059,LI,500,666,166,12,5,39,1180,4,1219,1159,municipality,2010
1177,3659520,"Port Washington CDP, New York",36059,LI,5698,6234,536,1273,346,2116,13730,267,15846,11844,municipality,2010
1178,3659531,"Port Washington North village, New York",36059,LI,1298,1395,97,263,44,200,2954,42,3154,2605,municipality,2010
1179,3663264,"Rockville Centre village, New York",36059,LI,9258,9679,421,498,1039,2169,21854,302,24023,20015,municipality,2010
1180,3663506,"Roosevelt CDP, New York",36059,LI,4031,4356,325,85,9873,5548,10710,426,16258,326,municipality,2010
1181,3663770,"Roslyn village, New York",36059,LI,1193,1288,95,243,58,311,2459,53,2770,2105,municipality,2010
1182,3663792,"Roslyn Estates village, New York",36059,LI,415,428,13,103,4,17,1234,12,1251,1115,municipality,2010
1183,3663803,"Roslyn Harbor village, New York",36059,LI,361,382,21,124,15,56,995,18,1051,838,municipality,2010
1184,3663814,"Roslyn Heights CDP, New York",36059,LI,2157,2263,106,1357,397,556,6021,209,6577,4058,municipality,2010
1185,3664232,"Russell Gardens village, New York",36059,LI,343,359,16,194,2,37,908,21,945,691,municipality,2010
1186,3664430,"Saddle Rock village, New York",36059,LI,267,280,13,54,3,14,816,25,830,734,municipality,2010
1187,3664441,"Saddle Rock Estates CDP, New York",36059,LI,140,142,2,11,0,2,464,11,466,442,municipality,2010
1188,3664842,"Salisbury CDP, New York",36059,LI,4004,4098,94,1521,211,1780,10313,205,12093,8376,municipality,2010
1189,3665035,"Sands Point village, New York",36059,LI,872,934,62,219,20,125,2550,46,2675,2265,municipality,2010
1190,3666047,"Sea Cliff village, New York",36059,LI,1960,2049,89,94,113,341,4654,53,4995,4394,municipality,2010
1191,3666058,"Seaford CDP, New York",36059,LI,5266,5395,129,334,70,761,14533,143,15294,13986,municipality,2010
1192,3666102,"Searingtown CDP, New York",36059,LI,1563,1604,41,1907,48,178,4737,115,4915,2667,municipality,2010
1193,3669001,"South Farmingdale CDP, New York",36059,LI,4784,4888,104,644,186,1454,13032,177,14486,12025,municipality,2010
1194,3669023,"South Floral Park village, New York",36059,LI,530,569,39,137,971,316,1448,95,1764,245,municipality,2010
1195,3669188,"South Hempstead CDP, New York",36059,LI,1047,1076,29,78,410,601,2642,58,3243,2096,municipality,2010
1196,3669892,"South Valley Stream CDP, New York",36059,LI,1969,2043,74,1079,1311,584,5378,210,5962,2778,municipality,2010
1197,3671267,"Stewart Manor village, New York",36059,LI,699,711,12,91,45,94,1802,20,1896,1646,municipality,2010
1198,3672554,"Syosset CDP, New York",36059,LI,6188,6339,151,4162,137,775,18054,297,18829,13458,municipality,2010
1199,3673605,"Thomaston village, New York",36059,LI,958,1004,46,731,25,137,2480,57,2617,1667,municipality,2010
1200,3676089,"Uniondale CDP, New York",36059,LI,7296,7652,356,774,12618,10173,20794,729,30967,6673,municipality,2010
1201,3676287,"University Gardens CDP, New York",36059,LI,1645,1695,50,1246,71,318,3908,87,4226,2504,municipality,2010
1202,3676331,"Upper Brookville village, New York",36059,LI,569,611,42,161,16,80,1618,36,1698,1405,municipality,2010
1203,3676705,"Valley Stream village, New York",36059,LI,12189,12625,436,4237,6544,8344,29167,1145,37511,17241,municipality,2010
1204,3678146,"Wantagh CDP, New York",36059,LI,6126,6250,124,372,51,889,17982,179,18871,17380,municipality,2010
1205,3679444,"Westbury village, New York",36059,LI,5078,5271,193,898,3127,4128,11018,348,15146,6645,municipality,2010
1206,3680225,"West Hempstead CDP, New York",36059,LI,5939,6130,191,1129,1807,3098,15764,404,18862,12424,municipality,2010
1207,3682117,"Williston Park village, New York",36059,LI,2668,2743,75,852,55,442,6845,121,7287,5817,municipality,2010
1208,3682744,"Woodbury CDP, New York",36059,LI,3054,3178,124,912,114,199,8708,96,8907,7586,municipality,2010
1209,3682942,"Woodmere CDP, New York",36059,LI,5336,5570,234,786,687,790,16331,120,17121,14738,municipality,2010
1210,3682986,"Woodsburgh village, New York",36059,LI,267,300,33,22,7,23,755,11,778,715,municipality,2010
1211,3605929113,"Glen Cove city, Nassau County, New York",36059,LI,9461,9734,273,1082,1614,5336,21286,446,26622,18144,municipality,2000
1212,3605929113,"Glen Cove city, Nassau County, New York",36059,LI,9764,10352,588,1235,1728,7513,19451,475,26964,16013,municipality,2010
1213,3605934000,"Hempstead town, Nassau County, New York",36059,LI,246828,252286,5458,26427,107929,86657,669267,13559,755924,521352,municipality,2000
1214,3605934000,"Hempstead town, Nassau County, New York",36059,LI,246456,256734,10278,39084,119480,132154,627603,14156,759757,454883,municipality,2010
1215,3605943335,"Long Beach city, Nassau County, New York",36059,LI,14923,16128,1205,814,2071,4540,30922,709,35462,27328,municipality,2000
1216,3605943335,"Long Beach city, Nassau County, New York",36059,LI,14809,16450,1641,881,1958,4691,28584,628,33275,25117,municipality,2010
1217,3605953000,"North Hempstead town, Nassau County, New York",36059,LI,76820,78927,2107,20209,13651,21872,200739,4117,222611,162762,municipality,2000
1218,3605953000,"North Hempstead town, Nassau County, New York",36059,LI,78080,81961,3881,33747,11971,29074,197248,4770,226322,146760,municipality,2010
1219,3605956000,"Oyster Bay town, Nassau County, New York",36059,LI,99355,101076,1721,14212,4595,14877,279048,2880,293925,257361,municipality,2000
1220,3605956000,"Oyster Bay town, Nassau County, New York",36059,LI,99419,102849,3430,26611,6168,21923,271291,3976,293214,234536,municipality,2010
1221,3606144919,"Manhattan borough, New York County, New York",36061,NYC,738644,798144,59500,143291,234698,417816,1119379,37517,1537195,703873,municipality,2000
1222,3606144919,"Manhattan borough, New York County, New York",36061,NYC,763846,847090,83244,177624,205340,403577,1182296,37839,1585873,761493,municipality,2010
1223,3607107003,"Blooming Grove town, Orange County, New York",36071,MHV,5836,6559,723,235,599,1556,15795,315,17351,14646,municipality,2000
1224,3607107003,"Blooming Grove town, Orange County, New York",36071,MHV,6284,6954,670,392,953,2709,15319,397,18028,13577,municipality,2010
1225,3607115308,"Chester town, Orange County, New York",36071,MHV,3848,3984,136,319,768,1231,10909,153,12140,9669,municipality,2000
1226,3607115308,"Chester town, Orange County, New York",36071,MHV,4135,4372,237,490,812,1669,10312,315,11981,8695,municipality,2010
1227,3607118300,"Cornwall town, Orange County, New York",36071,MHV,4625,4852,227,150,144,629,11678,158,12307,11226,municipality,2000
1228,3607118300,"Cornwall town, Orange County, New York",36071,MHV,4742,5136,394,212,221,1046,11600,251,12646,10916,municipality,2010
1229,3607118916,"Crawford town, Orange County, New York",36071,MHV,2707,2851,144,57,89,404,7471,85,7875,7240,municipality,2000
1230,3607118916,"Crawford town, Orange County, New York",36071,MHV,3279,3475,196,139,303,924,8392,214,9316,7736,municipality,2010
1231,3607119961,"Deerpark town, Orange County, New York",36071,MHV,2906,3332,426,45,117,300,7558,99,7858,7297,municipality,2000
1232,3607119961,"Deerpark town, Orange County, New York",36071,MHV,2988,3484,496,89,174,547,7354,192,7901,6899,municipality,2010
1233,3607129553,"Goshen town, Orange County, New York",36071,MHV,4074,4320,246,219,801,950,11963,105,12913,10838,municipality,2000
1234,3607129553,"Goshen town, Orange County, New York",36071,MHV,4536,4921,385,347,888,1867,11820,268,13687,10317,municipality,2010
1235,3607130631,"Greenville town, Orange County, New York",36071,MHV,1243,1365,122,40,47,170,3630,36,3800,3507,municipality,2000
1236,3607130631,"Greenville town, Orange County, New York",36071,MHV,1504,1653,149,66,113,425,4191,93,4616,3919,municipality,2010
1237,3607131907,"Hamptonburgh town, Orange County, New York",36071,MHV,1467,1532,65,69,88,207,4479,77,4686,4245,municipality,2000
1238,3607131907,"Hamptonburgh town, Orange County, New York",36071,MHV,1739,1819,80,167,202,484,5077,113,5561,4595,municipality,2010
1239,3607134550,"Highlands town, Orange County, New York",36071,MHV,3230,3418,188,324,1064,962,11522,373,12484,9761,municipality,2000
1240,3607134550,"Highlands town, Orange County, New York",36071,MHV,3026,3487,461,416,934,1585,10907,537,12492,9020,municipality,2010
1241,3607147042,"Middletown city, Orange County, New York",36071,MHV,9466,10124,658,423,3350,6375,19013,817,25388,14423,municipality,2000
1242,3607147042,"Middletown city, Orange County, New York",36071,MHV,9976,10866,890,503,5075,11158,16928,930,28086,10420,municipality,2010
1243,3607147713,"Minisink town, Orange County, New York",36071,MHV,1182,1245,63,21,37,165,3420,21,3585,3341,municipality,2000
1244,3607147713,"Minisink town, Orange County, New York",36071,MHV,1485,1561,76,49,105,410,4080,74,4490,3852,municipality,2010
1245,3607147999,"Monroe town, Orange County, New York",36071,MHV,8228,8517,289,425,369,1543,29864,322,31407,28748,municipality,2000
1246,3607147999,"Monroe town, Orange County, New York",36071,MHV,10312,11144,832,980,772,3365,36547,455,39912,34340,municipality,2010
1247,3607148153,"Montgomery town, Orange County, New York",36071,MHV,7273,7643,370,137,694,1620,19271,302,20891,18138,municipality,2000
1248,3607148153,"Montgomery town, Orange County, New York",36071,MHV,8000,8523,523,318,1378,3167,19439,493,22606,17250,municipality,2010
1249,3607148857,"Mount Hope town, Orange County, New York",36071,MHV,1582,1714,132,97,989,970,5669,69,6639,4514,municipality,2000
1250,3607148857,"Mount Hope town, Orange County, New York",36071,MHV,1770,1955,185,109,1025,1121,5897,135,7018,4628,municipality,2010
1251,3607150034,"Newburgh city, Orange County, New York",36071,MHV,9144,10476,1332,202,8961,10257,18002,870,28259,7969,municipality,2000
1252,3607150034,"Newburgh city, Orange County, New York",36071,MHV,9030,10505,1475,257,8071,13814,15052,844,28866,5880,municipality,2010
1253,3607150045,"Newburgh town, Orange County, New York",36071,MHV,9765,10122,357,557,1873,2644,24924,449,27568,22045,municipality,2000
1254,3607150045,"Newburgh town, Orange County, New York",36071,MHV,10762,11313,551,865,3289,4664,25137,653,29801,20330,municipality,2010
1255,3607150848,"New Windsor town, Orange County, New York",36071,MHV,8396,8759,363,389,1446,2538,20328,446,22866,18047,municipality,2000
1256,3607150848,"New Windsor town, Orange County, New York",36071,MHV,9291,9862,571,840,2599,4920,20324,581,25244,16304,municipality,2010
1257,3607159388,"Port Jervis city, Orange County, New York",36071,MHV,3533,3851,318,57,333,660,8200,221,8860,7589,municipality,2000
1258,3607159388,"Port Jervis city, Orange County, New York",36071,MHV,3570,3957,387,108,565,1054,7774,366,8828,6735,municipality,2010
1259,3607175781,"Tuxedo town, Orange County, New York",36071,MHV,1337,1457,120,103,39,142,3192,57,3334,2993,municipality,2000
1260,3607175781,"Tuxedo town, Orange County, New York",36071,MHV,1457,1691,234,190,73,258,3366,74,3624,3029,municipality,2010
1261,3607177992,"Wallkill town, Orange County, New York",36071,MHV,8866,9283,417,584,2145,3304,21355,606,24659,18020,municipality,2000
1262,3607177992,"Wallkill town, Orange County, New York",36071,MHV,10133,10777,644,855,3939,6162,21264,824,27426,15646,municipality,2010
1263,3607178366,"Warwick town, Orange County, New York",36071,MHV,10868,11818,950,259,1234,1991,28773,455,30764,26825,municipality,2000
1264,3607178366,"Warwick town, Orange County, New York",36071,MHV,11835,12982,1147,463,1425,3279,28786,590,32065,26308,municipality,2010
1265,3607178839,"Wawayanda town, Orange County, New York",36071,MHV,2095,2174,79,101,107,369,5904,90,6273,5606,municipality,2000
1266,3607178839,"Wawayanda town, Orange County, New York",36071,MHV,2444,2630,186,139,331,883,6383,125,7266,5788,municipality,2010
1267,3607182755,"Woodbury town, Orange County, New York",36071,MHV,3117,3358,241,241,273,751,8709,122,9460,8073,municipality,2000
1268,3607182755,"Woodbury town, Orange County, New York",36071,MHV,3627,3958,331,691,648,1674,9679,265,11353,8075,municipality,2010
1269,3607912529,"Carmel town, Putnam County, New York",36079,LHV,10847,11283,436,386,325,1955,31051,402,33006,29938,municipality,2000
1270,3607912529,"Carmel town, Putnam County, New York",36079,LHV,11672,12348,676,588,545,3469,30836,400,34305,29303,municipality,2010
1271,3607939331,"Kent town, Putnam County, New York",36079,LHV,4868,5353,485,166,193,808,13201,199,14009,12643,municipality,2000
1272,3607939331,"Kent town, Putnam County, New York",36079,LHV,4888,5508,620,245,308,1755,11752,220,13507,10979,municipality,2010
1273,3607956748,"Patterson town, Putnam County, New York",36079,LHV,3529,3746,217,140,380,792,10514,188,11306,9806,municipality,2000
1274,3607956748,"Patterson town, Putnam County, New York",36079,LHV,3905,4272,367,209,480,1555,10468,225,12023,9554,municipality,2010
1275,3607957584,"Philipstown town, Putnam County, New York",36079,LHV,3599,3983,384,98,86,357,9065,102,9422,8779,municipality,2000
1276,3607957584,"Philipstown town, Putnam County, New York",36079,LHV,3685,4164,479,134,148,671,8991,187,9662,8522,municipality,2010
1277,3607960147,"Putnam Valley town, Putnam County, New York",36079,LHV,3676,4253,577,84,149,671,10015,169,10686,9613,municipality,2000
1278,3607960147,"Putnam Valley town, Putnam County, New York",36079,LHV,4216,4837,621,207,239,1159,10650,207,11809,9997,municipality,2010
1279,3607968924,"Southeast town, Putnam County, New York",36079,LHV,6184,6412,228,283,304,1393,15923,142,17316,15194,municipality,2000
1280,3607968924,"Southeast town, Putnam County, New York",36079,LHV,6675,7095,420,449,327,3052,15352,222,18404,14354,municipality,2010
1281,3608160323,"Queens borough, Queens County, New York",36081,NYC,782664,817250,34586,389303,422831,556605,1672774,127745,2229379,732895,municipality,2000
1282,3608160323,"Queens borough, Queens County, New York",36081,NYC,780117,835127,55010,508334,395881,613750,1616972,96030,2230722,616727,municipality,2010
1283,3608570915,"Staten Island borough, Richmond County, New York",36085,NYC,156341,163993,7652,24786,39704,53550,390178,9372,443728,316316,municipality,2000
1284,3608570915,"Staten Island borough, Richmond County, New York",36085,NYC,165516,176656,11140,34697,44313,81051,387679,8500,468730,300169,municipality,2010
1285,3608715968,"Clarkstown town, Rockland County, New York",36087,LHV,27697,28220,523,6442,6178,5683,76399,1428,82082,62351,municipality,2000
1286,3608715968,"Clarkstown town, Rockland County, New York",36087,LHV,29234,30314,1080,8748,7598,9831,74356,1641,84187,56369,municipality,2010
1287,3608732765,"Haverstraw town, Rockland County, New York",36087,LHV,11255,11553,298,1062,3146,10729,23082,741,33811,18133,municipality,2000
1288,3608732765,"Haverstraw town, Rockland County, New York",36087,LHV,12170,12809,639,1559,4627,15012,21622,730,36634,14706,municipality,2010
1289,3608755211,"Orangetown town, Rockland County, New York",36087,LHV,17330,17827,497,3056,2687,2873,44838,881,47711,38214,municipality,2000
1290,3608755211,"Orangetown town, Rockland County, New York",36087,LHV,17826,18611,785,3386,2742,4782,44430,812,49212,37490,municipality,2010
1291,3608760510,"Ramapo town, Rockland County, New York",36087,LHV,31561,32422,861,4964,17965,8923,99982,2854,108905,74199,municipality,2000
1292,3608760510,"Ramapo town, Rockland County, New York",36087,LHV,34731,36754,2023,5013,19173,17223,109372,2092,126595,83094,municipality,2010
1293,3608771674,"Stony Point town, Rockland County, New York",36087,LHV,4832,4951,119,183,163,974,13270,168,14244,12756,municipality,2000
1294,3608771674,"Stony Point town, Rockland County, New York",36087,LHV,5281,5569,288,393,483,1935,13124,237,15059,12011,municipality,2010
1295,3601594,"Amagansett CDP, New York",36103,LI,513,1790,1277,22,13,119,1046,7,1165,1004,municipality,2010
1296,3602044,"Amityville village, New York",36103,LI,3690,3997,307,166,874,1249,8274,138,9523,7096,municipality,2010
1297,3602374,"Aquebogue CDP, New York",36103,LI,932,1127,195,5,102,290,2148,14,2438,2027,municipality,2010
1298,3602737,"Asharoken village, New York",36103,LI,255,302,47,13,0,20,634,9,654,612,municipality,2010
1299,3603408,"Babylon village, New York",36103,LI,4585,4768,183,263,221,817,11349,207,12166,10658,municipality,2010
1300,3604055,"Baiting Hollow CDP, New York",36103,LI,719,1208,489,12,15,98,1544,8,1642,1509,municipality,2010
1301,3604913,"Bayport CDP, New York",36103,LI,3346,3515,169,151,115,470,8426,88,8896,8072,municipality,2010
1302,3604935,"Bay Shore CDP, New York",36103,LI,9064,9663,599,845,4590,8101,18236,746,26337,12055,municipality,2010
1303,3605039,"Baywood CDP, New York",36103,LI,2162,2272,110,288,976,2548,4802,166,7350,3372,municipality,2010
1304,3605672,"Belle Terre village, New York",36103,LI,286,308,22,26,10,31,761,11,792,714,municipality,2010
1305,3605771,"Bellport village, New York",36103,LI,921,1170,249,27,32,87,1997,42,2084,1896,municipality,2010
1306,3607069,"Blue Point CDP, New York",36103,LI,1680,1747,67,78,36,200,4573,57,4773,4402,municipality,2010
1307,3607157,"Bohemia CDP, New York",36103,LI,3606,3731,125,232,91,723,9457,73,10180,9061,municipality,2010
1308,3608026,"Brentwood CDP, New York",36103,LI,13654,14202,548,1101,8344,41529,19135,1136,60664,8554,municipality,2010
1309,3608136,"Bridgehampton CDP, New York",36103,LI,748,2431,1683,21,232,256,1500,26,1756,1221,municipality,2010
1310,3608323,"Brightwaters village, New York",36103,LI,1126,1156,30,48,38,159,2944,48,3103,2810,municipality,2010
1311,3609000,"Brookhaven CDP, New York",36103,LI,1176,1268,92,24,214,212,3239,39,3451,2962,municipality,2010
1312,3611781,"Calverton CDP, New York",36103,LI,2965,3224,259,57,493,453,6057,89,6510,5418,municipality,2010
1313,3613376,"Centereach CDP, New York",36103,LI,10026,10408,382,1950,834,3575,28003,470,31578,24749,municipality,2010
1314,3613420,"Center Moriches CDP, New York",36103,LI,2597,2818,221,105,248,776,6804,138,7580,6313,municipality,2010
1315,3613442,"Centerport CDP, New York",36103,LI,2032,2120,88,102,26,194,5314,59,5508,5127,municipality,2010
1316,3613552,"Central Islip CDP, New York",36103,LI,9365,9961,596,1112,7740,17938,16512,977,34450,6683,municipality,2010
1317,3616958,"Cold Spring Harbor CDP, New York",36103,LI,1749,1809,60,113,34,194,4876,46,5070,4683,municipality,2010
1318,3617530,"Commack CDP, New York",36103,LI,11907,12138,231,1951,297,1722,34402,404,36124,31750,municipality,2010
1319,3618146,"Copiague CDP, New York",36103,LI,7535,7919,384,464,1455,7523,15470,384,22993,13167,municipality,2010
1320,3618157,"Coram CDP, New York",36103,LI,14632,15437,805,1952,3842,5307,33806,939,39113,27073,municipality,2010
1321,3619466,"Cutchogue CDP, New York",36103,LI,1347,2062,715,27,47,242,3107,20,3349,3013,municipality,2010
1322,3619972,"Deer Park CDP, New York",36103,LI,9383,9715,332,1871,3182,3364,24381,573,27745,18755,municipality,2010
1323,3620379,"Dering Harbor village, New York",36103,LI,5,35,30,0,0,0,11,0,11,11,municipality,2010
1324,3620687,"Dix Hills CDP, New York",36103,LI,8319,8529,210,2990,1385,1533,25359,551,26892,20433,municipality,2010
1325,3621985,"East Farmingdale CDP, New York",36103,LI,2002,2114,112,332,775,1353,5131,149,6484,3875,municipality,2010
1326,3622183,"East Hampton village, New York",36103,LI,533,1836,1303,12,8,128,955,4,1083,931,municipality,2010
1327,3622200,"East Hampton North CDP, New York",36103,LI,1536,2545,1009,44,244,1594,2548,81,4142,2179,municipality,2010
1328,3622315,"East Islip CDP, New York",36103,LI,4803,4942,139,223,143,903,13572,153,14475,13053,municipality,2010
1329,3622447,"East Marion CDP, New York",36103,LI,409,953,544,8,7,62,864,17,926,832,municipality,2010
1330,3622546,"East Moriches CDP, New York",36103,LI,1896,2163,267,46,75,312,4937,74,5249,4742,municipality,2010
1331,3622612,"East Northport CDP, New York",36103,LI,7114,7288,174,564,158,1354,18863,253,20217,17888,municipality,2010
1332,3622733,"East Patchogue CDP, New York",36103,LI,8294,8685,391,518,903,3951,18518,384,22469,16713,municipality,2010
1333,3622810,"Eastport CDP, New York",36103,LI,702,865,163,11,23,160,1671,17,1831,1620,municipality,2010
1334,3622832,"East Quogue CDP, New York",36103,LI,1832,3069,1237,61,63,425,4332,52,4757,4156,municipality,2010
1335,3622980,"East Shoreham CDP, New York",36103,LI,2047,2104,57,155,86,364,6302,56,6666,6005,municipality,2010
1336,3623316,"Eatons Neck CDP, New York",36103,LI,519,575,56,13,2,36,1370,19,1406,1336,municipality,2010
1337,3624405,"Elwood CDP, New York",36103,LI,3512,3585,73,887,674,918,10259,154,11177,8544,municipality,2010
1338,3625417,"Farmingville CDP, New York",36103,LI,4707,4884,177,571,339,1942,13539,265,15481,12364,municipality,2010
1339,3625839,"Fire Island CDP, New York",36103,LI,131,3395,3264,1,12,23,269,3,292,253,municipality,2010
1340,3625923,"Fishers Island CDP, New York",36103,LI,120,660,540,2,2,2,234,5,236,225,municipality,2010
1341,3626121,"Flanders CDP, New York",36103,LI,1345,1684,339,46,597,1677,2795,132,4472,2020,municipality,2010
1342,3626946,"Fort Salonga CDP, New York",36103,LI,3370,3484,114,216,84,388,9620,106,10008,9214,municipality,2010
1343,3628997,"Gilgo-Oak Beach-Captree CDP, New York",36103,LI,182,376,194,3,1,26,391,3,417,384,municipality,2010
1344,3629509,"Gordon Heights CDP, New York",36103,LI,1070,1182,112,75,1971,1012,3030,201,4042,783,municipality,2010
1345,3630235,"Great River CDP, New York",36103,LI,503,517,14,23,8,62,1427,7,1489,1389,municipality,2010
1346,3630543,"Greenlawn CDP, New York",36103,LI,4560,4722,162,555,1841,1724,12018,284,13742,9338,municipality,2010
1347,3630576,"Greenport village, New York",36103,LI,820,1191,371,11,219,746,1451,44,2197,1177,municipality,2010
1348,3630581,"Greenport West CDP, New York",36103,LI,960,1651,691,16,100,328,1796,34,2124,1646,municipality,2010
1349,3631445,"Halesite CDP, New York",36103,LI,1008,1070,62,38,17,106,2392,25,2498,2312,municipality,2010
1350,3631896,"Hampton Bays CDP, New York",36103,LI,5079,7873,2794,108,161,3895,9708,165,13603,9274,municipality,2010
1351,3632732,"Hauppauge CDP, New York",36103,LI,7333,7566,233,1226,389,1479,19403,240,20882,17548,municipality,2010
1352,3632963,"Head of the Harbor village, New York",36103,LI,511,551,40,38,10,46,1426,15,1472,1363,municipality,2010
1353,3635056,"Holbrook CDP, New York",36103,LI,9550,9820,270,1008,401,2311,24884,293,27195,23182,municipality,2010
1354,3635254,"Holtsville CDP, New York",36103,LI,6725,6929,204,859,326,1990,17724,230,19714,16309,municipality,2010
1355,3636233,"Huntington CDP, New York",36103,LI,7170,7482,312,390,382,906,17140,226,18046,16142,municipality,2010
1356,3637022,"Huntington Bay village, New York",36103,LI,534,578,44,26,6,49,1376,15,1425,1329,municipality,2010
1357,3637044,"Huntington Station CDP, New York",36103,LI,10067,10523,456,1154,3299,12109,20920,745,33029,15722,municipality,2010
1358,3637840,"Islandia village, New York",36103,LI,1026,1088,62,204,429,944,2391,68,3335,1690,municipality,2010
1359,3637869,"Islip CDP, New York",36103,LI,6437,6664,227,461,760,2580,16109,318,18689,14570,municipality,2010
1360,3638022,"Islip Terrace CDP, New York",36103,LI,1703,1764,61,124,90,478,4911,70,5389,4627,municipality,2010
1361,3638253,"Jamesport CDP, New York",36103,LI,715,1169,454,7,18,142,1568,13,1710,1530,municipality,2010
1362,3639672,"Kings Park CDP, New York",36103,LI,6212,6469,257,406,183,915,16367,197,17282,15581,municipality,2010
1363,3640530,"Lake Grove village, New York",36103,LI,3814,3956,142,737,215,866,10297,140,11163,9205,municipality,2010
1364,3640838,"Lake Ronkonkoma CDP, New York",36103,LI,6932,7199,267,904,423,2008,18147,309,20155,16511,municipality,2010
1365,3641465,"Laurel CDP, New York",36103,LI,524,810,286,6,24,124,1270,23,1394,1217,municipality,2010
1366,3642554,"Lindenhurst village, New York",36103,LI,9316,9665,349,518,341,2656,24597,357,27253,23381,municipality,2010
1367,3643005,"Lloyd Harbor village, New York",36103,LI,1162,1262,100,80,34,120,3540,48,3660,3378,municipality,2010
1368,3645139,"Manorville CDP, New York",36103,LI,5000,5303,303,249,222,938,13376,162,14314,12743,municipality,2010
1369,3646074,"Mastic CDP, New York",36103,LI,4526,4847,321,323,1247,3378,12103,471,15481,10062,municipality,2010
1370,3646085,"Mastic Beach CDP, New York",36103,LI,4231,4889,658,186,1120,2019,10911,354,12930,9251,municipality,2010
1371,3646140,"Mattituck CDP, New York",36103,LI,1693,2495,802,37,54,288,3931,66,4219,3774,municipality,2010
1372,3646404,"Medford CDP, New York",36103,LI,7821,8171,350,620,1328,4306,19836,417,24142,17471,municipality,2010
1373,3646514,"Melville CDP, New York",36103,LI,6908,7194,286,1372,607,955,18030,317,18985,15734,municipality,2010
1374,3646976,"Middle Island CDP, New York",36103,LI,4217,4479,262,361,786,974,9509,228,10483,8134,municipality,2010
1375,3647306,"Miller Place CDP, New York",36103,LI,4000,4141,141,359,191,621,11718,133,12339,11035,municipality,2010
1376,3648054,"Montauk CDP, New York",36103,LI,1422,4666,3244,30,74,537,2789,41,3326,2644,municipality,2010
1377,3648450,"Moriches CDP, New York",36103,LI,1322,1475,153,79,72,247,2591,40,2838,2400,municipality,2010
1378,3649066,"Mount Sinai CDP, New York",36103,LI,4080,4285,205,486,165,706,11412,141,12118,10620,municipality,2010
1379,3649424,"Napeague CDP, New York",36103,LI,107,762,655,3,1,6,194,3,200,187,municipality,2010
1380,3649825,"Nesconset CDP, New York",36103,LI,4564,4711,147,651,159,825,12562,112,13387,11640,municipality,2010
1381,3650727,"New Suffolk CDP, New York",36103,LI,177,307,130,0,1,22,327,1,349,325,municipality,2010
1382,3651286,"Nissequogue village, New York",36103,LI,573,646,73,87,11,60,1689,21,1749,1570,municipality,2010
1383,3651396,"North Amityville CDP, New York",36103,LI,5333,5636,303,167,10076,5093,12769,619,17862,1907,municipality,2010
1384,3651418,"Northampton CDP, New York",36103,LI,191,239,48,2,157,112,458,14,570,285,municipality,2010
1385,3651440,"North Babylon CDP, New York",36103,LI,6136,6378,242,696,1009,2221,15288,273,17509,13310,municipality,2010
1386,3651495,"North Bay Shore CDP, New York",36103,LI,4395,4627,232,697,2894,12310,6634,458,18944,2585,municipality,2010
1387,3651528,"North Bellport CDP, New York",36103,LI,3362,3652,290,288,2868,3382,8163,572,11545,4435,municipality,2010
1388,3652078,"North Great River CDP, New York",36103,LI,1264,1367,103,82,109,470,3531,36,4001,3304,municipality,2010
1389,3652188,"North Haven village, New York",36103,LI,332,739,407,12,1,24,809,4,833,792,municipality,2010
1390,3653198,"North Lindenhurst CDP, New York",36103,LI,3787,3898,111,362,564,2246,9406,194,11652,8286,municipality,2010
1391,3653319,"North Patchogue CDP, New York",36103,LI,2300,2432,132,127,155,1491,5755,90,7246,5383,municipality,2010
1392,3653396,"Northport village, New York",36103,LI,2921,3066,145,121,40,267,7134,57,7401,6916,municipality,2010
1393,3653561,"North Sea CDP, New York",36103,LI,1771,3477,1706,69,40,748,3710,65,4458,3536,municipality,2010
1394,3653775,"Northville CDP, New York",36103,LI,531,772,241,10,14,78,1262,16,1340,1222,municipality,2010
1395,3653852,"Northwest Harbor CDP, New York",36103,LI,1313,3394,2081,56,83,605,2712,47,3317,2526,municipality,2010
1396,3654056,"Noyack CDP, New York",36103,LI,1510,2881,1371,52,43,334,3234,40,3568,3099,municipality,2010
1397,3654144,"Oakdale CDP, New York",36103,LI,3116,3280,164,102,81,314,7660,50,7974,7427,municipality,2010
1398,3654430,"Ocean Beach village, New York",36103,LI,39,607,568,0,0,1,78,0,79,78,municipality,2010
1399,3654617,"Old Field village, New York",36103,LI,325,369,44,58,8,26,892,27,918,799,municipality,2010
1400,3655321,"Orient CDP, New York",36103,LI,353,772,419,6,8,16,727,9,743,704,municipality,2010
1401,3656660,"Patchogue village, New York",36103,LI,4694,5023,329,185,620,3488,8310,209,11798,7296,municipality,2010
1402,3656968,"Peconic CDP, New York",36103,LI,273,479,206,1,22,70,613,3,683,587,municipality,2010
1403,3659157,"Poquott village, New York",36103,LI,353,380,27,63,18,40,913,21,953,811,municipality,2010
1404,3659355,"Port Jefferson village, New York",36103,LI,3090,3270,180,470,117,500,7250,107,7750,6556,municipality,2010
1405,3659377,"Port Jefferson Station CDP, New York",36103,LI,2812,2949,137,416,183,1158,6680,83,7838,5998,municipality,2010
1406,3660408,"Quiogue CDP, New York",36103,LI,307,583,276,17,67,155,661,36,816,541,municipality,2010
1407,3660422,"Quogue village, New York",36103,LI,424,1623,1199,10,17,58,909,23,967,859,municipality,2010
1408,3661142,"Remsenburg-Speonk CDP, New York",36103,LI,984,1624,640,19,33,209,2433,33,2642,2348,municipality,2010
1409,3661665,"Ridge CDP, New York",36103,LI,5714,6235,521,241,601,749,12587,175,13336,11570,municipality,2010
1410,3661973,"Riverhead CDP, New York",36103,LI,4827,5295,468,220,2033,3369,9930,352,13299,7325,municipality,2010
1411,3662066,"Riverside CDP, New York",36103,LI,716,840,124,7,706,872,2039,90,2911,1236,municipality,2010
1412,3663319,"Rocky Point CDP, New York",36103,LI,4820,5366,546,222,187,978,13036,196,14014,12431,municipality,2010
1413,3663473,"Ronkonkoma CDP, New York",36103,LI,6512,6724,212,882,342,1944,17138,279,19082,15635,municipality,2010
1414,3664452,"Sagaponack village, New York",36103,LI,146,676,530,2,4,7,306,5,313,295,municipality,2010
1415,3664485,"Sag Harbor village, New York",36103,LI,1000,1941,941,31,157,285,1884,42,2169,1654,municipality,2010
1416,3664584,"St. James CDP, New York",36103,LI,4535,4741,206,261,65,750,12588,129,13338,12133,municipality,2010
1417,3664881,"Saltaire village, New York",36103,LI,15,459,444,0,0,0,37,0,37,37,municipality,2010
1418,3665409,"Sayville CDP, New York",36103,LI,5983,6220,237,307,161,814,16039,156,16853,15415,municipality,2010
1419,3666212,"Selden CDP, New York",36103,LI,6446,6739,293,866,568,2750,17101,324,19851,15343,municipality,2010
1420,3666481,"Setauket-East Setauket CDP, New York",36103,LI,5391,5589,198,1137,156,807,14670,249,15477,13128,municipality,2010
1421,3666828,"Shelter Island CDP, New York",36103,LI,598,1136,538,6,12,75,1258,18,1333,1222,municipality,2010
1422,3666850,"Shelter Island Heights CDP, New York",36103,LI,525,1583,1058,4,13,41,1007,24,1048,966,municipality,2010
1423,3667048,"Shinnecock Hills CDP, New York",36103,LI,744,1500,756,23,40,655,1533,34,2188,1436,municipality,2010
1424,3667070,"Shirley CDP, New York",36103,LI,8353,9022,669,701,1768,4781,23073,638,27854,19966,municipality,2010
1425,3667191,"Shoreham village, New York",36103,LI,192,229,37,16,7,15,516,3,531,490,municipality,2010
1426,3667851,"Smithtown CDP, New York",36103,LI,8773,9031,258,754,272,1361,25109,258,26470,23825,municipality,2010
1427,3668374,"Sound Beach CDP, New York",36103,LI,2729,3001,272,134,89,475,7137,133,7612,6781,municipality,2010
1428,3668462,"Southampton village, New York",36103,LI,1263,3314,2051,51,297,503,2606,71,3109,2187,municipality,2010
1429,3669254,"South Huntington CDP, New York",36103,LI,3378,3500,122,549,212,756,8666,164,9422,7741,municipality,2010
1430,3669452,"Southold CDP, New York",36103,LI,2414,3996,1582,47,43,482,5266,53,5748,5123,municipality,2010
1431,3670387,"Springs CDP, New York",36103,LI,2318,4340,2022,97,94,2410,4182,46,6592,3945,municipality,2010
1432,3671608,"Stony Brook CDP, New York",36103,LI,4846,5042,196,1029,215,603,13137,175,13740,11718,municipality,2010
1433,3671620,"Stony Brook University CDP, New York",36103,LI,26,26,0,1883,1247,612,8604,170,9216,5304,municipality,2010
1434,3673352,"Terryville CDP, New York",36103,LI,3827,3971,144,364,266,1831,10018,152,11849,9236,municipality,2010
1435,3675572,"Tuckahoe CDP, New York",36103,LI,480,865,385,18,128,366,1007,45,1373,816,municipality,2010
1436,3677519,"Village of the Branch village, New York",36103,LI,625,645,20,39,21,51,1756,25,1807,1671,municipality,2010
1437,3677772,"Wading River CDP, New York",36103,LI,2716,3090,374,71,150,349,7370,118,7719,7031,municipality,2010
1438,3677805,"Wainscott CDP, New York",36103,LI,264,876,612,3,15,93,557,19,650,520,municipality,2010
1439,3678575,"Water Mill CDP, New York",36103,LI,652,2085,1433,22,15,109,1450,17,1559,1396,municipality,2010
1440,3679246,"West Babylon CDP, New York",36103,LI,14537,15091,554,1163,4622,5262,37951,844,43213,31322,municipality,2010
1441,3679301,"West Bay Shore CDP, New York",36103,LI,1720,1818,98,101,100,343,4305,77,4648,4027,municipality,2010
1442,3680170,"Westhampton CDP, New York",36103,LI,1045,2120,1075,35,109,380,2699,51,3079,2504,municipality,2010
1443,3680181,"Westhampton Beach village, New York",36103,LI,691,2376,1685,17,46,340,1381,19,1721,1299,municipality,2010
1444,3680186,"West Hampton Dunes village, New York",36103,LI,24,272,248,1,0,2,53,0,55,52,municipality,2010
1445,3680258,"West Hills CDP, New York",36103,LI,1974,2037,63,300,60,304,5288,78,5592,4850,municipality,2010
1446,3680302,"West Islip CDP, New York",36103,LI,9040,9266,226,477,166,1557,26778,266,28335,25869,municipality,2010
1447,3680885,"West Sayville CDP, New York",36103,LI,1771,2124,353,55,35,183,4828,45,5011,4693,municipality,2010
1448,3681419,"Wheatley Heights CDP, New York",36103,LI,1480,1517,37,285,2701,692,4438,215,5130,1237,municipality,2010
1449,3683294,"Wyandanch CDP, New York",36103,LI,2926,3157,231,121,7326,3286,8361,335,11647,579,municipality,2010
1450,3683426,"Yaphank CDP, New York",36103,LI,1872,1961,89,105,389,677,5268,67,5945,4707,municipality,2010
1451,3610304000,"Babylon town, Suffolk County, New York",36103,LI,69048,71186,2138,3975,31945,21275,190517,4417,211792,150180,municipality,2000
1452,3610304000,"Babylon town, Suffolk County, New York",36103,LI,70894,74233,3339,6411,33147,35793,177810,4291,213603,133961,municipality,2010
1453,3610310000,"Brookhaven town, Suffolk County, New York",36103,LI,146828,155406,8578,12912,18196,36041,412207,7227,448248,373872,municipality,2000
1454,3610310000,"Brookhaven town, Suffolk County, New York",36103,LI,162884,175026,12142,18880,24428,60270,425770,8680,486040,373782,municipality,2010
1455,3610322194,"East Hampton town, Suffolk County, New York",36103,LI,8101,19640,11539,236,681,2914,16805,441,19719,15447,municipality,2000
1456,3610322194,"East Hampton town, Suffolk County, New York",36103,LI,8410,21038,12628,278,678,5660,15797,277,21457,14564,municipality,2010
1457,3610337000,"Huntington town, Suffolk County, New York",36103,LI,65917,67708,1791,6812,7934,12844,182445,2672,195289,165027,municipality,2000
1458,3610337000,"Huntington town, Suffolk County, New York",36103,LI,69311,71948,2637,10009,8933,22362,180902,3270,203264,158690,municipality,2010
1459,3610338000,"Islip town, Suffolk County, New York",36103,LI,98936,104278,5342,6872,26827,65031,257581,6079,322612,217803,municipality,2000
1460,3610338000,"Islip town, Suffolk County, New York",36103,LI,103631,110665,7034,9358,27898,97371,238172,5633,335543,195283,municipality,2010
1461,3610359106,"Poospatuck Reservation, Suffolk County, New York",36103,LI,93,100,7,0,35,13,258,219,271,4,municipality,2000
1462,3610359106,"Poospatuck Reservation, Suffolk County, New York",36103,LI,110,124,14,3,53,27,297,201,324,40,municipality,2010
1463,3610361984,"Riverhead town, Suffolk County, New York",36103,LI,10749,12479,1730,249,2862,1678,26002,398,27680,22493,municipality,2000
1464,3610361984,"Riverhead town, Suffolk County, New York",36103,LI,12990,15424,2434,367,2501,4649,28857,568,33506,25421,municipality,2010
1465,3610366839,"Shelter Island town, Suffolk County, New York",36103,LI,996,2370,1374,11,11,53,2175,30,2228,2123,municipality,2000
1466,3610366839,"Shelter Island town, Suffolk County, New York",36103,LI,1128,2754,1626,10,25,116,2276,42,2392,2199,municipality,2010
1467,3610367059,"Shinnecock Reservation, Suffolk County, New York",36103,LI,179,194,15,1,12,25,479,446,504,20,municipality,2000
1468,3610367059,"Shinnecock Reservation, Suffolk County, New York",36103,LI,226,256,30,3,29,42,620,555,662,33,municipality,2010
1469,3610368000,"Smithtown town, Suffolk County, New York",36103,LI,38487,39357,870,2743,689,3855,111860,891,115715,107537,municipality,2000
1470,3610368000,"Smithtown town, Suffolk County, New York",36103,LI,40055,41381,1326,4197,1122,6272,111529,1234,117801,104976,municipality,2010
1471,3610368473,"Southampton town, Suffolk County, New York",36103,LI,21504,35836,14332,454,3491,4700,50012,855,54712,45212,municipality,2000
1472,3610368473,"Southampton town, Suffolk County, New York",36103,LI,21193,41759,20566,618,2776,11295,45495,945,56790,41156,municipality,2010
1473,3610369463,"Southold town, Suffolk County, New York",36103,LI,8461,13769,5308,90,579,982,19617,261,20599,18687,municipality,2000
1474,3610369463,"Southold town, Suffolk County, New York",36103,LI,9090,15377,6287,161,527,2382,19586,275,21968,18623,municipality,2010
1475,3610506310,"Bethel town, Sullivan County, New York",36105,MHV,1649,3641,1992,22,189,492,3870,49,4362,3610,municipality,2000
1476,3610506310,"Bethel town, Sullivan County, New York",36105,MHV,1733,3954,2221,36,139,485,3770,89,4255,3506,municipality,2010
1477,3610511759,"Callicoon town, Sullivan County, New York",36105,MHV,1222,1797,575,21,18,139,2913,35,3052,2839,municipality,2000
1478,3610511759,"Callicoon town, Sullivan County, New York",36105,MHV,1288,2003,715,51,34,126,2931,43,3057,2803,municipality,2010
1479,3610516661,"Cochecton town, Sullivan County, New York",36105,MHV,555,955,400,8,12,22,1306,18,1328,1268,municipality,2000
1480,3610516661,"Cochecton town, Sullivan County, New York",36105,MHV,604,1114,510,10,29,57,1315,10,1372,1266,municipality,2010
1481,3610520104,"Delaware town, Sullivan County, New York",36105,MHV,956,1337,381,22,253,172,2547,25,2719,2247,municipality,2000
1482,3610520104,"Delaware town, Sullivan County, New York",36105,MHV,996,1535,539,11,313,185,2485,31,2670,2130,municipality,2010
1483,3610525241,"Fallsburg town, Sullivan County, New York",36105,MHV,3761,6661,2900,139,1780,1777,10457,238,12234,8300,municipality,2000
1484,3610525241,"Fallsburg town, Sullivan County, New York",36105,MHV,4225,8497,4272,176,1654,2823,10047,353,12870,7864,municipality,2010
1485,3610526528,"Forestburgh town, Sullivan County, New York",36105,MHV,327,500,173,0,17,40,793,3,833,773,municipality,2000
1486,3610526528,"Forestburgh town, Sullivan County, New York",36105,MHV,355,550,195,7,35,36,783,22,819,719,municipality,2010
1487,3610527573,"Fremont town, Sullivan County, New York",36105,MHV,563,1182,619,13,22,17,1374,29,1391,1310,municipality,2000
1488,3610527573,"Fremont town, Sullivan County, New York",36105,MHV,607,1323,716,12,31,48,1333,34,1381,1256,municipality,2010
1489,3610534473,"Highland town, Sullivan County, New York",36105,MHV,951,1558,607,10,73,95,2309,31,2404,2195,municipality,2000
1490,3610534473,"Highland town, Sullivan County, New York",36105,MHV,1049,1766,717,22,81,148,2382,43,2530,2236,municipality,2010
1491,3610542235,"Liberty town, Sullivan County, New York",36105,MHV,3711,5350,1639,133,825,1050,8582,146,9632,7478,municipality,2000
1492,3610542235,"Liberty town, Sullivan County, New York",36105,MHV,3883,5495,1612,146,817,1862,8023,245,9885,6815,municipality,2010
1493,3610543786,"Lumberland town, Sullivan County, New York",36105,MHV,781,1419,638,16,4,37,1902,29,1939,1853,municipality,2000
1494,3610543786,"Lumberland town, Sullivan County, New York",36105,MHV,967,1630,663,23,34,126,2342,45,2468,2240,municipality,2010
1495,3610544809,"Mamakating town, Sullivan County, New York",36105,MHV,4153,5629,1476,112,215,525,10477,195,11002,9955,municipality,2000
1496,3610544809,"Mamakating town, Sullivan County, New York",36105,MHV,4738,6251,1513,135,390,1027,11058,272,12085,10261,municipality,2010
1497,3610549847,"Neversink town, Sullivan County, New York",36105,MHV,1346,1960,614,8,20,78,3475,56,3553,3391,municipality,2000
1498,3610549847,"Neversink town, Sullivan County, New York",36105,MHV,1464,2045,581,21,45,129,3428,56,3557,3306,municipality,2010
1499,3610563176,"Rockland town, Sullivan County, New York",36105,MHV,1560,2475,915,35,107,278,3635,52,3913,3441,municipality,2000
1500,3610563176,"Rockland town, Sullivan County, New York",36105,MHV,1596,2755,1159,50,92,322,3453,76,3775,3235,municipality,2010
1501,3610573627,"Thompson town, Sullivan County, New York",36105,MHV,5543,9258,3715,260,2268,2066,12123,262,14189,9333,municipality,2000
1502,3610573627,"Thompson town, Sullivan County, New York",36105,MHV,5982,9130,3148,319,2590,3102,12206,471,15308,8826,municipality,2010
1503,3610575759,"Tusten town, Sullivan County, New York",36105,MHV,583,1008,425,11,94,51,1364,27,1415,1232,municipality,2000
1504,3610575759,"Tusten town, Sullivan County, New York",36105,MHV,652,1138,486,14,65,78,1437,41,1515,1317,municipality,2010
1505,3611120247,"Denning town, Ulster County, New York",36111,MHV,215,517,302,1,0,8,508,20,516,487,municipality,2000
1506,3611120247,"Denning town, Ulster County, New York",36111,MHV,234,531,297,1,6,7,544,19,551,518,municipality,2010
1507,3611124691,"Esopus town, Ulster County, New York",36111,MHV,3439,3724,285,88,195,178,9153,148,9331,8722,municipality,2000
1508,3611124691,"Esopus town, Ulster County, New York",36111,MHV,3492,3969,477,125,395,487,8554,240,9041,7794,municipality,2010
1509,3611128255,"Gardiner town, Ulster County, New York",36111,MHV,1997,2255,258,39,81,240,4998,94,5238,4784,municipality,2000
1510,3611128255,"Gardiner town, Ulster County, New York",36111,MHV,2229,2610,381,60,78,381,5332,92,5713,5102,municipality,2010
1511,3611132116,"Hardenburgh town, Ulster County, New York",36111,MHV,95,275,180,5,1,2,206,2,208,198,municipality,2000
1512,3611132116,"Hardenburgh town, Ulster County, New York",36111,MHV,112,344,232,5,0,7,231,13,238,213,municipality,2010
1513,3611137143,"Hurley town, Ulster County, New York",36111,MHV,2694,2946,252,80,87,125,6439,72,6564,6200,municipality,2000
1514,3611137143,"Hurley town, Ulster County, New York",36111,MHV,2693,3069,376,91,96,181,6133,112,6314,5834,municipality,2010
1515,3611139727,"Kingston city, Ulster County, New York",36111,MHV,9871,10637,766,356,2820,1516,21940,688,23456,18076,municipality,2000
1516,3611139727,"Kingston city, Ulster County, New York",36111,MHV,10217,11147,930,426,3214,3203,20690,985,23893,16065,municipality,2010
1517,3611139738,"Kingston town, Ulster County, New York",36111,MHV,356,398,42,4,16,15,893,17,908,856,municipality,2000
1518,3611139738,"Kingston town, Ulster County, New York",36111,MHV,380,432,52,11,27,28,861,10,889,813,municipality,2010
1519,3611142994,"Lloyd town, Ulster County, New York",36111,MHV,3626,3818,192,117,484,504,9437,173,9941,8663,municipality,2000
1520,3611142994,"Lloyd town, Ulster County, New York",36111,MHV,4112,4419,307,309,658,793,10070,237,10863,8866,municipality,2010
1521,3611145458,"Marbletown town, Ulster County, New York",36111,MHV,2386,2846,460,41,75,121,5733,111,5854,5506,municipality,2000
1522,3611145458,"Marbletown town, Ulster County, New York",36111,MHV,2400,2989,589,68,81,155,5452,107,5607,5196,municipality,2010
1523,3611145722,"Marlborough town, Ulster County, New York",36111,MHV,3020,3176,156,27,224,329,7934,104,8263,7579,municipality,2000
1524,3611145722,"Marlborough town, Ulster County, New York",36111,MHV,3335,3644,309,77,334,769,8039,153,8808,7475,municipality,2010
1525,3611150562,"New Paltz town, Ulster County, New York",36111,MHV,4455,4679,224,514,709,1054,11776,407,12830,10146,municipality,2000
1526,3611150562,"New Paltz town, Ulster County, New York",36111,MHV,4515,4877,362,605,612,1233,12770,353,14003,11200,municipality,2010
1527,3611154749,"Olive town, Ulster County, New York",36111,MHV,1869,2306,437,42,24,115,4464,73,4579,4325,municipality,2000
1528,3611154749,"Olive town, Ulster County, New York",36111,MHV,1960,2498,538,57,53,139,4280,106,4419,4064,municipality,2010
1529,3611158552,"Plattekill town, Ulster County, New York",36111,MHV,3649,3888,239,62,406,1583,8309,194,9892,7647,municipality,2000
1530,3611158552,"Plattekill town, Ulster County, New York",36111,MHV,3861,4242,381,84,534,1934,8565,174,10499,7773,municipality,2010
1531,3611163011,"Rochester town, Ulster County, New York",36111,MHV,2688,3750,1062,32,152,339,6679,147,7018,6348,municipality,2000
1532,3611163011,"Rochester town, Ulster County, New York",36111,MHV,2936,4019,1083,64,151,410,6903,184,7313,6504,municipality,2010
1533,3611163737,"Rosendale town, Ulster County, New York",36111,MHV,2587,2857,270,28,111,167,6185,104,6352,5942,municipality,2000
1534,3611163737,"Rosendale town, Ulster County, New York",36111,MHV,2572,2897,325,46,100,304,5771,125,6075,5500,municipality,2010
1535,3611165299,"Saugerties town, Ulster County, New York",36111,MHV,7478,8257,779,152,771,916,18952,265,19868,17764,municipality,2000
1536,3611165299,"Saugerties town, Ulster County, New York",36111,MHV,8163,9106,943,198,309,979,18503,384,19482,17612,municipality,2010
1537,3611166597,"Shandaken town, Ulster County, New York",36111,MHV,1463,2666,1203,38,33,99,3136,80,3235,2985,municipality,2000
1538,3611166597,"Shandaken town, Ulster County, New York",36111,MHV,1505,2776,1271,47,28,153,2932,77,3085,2780,municipality,2010
1539,3611166674,"Shawangunk town, Ulster County, New York",36111,MHV,3433,3754,321,107,945,837,11185,158,12022,9975,municipality,2000
1540,3611166674,"Shawangunk town, Ulster County, New York",36111,MHV,3887,4333,446,222,1078,1310,13022,200,14332,11522,municipality,2010
1541,3611175935,"Ulster town, Ulster County, New York",36111,MHV,4850,5239,389,192,349,307,12237,202,12544,11494,municipality,2000
1542,3611175935,"Ulster town, Ulster County, New York",36111,MHV,4961,5368,407,269,359,662,11665,298,12327,10739,municipality,2010
1543,3611178828,"Wawarsing town, Ulster County, New York",36111,MHV,4382,5821,1439,147,1483,2326,10563,331,12889,8602,municipality,2000
1544,3611178828,"Wawarsing town, Ulster County, New York",36111,MHV,4509,6211,1702,180,1784,2538,10619,426,13157,8229,municipality,2010
1545,3611183052,"Woodstock town, Ulster County, New York",36111,MHV,2946,3847,901,97,78,160,6081,141,6241,5765,municipality,2000
1546,3611183052,"Woodstock town, Ulster County, New York",36111,MHV,2976,4157,1181,115,85,236,5648,148,5884,5300,municipality,2010
1547,3611905320,"Bedford town, Westchester County, New York",36119,LHV,5731,6020,289,358,1167,1372,16761,178,18133,15058,municipality,2000
1548,3611905320,"Bedford town, Westchester County, New York",36119,LHV,5765,6326,561,507,855,2104,15231,252,17335,13617,municipality,2010
1549,3611918410,"Cortlandt town, Westchester County, New York",36119,LHV,13517,14065,548,978,1672,2766,35701,581,38467,32470,municipality,2000
1550,3611918410,"Cortlandt town, Westchester County, New York",36119,LHV,14987,15962,975,1479,1994,5324,36268,819,41592,31976,municipality,2010
1551,3611921820,"Eastchester town, Westchester County, New York",36119,LHV,12626,13035,409,2135,825,1402,29916,455,31318,26501,municipality,2000
1552,3611921820,"Eastchester town, Westchester County, New York",36119,LHV,12946,13747,801,2355,967,2335,30028,540,32363,26166,municipality,2010
1553,3611930367,"Greenburgh town, Westchester County, New York",36119,LHV,33043,34084,1041,7587,10993,7825,78939,1909,86764,58450,municipality,2000
1554,3611930367,"Greenburgh town, Westchester County, New York",36119,LHV,33495,35452,1957,9155,10377,12366,76034,1963,88400,54539,municipality,2010
1555,3611932413,"Harrison town, Westchester County, New York",36119,LHV,8394,8680,286,1309,308,1618,22536,335,24154,20584,municipality,2000
1556,3611932413,"Harrison town, Westchester County, New York",36119,LHV,8375,8956,581,2062,563,3202,24270,512,27472,21133,municipality,2010
1557,3611942136,"Lewisboro town, Westchester County, New York",36119,LHV,4218,4465,247,257,144,306,12018,136,12324,11481,municipality,2000
1558,3611942136,"Lewisboro town, Westchester County, New York",36119,LHV,4453,4854,401,294,153,552,11859,225,12411,11187,municipality,2010
1559,3611944842,"Mamaroneck town, Westchester County, New York",36119,LHV,10929,11255,326,896,751,3164,25803,412,28967,23744,municipality,2000
1560,3611944842,"Mamaroneck town, Westchester County, New York",36119,LHV,10849,11562,713,1131,775,4524,24632,555,29156,22171,municipality,2010
1561,3611948895,"Mount Kisco town, Westchester County, New York",36119,LHV,3993,4103,110,421,551,2450,7533,174,9983,6387,municipality,2000
1562,3611948895,"Mount Kisco town, Westchester County, New York",36119,LHV,4102,4289,187,515,500,3818,7059,182,10877,5862,municipality,2010
1563,3611949011,"Mount Pleasant town, Westchester County, New York",36119,LHV,13737,13985,248,1401,1962,6057,37164,421,43221,33380,municipality,2000
1564,3611949011,"Mount Pleasant town, Westchester County, New York",36119,LHV,14306,14826,520,2093,2076,7859,35865,622,43724,31074,municipality,2010
1565,3611949121,"Mount Vernon city, Westchester County, New York",36119,LHV,25729,27048,1319,1433,39889,7083,61298,3299,68381,16677,municipality,2000
1566,3611949121,"Mount Vernon city, Westchester County, New York",36119,LHV,26260,28990,2730,1206,41226,9592,57700,2819,67292,12449,municipality,2010
1567,3611950078,"New Castle town, Westchester County, New York",36119,LHV,5732,5843,111,969,231,487,17004,179,17491,15625,municipality,2000
1568,3611950078,"New Castle town, Westchester County, New York",36119,LHV,5786,6037,251,1282,263,710,16859,301,17569,15013,municipality,2010
1569,3611950617,"New Rochelle city, Westchester County, New York",36119,LHV,26189,26995,806,2304,13389,14492,57690,1725,72182,40272,municipality,2000
1570,3611950617,"New Rochelle city, Westchester County, New York",36119,LHV,27953,29586,1633,3212,13956,21452,55610,1494,77062,36948,municipality,2010
1571,3611951693,"North Castle town, Westchester County, New York",36119,LHV,3583,3706,123,430,182,449,10400,106,10849,9682,municipality,2000
1572,3611951693,"North Castle town, Westchester County, New York",36119,LHV,3913,4135,222,586,179,906,10935,176,11841,9994,municipality,2010
1573,3611953517,"North Salem town, Westchester County, New York",36119,LHV,1764,1979,215,50,37,189,4984,101,5173,4796,municipality,2000
1574,3611953517,"North Salem town, Westchester County, New York",36119,LHV,1811,2082,271,84,60,382,4722,67,5104,4511,municipality,2010
1575,3611955541,"Ossining town, Westchester County, New York",36119,LHV,12355,12733,378,1637,4969,7282,29252,614,36534,22032,municipality,2000
1576,3611955541,"Ossining town, Westchester County, New York",36119,LHV,12706,13386,680,1834,4345,11403,26271,634,37674,19458,municipality,2010
1577,3611956979,"Peekskill city, Westchester County, New York",36119,LHV,8696,9053,357,529,5483,4920,17521,733,22441,10776,municipality,2000
1578,3611956979,"Peekskill city, Westchester County, New York",36119,LHV,9060,9709,649,682,5052,8713,14870,697,23583,8439,municipality,2010
1579,3611957012,"Pelham town, Westchester County, New York",36119,LHV,4149,4246,97,468,519,714,11152,253,11866,9912,municipality,2000
1580,3611957012,"Pelham town, Westchester County, New York",36119,LHV,4247,4483,236,642,729,1243,11153,325,12396,9457,municipality,2010
1581,3611959685,"Pound Ridge town, Westchester County, New York",36119,LHV,1699,1868,169,78,53,116,4610,56,4726,4423,municipality,2000
1582,3611959685,"Pound Ridge town, Westchester County, New York",36119,LHV,1844,2108,264,96,64,233,4871,96,5104,4615,municipality,2010
1583,3611964309,"Rye city, Westchester County, New York",36119,LHV,5377,5559,182,964,181,718,14237,185,14955,12907,municipality,2000
1584,3611964309,"Rye city, Westchester County, New York",36119,LHV,5520,5957,437,932,207,1014,14706,238,15720,13329,municipality,2010
1585,3611964320,"Rye town, Westchester County, New York",36119,LHV,15389,15813,424,1252,2069,14264,29616,891,43880,25404,municipality,2000
1586,3611964320,"Rye town, Westchester County, New York",36119,LHV,15469,16556,1087,1470,1884,19477,26451,803,45928,22294,municipality,2010
1587,3611965442,"Scarsdale town, Westchester County, New York",36119,LHV,5662,5795,133,2241,263,467,17356,258,17823,14594,municipality,2000
1588,3611965442,"Scarsdale town, Westchester County, New York",36119,LHV,5418,5647,229,2220,242,671,16495,385,17166,13648,municipality,2010
1589,3611968308,"Somers town, Westchester County, New York",36119,LHV,6802,7098,296,341,293,543,17803,163,18346,17006,municipality,2000
1590,3611968308,"Somers town, Westchester County, New York",36119,LHV,7623,7982,359,640,304,1010,19424,252,20434,18228,municipality,2010
1591,3611981677,"White Plains city, Westchester County, New York",36119,LHV,20921,21576,655,2371,8138,12476,40601,1349,53077,28743,municipality,2000
1592,3611981677,"White Plains city, Westchester County, New York",36119,LHV,22910,24382,1472,3587,7502,16839,40014,1120,56853,27805,municipality,2010
1593,3611984000,"Yonkers city, Westchester County, New York",36119,LHV,74351,77589,3238,9290,30164,50852,145234,6434,196086,99346,municipality,2000
1594,3611984000,"Yonkers city, Westchester County, New York",36119,LHV,74550,80389,5839,11370,31297,67927,128049,4219,195976,81163,municipality,2010
1595,3611984077,"Yorktown town, Westchester County, New York",36119,LHV,12556,12852,296,1242,994,2112,34206,444,36318,31526,municipality,2000
1596,3611984077,"Yorktown town, Westchester County, New York",36119,LHV,12884,13418,534,1689,1015,3376,32705,514,36081,29487,municipality,2010
1597,36005CS,BX Central and South,36005,NYC,148853,158913,10060,15078,119031,236419,202201,13699,438620,54393,municipality,2000
1598,36005CS,BX Central and South,36005,NYC,156721,165740,9019,22186,122382,265843,195443,10563,461286,40312,municipality,2010
1599,36005NE,BX North and East,36005,NYC,94854,99908,5054,4473,117431,50118,198037,7796,248155,68337,municipality,2000
1600,36005NE,BX North and East,36005,NYC,96791,102562,5771,5609,121515,68901,184473,6455,253374,50894,municipality,2010
1601,36005W,BX West,36005,NYC,219505,231838,12333,19007,179876,358168,287707,17903,645875,70921,municipality,2000
1602,36005W,BX West,36005,NYC,229937,243594,13657,19540,172798,406669,263779,11438,670448,60003,municipality,2010
1603,36047C,BK Central,36047,NYC,201610,213139,11529,11348,413337,44928,530958,18242,575886,88031,municipality,2000
1604,36047C,BK Central,36047,NYC,204464,218751,14287,13366,394809,49672,509846,13398,559518,88273,municipality,2010
1605,36047E,BK East,36047,NYC,85177,92283,7106,6441,155780,81201,182446,10676,263647,9549,municipality,2000
1606,36047E,BK East,36047,NYC,92886,100608,7722,9622,164346,84875,189244,8111,274119,7165,municipality,2010
1607,36047N,BK North,36047,NYC,128716,140487,11771,9929,124682,153255,230607,14684,383862,81312,municipality,2000
1608,36047N,BK North,36047,NYC,150039,165611,15572,15963,112659,147533,263514,7967,411047,126925,municipality,2010
1609,36047S,BK Southern,36047,NYC,324145,336444,12299,116417,90150,94095,787906,32673,882001,548666,municipality,2000
1610,36047S,BK Southern,36047,NYC,323559,357209,33650,160096,79237,114375,773686,15884,888061,518469,municipality,2010
1611,36047W,BK West,36047,NYC,141079,148513,7434,40156,64634,114399,245531,13767,359930,126974,municipality,2000
1612,36047W,BK West,36047,NYC,145908,158114,12206,61082,48015,99830,272125,10554,371955,152474,municipality,2010
1613,36061E,MN East Side,36061,NYC,212494,232127,19633,29113,12356,23002,337502,7312,360504,288721,municipality,2000
1614,36061E,MN East Side,36061,NYC,206971,234068,27097,40137,12266,26956,343974,8344,370930,283227,municipality,2010
1615,36061L,MN Lower,36061,NYC,138123,146707,8584,76240,16247,52259,239687,8080,291946,139120,municipality,2000
1616,36061L,MN Lower,36061,NYC,152412,166325,13913,78234,15539,50634,263637,8387,314271,161477,municipality,2010
1617,36061U,MN Upper,36061,NYC,210107,226337,16230,15198,181739,294053,276238,13586,570291,65715,municipality,2000
1618,36061U,MN Upper,36061,NYC,216933,233344,16411,23354,155467,278755,283361,12391,562116,92149,municipality,2010
1619,36061WM,MN West Side and Midtown,36061,NYC,177920,192973,15053,22740,24356,48502,265952,8539,314454,210317,municipality,2000
1620,36061WM,MN West Side and Midtown,36061,NYC,187530,213353,25823,35899,22068,47232,291324,8717,338556,224640,municipality,2010
1621,36081NE,QN Northeast,36081,NYC,188358,194808,6450,154038,30795,75682,433469,19890,509151,228746,municipality,2000
1622,36081NE,QN Northeast,36081,NYC,188278,199124,10846,216089,28051,79640,439557,14036,519197,181381,municipality,2010
1623,36081NW,QN Northwest,36081,NYC,338979,350623,11644,164231,49575,334561,592309,39389,926870,339114,municipality,2000
1624,36081NW,QN Northwest,36081,NYC,337909,362407,24498,189619,39603,362648,557243,21646,919891,306375,municipality,2010
1625,36081SE,QN Southeast,36081,NYC,168275,180465,12190,31621,311244,68892,453267,29846,522159,80556,municipality,2000
1626,36081SE,QN Southeast,36081,NYC,169682,183794,14112,49124,295216,84386,440799,27720,525185,68739,municipality,2010
1627,36081SW,QN Southwest,36081,NYC,87052,91354,4302,39413,31217,77470,193729,38620,271199,84479,municipality,2000
1628,36081SW,QN Southwest,36081,NYC,84248,89802,5554,53502,33011,87076,179373,32628,266449,60232,municipality,2010
1629,36085C,SI Central,36085,NYC,45882,47705,1823,11286,3198,12406,115771,2522,128177,98765,municipality,2000
1630,36085C,SI Central,36085,NYC,47772,50814,3042,14989,4027,17665,115456,2386,133121,94054,municipality,2010
1631,36085N,SI North,36085,NYC,57306,60986,3680,8496,35189,32192,130417,5468,162609,81264,municipality,2000
1632,36085N,SI North,36085,NYC,60652,65422,4770,13111,38620,50055,125701,4445,175756,69525,municipality,2010
1633,36085S,SI South,36085,NYC,53153,55302,2149,5004,1317,8952,143990,1382,152942,136287,municipality,2000
1634,36085S,SI South,36085,NYC,57092,60420,3328,6597,1666,13331,146522,1669,159853,136590,municipality,2010
