,stco,geoid,name,POP100,HU100,P0010001,P0020001,P0020002,P0020003,P0020004,P0020005,P0020006,P0020007,P0020008,P0020009,P0020010,P0020011,H0010001,H0010002,H0010003
0,36005,36005CS,BX Central and South,488720,176934,488720,488720,275049,213671,203837,36205,121583,1227,38360,157,6305,9834,176934,169664,7270
1,36005,36005NE,BX North and East,272546,108236,272546,272546,87739,184807,177983,40332,125441,600,8026,95,3489,6824,108236,102721,5515
2,36005,36005W,BX West,711388,261860,711388,711388,443675,267713,256001,54259,172369,1260,21380,205,6528,11712,261860,250065,11795
3,36047,36047C,BK Central,595377,233830,595377,595377,58718,536659,504091,112351,360365,948,22709,139,7579,32568,233830,219831,13999
4,36047,36047E,BK East,303777,111587,303777,303777,96051,207726,193980,9930,162190,1011,16180,99,4570,13746,111587,105312,6275
5,36047,36047N,BK North,466312,196281,466312,466312,135560,330752,312789,188455,90632,759,27094,207,5642,17963,196281,181849,14432
6,36047,36047S,BK Southern,947567,353658,947567,947567,129656,817911,787261,479312,72951,753,222461,156,11628,30650,353658,333754,19904
7,36047,36047W,BK West,423041,182298,423041,423041,96441,326600,308357,178379,43558,493,82332,117,3478,18243,182298,169058,13240
8,36061,36061E,MN East Side,395822,243538,395822,395822,33055,362767,347882,277070,12077,307,55392,342,2694,14885,243538,213958,29580
9,36061,36061L,MN Lower,333976,182984,333976,333976,52885,281091,267695,170323,18011,268,76373,189,2531,13396,182984,163598,19386
10,36061,36061U,MN Upper,572033,247817,572033,572033,258287,313746,295110,112628,142810,916,33681,191,4884,18636,247817,232977,14840
11,36061,36061WM,MN West Side and Midtown,392420,239587,392420,392420,58413,334007,317935,233273,26694,404,54178,160,3226,16072,239587,207249,32338
12,36081,36081NE,QN Northeast,558077,211569,558077,558077,93934,464143,452678,142323,27810,656,276442,118,5329,11465,211569,200522,11047
13,36081,36081NW,QN Northwest,990334,394292,990334,990334,381069,609265,583606,295466,40649,1173,235705,273,10340,25659,394292,371899,22393
14,36081,36081SE,QN Southeast,574799,196342,574799,574799,98648,476151,447646,62816,284721,3621,77796,453,18239,28505,196342,185459,10883
15,36081,36081SW,QN Southwest,282254,94130,282254,282254,94210,188044,169561,48753,28195,4126,66640,266,21581,18483,94130,89330,4800
16,36085,36085C,SI Central,141576,51972,141576,141576,20379,121197,118347,86419,4948,112,25915,58,895,2850,51972,48976,2996
17,36085,36085N,SI North,189663,69066,189663,189663,58955,130708,125280,62560,40093,383,20632,56,1556,5428,69066,64940,4126
18,36085,36085S,SI South,164508,62654,164508,164508,17626,146882,143842,129002,1794,129,12206,21,690,3040,62654,59286,3368
0,9001,900104720,"Bethel town, Fairfield County, Connecticut",20358,7980,20358,20358,2622,17736,16613,14409,565,19,1213,1,406,1123,7980,7653,327
1,9001,900108070,"Bridgeport town, Fairfield County, Connecticut",148654,58874,148654,148654,62853,85801,80315,24404,48690,228,4024,31,2938,5486,58874,54261,4613
2,9001,900108980,"Brookfield town, Fairfield County, Connecticut",17528,7116,17528,17528,1470,16058,15223,13785,299,11,946,3,179,835,7116,6695,421
3,9001,900118500,"Danbury town, Fairfield County, Connecticut",86518,33562,86518,86518,28690,57828,52007,37963,5630,70,5339,25,2980,5821,33562,31762,1800
4,9001,900118850,"Darien town, Fairfield County, Connecticut",21499,7265,21499,21499,1234,20265,19470,18016,148,17,1197,4,88,795,7265,6814,451
5,9001,900123890,"Easton town, Fairfield County, Connecticut",7605,2756,7605,7605,444,7161,6883,6408,106,6,328,1,34,278,2756,2605,151
6,9001,900126620,"Fairfield town, Fairfield County, Connecticut",61512,21982,61512,61512,4806,56706,54497,50035,1110,23,2906,5,418,2209,21982,20820,1162
7,9001,900133620,"Greenwich town, Fairfield County, Connecticut",63518,25677,63518,63518,8135,55383,52414,45877,1157,33,4726,15,606,2969,25677,23316,2361
8,9001,900148620,"Monroe town, Fairfield County, Connecticut",18825,6918,18825,18825,1470,17355,16717,15548,400,20,660,0,89,638,6918,6690,228
9,9001,900150580,"New Canaan town, Fairfield County, Connecticut",20622,7502,20622,20622,1121,19501,18670,17169,244,6,1159,4,88,831,7502,6923,579
10,9001,900150860,"New Fairfield town, Fairfield County, Connecticut",13579,5635,13579,13579,1201,12378,11933,11438,153,11,230,3,98,445,5635,4948,687
11,9001,900152980,"Newtown town, Fairfield County, Connecticut",27173,10322,27173,27173,1757,25416,24434,22950,592,12,734,10,136,982,10322,9766,556
12,9001,900156060,"Norwalk town, Fairfield County, Connecticut",91184,38152,91184,91184,27629,63555,60928,44314,11074,102,4772,14,652,2627,38152,36078,2074
13,9001,900163480,"Redding town, Fairfield County, Connecticut",8765,3664,8765,8765,465,8300,7970,7580,75,11,243,2,59,330,3664,3356,308
14,9001,900163970,"Ridgefield town, Fairfield County, Connecticut",25033,9506,25033,25033,1506,23527,22612,20956,214,22,1261,3,156,915,9506,8968,538
15,9001,900168170,"Shelton town, Fairfield County, Connecticut",40869,17174,40869,40869,4080,36789,35641,31701,1812,30,1800,11,287,1148,17174,16356,818
16,9001,900168310,"Sherman town, Fairfield County, Connecticut",3527,1834,3527,3527,159,3368,3232,3149,25,1,51,0,6,136,1834,1425,409
17,9001,900173070,"Stamford town, Fairfield County, Connecticut",135470,56953,135470,135470,37958,97512,93710,64876,16201,140,11453,22,1018,3802,56953,53241,3712
18,9001,900174190,"Stratford town, Fairfield County, Connecticut",52355,21643,52355,52355,11107,41248,39329,28407,9136,53,1310,11,412,1919,21643,20435,1208
19,9001,900177200,"Trumbull town, Fairfield County, Connecticut",36827,13159,36827,36827,3505,33322,32103,27652,1642,22,2509,1,277,1219,13159,12622,537
20,9001,900183430,"Weston town, Fairfield County, Connecticut",10354,3671,10354,10354,631,9723,9242,8443,143,3,575,3,75,481,3671,3420,251
21,9001,900183500,"Westport town, Fairfield County, Connecticut",27141,10567,27141,27141,1592,25549,24414,22169,375,15,1703,0,152,1135,10567,9720,847
22,9001,900186370,"Wilton town, Fairfield County, Connecticut",18503,6567,18503,18503,916,17587,16774,14876,201,3,1612,4,78,813,6567,6210,357
23,9005,900502760,"Barkhamsted town, Litchfield County, Connecticut",3647,1566,3647,3647,84,3563,3436,3382,11,1,26,0,16,127,1566,1457,109
24,9005,900504930,"Bethlehem town, Litchfield County, Connecticut",3385,1605,3385,3385,104,3281,3173,3104,31,4,22,0,12,108,1605,1398,207
25,9005,900508210,"Bridgewater town, Litchfield County, Connecticut",1662,863,1662,1662,41,1621,1553,1520,14,1,10,0,8,68,863,728,135
26,9005,900510940,"Canaan town, Litchfield County, Connecticut",1080,639,1080,1080,56,1024,1001,975,15,3,1,0,7,23,639,480,159
27,9005,900516050,"Colebrook town, Litchfield County, Connecticut",1361,694,1361,1361,31,1330,1275,1257,5,1,4,0,8,55,694,584,110
28,9005,900517240,"Cornwall town, Litchfield County, Connecticut",1567,1002,1567,1567,61,1506,1467,1433,4,1,24,0,5,39,1002,732,270
29,9005,900532290,"Goshen town, Litchfield County, Connecticut",3150,1708,3150,3150,120,3030,2924,2869,16,2,32,0,5,106,1708,1285,423
30,9005,900537280,"Harwinton town, Litchfield County, Connecticut",5484,2313,5484,5484,172,5312,5132,5045,35,8,31,0,13,180,2313,2179,134
31,9005,900540290,"Kent town, Litchfield County, Connecticut",3019,1687,3019,3019,156,2863,2733,2586,31,21,85,0,10,130,1687,1285,402
32,9005,900543370,"Litchfield town, Litchfield County, Connecticut",8192,3966,8192,8192,276,7916,7653,7463,51,13,114,0,12,263,3966,3467,499
33,9005,900549460,"Morris town, Litchfield County, Connecticut",2256,1253,2256,2256,67,2189,2125,2093,12,0,14,0,6,64,1253,933,320
34,9005,900551350,"New Hartford town, Litchfield County, Connecticut",6658,2968,6658,6658,177,6481,6238,6105,18,6,75,3,31,243,2968,2681,287
35,9005,900552630,"New Milford town, Litchfield County, Connecticut",28115,11928,28115,28115,3241,24874,23432,21515,639,32,958,6,282,1442,11928,10994,934
36,9005,900553470,"Norfolk town, Litchfield County, Connecticut",1588,932,1588,1588,48,1540,1481,1449,8,4,18,0,2,59,932,715,217
37,9005,900554030,"North Canaan town, Litchfield County, Connecticut",3211,1582,3211,3211,266,2945,2814,2747,36,6,15,0,10,131,1582,1399,183
38,9005,900560750,"Plymouth town, Litchfield County, Connecticut",11671,5151,11671,11671,739,10932,10388,10057,141,16,145,9,20,544,5151,4856,295
39,9005,900565930,"Roxbury town, Litchfield County, Connecticut",2260,1163,2260,2260,70,2190,2102,2053,9,2,29,0,9,88,1163,979,184
40,9005,900566420,"Salisbury town, Litchfield County, Connecticut",4194,2519,4194,4194,197,3997,3845,3643,80,8,78,1,35,152,2519,1717,802
41,9005,900567960,"Sharon town, Litchfield County, Connecticut",2680,1724,2680,2680,98,2582,2499,2390,35,1,44,0,29,83,1724,1238,486
42,9005,900575730,"Thomaston town, Litchfield County, Connecticut",7442,3340,7442,7442,340,7102,6826,6637,58,9,91,1,30,276,3340,3145,195
43,9005,900576570,"Torrington town, Litchfield County, Connecticut",35515,17040,35515,35515,5433,30082,28485,26308,1060,64,891,15,147,1597,17040,15490,1550
44,9005,900579510,"Warren town, Litchfield County, Connecticut",1351,790,1351,1351,56,1295,1238,1211,1,6,14,0,6,57,790,580,210
45,9005,900579720,"Washington town, Litchfield County, Connecticut",3646,2056,3646,3646,219,3427,3319,3217,24,5,49,0,24,108,2056,1526,530
46,9005,900580490,"Watertown town, Litchfield County, Connecticut",22105,9137,22105,22105,1390,20715,20064,19121,399,21,399,10,114,651,9137,8742,395
47,9005,900586440,"Winchester town, Litchfield County, Connecticut",10224,5405,10224,10224,684,9540,9117,8812,116,15,124,12,38,423,5405,4661,744
48,9005,900587910,"Woodbury town, Litchfield County, Connecticut",9723,4584,9723,9723,454,9269,8934,8609,108,18,141,6,52,335,4584,4251,333
49,9009,900900000,"County subdivisions not defined, New Haven County, Connecticut",0,0,0,0,0,0,0,0,0,0,0,0,0,0,0,0,0
50,9009,900901220,"Ansonia town, New Haven County, Connecticut",18918,8104,18918,18918,4493,14425,13685,10688,2474,27,382,1,113,740,8104,7570,534
51,9009,900903250,"Beacon Falls town, New Haven County, Connecticut",6000,2618,6000,6000,413,5587,5386,5126,124,9,84,0,43,201,2618,2485,133
52,9009,900904580,"Bethany town, New Haven County, Connecticut",5297,2039,5297,5297,182,5115,4938,4561,101,3,248,0,25,177,2039,1948,91
53,9009,900907310,"Branford town, New Haven County, Connecticut",28273,14180,28273,28273,1862,26411,25564,23427,654,25,1311,10,137,847,14180,13069,1111
54,9009,900914160,"Cheshire town, New Haven County, Connecticut",28733,10401,28733,28733,1818,26915,26015,22882,1226,16,1788,2,101,900,10401,10041,360
55,9009,900919550,"Derby town, New Haven County, Connecticut",12325,5759,12325,12325,2544,9781,9391,7595,1373,20,336,3,64,390,5759,5408,351
56,9009,900922910,"East Haven town, New Haven County, Connecticut",27923,12394,27923,27923,5054,22869,22125,19656,1262,26,1066,3,112,744,12394,11635,759
57,9009,900934950,"Guilford town, New Haven County, Connecticut",22073,9693,22073,22073,1135,20938,20142,19085,202,10,781,2,62,796,9693,8813,880
58,9009,900935650,"Hamden town, New Haven County, Connecticut",61169,25984,61169,61169,7836,53333,51170,32384,14834,178,3447,25,302,2163,25984,23988,1996
59,9009,900944560,"Madison town, New Haven County, Connecticut",17691,8060,17691,17691,641,17050,16477,15705,127,20,562,0,63,573,8060,6987,1073
60,9009,900946520,"Meriden town, New Haven County, Connecticut",60850,26177,60850,60850,22295,38555,36384,29104,5565,67,1311,25,312,2171,26177,24346,1831
61,9009,900946940,"Middlebury town, New Haven County, Connecticut",7574,3047,7574,7574,332,7242,7038,6560,67,0,377,3,31,204,3047,2859,188
62,9009,900947535,"Milford town, New Haven County, Connecticut",52044,23749,52044,52044,4111,47933,46122,41417,1531,51,2840,17,266,1811,23749,22338,1411
63,9009,900949950,"Naugatuck town, New Haven County, Connecticut",31519,13239,31519,31519,4871,26648,24909,21366,2195,31,749,7,561,1739,13239,12432,807
64,9009,900952070,"New Haven town, New Haven County, Connecticut",134023,57525,134023,134023,41068,92955,88115,37010,40788,339,9044,61,873,4840,57525,52263,5262
65,9009,900953890,"North Branford town, New Haven County, Connecticut",13544,5633,13544,13544,670,12874,12556,12137,145,7,234,0,33,318,5633,5323,310
66,9009,900954870,"North Haven town, New Haven County, Connecticut",24253,9981,24253,24253,1490,22763,22124,19631,889,23,1468,8,105,639,9981,9546,435
67,9009,900957600,"Orange town, New Haven County, Connecticut",14280,5480,14280,14280,715,13565,13112,11326,259,11,1458,1,57,453,5480,5282,198
68,9009,900958300,"Oxford town, New Haven County, Connecticut",12706,5022,12706,12706,681,12025,11657,11254,128,7,218,4,46,368,5022,4774,248
69,9009,900962290,"Prospect town, New Haven County, Connecticut",9401,3762,9401,9401,426,8975,8676,8331,206,10,94,2,33,299,3762,3627,135
70,9009,900967610,"Seymour town, New Haven County, Connecticut",16748,7112,16748,16748,1752,14996,14479,13298,668,13,421,5,74,517,7112,6779,333
71,9009,900969640,"Southbury town, New Haven County, Connecticut",19879,9270,19879,19879,830,19049,18477,17625,200,6,556,2,88,572,9270,8587,683
72,9009,900978740,"Wallingford town, New Haven County, Connecticut",44396,18938,44396,44396,4770,39626,38283,35397,842,57,1809,18,160,1343,18938,18104,834
73,9009,900980070,"Waterbury town, New Haven County, Connecticut",114403,48392,114403,114403,45281,69122,64515,37760,22269,307,2349,32,1798,4607,48392,44425,3967
74,9009,900982870,"West Haven town, New Haven County, Connecticut",55584,22735,55584,55584,13177,42407,40531,25960,11485,118,2609,10,349,1876,22735,21409,1326
75,9009,900987560,"Wolcott town, New Haven County, Connecticut",16142,6408,16142,16142,1087,15055,14525,13778,395,27,250,3,72,530,6408,6141,267
76,9009,900987700,"Woodbridge town, New Haven County, Connecticut",9087,3476,9087,9087,547,8540,8173,6625,264,5,1203,3,73,367,3476,3258,218
77,26103,3628997,"Gilgo-Oak Beach-Captree CDP, New York",268,233,268,268,20,248,248,225,5,0,18,0,0,0,233,113,120
78,34003,3400300700,"Allendale borough, Bergen County, New Jersey",6848,2450,6848,6848,456,6392,6165,5261,42,1,837,2,22,227,2450,2327,123
79,34003,3400301090,"Alpine borough, Bergen County, New Jersey",1762,676,1762,1762,121,1641,1601,949,54,0,593,0,5,40,676,587,89
80,34003,3400305170,"Bergenfield borough, Bergen County, New Jersey",28321,9387,28321,28321,9121,19200,18668,9278,1894,30,7222,0,244,532,9387,9097,290
81,34003,3400306490,"Bogota borough, Bergen County, New Jersey",8778,3026,8778,8778,4506,4272,4057,2614,585,15,748,2,93,215,3026,2939,87
82,34003,3400310480,"Carlstadt borough, Bergen County, New Jersey",6372,2563,6372,6372,1582,4790,4646,3855,132,10,608,0,41,144,2563,2429,134
83,34003,3400313570,"Cliffside Park borough, Bergen County, New Jersey",25693,11435,25693,25693,8954,16739,16007,11185,656,23,3784,5,354,732,11435,10735,700
84,34003,3400313810,"Closter borough, Bergen County, New Jersey",8594,2891,8594,8594,725,7869,7620,4496,83,2,3009,0,30,249,2891,2762,129
85,34003,3400315820,"Cresskill borough, Bergen County, New Jersey",9155,3157,9155,9155,630,8525,8301,5305,90,3,2865,1,37,224,3157,3015,142
86,34003,3400317530,"Demarest borough, Bergen County, New Jersey",4981,1680,4981,4981,270,4711,4570,2941,41,1,1562,1,24,141,1680,1598,82
87,34003,3400318400,"Dumont borough, Bergen County, New Jersey",17863,6572,17863,17863,3883,13980,13538,9847,503,12,3081,2,93,442,6572,6408,164
88,34003,3400319510,"East Rutherford borough, Bergen County, New Jersey",10022,4585,10022,10022,2556,7466,7225,5028,456,28,1612,2,99,241,4585,4306,279
89,34003,3400320020,"Edgewater borough, Bergen County, New Jersey",14336,7315,14336,14336,1959,12377,11878,5934,772,13,5071,1,87,499,7315,6742,573
90,34003,3400321300,"Elmwood Park borough, Bergen County, New Jersey",21422,7949,21422,21422,5898,15524,15052,10928,1494,25,2367,0,238,472,7949,7652,297
91,34003,3400321450,"Emerson borough, Bergen County, New Jersey",7290,2600,7290,7290,948,6342,6164,5328,108,4,709,0,15,178,2600,2482,118
92,34003,3400321480,"Englewood city, Bergen County, New Jersey",29308,11563,29308,29308,9639,19669,18909,8497,7180,46,2863,8,315,760,11563,10909,654
93,34003,3400321510,"Englewood Cliffs borough, Bergen County, New Jersey",5342,1961,5342,5342,341,5001,4863,2201,107,0,2534,0,21,138,1961,1846,115
94,34003,3400322470,"Fair Lawn borough, Bergen County, New Jersey",34927,12649,34927,34927,5369,29558,28781,23305,784,24,4468,10,190,777,12649,12243,406
95,34003,3400322560,"Fairview borough, Bergen County, New Jersey",15025,5291,15025,15025,10018,5007,4712,3513,240,27,694,0,238,295,5291,5021,270
96,34003,3400324420,"Fort Lee borough, Bergen County, New Jersey",40191,19861,40191,40191,5376,34815,33895,15488,1192,21,16949,9,236,920,19861,18451,1410
97,34003,3400324990,"Franklin Lakes borough, Bergen County, New Jersey",11079,4051,11079,11079,786,10293,10031,8755,172,2,1051,3,48,262,4051,3722,329
98,34003,3400325770,"Garfield city, Bergen County, New Jersey",32655,12407,32655,32655,12781,19874,19343,16398,1684,48,985,3,225,531,12407,11773,634
99,34003,3400326640,"Glen Rock borough, Bergen County, New Jersey",12133,4041,12133,12133,848,11285,10843,9037,163,0,1617,1,25,442,4041,3934,107
100,34003,3400328680,"Hackensack city, Bergen County, New Jersey",46030,20290,46030,46030,19220,26810,25849,11053,9558,62,4734,7,435,961,20290,19132,1158
101,34003,3400330150,"Harrington Park borough, Bergen County, New Jersey",4741,1643,4741,4741,299,4442,4333,3235,35,0,1049,0,14,109,1643,1594,49
102,34003,3400330420,"Hasbrouck Heights borough, Bergen County, New Jersey",12125,4715,12125,12125,2551,9574,9301,7466,333,7,1421,1,73,273,4715,4535,180
103,34003,3400330540,"Haworth borough, Bergen County, New Jersey",3343,1148,3343,3343,191,3152,3024,2416,51,0,545,0,12,128,1148,1104,44
104,34003,3400331920,"Hillsdale borough, Bergen County, New Jersey",10143,3635,10143,10143,1138,9005,8769,7861,115,3,742,1,47,236,3635,3502,133
105,34003,3400332310,"Ho-Ho-Kus borough, Bergen County, New Jersey",4258,1473,4258,4258,302,3956,3842,3475,26,1,321,0,19,114,1473,1416,57
106,34003,3400340020,"Leonia borough, Bergen County, New Jersey",9304,3476,9304,9304,1669,7635,7368,3256,202,2,3876,0,32,267,3476,3359,117
107,34003,3400340680,"Little Ferry borough, Bergen County, New Jersey",10987,4527,10987,10987,3468,7519,7298,4012,469,6,2717,3,91,221,4527,4351,176
108,34003,3400341100,"Lodi borough, Bergen County, New Jersey",26206,10414,26206,26206,10838,15368,14842,10413,2020,12,2194,0,203,526,10414,9971,443
109,34003,3400342090,"Lyndhurst township, Bergen County, New Jersey",22519,9516,22519,22519,6081,16438,15895,13388,688,9,1587,0,223,543,9516,9069,447
110,34003,3400342750,"Mahwah township, Bergen County, New Jersey",25487,10109,25487,25487,2204,23283,22554,18840,686,93,2830,2,103,729,10109,9727,382
111,34003,3400344880,"Maywood borough, Bergen County, New Jersey",10080,3829,10080,10080,2567,7513,7286,5143,605,32,1442,1,63,227,3829,3717,112
112,34003,3400346110,"Midland Park borough, Bergen County, New Jersey",7014,2887,7014,7014,734,6280,6100,5749,70,6,241,0,34,180,2887,2750,137
113,34003,3400347610,"Montvale borough, Bergen County, New Jersey",8436,3115,8436,8436,683,7753,7532,6069,121,0,1324,1,17,221,3115,3016,99
114,34003,3400347700,"Moonachie borough, Bergen County, New Jersey",3133,1149,3133,3133,1292,1841,1789,1391,20,0,351,0,27,52,1149,1120,29
115,34003,3400351660,"New Milford borough, Bergen County, New Jersey",16923,6432,16923,16923,3304,13619,13191,8830,796,6,3420,0,139,428,6432,6276,156
116,34003,3400352320,"North Arlington borough, Bergen County, New Jersey",16457,6749,16457,16457,5109,11348,10850,9245,257,7,1173,2,166,498,6749,6525,224
117,34003,3400353430,"Northvale borough, Bergen County, New Jersey",4761,1700,4761,4761,569,4192,4060,2714,55,0,1278,0,13,132,1700,1641,59
118,34003,3400353610,"Norwood borough, Bergen County, New Jersey",5641,2032,5641,5641,418,5223,5091,3196,74,4,1809,0,8,132,2032,1943,89
119,34003,3400353850,"Oakland borough, Bergen County, New Jersey",12748,4561,12748,12748,1210,11538,11137,10370,119,12,605,1,30,401,4561,4356,205
120,34003,3400354870,"Old Tappan borough, Bergen County, New Jersey",5888,2083,5888,5888,380,5508,5350,3673,59,3,1600,0,15,158,2083,1982,101
121,34003,3400354990,"Oradell borough, Bergen County, New Jersey",8244,2850,8244,8244,734,7510,7285,5889,73,7,1277,0,39,225,2850,2782,68
122,34003,3400355770,"Palisades Park borough, Bergen County, New Jersey",20292,7668,20292,20292,4862,15430,15174,2903,262,10,11900,6,93,256,7668,7314,354
123,34003,3400355950,"Paramus borough, Bergen County, New Jersey",26698,8786,26698,26698,2810,23888,23119,15556,459,3,6966,0,135,769,8786,8448,338
124,34003,3400356130,"Park Ridge borough, Bergen County, New Jersey",8883,3435,8883,8883,936,7947,7729,6972,91,2,631,0,33,218,3435,3310,125
125,34003,3400361680,"Ramsey borough, Bergen County, New Jersey",14798,5670,14798,14798,1374,13424,13041,11711,127,4,1134,1,64,383,5670,5488,182
126,34003,3400362910,"Ridgefield borough, Bergen County, New Jersey",11501,4237,11501,11501,3343,8158,7921,4281,200,10,3319,4,107,237,4237,4050,187
127,34003,3400362940,"Ridgefield Park village, Bergen County, New Jersey",13224,5269,13224,13224,6189,7035,6688,4477,649,8,1460,1,93,347,5269,4986,283
128,34003,3400363000,"Ridgewood village, Bergen County, New Jersey",25979,8814,25979,25979,2069,23910,22813,17786,353,7,4556,0,111,1097,8814,8490,324
129,34003,3400363360,"River Edge borough, Bergen County, New Jersey",12049,4337,12049,12049,1339,10710,10424,6649,283,8,3434,0,50,286,4337,4191,146
130,34003,3400363690,"River Vale township, Bergen County, New Jersey",9909,3644,9909,9909,731,9178,8905,7756,117,8,993,1,30,273,3644,3536,108
131,34003,3400363990,"Rochelle Park township, Bergen County, New Jersey",5814,2227,5814,5814,1575,4239,4095,3254,208,3,602,0,28,144,2227,2151,76
132,34003,3400364170,"Rockleigh borough, Bergen County, New Jersey",407,81,407,407,33,374,365,327,10,0,27,0,1,9,81,69,12
133,34003,3400365280,"Rutherford borough, Bergen County, New Jersey",18834,7370,18834,18834,3395,15439,14718,11242,631,27,2688,6,124,721,7370,7061,309
134,34003,3400365340,"Saddle Brook township, Bergen County, New Jersey",14294,5618,14294,14294,2748,11546,11285,9554,442,6,1219,2,62,261,5618,5378,240
135,34003,3400365400,"Saddle River borough, Bergen County, New Jersey",3372,1458,3372,3372,181,3191,3093,2550,65,11,451,2,14,98,1458,1246,212
136,34003,3400368970,"South Hackensack township, Bergen County, New Jersey",2701,950,2701,2701,1256,1445,1394,1068,135,1,172,1,17,51,950,922,28
137,34003,3400372360,"Teaneck township, Bergen County, New Jersey",41246,14430,41246,41246,8848,32398,31047,16845,9180,46,4378,8,590,1351,14430,13784,646
138,34003,3400372420,"Tenafly borough, Bergen County, New Jersey",15409,5184,15409,15409,1137,14272,13777,8719,240,8,4711,12,87,495,5184,4913,271
139,34003,3400372480,"Teterboro borough, Bergen County, New Jersey",61,26,61,61,25,36,34,26,7,0,1,0,0,2,26,25,1
140,34003,3400375140,"Upper Saddle River borough, Bergen County, New Jersey",8353,2785,8353,8353,579,7774,7524,6120,129,1,1240,1,33,250,2785,2658,127
141,34003,3400376400,"Waldwick borough, Bergen County, New Jersey",10058,3691,10058,10058,1315,8743,8504,7701,126,6,640,0,31,239,3691,3577,114
142,34003,3400376490,"Wallington borough, Bergen County, New Jersey",11868,5108,11868,11868,2299,9569,9408,8286,320,11,694,6,91,161,5108,4825,283
143,34003,3400377135,"Washington township, Bergen County, New Jersey",9285,3375,9285,9285,800,8485,8273,7585,87,8,566,0,27,212,3375,3278,97
144,34003,3400380270,"Westwood borough, Bergen County, New Jersey",11282,4716,11282,11282,1651,9631,9282,7861,448,6,928,6,33,349,4716,4515,201
145,34003,3400382300,"Woodcliff Lake borough, Bergen County, New Jersey",6128,2235,6128,6128,407,5721,5568,4955,46,2,536,1,28,153,2235,2114,121
146,34003,3400382570,"Wood-Ridge borough, Bergen County, New Jersey",10137,4057,10137,10137,1738,8399,8175,6141,337,4,1617,0,76,224,4057,3920,137
147,34003,3400383050,"Wyckoff township, Bergen County, New Jersey",16585,5769,16585,16585,1315,15270,14762,13767,93,4,872,3,23,508,5769,5569,200
148,34013,3401304695,"Belleville township, Essex County, New Jersey",38222,14970,38222,38222,19181,19041,18188,10310,3092,50,4201,18,517,853,14970,14282,688
149,34013,3401306260,"Bloomfield township, Essex County, New Jersey",53105,21714,53105,53105,16197,36908,34905,19668,9941,84,4495,4,713,2003,21714,20810,904
150,34013,3401309250,"Caldwell borough, Essex County, New Jersey",9027,3669,9027,9027,1313,7714,7498,6471,419,4,545,4,55,216,3669,3538,131
151,34013,3401311200,"Cedar Grove township, Essex County, New Jersey",12980,5042,12980,12980,1465,11515,11160,9754,305,18,1016,2,65,355,5042,4754,288
152,34013,3401313045,"City of Orange township, Essex County, New Jersey",34447,13590,34447,34447,9983,24464,23316,1073,21627,44,262,7,303,1148,13590,12788,802
153,34013,3401319390,"East Orange city, Essex County, New Jersey",69612,30357,69612,69612,9032,60580,57318,1388,54689,164,501,6,570,3262,30357,27410,2947
154,34013,3401321840,"Essex Fells borough, Essex County, New Jersey",2244,806,2244,2244,137,2107,2021,1889,24,2,104,0,2,86,806,750,56
155,34013,3401322385,"Fairfield township, Essex County, New Jersey",7872,2826,7872,7872,733,7139,6980,6562,38,0,355,1,24,159,2826,2747,79
156,34013,3401326610,"Glen Ridge borough, Essex County, New Jersey",7802,2592,7802,7802,558,7244,6749,5825,289,0,587,0,48,495,2592,2529,63
157,34013,3401334450,"Irvington township, Essex County, New Jersey",61176,24984,61176,61176,8985,52191,50124,983,48208,84,413,7,429,2067,24984,22638,2346
158,34013,3401340890,"Livingston township, Essex County, New Jersey",31330,10719,31330,31330,1583,29747,28972,18812,953,12,9014,4,177,775,10719,10337,382
159,34013,3401343800,"Maplewood township, Essex County, New Jersey",25684,9269,25684,25684,2182,23502,22061,13170,7740,30,951,4,166,1441,9269,8866,403
160,34013,3401346380,"Millburn township, Essex County, New Jersey",21710,7241,21710,21710,973,20737,19891,12147,458,15,7123,2,146,846,7241,6908,333
161,34013,3401347500,"Montclair township, Essex County, New Jersey",40921,16304,40921,40921,4304,36617,34137,22593,9008,36,2045,11,444,2480,16304,15555,749
162,34013,3401351000,"Newark city, Essex County, New Jersey",311549,118163,311549,311549,113374,198175,185706,24916,147905,572,4871,63,7379,12469,118163,108789,9374
163,34013,3401352620,"North Caldwell borough, Essex County, New Jersey",6694,2364,6694,6694,405,6289,6092,5476,85,3,518,0,10,197,2364,2258,106
164,34013,3401353680,"Nutley township, Essex County, New Jersey",30143,12340,30143,30143,5858,24285,23539,18864,928,38,3518,13,178,746,12340,11887,453
165,34013,3401364590,"Roseland borough, Essex County, New Jersey",6299,2607,6299,6299,437,5862,5677,4904,192,7,551,1,22,185,2607,2523,84
166,34013,3401369274,"South Orange Village township, Essex County, New Jersey",18484,6306,18484,18484,1604,16880,15836,10510,3803,11,1228,2,282,1044,6306,5940,366
167,34013,3401375815,"Verona township, Essex County, New Jersey",14572,6150,14572,14572,1431,13141,12675,11591,323,11,696,2,52,466,6150,5862,288
168,34013,3401378510,"West Caldwell township, Essex County, New Jersey",11012,4137,11012,11012,971,10041,9702,9064,138,0,440,0,60,339,4137,4004,133
169,34013,3401379800,"West Orange township, Essex County, New Jersey",48843,18746,48843,48843,9647,39196,37101,19155,13916,53,3523,18,436,2095,18746,17738,1008
170,34017,3401703580,"Bayonne city, Hudson County, New Jersey",71686,29727,71686,71686,22101,49585,47559,32697,7116,80,7011,17,638,2026,29727,27867,1860
171,34017,3401719360,"East Newark borough, Hudson County, New Jersey",2594,920,2594,2594,1619,975,906,511,54,2,257,0,82,69,920,889,31
172,34017,3401728650,"Guttenberg town, Hudson County, New Jersey",12017,5142,12017,12017,7868,4149,3965,2426,343,7,1064,3,122,184,5142,4920,222
173,34017,3401730210,"Harrison town, Hudson County, New Jersey",19450,8594,19450,19450,7759,11691,10905,4690,722,18,4946,0,529,786,8594,8111,483
174,34017,3401732250,"Hoboken city, Hudson County, New Jersey",60419,30202,60419,60419,8542,51877,49797,40657,2106,29,6518,50,437,2080,30202,28175,2027
175,34017,3401736000,"Jersey City city, Hudson County, New Jersey",292449,130992,292449,292449,72777,219672,210191,69624,54199,638,81425,101,4204,9481,130992,119517,11475
176,34017,3401736510,"Kearny town, Hudson County, New Jersey",41999,15392,41999,41999,20465,21534,19514,14889,1246,37,2034,23,1285,2020,15392,14639,753
177,34017,3401752470,"North Bergen township, Hudson County, New Jersey",63361,25079,63361,63361,44900,18461,17603,11235,1403,70,4269,14,612,858,25079,23426,1653
178,34017,3401766570,"Secaucus town, Hudson County, New Jersey",22181,9316,22181,22181,4700,17481,16997,8760,922,23,7167,3,122,484,9316,8840,476
179,34017,3401774630,"Union City city, Hudson County, New Jersey",68589,26455,68589,68589,56509,12080,11310,6855,1355,99,2394,7,600,770,26455,24511,1944
180,34017,3401777930,"Weehawken township, Hudson County, New Jersey",17197,9089,17197,17197,5665,11532,10970,7537,685,15,2594,7,132,562,9089,7969,1120
181,34017,3401779610,"West New York town, Hudson County, New Jersey",52912,21798,52912,52912,40114,12798,12134,6649,1234,51,3745,8,447,664,21798,20544,1254
182,34019,3401900550,"Alexandria township, Hunterdon County, New Jersey",4809,1857,4809,4809,287,4522,4370,4168,65,9,105,1,22,152,1857,1751,106
183,34019,3401905650,"Bethlehem township, Hunterdon County, New Jersey",3745,1406,3745,3745,209,3536,3413,3267,40,2,92,0,12,123,1406,1347,59
184,34019,3401906370,"Bloomsbury borough, Hunterdon County, New Jersey",792,371,792,792,54,738,714,671,25,0,13,0,5,24,371,340,31
185,34019,3401909280,"Califon borough, Hunterdon County, New Jersey",1005,429,1005,1005,41,964,923,901,1,1,15,0,5,41,429,404,25
186,34019,3401913720,"Clinton town, Hunterdon County, New Jersey",2773,1157,2773,2773,281,2492,2414,2115,50,7,235,0,7,78,1157,1114,43
187,34019,3401913750,"Clinton township, Hunterdon County, New Jersey",13505,4888,13505,13505,1071,12434,11991,10391,757,8,768,1,66,443,4888,4658,230
188,34019,3401917170,"Delaware township, Hunterdon County, New Jersey",4560,1952,4560,4560,264,4296,4132,4006,39,4,64,0,19,164,1952,1795,157
189,34019,3401918820,"East Amwell township, Hunterdon County, New Jersey",3917,1628,3917,3917,217,3700,3597,3467,35,12,64,0,19,103,1628,1548,80
190,34019,3401923700,"Flemington borough, Hunterdon County, New Jersey",4876,1974,4876,4876,1928,2948,2839,2350,133,7,317,1,31,109,1974,1853,121
191,34019,3401924870,"Franklin township, Hunterdon County, New Jersey",3267,1257,3267,3267,214,3053,2935,2828,28,1,58,0,20,118,1257,1172,85
192,34019,3401925350,"Frenchtown borough, Hunterdon County, New Jersey",1370,677,1370,1370,104,1266,1209,1156,16,1,23,0,13,57,677,629,48
193,34019,3401926550,"Glen Gardner borough, Hunterdon County, New Jersey",1682,835,1682,1682,141,1541,1495,1398,62,0,18,1,16,46,835,785,50
194,34019,3401929460,"Hampton borough, Hunterdon County, New Jersey",1438,650,1438,1438,126,1312,1259,1186,31,0,34,0,8,53,650,612,38
195,34019,3401931320,"High Bridge borough, Hunterdon County, New Jersey",3546,1517,3546,3546,340,3206,3100,2928,51,1,113,0,7,106,1517,1424,93
196,34019,3401932460,"Holland township, Hunterdon County, New Jersey",5177,2099,5177,5177,220,4957,4780,4694,31,2,44,0,9,177,2099,2001,98
197,34019,3401937065,"Kingwood township, Hunterdon County, New Jersey",3802,1606,3802,3802,143,3659,3531,3436,42,3,40,0,10,128,1606,1476,130
198,34019,3401938610,"Lambertville city, Hunterdon County, New Jersey",4139,2265,4139,4139,525,3614,3499,3337,75,3,62,1,21,115,2265,2093,172
199,34019,3401939630,"Lebanon borough, Hunterdon County, New Jersey",1665,828,1665,1665,144,1521,1471,1328,70,0,70,0,3,50,828,795,33
200,34019,3401939660,"Lebanon township, Hunterdon County, New Jersey",6195,2505,6195,6195,356,5839,5639,5422,64,4,123,0,26,200,2505,2368,137
201,34019,3401946260,"Milford borough, Hunterdon County, New Jersey",1232,556,1232,1232,83,1149,1117,1082,17,2,12,0,4,32,556,524,32
202,34019,3401961920,"Raritan township, Hunterdon County, New Jersey",23447,8911,23447,23447,1899,21548,20798,17989,588,16,2104,2,99,750,8911,8613,298
203,34019,3401962250,"Readington township, Hunterdon County, New Jersey",16128,6552,16128,16128,1217,14911,14456,13443,213,8,744,0,48,455,6552,6271,281
204,34019,3401970980,"Stockton borough, Hunterdon County, New Jersey",495,255,495,495,10,485,472,463,0,0,8,0,1,13,255,233,22
205,34019,3401972510,"Tewksbury township, Hunterdon County, New Jersey",5870,2386,5870,5870,332,5538,5340,5019,54,0,232,0,35,198,2386,2185,201
206,34019,3401974420,"Union township, Hunterdon County, New Jersey",6507,1917,6507,6507,543,5964,5790,5026,481,1,258,1,23,174,1917,1840,77
207,34019,3401978230,"West Amwell township, Hunterdon County, New Jersey",3005,1209,3005,3005,180,2825,2725,2596,62,0,61,0,6,100,1209,1147,62
208,34021,3402119780,"East Windsor township, Mercer County, New Jersey",30045,11690,30045,30045,7750,22295,21572,11910,2653,43,6780,11,175,723,11690,11158,532
209,34021,3402122185,"Ewing township, Mercer County, New Jersey",37264,15637,37264,37264,4868,32396,31179,17587,11364,52,1938,16,222,1217,15637,13889,1748
210,34021,3402129310,"Hamilton township, Mercer County, New Jersey",92297,37716,92297,92297,18279,74018,71473,55199,11724,67,4121,14,348,2545,37716,36125,1591
211,34021,3402131620,"Hightstown borough, Mercer County, New Jersey",5900,2216,5900,5900,2166,3734,3521,2739,402,6,333,4,37,213,2216,2097,119
212,34021,3402133150,"Hopewell borough, Mercer County, New Jersey",1918,828,1918,1918,84,1834,1752,1685,32,4,27,1,3,82,828,787,41
213,34021,3402133180,"Hopewell township, Mercer County, New Jersey",17491,6748,17491,17491,1039,16452,15834,13108,586,9,2035,7,89,618,6748,6367,381
214,34021,3402139510,"Lawrence township, Mercer County, New Jersey",33077,13268,33077,33077,3687,29390,28200,18370,3755,27,5883,8,157,1190,13268,12550,718
215,34021,3402157600,"Pennington borough, Mercer County, New Jersey",2802,1088,2802,2802,88,2714,2604,2466,45,4,83,0,6,110,1088,1028,60
216,34021,3402160900,"Princeton borough, Mercer County, New Jersey",30681,10380,30681,30681,3014,27667,26141,17446,1742,17,6732,9,195,1526,10380,9373,1007
217,34021,3402163850,"Robbinsville township, Mercer County, New Jersey",15476,5687,15476,15476,790,14686,14206,9336,469,21,4307,0,73,480,5687,5479,208
218,34021,3402174000,"Trenton city, Mercer County, New Jersey",90871,34322,90871,90871,40905,49966,48096,8510,38386,144,592,24,440,1870,34322,30139,4183
219,34021,3402180240,"West Windsor township, Mercer County, New Jersey",29518,10862,29518,29518,1507,28011,27108,10224,1206,33,15499,12,134,903,10862,10369,493
220,34023,3402310750,"Carteret borough, Middlesex County, New Jersey",25326,8809,25326,25326,9340,15986,15430,5586,3820,43,5756,6,219,556,8809,8387,422
221,34023,3402315550,"Cranbury township, Middlesex County, New Jersey",3842,1388,3842,3842,183,3659,3543,2612,108,0,803,0,20,116,1388,1323,65
222,34023,3402318490,"Dunellen borough, Middlesex County, New Jersey",7637,2727,7637,7637,2820,4817,4587,3390,669,2,430,4,92,230,2727,2620,107
223,34023,3402319000,"East Brunswick township, Middlesex County, New Jersey",49715,18088,49715,49715,4758,44957,43548,27185,2113,41,13894,7,308,1409,18088,17302,786
224,34023,3402320230,"Edison township, Middlesex County, New Jersey",107588,38493,107588,107588,10771,96817,94630,28304,7764,219,57687,27,629,2187,38493,36852,1641
225,34023,3402330840,"Helmetta borough, Middlesex County, New Jersey",2455,1091,2455,2455,282,2173,2081,1846,99,1,119,4,12,92,1091,1052,39
226,34023,3402331470,"Highland Park borough, Middlesex County, New Jersey",15072,6669,15072,15072,2251,12821,12302,8212,1258,12,2643,5,172,519,6669,6320,349
227,34023,3402334890,"Jamesburg borough, Middlesex County, New Jersey",5783,2228,5783,5783,1843,3940,3755,3043,401,9,267,1,34,185,2228,2115,113
228,34023,3402345690,"Metuchen borough, Middlesex County, New Jersey",15049,6053,15049,15049,1510,13539,12830,9259,645,16,2825,2,83,709,6053,5822,231
229,34023,3402345900,"Middlesex borough, Middlesex County, New Jersey",14636,5472,14636,14636,3751,10885,10471,8331,902,14,1159,0,65,414,5472,5302,170
230,34023,3402346620,"Milltown borough, Middlesex County, New Jersey",7037,2707,7037,7037,810,6227,6013,5555,178,5,246,0,29,214,2707,2613,94
231,34023,3402347280,"Monroe township, Middlesex County, New Jersey",48594,21504,48594,48594,2746,45848,44992,30185,1655,42,12892,4,214,856,21504,20289,1215
232,34023,3402351210,"New Brunswick city, Middlesex County, New Jersey",55266,17509,55266,55266,31376,23890,23136,10322,6278,34,5722,30,750,754,17509,15387,2122
233,34023,3402352560,"North Brunswick township, Middlesex County, New Jersey",43905,15585,43905,43905,10676,33229,32086,12614,7737,75,11212,1,447,1143,15585,15025,560
234,34023,3402354705,"Old Bridge township, Middlesex County, New Jersey",66876,26067,66876,66876,9276,57600,55695,40394,4671,71,10119,17,423,1905,26067,25059,1008
235,34023,3402358200,"Perth Amboy city, Middlesex County, New Jersey",55436,17855,55436,55436,46149,9287,8747,4153,3483,38,610,12,451,540,17855,17136,719
236,34023,3402359010,"Piscataway township, Middlesex County, New Jersey",60804,18904,60804,60804,8276,52528,50980,14251,11771,130,23973,21,834,1548,18904,18071,833
237,34023,3402359280,"Plainsboro township, Middlesex County, New Jersey",24084,10281,24084,24084,1449,22635,22029,6696,1579,49,13578,7,120,606,10281,9720,561
238,34023,3402365790,"Sayreville borough, Middlesex County, New Jersey",45345,17695,45345,45345,7868,37477,36187,22366,5743,66,7611,5,396,1290,17695,16910,785
239,34023,3402368550,"South Amboy city, Middlesex County, New Jersey",9411,3906,9411,9411,2093,7318,7006,5948,529,8,470,1,50,312,3906,3740,166
240,34023,3402368790,"South Brunswick township, Middlesex County, New Jersey",47043,16647,47043,47043,3510,43533,42393,16098,3405,85,22604,7,194,1140,16647,16014,633
241,34023,3402369390,"South Plainfield borough, Middlesex County, New Jersey",24338,8432,24338,24338,4555,19783,19008,11588,2496,51,4579,5,289,775,8432,8217,215
242,34023,3402369420,"South River borough, Middlesex County, New Jersey",16118,5977,16118,16118,4198,11920,11075,8804,1000,4,826,2,439,845,5977,5694,283
243,34023,3402369810,"Spotswood borough, Middlesex County, New Jersey",8163,3297,8163,8163,917,7246,6968,6144,272,3,523,0,26,278,3297,3196,101
244,34023,3402382000,"Woodbridge township, Middlesex County, New Jersey",103639,38137,103639,103639,22279,81360,78786,40272,10143,165,27425,24,757,2574,38137,36381,1756
245,34025,3402500000,"County subdivisions not defined, Monmouth County, New Jersey",0,0,0,0,0,0,0,0,0,0,0,0,0,0,0,0,0
246,34025,3402500070,"Aberdeen township, Monmouth County, New Jersey",19329,7967,19329,19329,2642,16687,15955,12820,1883,25,1116,3,108,732,7967,7697,270
247,34025,3402500730,"Allenhurst borough, Monmouth County, New Jersey",472,369,472,472,19,453,442,435,4,0,3,0,0,11,369,199,170
248,34025,3402500760,"Allentown borough, Monmouth County, New Jersey",1734,724,1734,1734,92,1642,1582,1477,64,3,28,2,8,60,724,694,30
249,34025,3402501960,"Asbury Park city, Monmouth County, New Jersey",15188,8274,15188,15188,4079,11109,10602,5284,5059,14,162,4,79,507,8274,7087,1187
250,34025,3402502110,"Atlantic Highlands borough, Monmouth County, New Jersey",4414,2092,4414,4414,363,4051,3885,3748,54,0,78,1,4,166,2092,1949,143
251,34025,3402502440,"Avon-by-the-Sea borough, Monmouth County, New Jersey",1933,1334,1933,1933,141,1792,1747,1702,22,1,20,0,2,45,1334,902,432
252,34025,3402504930,"Belmar borough, Monmouth County, New Jersey",5907,4066,5907,5907,963,4944,4815,4605,100,5,71,0,34,129,4066,2867,1199
253,34025,3402506970,"Bradley Beach borough, Monmouth County, New Jersey",4282,3221,4282,4282,880,3402,3280,3119,82,7,57,0,15,122,3221,2157,1064
254,34025,3402507750,"Brielle borough, Monmouth County, New Jersey",4982,2176,4982,4982,226,4756,4628,4500,69,3,34,2,20,128,2176,1949,227
255,34025,3402514560,"Colts Neck township, Monmouth County, New Jersey",9957,3451,9957,9957,614,9343,9112,8469,105,0,495,1,42,231,3451,3307,144
256,34025,3402516660,"Deal borough, Monmouth County, New Jersey",900,925,900,900,120,780,757,731,6,0,6,0,14,23,925,347,578
257,34025,3402519840,"Eatontown borough, Monmouth County, New Jersey",13597,6182,13597,13597,2005,11592,10768,7572,1644,19,1316,2,215,824,6182,5842,340
258,34025,3402521570,"Englishtown borough, Monmouth County, New Jersey",2346,820,2346,2346,368,1978,1913,1630,66,0,207,0,10,65,820,789,31
259,34025,3402522440,"Fair Haven borough, Monmouth County, New Jersey",6269,2074,6269,6269,241,6028,5839,5664,66,6,92,0,11,189,2074,1994,80
260,34025,3402522950,"Farmingdale borough, Monmouth County, New Jersey",1504,630,1504,1504,167,1337,1270,1148,80,0,40,1,1,67,630,616,14
261,34025,3402525200,"Freehold borough, Monmouth County, New Jersey",12538,4394,12538,12538,6649,5889,5597,4060,1110,10,330,3,84,292,4394,4143,251
262,34025,3402525230,"Freehold township, Monmouth County, New Jersey",35369,13500,35369,35369,3636,31733,30665,26399,1506,28,2585,4,143,1068,13500,12897,603
263,34025,3402530690,"Hazlet township, Monmouth County, New Jersey",20125,7492,20125,20125,2292,17833,17287,16173,330,16,682,9,77,546,7492,7179,313
264,34025,3402531500,"Highlands borough, Monmouth County, New Jersey",4621,2931,4621,4621,343,4278,4097,3928,80,3,55,0,31,181,2931,2425,506
265,34025,3402532640,"Holmdel township, Monmouth County, New Jersey",17400,6038,17400,17400,989,16411,15814,11994,189,5,3555,0,71,597,6038,5787,251
266,34025,3402533300,"Howell township, Monmouth County, New Jersey",53537,19694,53537,53537,6359,47178,45437,40545,1958,39,2621,10,264,1741,19694,18906,788
267,34025,3402534200,"Interlaken borough, Monmouth County, New Jersey",828,400,828,828,19,809,783,768,1,1,4,0,9,26,400,362,38
268,34025,3402536480,"Keansburg borough, Monmouth County, New Jersey",9755,4361,9755,9755,1932,7823,7368,6136,921,13,265,4,29,455,4361,3808,553
269,34025,3402536810,"Keyport borough, Monmouth County, New Jersey",7204,3427,7204,7204,1572,5632,5397,4754,387,5,226,1,24,235,3427,3202,225
270,34025,3402537560,"Lake Como borough, Monmouth County, New Jersey",1697,1081,1697,1697,336,1361,1314,1199,73,0,33,0,9,47,1081,778,303
271,34025,3402540770,"Little Silver borough, Monmouth County, New Jersey",6131,2323,6131,6131,261,5870,5681,5504,25,1,138,0,13,189,2323,2196,127
272,34025,3402541010,"Loch Arbour village, Monmouth County, New Jersey",224,154,224,224,8,216,213,206,0,0,6,0,1,3,154,94,60
273,34025,3402541310,"Long Branch city, Monmouth County, New Jersey",31667,14944,31667,31667,10332,21335,18469,13133,3177,23,588,6,1542,2866,14944,12391,2553
274,34025,3402542990,"Manalapan township, Monmouth County, New Jersey",40905,14850,40905,40905,3188,37717,36779,32140,876,13,3561,5,184,938,14850,14325,525
275,34025,3402543050,"Manasquan borough, Monmouth County, New Jersey",5938,3412,5938,5938,417,5521,5398,5335,10,1,48,3,1,123,3412,2462,950
276,34025,3402544070,"Marlboro township, Monmouth County, New Jersey",41502,14215,41502,41502,2323,39179,38362,28433,728,37,9020,4,140,817,14215,13774,441
277,34025,3402544520,"Matawan borough, Monmouth County, New Jersey",9565,4010,9565,9565,1431,8134,7760,6359,725,10,594,0,72,374,4010,3849,161
278,34025,3402545990,"Middletown township, Monmouth County, New Jersey",67106,25859,67106,67106,5112,61994,60114,57142,823,43,1867,7,232,1880,25859,24710,1149
279,34025,3402546560,"Millstone township, Monmouth County, New Jersey",10376,3428,10376,10376,844,9532,9209,8111,415,14,627,0,42,323,3428,3324,104
280,34025,3402547130,"Monmouth Beach borough, Monmouth County, New Jersey",3174,2006,3174,3174,122,3052,2978,2908,9,5,36,0,20,74,2006,1452,554
281,34025,3402549890,"Neptune township, Monmouth County, New Jersey",28061,13278,28061,28061,4052,24009,22917,12558,9419,32,770,4,134,1092,13278,11466,1812
282,34025,3402549920,"Neptune City borough, Monmouth County, New Jersey",4626,2251,4626,4626,644,3982,3781,3041,627,8,92,0,13,201,2251,2109,142
283,34025,3402554270,"Ocean township, Monmouth County, New Jersey",27672,12257,27672,27672,3007,24665,23719,19270,2507,23,1636,5,278,946,12257,11249,1008
284,34025,3402554570,"Oceanport borough, Monmouth County, New Jersey",6150,2469,6150,6150,611,5539,5366,5155,85,0,70,1,55,173,2469,2346,123
285,34025,3402562430,"Red Bank borough, Monmouth County, New Jersey",12936,5863,12936,12936,4890,8046,7710,6458,966,4,231,1,50,336,5863,5423,440
286,34025,3402564410,"Roosevelt borough, Monmouth County, New Jersey",808,331,808,808,103,705,673,630,23,1,12,0,7,32,331,307,24
287,34025,3402565130,"Rumson borough, Monmouth County, New Jersey",7343,2624,7343,7343,308,7035,6799,6635,21,2,106,0,35,236,2624,2398,226
288,34025,3402566240,"Sea Bright borough, Monmouth County, New Jersey",1449,1200,1449,1449,78,1371,1327,1271,13,0,34,0,9,44,1200,793,407
289,34025,3402566330,"Sea Girt borough, Monmouth County, New Jersey",1866,1305,1866,1866,56,1810,1791,1771,9,2,4,1,4,19,1305,786,519
290,34025,3402567350,"Shrewsbury borough, Monmouth County, New Jersey",4184,1509,4184,4184,165,4019,3891,3700,61,4,97,1,28,128,1509,1456,53
291,34025,3402567365,"Shrewsbury township, Monmouth County, New Jersey",1076,544,1076,1076,217,859,798,557,148,2,88,0,3,61,544,505,39
292,34025,3402570110,"Spring Lake borough, Monmouth County, New Jersey",2789,2107,2789,2789,86,2703,2650,2591,11,1,36,0,11,53,2107,1225,882
293,34025,3402570140,"Spring Lake Heights borough, Monmouth County, New Jersey",4890,2998,4890,4890,221,4669,4553,4463,23,4,54,0,9,116,2998,2428,570
294,34025,3402573020,"Tinton Falls borough, Monmouth County, New Jersey",19181,8972,19181,19181,1694,17487,16846,14085,1610,16,1041,0,94,641,8972,8500,472
295,34025,3402574540,"Union Beach borough, Monmouth County, New Jersey",5723,2183,5723,5723,726,4997,4776,4499,111,10,125,0,31,221,2183,2036,147
296,34025,3402574900,"Upper Freehold township, Monmouth County, New Jersey",7273,2604,7273,7273,454,6819,6612,5950,161,5,460,1,35,207,2604,2471,133
297,34025,3402576460,"Wall township, Monmouth County, New Jersey",26525,10838,26525,26525,1559,24966,24243,23242,461,13,443,11,73,723,10838,10121,717
298,34025,3402579310,"West Long Branch borough, Monmouth County, New Jersey",8587,2755,8587,8587,774,7813,7387,6818,275,5,143,0,146,426,2755,2551,204
299,34027,3402706610,"Boonton town, Morris County, New Jersey",8815,3555,8815,8815,1409,7406,7044,5600,444,6,953,1,40,362,3555,3412,143
300,34027,3402706640,"Boonton township, Morris County, New Jersey",4380,1583,4380,4380,275,4105,3961,3626,47,2,275,0,11,144,1583,1504,79
301,34027,3402709040,"Butler borough, Morris County, New Jersey",8047,3403,8047,8047,1409,6638,6414,5987,123,5,284,0,15,224,3403,3258,145
302,34027,3402712100,"Chatham borough, Morris County, New Jersey",9212,3224,9212,9212,675,8537,8147,7159,89,0,847,0,52,390,3224,3057,167
303,34027,3402712130,"Chatham township, Morris County, New Jersey",10983,4155,10983,10983,514,10469,10078,8549,81,4,1387,0,57,391,4155,3963,192
304,34027,3402712580,"Chester borough, Morris County, New Jersey",1681,660,1681,1681,281,1400,1343,1276,5,1,60,0,1,57,660,633,27
305,34027,3402712610,"Chester township, Morris County, New Jersey",7713,2736,7713,7713,539,7174,6878,6377,90,3,381,1,26,296,2736,2575,161
306,34027,3402717650,"Denville township, Morris County, New Jersey",17107,6834,17107,17107,1280,15827,15221,13485,317,27,1351,0,41,606,6834,6442,392
307,34027,3402718070,"Dover town, Morris County, New Jersey",18460,5972,18460,18460,14209,4251,4059,2726,783,27,423,0,100,192,5972,5752,220
308,34027,3402719210,"East Hanover township, Morris County, New Jersey",11105,4040,11105,11105,876,10229,10050,8450,141,4,1425,0,30,179,4040,3935,105
309,34027,3402723910,"Florham Park borough, Morris County, New Jersey",12585,4768,12585,12585,929,11656,11264,9410,725,5,1075,8,41,392,4768,4468,300
310,34027,3402729550,"Hanover township, Morris County, New Jersey",14677,5928,14677,14677,1046,13631,13208,10880,325,10,1948,5,40,423,5928,5694,234
311,34027,3402729700,"Harding township, Morris County, New Jersey",3871,1569,3871,3871,179,3692,3537,3305,41,1,180,0,10,155,1569,1419,150
312,34027,3402734980,"Jefferson township, Morris County, New Jersey",20538,8566,20538,20538,1998,18540,17974,16605,356,18,860,7,128,566,8566,7840,726
313,34027,3402737110,"Kinnelon borough, Morris County, New Jersey",9966,3571,9966,9966,728,9238,8939,8192,91,6,610,0,40,299,3571,3405,166
314,34027,3402740290,"Lincoln Park borough, Morris County, New Jersey",10915,4181,10915,10915,1469,9446,9160,8040,332,7,719,2,60,286,4181,4063,118
315,34027,3402741362,"Long Hill township, Morris County, New Jersey",8629,3240,8629,8629,912,7717,7418,6576,73,6,693,4,66,299,3240,3118,122
316,34027,3402742510,"Madison borough, Morris County, New Jersey",16937,5989,16937,16937,2004,14933,14309,12482,463,11,1262,7,84,624,5989,5705,284
317,34027,3402745330,"Mendham borough, Morris County, New Jersey",4981,1867,4981,4981,293,4688,4542,4321,29,2,161,0,29,146,1867,1762,105
318,34027,3402745360,"Mendham township, Morris County, New Jersey",6016,2105,6016,6016,330,5686,5410,4929,93,1,347,0,40,276,2105,1986,119
319,34027,3402746860,"Mine Hill township, Morris County, New Jersey",4015,1523,4015,4015,1283,2732,2612,2178,191,3,210,1,29,120,1523,1477,46
320,34027,3402747670,"Montville township, Morris County, New Jersey",22450,8206,22450,22450,1578,20872,20264,15009,319,18,4811,6,101,608,8206,7901,305
321,34027,3402748090,"Morris township, Morris County, New Jersey",22974,8993,22974,22974,2378,20596,19775,17253,1019,9,1368,9,117,821,8993,8587,406
322,34027,3402748210,"Morris Plains borough, Morris County, New Jersey",6153,2527,6153,6153,590,5563,5396,4675,219,0,487,0,15,167,2527,2432,95
323,34027,3402748300,"Morristown town, Morris County, New Jersey",20180,9213,20180,20180,7367,12813,12287,9198,1961,28,961,11,128,526,9213,8482,731
324,34027,3402748480,"Mountain Lakes borough, Morris County, New Jersey",4472,1429,4472,4472,247,4225,4016,3285,19,4,694,1,13,209,1429,1376,53
325,34027,3402748690,"Mount Arlington borough, Morris County, New Jersey",5909,2915,5909,5909,719,5190,5037,4478,197,3,334,0,25,153,2915,2651,264
326,34027,3402749080,"Mount Olive township, Morris County, New Jersey",28886,11597,28886,28886,4460,24426,23387,18399,1807,12,3025,3,141,1039,11597,11079,518
327,34027,3402750130,"Netcong borough, Morris County, New Jersey",3375,1490,3375,3375,817,2558,2454,2162,151,12,118,0,11,104,1490,1434,56
328,34027,3402756460,"Parsippany-Troy Hills township, Morris County, New Jersey",56162,22146,56162,56162,5631,50531,48965,24960,1911,77,21694,6,317,1566,22146,21346,800
329,34027,3402758110,"Pequannock township, Morris County, New Jersey",15571,6688,15571,15571,1224,14347,14002,13461,98,8,395,3,37,345,6688,6379,309
330,34027,3402761890,"Randolph township, Morris County, New Jersey",26504,9676,26504,26504,3791,22713,21808,17750,740,15,3185,1,117,905,9676,9354,322
331,34027,3402763300,"Riverdale borough, Morris County, New Jersey",4107,2009,4107,4107,411,3696,3586,3269,88,0,219,1,9,110,2009,1929,80
332,34027,3402764050,"Rockaway borough, Morris County, New Jersey",6598,2645,6598,6598,1355,5243,5054,4273,187,7,553,1,33,189,2645,2561,84
333,34027,3402764080,"Rockaway township, Morris County, New Jersey",25341,10140,25341,25341,3995,21346,20556,17804,731,10,1918,10,83,790,10140,9643,497
334,34027,3402764980,"Roxbury township, Morris County, New Jersey",22950,8682,22950,22950,3340,19610,18923,16865,647,8,1292,2,109,687,8682,8356,326
335,34027,3402775890,"Victory Gardens borough, Morris County, New Jersey",1582,584,1582,1582,1185,397,374,177,142,4,41,0,10,23,584,571,13
336,34027,3402777240,"Washington township, Morris County, New Jersey",18197,6577,18197,18197,1359,16838,16339,15209,286,2,760,2,80,499,6577,6343,234
337,34027,3402780390,"Wharton borough, Morris County, New Jersey",7241,2736,7241,7241,3576,3665,3473,2795,225,7,394,1,51,192,2736,2604,132
338,34029,3402900000,"County subdivisions not defined, Ocean County, New Jersey",0,0,0,0,0,0,0,0,0,0,0,0,0,0,0,0,0
339,34029,3402903050,"Barnegat township, Ocean County, New Jersey",24296,10724,24296,24296,2460,21836,21009,19461,987,20,471,4,66,827,10724,9758,966
340,34029,3402903130,"Barnegat Light borough, Ocean County, New Jersey",640,1257,640,640,21,619,605,601,0,0,1,1,2,14,1257,321,936
341,34029,3402903520,"Bay Head borough, Ocean County, New Jersey",930,1024,930,930,27,903,886,865,5,2,11,0,3,17,1024,434,590
342,34029,3402903940,"Beach Haven borough, Ocean County, New Jersey",1027,2600,1027,1027,102,925,909,906,2,0,0,0,1,16,2600,485,2115
343,34029,3402904180,"Beachwood borough, Ocean County, New Jersey",10859,3860,10859,10859,1290,9569,9192,8765,239,7,147,2,32,377,3860,3719,141
344,34029,3402905305,"Berkeley township, Ocean County, New Jersey",43754,24629,43754,43754,3680,40074,38945,37056,1079,34,637,11,128,1129,24629,21040,3589
345,34029,3402907420,"Brick township, Ocean County, New Jersey",73620,33863,73620,73620,8218,65402,63096,59338,2071,64,1347,10,266,2306,33863,30119,3744
346,34029,3402918670,"Eagleswood township, Ocean County, New Jersey",1722,797,1722,1722,116,1606,1550,1519,8,12,10,0,1,56,797,676,121
347,34029,3402930390,"Harvey Cedars borough, Ocean County, New Jersey",391,1178,391,391,6,385,383,381,0,0,2,0,0,2,1178,198,980
348,34029,3402934530,"Island Heights borough, Ocean County, New Jersey",1650,841,1650,1650,55,1595,1525,1487,8,3,14,1,12,70,841,722,119
349,34029,3402934680,"Jackson township, Ocean County, New Jersey",58544,21626,58544,58544,7543,51001,49160,44395,2769,42,1558,13,383,1841,21626,20470,1156
350,34029,3402937380,"Lacey township, Ocean County, New Jersey",28655,12483,28655,28655,2000,26655,25770,25091,223,22,334,5,95,885,12483,11086,1397
351,34029,3402937770,"Lakehurst borough, Ocean County, New Jersey",2636,979,2636,2636,505,2131,2005,1680,236,2,76,0,11,126,979,908,71
352,34029,3402938550,"Lakewood township, Ocean County, New Jersey",135158,34726,135158,135158,15768,119390,117531,111388,3290,91,699,7,2056,1859,34726,31850,2876
353,34029,3402939390,"Lavallette borough, Ocean County, New Jersey",1787,3078,1787,1787,60,1727,1676,1657,8,2,7,0,2,51,3078,924,2154
354,34029,3402940560,"Little Egg Harbor township, Ocean County, New Jersey",20784,10812,20784,20784,1541,19243,18541,17859,367,24,225,11,55,702,10812,8715,2097
355,34029,3402941250,"Long Beach township, Ocean County, New Jersey",3153,8832,3153,3153,102,3051,2994,2953,2,0,29,0,10,57,8832,1593,7239
356,34029,3402943140,"Manchester township, Ocean County, New Jersey",45115,26764,45115,45115,3503,41612,40483,37442,1845,50,1017,6,123,1129,26764,24287,2477
357,34029,3402943380,"Mantoloking borough, Ocean County, New Jersey",331,498,331,331,15,316,312,305,1,0,4,2,0,4,498,158,340
358,34029,3402954300,"Ocean township, Ocean County, New Jersey",8835,4715,8835,8835,407,8428,8185,8004,72,14,71,2,22,243,4715,3979,736
359,34029,3402954450,"Ocean Gate borough, Ocean County, New Jersey",1932,1153,1932,1932,156,1776,1682,1623,46,0,5,0,8,94,1153,851,302
360,34029,3402958590,"Pine Beach borough, Ocean County, New Jersey",2139,931,2139,2139,133,2006,1930,1876,17,0,29,0,8,76,931,840,91
361,34029,3402959790,"Plumsted township, Ocean County, New Jersey",8072,3139,8072,8072,677,7395,7037,6832,107,10,58,2,28,358,3139,2996,143
362,34029,3402959880,"Point Pleasant borough, Ocean County, New Jersey",18941,8485,18941,18941,1327,17614,17171,16892,58,20,154,11,36,443,8485,7506,979
363,34029,3402959910,"Point Pleasant Beach borough, Ocean County, New Jersey",4766,3397,4766,4766,475,4291,4182,4084,28,1,57,1,11,109,3397,2045,1352
364,34029,3402966450,"Seaside Heights borough, Ocean County, New Jersey",2440,2870,2440,2440,566,1874,1760,1573,136,11,36,0,4,114,2870,1148,1722
365,34029,3402966480,"Seaside Park borough, Ocean County, New Jersey",1436,2586,1436,1436,55,1381,1352,1332,4,1,9,3,3,29,2586,772,1814
366,34029,3402967110,"Ship Bottom borough, Ocean County, New Jersey",1098,1938,1098,1098,72,1026,1006,988,1,1,11,0,5,20,1938,549,1389
367,34029,3402969510,"South Toms River borough, Ocean County, New Jersey",3643,1141,3643,3643,1040,2603,2406,1778,528,8,75,0,17,197,1141,1081,60
368,34029,3402970320,"Stafford township, Ocean County, New Jersey",28617,14399,28617,28617,2468,26149,25346,24542,316,12,420,5,51,803,14399,11073,3326
369,34029,3402971640,"Surf City borough, Ocean County, New Jersey",1243,2468,1243,1243,44,1199,1183,1169,1,0,8,0,5,16,2468,644,1824
370,34029,3402973125,"Toms River township, Ocean County, New Jersey",95438,44526,95438,95438,11593,83845,81127,73671,3155,65,3780,11,445,2718,44526,36291,8235
371,34029,3402974210,"Tuckerton borough, Ocean County, New Jersey",3577,2110,3577,3577,304,3273,3160,3065,40,5,37,3,10,113,2110,1574,536
372,34031,3403106340,"Bloomingdale borough, Passaic County, New Jersey",7777,3267,7777,7777,1186,6591,6355,5914,114,9,273,0,45,236,3267,3112,155
373,34031,3403113690,"Clifton city, Passaic County, New Jersey",90296,33325,90296,90296,36159,54137,52273,39250,3899,89,8414,14,607,1864,33325,31968,1357
374,34031,3403129070,"Haledon borough, Passaic County, New Jersey",9052,3117,9052,9052,4476,4576,4390,2594,1063,9,631,0,93,186,3117,3017,100
375,34031,3403130570,"Hawthorne borough, Passaic County, New Jersey",19637,7946,19637,19637,4778,14859,14372,13129,591,12,532,2,106,487,7946,7624,322
376,34031,3403140620,"Little Falls township, Passaic County, New Jersey",13360,4947,13360,13360,2264,11096,10747,9116,834,4,723,2,68,349,4947,4721,226
377,34031,3403153040,"North Haledon borough, Passaic County, New Jersey",8927,3141,8927,8927,1129,7798,7596,6926,290,9,349,1,21,202,3141,3054,87
378,34031,3403156550,"Passaic city, Passaic County, New Jersey",70537,21513,70537,70537,51584,18953,18213,10818,4005,111,2599,8,672,740,21513,20595,918
379,34031,3403157000,"Paterson city, Passaic County, New Jersey",159732,52885,159732,159732,98863,60869,58644,12523,36667,186,7991,17,1260,2225,52885,50326,2559
380,34031,3403160090,"Pompton Lakes borough, Passaic County, New Jersey",11127,4349,11127,11127,2174,8953,8620,7784,170,9,594,1,62,333,4349,4200,149
381,34031,3403161170,"Prospect Park borough, Passaic County, New Jersey",6372,2017,6372,6372,3752,2620,2529,1153,1023,7,294,0,52,91,2017,1932,85
382,34031,3403163150,"Ringwood borough, Passaic County, New Jersey",11735,4364,11735,11735,1084,10651,10220,9700,167,109,196,1,47,431,4364,4180,184
383,34031,3403173140,"Totowa borough, Passaic County, New Jersey",11065,4026,11065,11065,2408,8657,8431,7297,247,0,838,1,48,226,4026,3899,127
384,34031,3403176730,"Wanaque borough, Passaic County, New Jersey",11317,4597,11317,11317,1659,9658,9308,8371,305,27,543,0,62,350,4597,4392,205
385,34031,3403177840,"Wayne township, Passaic County, New Jersey",54838,19808,54838,54838,6439,48399,47047,39997,1639,26,5167,0,218,1352,19808,19165,643
386,34031,3403179460,"West Milford township, Passaic County, New Jersey",24862,10570,24862,24862,2259,22603,21770,20895,320,73,378,4,100,833,10570,9638,932
387,34031,3403182423,"Woodland Park borough, Passaic County, New Jersey",13484,5495,13484,13484,3816,9668,9349,8075,525,8,687,1,53,319,5495,5252,243
388,34035,3403504450,"Bedminster township, Somerset County, New Jersey",8272,4483,8272,8272,804,7468,7231,6160,153,7,882,0,29,237,4483,4222,261
389,34035,3403505560,"Bernards township, Somerset County, New Jersey",27830,10665,27830,27830,1595,26235,25305,18040,447,7,6708,6,97,930,10665,10197,468
390,34035,3403505590,"Bernardsville borough, Somerset County, New Jersey",7893,2953,7893,7893,1272,6621,6351,5927,49,3,343,0,29,270,2953,2756,197
391,34035,3403506790,"Bound Brook borough, Somerset County, New Jersey",11988,4389,11988,11988,6374,5614,5327,3642,976,15,483,4,207,287,4389,4181,208
392,34035,3403507180,"Branchburg township, Somerset County, New Jersey",14940,5843,14940,14940,1116,13824,13333,11221,438,7,1609,0,58,491,5843,5660,183
393,34035,3403507720,"Bridgewater township, Somerset County, New Jersey",45977,16739,45977,45977,4517,41460,40166,27547,1268,42,11080,9,220,1294,16739,16044,695
394,34035,3403522890,"Far Hills borough, Somerset County, New Jersey",924,418,924,924,107,817,798,745,8,0,42,0,3,19,418,372,46
395,34035,3403524900,"Franklin township, Somerset County, New Jersey",68364,27335,68364,68364,11938,56426,54362,21405,16531,95,15835,13,483,2064,27335,25860,1475
396,34035,3403527510,"Green Brook township, Somerset County, New Jersey",7281,2510,7281,7281,843,6438,6229,4134,313,5,1743,0,34,209,2510,2436,74
397,34035,3403531890,"Hillsborough township, Somerset County, New Jersey",43276,15955,43276,43276,4067,39209,37806,25625,2040,30,9889,9,213,1403,15955,15296,659
398,34035,3403543620,"Manville borough, Somerset County, New Jersey",10953,4290,10953,10953,3464,7489,7173,6255,514,14,337,7,46,316,4290,4092,198
399,34035,3403546590,"Millstone borough, Somerset County, New Jersey",448,168,448,448,34,414,397,380,7,1,9,0,0,17,168,153,15
400,34035,3403547580,"Montgomery township, Somerset County, New Jersey",23690,8390,23690,23690,1314,22376,21567,11391,721,15,9352,5,83,809,8390,8003,387
401,34035,3403553280,"North Plainfield borough, Somerset County, New Jersey",22808,8055,22808,22808,11548,11260,10699,4998,4390,17,1064,8,222,561,8055,7715,340
402,34035,3403557300,"Peapack and Gladstone borough, Somerset County, New Jersey",2558,937,2558,2558,319,2239,2178,2061,60,0,50,0,7,61,937,887,50
403,34035,3403561980,"Raritan borough, Somerset County, New Jersey",7835,3167,7835,7835,1672,6163,5957,4120,247,6,1558,1,25,206,3167,2993,174
404,34035,3403564320,"Rocky Hill borough, Somerset County, New Jersey",743,298,743,743,70,673,648,604,3,1,36,0,4,25,298,278,20
405,34035,3403568460,"Somerville borough, Somerset County, New Jersey",12346,5387,12346,12346,3113,9233,8805,6073,1201,22,1433,2,74,428,5387,5050,337
406,34035,3403568730,"South Bound Brook borough, Somerset County, New Jersey",4863,1941,4863,4863,1537,3326,3178,2212,528,7,395,1,35,148,1941,1854,87
407,34035,3403576940,"Warren township, Somerset County, New Jersey",15923,5614,15923,15923,1156,14767,14200,10569,277,6,3249,4,95,567,5614,5374,240
408,34035,3403577600,"Watchung borough, Somerset County, New Jersey",6449,2285,6449,6449,519,5930,5669,4302,309,6,1001,0,51,261,2285,2175,110
409,34037,3403701330,"Andover borough, Sussex County, New Jersey",595,277,595,595,59,536,509,484,17,1,5,1,1,27,277,254,23
410,34037,3403701360,"Andover township, Sussex County, New Jersey",5996,2219,5996,5996,530,5466,5272,4827,187,10,211,0,37,194,2219,2102,117
411,34037,3403707300,"Branchville borough, Sussex County, New Jersey",791,372,791,791,53,738,709,682,8,2,17,0,0,29,372,334,38
412,34037,3403709160,"Byram township, Sussex County, New Jersey",8028,3292,8028,8028,683,7345,7063,6756,132,2,128,0,45,282,3292,2946,346
413,34037,3403724810,"Frankford township, Sussex County, New Jersey",5302,2550,5302,5302,297,5005,4830,4685,42,13,75,0,15,175,2550,2084,466
414,34037,3403724930,"Franklin borough, Sussex County, New Jersey",4912,2177,4912,4912,661,4251,4042,3822,108,6,78,0,28,209,2177,2047,130
415,34037,3403725140,"Fredon township, Sussex County, New Jersey",3235,1256,3235,3235,181,3054,2960,2866,20,5,58,0,11,94,1256,1192,64
416,34037,3403727420,"Green township, Sussex County, New Jersey",3627,1291,3627,3627,306,3321,3224,3071,65,2,62,0,24,97,1291,1244,47
417,34037,3403729220,"Hamburg borough, Sussex County, New Jersey",3266,1539,3266,3266,318,2948,2814,2603,98,7,94,0,12,134,1539,1452,87
418,34037,3403729490,"Hampton township, Sussex County, New Jersey",4893,2186,4893,4893,267,4626,4464,4335,26,5,79,0,19,162,2186,1996,190
419,34037,3403729850,"Hardyston township, Sussex County, New Jersey",8125,3847,8125,8125,647,7478,7210,6705,244,10,215,0,36,268,3847,3371,476
420,34037,3403732910,"Hopatcong borough, Sussex County, New Jersey",14362,6393,14362,14362,2544,11818,11382,10487,423,34,353,3,82,436,6393,5724,669
421,34037,3403737440,"Lafayette township, Sussex County, New Jersey",2358,921,2358,2358,164,2194,2134,2083,20,1,13,0,17,60,921,881,40
422,34037,3403747430,"Montague township, Sussex County, New Jersey",3792,1832,3792,3792,370,3422,3275,3108,71,6,69,0,21,147,1832,1560,272
423,34037,3403751930,"Newton town, Sussex County, New Jersey",8374,3687,8374,8374,1363,7011,6669,5894,432,22,292,0,29,342,3687,3400,287
424,34037,3403754660,"Ogdensburg borough, Sussex County, New Jersey",2258,927,2258,2258,265,1993,1895,1835,20,3,28,0,9,98,927,873,54
425,34037,3403765700,"Sandyston township, Sussex County, New Jersey",1977,979,1977,1977,101,1876,1803,1755,9,0,31,0,8,73,979,806,173
426,34037,3403769690,"Sparta township, Sussex County, New Jersey",19600,7614,19600,19600,1570,18030,17330,16299,309,10,620,4,88,700,7614,7032,582
427,34037,3403770380,"Stanhope borough, Sussex County, New Jersey",3526,1507,3526,3526,492,3034,2916,2724,74,3,93,2,20,118,1507,1432,75
428,34037,3403770890,"Stillwater township, Sussex County, New Jersey",4004,1943,4004,4004,202,3802,3691,3609,23,4,38,1,16,111,1943,1609,334
429,34037,3403771670,"Sussex borough, Sussex County, New Jersey",2024,1013,2024,2024,284,1740,1656,1576,47,0,26,0,7,84,1013,901,112
430,34037,3403775740,"Vernon township, Sussex County, New Jersey",22358,10538,22358,22358,2163,20195,19420,18762,331,37,206,0,84,775,10538,8612,1926
431,34037,3403776640,"Walpack township, Sussex County, New Jersey",7,5,7,7,2,5,5,5,0,0,0,0,0,0,5,5,0
432,34037,3403776790,"Wantage township, Sussex County, New Jersey",10811,4344,10811,10811,788,10023,9618,9274,152,8,127,0,57,405,4344,4058,286
433,34039,3403905320,"Berkeley Heights township, Union County, New Jersey",13285,4660,13285,13285,1140,12145,11675,9278,242,5,2065,1,84,470,4660,4484,176
434,34039,3403913150,"Clark township, Union County, New Jersey",15544,6114,15544,15544,1945,13599,13274,12346,231,4,644,3,46,325,6114,5919,195
435,34039,3403915640,"Cranford township, Union County, New Jersey",23847,9264,23847,23847,2443,21404,20618,18946,653,6,903,4,106,786,9264,8891,373
436,34039,3403921000,"Elizabeth city, Union County, New Jersey",137298,48439,137298,137298,90233,47065,43886,16553,22261,152,2757,18,2145,3179,48439,46314,2125
437,34039,3403922860,"Fanwood borough, Union County, New Jersey",7774,2829,7774,7774,729,7045,6719,5604,386,3,713,2,11,326,2829,2725,104
438,34039,3403925800,"Garwood borough, Union County, New Jersey",4454,2016,4454,4454,670,3784,3657,3436,69,1,119,0,32,127,2016,1920,96
439,34039,3403931980,"Hillside township, Union County, New Jersey",22456,7844,22456,22456,5189,17267,16174,3787,11327,25,498,0,537,1093,7844,7517,327
440,34039,3403936690,"Kenilworth borough, Union County, New Jersey",8427,3019,8427,8427,1933,6494,6226,5524,219,8,435,2,38,268,3019,2932,87
441,34039,3403940350,"Linden city, Union County, New Jersey",43738,16452,43738,43738,15055,28683,27529,13744,11722,33,1484,5,541,1154,16452,15609,843
442,34039,3403948510,"Mountainside borough, Union County, New Jersey",7020,2564,7020,7020,667,6353,6150,5498,134,2,466,0,50,203,2564,2399,165
443,34039,3403951810,"New Providence borough, Union County, New Jersey",13650,5497,13650,13650,1251,12399,11910,9429,241,7,2171,2,60,489,5497,5071,426
444,34039,3403959190,"Plainfield city, Union County, New Jersey",54586,17125,54586,54586,29792,24794,23663,3383,19034,104,500,8,634,1131,17125,16308,817
445,34039,3403961530,"Rahway city, Union County, New Jersey",29556,12363,29556,29556,8867,20689,19699,8913,8892,40,1622,4,228,990,12363,11544,819
446,34039,3403964620,"Roselle borough, Union County, New Jersey",22695,8431,22695,22695,7900,14795,14120,2474,10800,37,580,7,222,675,8431,8008,423
447,34039,3403964650,"Roselle Park borough, Union County, New Jersey",13967,5346,13967,13967,5293,8674,8326,5725,1186,7,1271,1,136,348,5346,5213,133
448,34039,3403966060,"Scotch Plains township, Union County, New Jersey",24968,9103,24968,24968,2579,22389,21431,16297,2365,14,2610,0,145,958,9103,8807,296
449,34039,3403970020,"Springfield township, Union County, New Jersey",17178,7105,17178,17178,2235,14943,14324,11140,1504,7,1541,1,131,619,7105,6820,285
450,34039,3403971430,"Summit city, Union County, New Jersey",22719,8365,22719,22719,3313,19406,18421,15016,895,8,2371,5,126,985,8365,7905,460
451,34039,3403974480,"Union township, Union County, New Jersey",59728,21571,59728,59728,11899,47829,45761,19146,19296,68,6472,13,766,2068,21571,20672,899
452,34039,3403979040,"Westfield town, Union County, New Jersey",31032,11095,31032,31032,2247,28785,27514,23819,790,19,2735,1,150,1271,11095,10622,473
453,34039,3403981650,"Winfield township, Union County, New Jersey",1423,706,1423,1423,139,1284,1212,1187,14,2,6,1,2,72,706,692,14
454,34041,3404100670,"Allamuchy township, Warren County, New Jersey",5335,2467,5335,5335,465,4870,4701,4258,227,7,181,0,28,169,2467,2358,109
455,34041,3404101030,"Alpha borough, Warren County, New Jersey",2328,1047,2328,2328,211,2117,2046,1935,65,1,41,1,3,71,1047,972,75
456,34041,3404104990,"Belvidere town, Warren County, New Jersey",2520,1143,2520,2520,198,2322,2233,2166,28,7,20,0,12,89,1143,1031,112
457,34041,3404106160,"Blairstown township, Warren County, New Jersey",5704,2245,5704,5704,332,5372,5180,4986,67,9,74,4,40,192,2245,2106,139
458,34041,3404124960,"Franklin township, Warren County, New Jersey",2968,1219,2968,2968,174,2794,2683,2519,54,0,92,5,13,111,1219,1124,95
459,34041,3404125320,"Frelinghuysen township, Warren County, New Jersey",2199,833,2199,2199,124,2075,1997,1956,26,0,11,0,4,78,833,780,53
460,34041,3404128260,"Greenwich township, Warren County, New Jersey",5473,1868,5473,5473,546,4927,4707,3792,474,1,416,0,24,220,1868,1798,70
461,34041,3404128710,"Hackettstown town, Warren County, New Jersey",10248,3945,10248,10248,2393,7855,7579,6781,341,11,402,1,43,276,3945,3769,176
462,34041,3404129820,"Hardwick township, Warren County, New Jersey",1598,612,1598,1598,105,1493,1440,1414,12,1,11,0,2,53,612,578,34
463,34041,3404130090,"Harmony township, Warren County, New Jersey",2503,1066,2503,2503,57,2446,2365,2305,29,1,21,0,9,81,1066,993,73
464,34041,3404133060,"Hope township, Warren County, New Jersey",1835,806,1835,1835,139,1696,1627,1594,8,0,16,0,9,69,806,743,63
465,34041,3404133930,"Independence township, Warren County, New Jersey",5469,2439,5469,5469,444,5025,4836,4543,143,2,122,1,25,189,2439,2325,114
466,34041,3404137320,"Knowlton township, Warren County, New Jersey",2894,1197,2894,2894,197,2697,2542,2469,22,4,37,0,10,155,1197,1103,94
467,34041,3404140110,"Liberty township, Warren County, New Jersey",2670,1144,2670,2670,156,2514,2424,2323,40,6,41,0,14,90,1144,1022,122
468,34041,3404141490,"Lopatcong township, Warren County, New Jersey",8776,3859,8776,8776,803,7973,7726,6496,714,7,440,4,65,247,3859,3588,271
469,34041,3404143320,"Mansfield township, Warren County, New Jersey",7781,3351,7781,7781,1153,6628,6307,5599,408,7,251,0,42,321,3351,3139,212
470,34041,3404155530,"Oxford township, Warren County, New Jersey",2444,1040,2444,2444,186,2258,2130,2055,47,0,24,0,4,128,1040,967,73
471,34041,3404158350,"Phillipsburg town, Warren County, New Jersey",15249,6659,15249,15249,2552,12697,11887,9686,1907,6,219,1,68,810,6659,6024,635
472,34041,3404159820,"Pohatcong township, Warren County, New Jersey",3241,1428,3241,3241,215,3026,2878,2731,89,2,43,2,11,148,1428,1310,118
473,34041,3404177270,"Washington borough, Warren County, New Jersey",7299,3219,7299,7299,1002,6297,6025,5198,540,15,230,7,35,272,3219,3002,217
474,34041,3404177300,"Washington township, Warren County, New Jersey",6492,2553,6492,6492,533,5959,5751,5327,238,5,153,2,26,208,2553,2426,127
475,34041,3404180570,"White township, Warren County, New Jersey",4606,2317,4606,4606,240,4366,4274,4122,94,4,41,0,13,92,2317,2169,148
476,36005,3600508510,"Bronx borough, Bronx County, New York",1472654,547030,1472654,1472654,806463,666191,637821,130796,419393,3087,67766,457,16322,28370,547030,522450,24580
477,36027,3602701693,"Amenia town, Dutchess County, New York",3769,1962,3769,3769,425,3344,3164,2974,87,16,70,0,17,180,1962,1622,340
478,36027,3602705100,"Beacon city, Dutchess County, New York",13769,6262,13769,13769,2686,11083,10396,8204,1741,12,290,11,138,687,6262,5780,482
479,36027,3602705452,"Beekman town, Dutchess County, New York",14172,4874,14172,14172,1881,12291,11860,9952,1485,17,356,3,47,431,4874,4409,465
480,36027,3602716408,"Clinton town, Dutchess County, New York",4037,1901,4037,4037,196,3841,3666,3521,75,3,56,1,10,175,1901,1593,308
481,36027,3602720819,"Dover town, Dutchess County, New York",8415,3505,8415,8415,1638,6777,6418,5736,372,8,266,0,36,359,3505,3182,323
482,36027,3602721996,"East Fishkill town, Dutchess County, New York",29707,10829,29707,29707,3679,26028,25002,22403,1130,29,1254,2,184,1026,10829,10206,623
483,36027,3602725978,"Fishkill town, Dutchess County, New York",24226,9521,24226,24226,3822,20404,19655,15138,3160,46,1180,5,126,749,9521,9039,482
484,36027,3602737209,"Hyde Park town, Dutchess County, New York",21021,8433,21021,21021,1989,19032,17957,15405,1594,35,810,1,112,1075,8433,7921,512
485,36027,3602740299,"La Grange town, Dutchess County, New York",15975,5897,15975,15975,1783,14192,13522,11852,842,16,707,4,101,670,5897,5617,280
486,36027,3602747207,"Milan town, Dutchess County, New York",2245,1202,2245,2245,131,2114,1994,1912,32,6,30,0,14,120,1202,957,245
487,36027,3602751891,"North East town, Dutchess County, New York",2971,1543,2971,2971,419,2552,2431,2318,48,2,53,1,9,121,1543,1223,320
488,36027,3602756825,"Pawling town, Dutchess County, New York",8012,3518,8012,8012,1178,6834,6588,6196,201,12,133,3,43,246,3518,3117,401
489,36027,3602758156,"Pine Plains town, Dutchess County, New York",2218,1175,2218,2218,126,2092,1980,1921,18,4,30,1,6,112,1175,946,229
490,36027,3602758695,"Pleasant Valley town, Dutchess County, New York",9799,4151,9799,9799,866,8933,8474,7817,384,6,184,3,80,459,4151,3921,230
491,36027,3602759641,"Poughkeepsie city, Dutchess County, New York",31577,14604,31577,31577,7105,24472,22813,10853,11165,64,505,12,214,1659,14604,13139,1465
492,36027,3602759652,"Poughkeepsie town, Dutchess County, New York",45471,16878,45471,45471,6794,38677,36864,28406,5115,41,2802,7,493,1813,16878,15857,1021
493,36027,3602760905,"Red Hook town, Dutchess County, New York",9953,4415,9953,9953,733,9220,8872,8381,148,10,299,2,32,348,4415,3926,489
494,36027,3602761357,"Rhinebeck town, Dutchess County, New York",7596,3787,7596,7596,506,7090,6806,6510,97,5,154,0,40,284,3787,3320,467
495,36027,3602770662,"Stanford town, Dutchess County, New York",3682,1859,3682,3682,277,3405,3276,3073,135,5,43,0,20,129,1859,1494,365
496,36027,3602776166,"Union Vale town, Dutchess County, New York",4558,1766,4558,4558,312,4246,4104,3926,74,3,78,2,21,142,1766,1587,179
497,36027,3602778157,"Wappinger town, Dutchess County, New York",28216,11657,28216,28216,5228,22988,21965,18331,2120,39,1270,9,196,1023,11657,11183,474
498,36027,3602778388,"Washington town, Dutchess County, New York",4522,2270,4522,4522,450,4072,3859,3666,103,8,65,0,17,213,2270,1888,382
499,36047,3604710022,"Brooklyn borough, Kings County, New York",2736074,1077654,2736074,2736074,516426,2219648,2106478,968427,729696,3964,370776,718,32897,113170,1077654,1009804,67850
500,36059,3601011,"Albertson CDP, New York",5220,1857,5220,5220,468,4752,4638,2867,25,6,1700,1,39,114,1857,1795,62
501,36059,3602968,"Atlantic Beach village, New York",1707,1046,1707,1707,83,1624,1580,1533,3,0,28,0,16,44,1046,763,283
502,36059,3604143,"Baldwin CDP, New York",33919,11092,33919,33919,7588,26331,24994,9831,12989,55,1576,8,535,1337,11092,10702,390
503,36059,3604550,"Barnum Island CDP, New York",2590,1062,2590,2590,504,2086,2025,1762,69,4,156,0,34,61,1062,1026,36
504,36059,3604803,"Baxter Estates village, New York",991,425,991,991,173,818,785,700,7,0,74,0,4,33,425,394,31
505,36059,3604891,"Bay Park CDP, New York",2117,888,2117,2117,228,1889,1848,1766,42,2,28,0,10,41,888,845,43
506,36059,3605034,"Bayville village, New York",6748,2691,6748,6748,704,6044,5888,5691,32,3,140,1,21,156,2691,2518,173
507,36059,3605639,"Bellerose village, New York",1173,388,1173,1173,121,1052,1009,896,36,1,62,1,13,43,388,384,4
508,36059,3605661,"Bellerose Terrace CDP, New York",2329,692,2329,2329,655,1674,1597,601,151,15,782,1,47,77,692,670,22
509,36059,3605738,"Bellmore CDP, New York",16297,5776,16297,16297,1570,14727,14273,13237,242,2,737,0,55,454,5776,5572,204
510,36059,3605929113,"Glen Cove city, Nassau County, New York",28365,10793,28365,28365,9752,18613,18055,14775,1595,58,1449,2,176,558,10793,10099,694
511,36059,3605934000,"Hempstead town, Nassau County, New York",793409,260524,793409,793409,174883,618526,597414,402466,125839,1139,59525,172,8273,21112,260524,250261,10263
512,36059,3605943335,"Long Beach city, Nassau County, New York",35029,16771,35029,35029,5370,29659,28794,25531,1820,42,1107,21,273,865,16771,15360,1411
513,36059,3605953000,"North Hempstead town, Nassau County, New York",237639,83729,237639,237639,35083,202556,196132,128168,11312,253,54700,50,1649,6424,83729,79546,4183
514,36059,3605956000,"Oyster Bay town, Nassau County, New York",301332,104915,301332,301332,31337,269995,263226,208514,6650,222,46384,47,1409,6769,104915,100216,4699
515,36059,3606387,"Bethpage CDP, New York",16658,6072,16658,16658,1735,14923,14587,12292,151,7,2066,4,67,336,6072,5810,262
516,36059,3610132,"Brookville village, New York",2939,661,2939,2939,152,2787,2718,2273,45,2,390,0,8,69,661,625,36
517,36059,3612419,"Carle Place CDP, New York",5005,1908,5005,5005,740,4265,4120,3434,148,6,488,0,44,145,1908,1825,83
518,36059,3613233,"Cedarhurst village, New York",7374,2413,7374,7374,1040,6334,6217,5803,151,0,189,0,74,117,2413,2265,148
519,36059,3613618,"Centre Island village, New York",407,229,407,407,31,376,373,351,2,0,19,1,0,3,229,160,69
520,36059,3618597,"Cove Neck village, New York",293,138,293,293,18,275,266,264,0,1,0,0,1,9,138,125,13
521,36059,3621578,"East Atlantic Beach CDP, New York",2101,994,2101,2101,128,1973,1933,1898,8,0,18,0,9,40,994,860,134
522,36059,3622260,"East Hills village, New York",7284,2294,7284,7284,303,6981,6815,5808,85,1,888,0,33,166,2294,2218,76
523,36059,3622480,"East Massapequa CDP, New York",19854,7112,19854,19854,2775,17079,16531,13474,2415,14,486,2,140,548,7112,6884,228
524,36059,3622502,"East Meadow CDP, New York",37796,12951,37796,37796,6048,31748,30832,22039,1668,39,6758,11,317,916,12951,12361,590
525,36059,3622623,"East Norwich CDP, New York",2792,998,2792,2792,222,2570,2507,2362,26,0,111,0,8,63,998,968,30
526,36059,3622876,"East Rockaway village, New York",10159,4000,10159,10159,1451,8708,8459,7789,296,4,327,0,43,249,4000,3814,186
527,36059,3623217,"East Williston village, New York",2645,864,2645,2645,150,2495,2412,2060,5,0,340,0,7,83,864,828,36
528,36059,3624273,"Elmont CDP, New York",35265,10270,35265,35265,8024,27241,25933,4282,15460,102,5290,15,784,1308,10270,9896,374
529,36059,3625384,"Farmingdale village, New York",8466,3868,8466,8466,1291,7175,6987,6019,280,9,618,0,61,188,3868,3627,241
530,36059,3626264,"Floral Park village, New York",16172,5961,16172,16172,2067,14105,13745,11495,262,14,1889,3,82,360,5961,5746,215
531,36059,3626352,"Flower Hill village, New York",4794,1529,4794,4794,280,4514,4395,3423,32,7,904,0,29,119,1529,1473,56
532,36059,3627309,"Franklin Square CDP, New York",30903,10231,30903,30903,5979,24924,24277,18604,1385,40,3947,8,293,647,10231,9903,328
533,36059,3627485,"Freeport village, New York",44472,14137,44472,44472,21312,23160,21903,7632,12830,89,792,15,545,1257,14137,13501,636
534,36059,3628178,"Garden City village, New York",23272,7715,23272,23272,1486,21786,21274,19344,212,12,1589,7,110,512,7715,7513,202
535,36059,3628189,"Garden City Park CDP, New York",7985,2592,7985,7985,999,6986,6762,2702,223,19,3742,2,74,224,2592,2499,93
536,36059,3628200,"Garden City South CDP, New York",4119,1454,4119,4119,475,3644,3567,3160,42,7,348,0,10,77,1454,1401,53
537,36059,3629113,"Glen Cove city, New York",28365,10793,28365,28365,9752,18613,18055,14775,1595,58,1449,2,176,558,10793,10099,694
538,36059,3629245,"Glen Head CDP, New York",4837,1787,4837,4837,546,4291,4176,3786,32,2,330,0,26,115,1787,1718,69
539,36059,3629421,"Glenwood Landing CDP, New York",3948,1422,3948,3948,355,3593,3501,3212,25,3,236,1,24,92,1422,1375,47
540,36059,3630169,"Great Neck village, New York",11145,3883,11145,11145,1204,9941,9512,7767,145,5,1497,1,97,429,3883,3620,263
541,36059,3630191,"Great Neck Estates village, New York",2990,937,2990,2990,122,2868,2770,2159,16,2,563,0,30,98,937,879,58
542,36059,3630202,"Great Neck Gardens CDP, New York",1268,397,1268,1268,30,1238,1210,812,3,0,390,0,5,28,397,380,17
543,36059,3630213,"Great Neck Plaza village, New York",7482,3954,7482,7482,626,6856,6661,4523,135,5,1960,0,38,195,3954,3702,252
544,36059,3630598,"Greenvale CDP, New York",1069,373,1069,1069,118,951,912,622,8,0,270,0,12,39,373,344,29
545,36059,3632094,"Harbor Hills CDP, New York",562,188,562,562,5,557,536,488,0,0,45,0,3,21,188,177,11
546,36059,3632105,"Harbor Isle CDP, New York",1436,497,1436,1436,145,1291,1256,1201,26,2,22,0,5,35,497,473,24
547,36059,3633139,"Hempstead village, New York",59169,16954,59169,59169,29640,29529,28135,3067,23041,147,1242,17,621,1394,16954,16299,655
548,36059,3634198,"Herricks CDP, New York",4398,1380,4398,4398,196,4202,4093,1487,27,18,2522,3,36,109,1380,1330,50
549,36059,3634286,"Hewlett CDP, New York",7262,2698,7262,7262,1086,6176,5983,4989,303,4,630,1,56,193,2698,2532,166
550,36059,3634297,"Hewlett Bay Park village, New York",494,144,494,494,20,474,451,400,7,2,40,0,2,23,144,140,4
551,36059,3634308,"Hewlett Harbor village, New York",1290,442,1290,1290,59,1231,1201,1124,13,3,59,0,2,30,442,418,24
552,36059,3634319,"Hewlett Neck village, New York",569,161,569,569,30,539,533,491,12,5,22,0,3,6,161,149,12
553,36059,3634374,"Hicksville CDP, New York",43869,13889,43869,43869,8003,35866,34788,19073,1129,75,14178,7,326,1078,13889,13477,412
554,36059,3637583,"Inwood CDP, New York",11340,3355,11340,11340,5997,5343,5158,2680,1920,9,431,4,114,185,3355,3180,175
555,36059,3637847,"Island Park village, New York",4928,1851,4928,4928,1645,3283,3158,2729,149,9,203,8,60,125,1851,1725,126
556,36059,3638539,"Jericho CDP, New York",14808,4818,14808,14808,595,14213,13925,6369,301,7,7168,3,77,288,4818,4597,221
557,36059,3639309,"Kensington village, New York",1226,457,1226,1226,15,1211,1173,877,4,1,282,1,8,38,457,430,27
558,36059,3639694,"Kings Point village, New York",5619,1416,5619,5619,214,5405,5102,4680,88,0,307,4,23,303,1416,1293,123
559,36059,3640937,"Lake Success village, New York",2828,858,2828,2828,103,2725,2658,1039,12,1,1587,0,19,67,858,820,38
560,36059,3641003,"Lakeview CDP, New York",6077,1625,6077,6077,1123,4954,4701,152,4249,17,157,0,126,253,1625,1567,58
561,36059,3641432,"Lattingtown village, New York",1881,708,1881,1881,117,1764,1708,1613,5,0,81,1,8,56,708,614,94
562,36059,3641487,"Laurel Hollow village, New York",1940,630,1940,1940,92,1848,1793,1603,15,0,168,0,7,55,630,594,36
563,36059,3641553,"Lawrence village, New York",6809,2432,6809,6809,308,6501,6389,6095,85,0,93,0,116,112,2432,2185,247
564,36059,3642081,"Levittown CDP, New York",51758,17123,51758,51758,8617,43141,41782,34853,675,65,5900,6,283,1359,17123,16634,489
565,36059,3642279,"Lido Beach CDP, New York",2719,1302,2719,2719,148,2571,2520,2454,10,0,52,0,4,51,1302,1161,141
566,36059,3643192,"Locust Valley CDP, New York",3571,1339,3571,3571,861,2710,2645,2408,90,0,124,0,23,65,1339,1268,71
567,36059,3643335,"Long Beach city, New York",35029,16771,35029,35029,5370,29659,28794,25531,1820,42,1107,21,273,865,16771,15360,1411
568,36059,3643874,"Lynbrook village, New York",20438,7798,20438,20438,3847,16591,16002,13210,1345,22,1270,1,154,589,7798,7459,339
569,36059,3644787,"Malverne village, New York",8560,3159,8560,8560,1116,7444,7235,6163,464,11,488,0,109,209,3159,3068,91
570,36059,3644792,"Malverne Park Oaks CDP, New York",538,194,538,538,63,475,457,334,60,0,47,0,16,18,194,186,8
571,36059,3644897,"Manhasset CDP, New York",8176,2947,8176,8176,868,7308,7094,4606,597,8,1863,0,20,214,2947,2790,157
572,36059,3644908,"Manhasset Hills CDP, New York",3649,1154,3649,3649,237,3412,3341,1287,32,6,1974,0,42,71,1154,1119,35
573,36059,3645106,"Manorhaven village, New York",6956,2699,6956,6956,2487,4469,4338,3195,106,4,995,2,36,131,2699,2534,165
574,36059,3645986,"Massapequa CDP, New York",21355,7375,21355,21355,1586,19769,19264,18661,112,9,432,3,47,505,7375,7152,223
575,36059,3645997,"Massapequa Park village, New York",17109,5913,17109,17109,1235,15874,15563,15105,78,12,306,0,62,311,5913,5759,154
576,36059,3646107,"Matinecock village, New York",847,323,847,847,77,770,757,710,1,0,46,0,0,13,323,284,39
577,36059,3646668,"Merrick CDP, New York",22040,7672,22040,22040,2066,19974,19480,18074,339,8,928,0,131,494,7672,7436,236
578,36059,3647405,"Mill Neck village, New York",1054,414,1054,1054,132,922,890,802,20,0,67,0,1,32,414,349,65
579,36059,3647636,"Mineola village, New York",20800,8776,20800,20800,4071,16729,16104,12500,528,13,2860,3,200,625,8776,8311,465
580,36059,3649231,"Munsey Park village, New York",2809,842,2809,2809,149,2660,2558,2141,29,1,378,1,8,102,842,821,21
581,36059,3649330,"Muttontown village, New York",3512,1141,3512,3512,159,3353,3286,2027,54,1,1189,5,10,67,1141,1057,84
582,36059,3650067,"New Cassel CDP, New York",14199,3402,14199,14199,7917,6282,6083,667,4895,18,422,1,80,199,3402,3185,217
583,36059,3650397,"New Hyde Park village, New York",10257,3376,10257,10257,1413,8844,8610,4253,176,29,4063,4,85,234,3376,3260,116
584,36059,3651517,"North Bellmore CDP, New York",20583,6866,20583,20583,2374,18209,17691,15443,645,5,1470,3,125,518,6866,6723,143
585,36059,3653022,"North Hills village, New York",5464,2500,5464,5464,151,5313,5203,3245,53,0,1878,3,24,110,2500,2290,210
586,36059,3653231,"North Lynbrook CDP, New York",747,234,747,747,113,634,610,468,70,0,68,0,4,24,234,233,1
587,36059,3653253,"North Massapequa CDP, New York",17829,6103,17829,17829,1541,16288,15983,15369,107,4,459,0,44,305,6103,5963,140
588,36059,3653264,"North Merrick CDP, New York",12238,4137,12238,12238,1332,10906,10627,9566,305,5,668,2,81,279,4137,4023,114
589,36059,3653275,"North New Hyde Park CDP, New York",15657,5024,15657,15657,1230,14427,14138,6588,108,37,7238,8,159,289,5024,4887,137
590,36059,3653748,"North Valley Stream CDP, New York",18197,5638,18197,18197,2677,15520,14753,2635,8111,74,3515,6,412,767,5638,5447,191
591,36059,3653792,"North Wantagh CDP, New York",11931,4282,11931,11931,1416,10515,10260,9673,138,3,375,0,71,255,4282,4174,108
592,36059,3654441,"Oceanside CDP, New York",32637,11552,32637,32637,4529,28108,27335,25259,658,19,1181,1,217,773,11552,11212,340
593,36059,3654551,"Old Bethpage CDP, New York",6403,2836,6403,6403,340,6063,5924,5293,17,0,597,0,17,139,2836,2390,446
594,36059,3654562,"Old Brookville village, New York",2020,718,2020,2020,120,1900,1866,1558,31,3,260,0,14,34,718,692,26
595,36059,3654705,"Old Westbury village, New York",4289,1209,4289,4289,318,3971,3823,2234,586,3,977,0,23,148,1209,1080,129
596,36059,3655992,"Oyster Bay CDP, New York",7049,2964,7049,7049,1396,5653,5486,4993,228,8,236,0,21,167,2964,2831,133
597,36059,3656011,"Oyster Bay Cove village, New York",2265,759,2265,2265,113,2152,2082,1774,22,0,270,0,16,70,759,695,64
598,36059,3658409,"Plainedge CDP, New York",9517,2941,9517,9517,1093,8424,8230,7177,172,3,815,15,48,194,2941,2863,78
599,36059,3658442,"Plainview CDP, New York",27100,9207,27100,27100,1598,25502,24941,19134,131,21,5548,1,106,561,9207,8861,346
600,36059,3658475,"Plandome village, New York",1448,445,1448,1448,67,1381,1350,1169,9,2,165,1,4,31,445,411,34
601,36059,3658486,"Plandome Heights village, New York",1009,333,1009,1009,71,938,914,718,0,2,185,1,8,24,333,327,6
602,36059,3658497,"Plandome Manor village, New York",793,272,793,793,50,743,736,638,2,0,91,0,5,7,272,252,20
603,36059,3658849,"Point Lookout CDP, New York",1527,855,1527,1527,62,1465,1437,1407,8,0,18,0,4,28,855,668,187
604,36059,3659520,"Port Washington CDP, New York",16753,6269,16753,16753,2524,14229,13637,11747,312,11,1502,4,61,592,6269,5925,344
605,36059,3659531,"Port Washington North village, New York",3160,1377,3160,3160,297,2863,2786,2435,28,0,296,1,26,77,1377,1324,53
606,36059,3663264,"Rockville Centre village, New York",26016,9991,26016,26016,3029,22987,22379,20319,1314,19,617,0,110,608,9991,9669,322
607,36059,3663506,"Roosevelt CDP, New York",18066,4441,18066,18066,8406,9660,9247,343,8519,32,169,11,173,413,4441,4242,199
608,36059,3663770,"Roslyn village, New York",2988,1441,2988,2988,513,2475,2401,1872,44,4,465,3,13,74,1441,1309,132
609,36059,3663792,"Roslyn Estates village, New York",1318,407,1318,1318,42,1276,1248,1062,10,0,169,0,7,28,407,391,16
610,36059,3663803,"Roslyn Harbor village, New York",1067,379,1067,1067,63,1004,959,756,4,0,196,0,3,45,379,330,49
611,36059,3663814,"Roslyn Heights CDP, New York",6747,2218,6747,6747,700,6047,5878,3203,375,10,2239,0,51,169,2218,2108,110
612,36059,3664232,"Russell Gardens village, New York",978,339,978,978,30,948,924,492,3,0,418,1,10,24,339,314,25
613,36059,3664430,"Saddle Rock village, New York",989,293,989,989,18,971,944,840,1,0,94,0,9,27,293,281,12
614,36059,3664441,"Saddle Rock Estates CDP, New York",428,139,428,428,1,427,410,355,3,0,41,0,11,17,139,130,9
615,36059,3664842,"Salisbury CDP, New York",12618,4106,12618,12618,2484,10134,9794,6994,321,7,2383,1,88,340,4106,3989,117
616,36059,3665035,"Sands Point village, New York",2712,947,2712,2712,117,2595,2551,2249,32,0,261,0,9,44,947,878,69
617,36059,3666047,"Sea Cliff village, New York",5062,2086,5062,5062,475,4587,4407,4160,82,2,148,1,14,180,2086,1954,132
618,36059,3666058,"Seaford CDP, New York",15251,5475,15251,15251,1239,14012,13658,13051,111,2,428,0,66,354,5475,5293,182
619,36059,3666102,"Searingtown CDP, New York",5044,1607,5044,5044,197,4847,4726,1986,58,6,2647,0,29,121,1607,1556,51
620,36059,3669001,"South Farmingdale CDP, New York",14345,4902,14345,14345,2078,12267,11961,10822,284,11,773,0,71,306,4902,4765,137
621,36059,3669023,"South Floral Park village, New York",1741,534,1741,1741,384,1357,1267,158,834,8,240,0,27,90,534,507,27
622,36059,3669188,"South Hempstead CDP, New York",3406,1074,3406,3406,836,2570,2482,1852,506,10,79,2,33,88,1074,1029,45
623,36059,3669892,"South Valley Stream CDP, New York",6386,2063,6386,6386,793,5593,5356,2125,1674,20,1376,2,159,237,2063,1995,68
624,36059,3671267,"Stewart Manor village, New York",1992,709,1992,1992,256,1736,1680,1480,39,3,149,0,9,56,709,691,18
625,36059,3672554,"Syosset CDP, New York",19259,6293,19259,19259,971,18288,17802,10645,118,19,6944,2,74,486,6293,6033,260
626,36059,3673605,"Thomaston village, New York",2759,1024,2759,2759,121,2638,2575,1245,37,4,1265,1,23,63,1024,984,40
627,36059,3676089,"Uniondale CDP, New York",32473,8255,32473,32473,12934,19539,18682,5644,11543,76,1119,12,288,857,8255,7850,405
628,36059,3676287,"University Gardens CDP, New York",4358,1706,4358,4358,323,4035,3905,1702,60,0,2119,0,24,130,1706,1642,64
629,36059,3676331,"Upper Brookville village, New York",1786,612,1786,1786,87,1699,1645,1323,31,0,278,0,13,54,612,557,55
630,36059,3676705,"Valley Stream village, New York",40634,12925,40634,40634,10672,29962,28415,11450,9343,120,6503,21,978,1547,12925,12494,431
631,36059,3678146,"Wantagh CDP, New York",18613,6228,18613,18613,1399,17214,16836,16211,59,7,495,0,64,378,6228,6062,166
632,36059,3679444,"Westbury village, New York",15864,5265,15864,15864,5143,10721,10275,5875,2741,28,1481,4,146,446,5265,5083,182
633,36059,3680225,"West Hempstead CDP, New York",19835,6315,19835,19835,3956,15879,15317,11322,2249,33,1438,0,275,562,6315,6093,222
634,36059,3682117,"Williston Park village, New York",7591,2787,7591,7591,753,6838,6619,5025,81,4,1448,1,60,219,2787,2691,96
635,36059,3682744,"Woodbury CDP, New York",9335,3402,9335,9335,532,8803,8664,6881,127,2,1611,0,43,139,3402,3155,247
636,36059,3682942,"Woodmere CDP, New York",18669,5485,18669,18669,960,17709,17418,15791,757,0,586,4,280,291,5485,5199,286
637,36059,3682986,"Woodsburgh village, New York",897,306,897,897,28,869,859,811,3,1,33,0,11,10,306,293,13
638,36061,3606144919,"Manhattan borough, New York County, New York",1694251,913926,1694251,1694251,402640,1291611,1228622,793294,199592,1895,219624,882,13335,62989,913926,817782,96144
639,36071,3607107003,"Blooming Grove town, Orange County, New York",18811,6944,18811,18811,3913,14898,14228,11981,1387,73,401,4,382,670,6944,6253,691
640,36071,3607115308,"Chester town, Orange County, New York",12646,4590,12646,12646,2446,10200,9743,8065,1058,15,498,2,105,457,4590,4356,234
641,36071,3607118300,"Cornwall town, Orange County, New York",12884,5240,12884,12884,1664,11220,10699,9761,414,17,408,3,96,521,5240,4923,317
642,36071,3607118916,"Crawford town, Orange County, New York",9130,3549,9130,9130,1370,7760,7402,6847,346,11,138,1,59,358,3549,3339,210
643,36071,3607119961,"Deerpark town, Orange County, New York",7509,3319,7509,7509,657,6852,6457,5851,211,22,328,3,42,395,3319,2954,365
644,36071,3607129553,"Goshen town, Orange County, New York",14571,5226,14571,14571,3133,11438,11061,9604,888,29,473,1,66,377,5226,4832,394
645,36071,3607130631,"Greenville town, Orange County, New York",4689,1725,4689,4689,626,4063,3903,3652,144,7,54,0,46,160,1725,1613,112
646,36071,3607131907,"Hamptonburgh town, Orange County, New York",5489,1877,5489,5489,797,4692,4503,4086,175,4,203,0,35,189,1877,1778,99
647,36071,3607134550,"Highlands town, Orange County, New York",12939,3554,12939,12939,2066,10873,10319,8235,1333,59,598,28,66,554,3554,3156,398
648,36071,3607147042,"Middletown city, Orange County, New York",30345,11980,30345,30345,13243,17102,16019,8236,6304,73,1130,3,273,1083,11980,11011,969
649,36071,3607147713,"Minisink town, Orange County, New York",4621,1659,4621,4621,618,4003,3866,3657,127,5,45,0,32,137,1659,1579,80
650,36071,3607147999,"Monroe town, Orange County, New York",54341,13628,54341,54341,5807,48534,47175,35458,1588,29,1199,16,8885,1359,13628,12853,775
651,36071,3607148153,"Montgomery town, Orange County, New York",23322,8920,23322,23322,4320,19002,18032,15797,1663,37,389,5,141,970,8920,8367,553
652,36071,3607148857,"Mount Hope town, Orange County, New York",6537,2059,6537,6537,1143,5394,5208,4079,756,17,298,0,58,186,2059,1869,190
653,36071,3607150034,"Newburgh city, Orange County, New York",28856,11099,28856,28856,15085,13771,12885,4833,7545,55,246,8,198,886,11099,9771,1328
654,36071,3607150045,"Newburgh town, Orange County, New York",31985,12406,31985,31985,7066,24919,23734,18410,4095,55,929,3,242,1185,12406,11745,661
655,36071,3607150848,"New Windsor town, Orange County, New York",27805,11156,27805,27805,7100,20705,19735,14468,3969,40,1059,15,184,970,11156,10500,656
656,36071,3607159388,"Port Jervis city, Orange County, New York",8775,3992,8775,8775,1311,7464,6914,5843,727,33,181,1,129,550,3992,3542,450
657,36071,3607175781,"Tuxedo town, Orange County, New York",3811,1660,3811,3811,466,3345,3230,2831,182,0,191,0,26,115,1660,1441,219
658,36071,3607177992,"Wallkill town, Orange County, New York",30486,12047,30486,30486,8492,21994,20870,13464,5709,101,1289,8,299,1124,12047,11371,676
659,36071,3607178366,"Warwick town, Orange County, New York",32027,13315,32027,32027,4429,27598,26561,24413,1268,56,622,3,199,1037,13315,12115,1200
660,36071,3607178839,"Wawayanda town, Orange County, New York",7534,2758,7534,7534,1335,6199,5968,5272,451,6,190,0,49,231,2758,2593,165
661,36071,3607182755,"Woodbury town, Orange County, New York",12197,4176,12197,12197,2657,9540,9212,7005,1001,10,796,0,400,328,4176,3785,391
662,36079,3607912529,"Carmel town, Putnam County, New York",33576,12578,33576,33576,5301,28275,27480,25831,752,20,698,0,179,795,12578,11897,681
663,36079,3607939331,"Kent town, Putnam County, New York",12900,5429,12900,12900,2818,10082,9692,8963,359,18,270,0,82,390,5429,4866,563
664,36079,3607956748,"Patterson town, Putnam County, New York",11541,4101,11541,11541,2557,8984,8645,7872,447,13,253,2,58,339,4101,3786,315
665,36079,3607957584,"Philipstown town, Putnam County, New York",9831,4325,9831,9831,916,8915,8505,8087,150,7,208,1,52,410,4325,3847,478
666,36079,3607960147,"Putnam Valley town, Putnam County, New York",11762,4817,11762,11762,1852,9910,9488,8859,292,10,251,5,71,422,4817,4237,580
667,36079,3607968924,"Southeast town, Putnam County, New York",18058,7058,18058,18058,4316,13742,13356,12330,425,12,466,4,119,386,7058,6696,362
668,36081,3608160323,"Queens borough, Queens County, New York",2405464,896333,2405464,2405464,667861,1737603,1653491,549358,381375,9576,656583,1110,55489,84112,896333,847210,49123
669,36085,3608570915,"Staten Island borough, Richmond County, New York",495747,183692,495747,495747,96960,398787,387469,277981,46835,624,58753,135,3141,11318,183692,173202,10490
670,36087,3608715968,"Clarkstown town, Rockland County, New York",86855,30629,86855,86855,16275,70580,68409,49281,8298,66,10152,10,602,2171,30629,29489,1140
671,36087,3608732765,"Haverstraw town, Rockland County, New York",39087,13178,39087,39087,18556,20531,19790,12340,5434,37,1713,7,259,741,13178,12646,532
672,36087,3608755211,"Orangetown town, Rockland County, New York",48655,18986,48655,48655,6428,42227,40830,34462,2577,27,3480,4,280,1397,18986,17945,1041
673,36087,3608760510,"Ramapo town, Rockland County, New York",148919,39869,148919,148919,21984,126935,123940,100337,16555,245,4563,19,2221,2995,39869,37722,2147
674,36087,3608771674,"Stony Point town, Rockland County, New York",14813,5406,14813,14813,3208,11605,11209,9693,911,15,505,2,83,396,5406,5146,260
675,36103,3601594,"Amagansett CDP, New York",1824,1776,1824,1824,186,1638,1599,1522,35,0,18,2,22,39,1776,770,1006
676,36103,3602044,"Amityville village, New York",9500,4015,9500,9500,1761,7739,7514,6403,876,18,163,0,54,225,4015,3846,169
677,36103,3602374,"Aquebogue CDP, New York",2547,1164,2547,2547,476,2071,2005,1919,52,2,26,0,6,66,1164,969,195
678,36103,3602737,"Asharoken village, New York",592,296,592,592,31,561,550,532,2,0,6,0,10,11,296,231,65
679,36103,3603408,"Babylon village, New York",12188,4732,12188,12188,1067,11121,10773,10221,199,6,294,1,52,348,4732,4544,188
680,36103,3604055,"Baiting Hollow CDP, New York",2763,1656,2763,2763,309,2454,2396,2290,67,7,21,1,10,58,1656,1081,575
681,36103,3604913,"Bayport CDP, New York",8609,3506,8609,8609,754,7855,7644,7301,161,4,142,2,34,211,3506,3245,261
682,36103,3604935,"Bay Shore CDP, New York",29244,10126,29244,29244,11127,18117,17322,10660,5044,82,1236,5,295,795,10126,9667,459
683,36103,3605039,"Baywood CDP, New York",7726,2266,7726,7726,3470,4256,3992,2561,1019,5,301,1,105,264,2266,2210,56
684,36103,3605672,"Belle Terre village, New York",808,312,808,808,54,754,727,672,8,0,42,0,5,27,312,287,25
685,36103,3605771,"Bellport village, New York",2203,1170,2203,2203,118,2085,2013,1924,46,5,34,0,4,72,1170,938,232
686,36103,3607069,"Blue Point CDP, New York",5156,2132,5156,5156,287,4869,4754,4599,42,3,87,0,23,115,2132,2029,103
687,36103,3607157,"Bohemia CDP, New York",9852,3720,9852,9852,1040,8812,8610,8074,170,2,349,0,15,202,3720,3581,139
688,36103,3608026,"Brentwood CDP, New York",62387,14127,62387,62387,47072,15315,14520,5816,6766,91,1134,6,707,795,14127,13658,469
689,36103,3608136,"Bridgehampton CDP, New York",2953,2632,2953,2953,417,2536,2446,2160,199,3,71,0,13,90,2632,1136,1496
690,36103,3608323,"Brightwaters village, New York",3181,1160,3181,3181,250,2931,2849,2718,82,0,46,0,3,82,1160,1135,25
691,36103,3609000,"Brookhaven CDP, New York",3330,1177,3330,3330,303,3027,2933,2686,190,10,34,0,13,94,1177,1097,80
692,36103,3610304000,"Babylon town, Suffolk County, New York",218223,75270,218223,218223,52142,166081,160237,114931,33874,428,9329,20,1655,5844,75270,71907,3363
693,36103,3610310000,"Brookhaven town, Suffolk County, New York",485773,178581,485773,485773,83528,402245,386917,329999,30287,814,23108,97,2612,15328,178581,167187,11394
694,36103,3610322194,"East Hampton town, Suffolk County, New York",28385,21163,28385,28385,7531,20854,20106,18607,770,57,474,12,186,748,21163,11118,10045
695,36103,3610337000,"Huntington town, Suffolk County, New York",204127,73073,204127,204127,31403,172724,167499,143950,8667,147,13598,27,1110,5225,73073,70014,3059
696,36103,3610338000,"Islip town, Suffolk County, New York",339938,111346,339938,339938,118903,221035,213728,172617,26931,455,11001,58,2666,7307,111346,105002,6344
697,36103,3610359106,"Poospatuck Reservation, Suffolk County, New York",436,159,436,436,87,349,304,34,55,215,0,0,0,45,159,150,9
698,36103,3610361984,"Riverhead town, Suffolk County, New York",35902,16310,35902,35902,8262,27640,26742,23881,2193,53,436,5,174,898,16310,13879,2431
699,36103,3610366839,"Shelter Island town, Suffolk County, New York",3253,2731,3253,3253,289,2964,2849,2777,21,0,46,0,5,115,2731,1481,1250
700,36103,3610367059,"Shinnecock Reservation, Suffolk County, New York",819,349,819,819,47,772,744,28,30,684,2,0,0,28,349,300,49
701,36103,3610368000,"Smithtown town, Suffolk County, New York",116296,41415,116296,116296,9979,106317,103561,95702,1662,58,5585,6,548,2756,41415,40018,1397
702,36103,3610368473,"Southampton town, Suffolk County, New York",69036,42770,69036,69036,17178,51858,50186,46104,2293,170,1185,9,425,1672,42770,25806,16964
703,36103,3610369463,"Southold town, Suffolk County, New York",23732,15773,23732,23732,3610,20122,19566,18700,485,21,255,7,98,556,15773,10010,5763
704,36103,3611781,"Calverton CDP, New York",5934,3016,5934,5934,1095,4839,4698,4203,414,7,47,0,27,141,3016,2779,237
705,36103,3613376,"Centereach CDP, New York",30980,10405,30980,30980,5147,25833,24974,21175,964,41,2658,8,128,859,10405,10008,397
706,36103,3613420,"Center Moriches CDP, New York",8046,2960,8046,8046,1129,6917,6690,6308,243,8,109,0,22,227,2960,2770,190
707,36103,3613442,"Centerport CDP, New York",5822,2272,5822,5822,306,5516,5347,5181,20,2,108,1,35,169,2272,2171,101
708,36103,3613552,"Central Islip CDP, New York",36714,10344,36714,36714,21856,14858,14077,5414,7005,98,1085,11,464,781,10344,9870,474
709,36103,3616958,"Cold Spring Harbor CDP, New York",3064,1020,3064,3064,203,2861,2763,2621,10,1,119,0,12,98,1020,975,45
710,36103,3617530,"Commack CDP, New York",36536,12312,36536,36536,2914,33622,32857,29468,632,28,2536,4,189,765,12312,12009,303
711,36103,3618146,"Copiague CDP, New York",23429,8024,23429,23429,9634,13795,13308,10743,1836,18,524,1,186,487,8024,7684,340
712,36103,3618157,"Coram CDP, New York",40220,16060,40220,40220,7454,32766,31371,24163,4703,51,2197,9,248,1395,16060,15234,826
713,36103,3619466,"Cutchogue CDP, New York",3437,2121,3437,3437,417,3020,2962,2886,36,1,28,1,10,58,2121,1400,721
714,36103,3619972,"Deer Park CDP, New York",28837,9839,28837,28837,5206,23631,22845,15200,3982,74,3322,1,266,786,9839,9510,329
715,36103,3620379,"Dering Harbor village, New York",50,34,50,50,16,34,29,24,0,0,4,0,1,5,34,17,17
716,36103,3620687,"Dix Hills CDP, New York",26180,8315,26180,26180,2224,23956,23178,17099,1410,28,4397,8,236,778,8315,8016,299
717,36103,3621985,"East Farmingdale CDP, New York",6617,2275,6617,6617,1706,4911,4750,3384,785,5,528,2,46,161,2275,2177,98
718,36103,3622183,"East Hampton village, New York",1517,1774,1517,1517,177,1340,1308,1253,24,0,24,0,7,32,1774,668,1106
719,36103,3622200,"East Hampton North CDP, New York",5377,2856,5377,5377,2396,2981,2864,2524,219,8,75,0,38,117,2856,1889,967
720,36103,3622315,"East Islip CDP, New York",13931,4918,13931,13931,1454,12477,12149,11567,209,9,302,0,62,328,4918,4769,149
721,36103,3622447,"East Marion CDP, New York",1048,946,1048,1048,109,939,912,881,11,2,11,1,6,27,946,494,452
722,36103,3622546,"East Moriches CDP, New York",5946,2349,5946,5946,571,5375,5235,5001,112,6,84,0,32,140,2349,2120,229
723,36103,3622612,"East Northport CDP, New York",20048,7246,20048,20048,2120,17928,17428,16539,205,13,591,1,79,500,7246,6996,250
724,36103,3622733,"East Patchogue CDP, New York",21580,8612,21580,21580,4975,16605,15945,14297,982,45,522,7,92,660,8612,8221,391
725,36103,3622810,"Eastport CDP, New York",2219,1015,2219,2219,300,1919,1851,1786,32,1,19,2,11,68,1015,907,108
726,36103,3622832,"East Quogue CDP, New York",5557,3104,5557,5557,1029,4528,4408,4268,36,3,77,0,24,120,3104,2152,952
727,36103,3622980,"East Shoreham CDP, New York",6841,2248,6841,6841,647,6194,5962,5620,121,5,183,0,33,232,2248,2181,67
728,36103,3623316,"Eatons Neck CDP, New York",1334,570,1334,1334,60,1274,1249,1217,5,0,22,0,5,25,570,507,63
729,36103,3624405,"Elwood CDP, New York",11426,3846,11426,11426,1387,10039,9725,8190,535,1,941,0,58,314,3846,3730,116
730,36103,3625417,"Farmingville CDP, New York",14983,4845,14983,14983,2659,12324,11852,10520,510,5,709,2,106,472,4845,4706,139
731,36103,3625839,"Fire Island CDP, New York",777,3357,777,777,99,678,650,585,29,10,17,0,9,28,3357,393,2964
732,36103,3625923,"Fishers Island CDP, New York",424,609,424,424,32,392,370,352,3,0,11,2,2,22,609,180,429
733,36103,3626121,"Flanders CDP, New York",5098,1714,5098,5098,2764,2334,2209,1707,421,5,37,0,39,125,1714,1492,222
734,36103,3626946,"Fort Salonga CDP, New York",9652,3430,9652,9652,619,9033,8783,8450,75,6,227,1,24,250,3430,3299,131
735,36103,3628997,"Gilgo-Oak Beach-Captree CDP, New York",233,172,233,233,6,227,222,216,2,0,2,0,2,5,172,111,61
736,36103,3629509,"Gordon Heights CDP, New York",3981,1131,3981,3981,1479,2502,2319,649,1478,55,91,0,46,183,1131,1059,72
737,36103,3630235,"Great River CDP, New York",2005,842,2005,2005,155,1850,1818,1752,29,1,36,0,0,32,842,798,44
738,36103,3630543,"Greenlawn CDP, New York",13661,4669,13661,13661,2420,11241,10854,8329,1660,14,773,0,78,387,4669,4524,145
739,36103,3630576,"Greenport village, New York",2583,1277,2583,2583,957,1626,1542,1300,197,4,25,0,16,84,1277,950,327
740,36103,3630581,"Greenport West CDP, New York",2282,1658,2282,2282,388,1894,1854,1729,85,0,29,0,11,40,1658,1056,602
741,36103,3631445,"Halesite CDP, New York",2527,1099,2527,2527,176,2351,2288,2169,41,0,60,0,18,63,1099,1034,65
742,36103,3631896,"Hampton Bays CDP, New York",15228,7879,15228,15228,5715,9513,9239,8759,167,25,177,1,110,274,7879,5669,2210
743,36103,3632732,"Hauppauge CDP, New York",20083,7384,20083,20083,2080,18003,17535,15440,503,11,1481,1,99,468,7384,7180,204
744,36103,3632963,"Head of the Harbor village, New York",1520,537,1520,1520,177,1343,1287,1212,4,1,59,0,11,56,537,475,62
745,36103,3635056,"Holbrook CDP, New York",26487,9714,26487,26487,3166,23321,22774,20723,701,19,1194,3,134,547,9714,9439,275
746,36103,3635254,"Holtsville CDP, New York",18937,6646,18937,18937,2728,16209,15730,14130,455,16,1040,3,86,479,6646,6448,198
747,36103,3636233,"Huntington CDP, New York",19645,8341,19645,19645,1458,18187,17651,16612,368,10,568,5,88,536,8341,7920,421
748,36103,3637022,"Huntington Bay village, New York",1446,593,1446,1446,56,1390,1351,1301,5,1,29,0,15,39,593,552,41
749,36103,3637044,"Huntington Station CDP, New York",34878,10943,34878,34878,15793,19085,18277,13388,3012,38,1588,8,243,808,10943,10517,426
750,36103,3637840,"Islandia village, New York",3567,1087,3567,3567,1135,2432,2340,1651,437,5,219,0,28,92,1087,1044,43
751,36103,3637869,"Islip CDP, New York",18418,6605,18418,18418,3574,14844,14371,12703,889,23,635,2,119,473,6605,6407,198
752,36103,3638022,"Islip Terrace CDP, New York",5323,1774,5323,5323,836,4487,4364,4023,146,13,147,1,34,123,1774,1698,76
753,36103,3638253,"Jamesport CDP, New York",1609,1126,1609,1609,177,1432,1411,1381,22,0,7,1,0,21,1126,689,437
754,36103,3639672,"Kings Park CDP, New York",17085,6564,17085,17085,1414,15671,15306,14499,179,4,554,0,70,365,6564,6311,253
755,36103,3640530,"Lake Grove village, New York",11072,4078,11072,11072,1252,9820,9532,8299,277,9,920,0,27,288,4078,3910,168
756,36103,3640838,"Lake Ronkonkoma CDP, New York",18619,7223,18619,18619,2588,16031,15494,13560,687,21,1086,3,137,537,7223,6645,578
757,36103,3641465,"Laurel CDP, New York",1495,800,1495,1495,249,1246,1217,1182,6,4,15,0,10,29,800,550,250
758,36103,3642554,"Lindenhurst village, New York",27148,9712,27148,27148,4458,22690,22053,20548,629,23,729,0,124,637,9712,9260,452
759,36103,3643005,"Lloyd Harbor village, New York",3571,1246,3571,3571,206,3365,3262,3100,9,0,136,0,17,103,1246,1150,96
760,36103,3645139,"Manorville CDP, New York",14317,5364,14317,14317,1428,12889,12456,11814,326,12,253,0,51,433,5364,5159,205
761,36103,3646074,"Mastic CDP, New York",15404,4792,15404,15404,4605,10799,10198,8191,1440,43,390,10,124,601,4792,4557,235
762,36103,3646085,"Mastic Beach CDP, New York",14199,5198,14199,14199,3160,11039,10334,8194,1771,64,208,4,93,705,5198,4677,521
763,36103,3646140,"Mattituck CDP, New York",4322,2527,4322,4322,516,3806,3706,3586,65,3,39,1,12,100,2527,1805,722
764,36103,3646404,"Medford CDP, New York",24247,8416,24247,24247,5973,18274,17554,15080,1545,31,758,8,132,720,8416,8095,321
765,36103,3646514,"Melville CDP, New York",19284,7777,19284,19284,1288,17996,17538,14654,794,12,1997,3,78,458,7777,7368,409
766,36103,3646976,"Middle Island CDP, New York",10546,4588,10546,10546,1290,9256,8919,7226,1308,33,282,7,63,337,4588,4375,213
767,36103,3647306,"Miller Place CDP, New York",11723,4157,11723,11723,882,10841,10566,9991,178,10,348,7,32,275,4157,4001,156
768,36103,3648054,"Montauk CDP, New York",4318,4487,4318,4318,804,3514,3384,3195,86,5,62,2,34,130,4487,1804,2683
769,36103,3648450,"Moriches CDP, New York",3026,1460,3026,3026,390,2636,2505,2101,321,7,54,0,22,131,1460,1361,99
770,36103,3649066,"Mount Sinai CDP, New York",11623,4339,11623,11623,984,10639,10372,9556,157,18,599,0,42,267,4339,4131,208
771,36103,3649424,"Napeague CDP, New York",368,480,368,368,29,339,329,307,7,0,11,0,4,10,480,179,301
772,36103,3649825,"Nesconset CDP, New York",13207,4707,13207,13207,1186,12021,11709,10575,208,8,838,0,80,312,4707,4560,147
773,36103,3650727,"New Suffolk CDP, New York",403,316,403,403,38,365,360,354,1,0,2,2,1,5,316,187,129
774,36103,3651286,"Nissequogue village, New York",1564,625,1564,1564,78,1486,1451,1392,6,5,40,2,6,35,625,578,47
775,36103,3651396,"North Amityville CDP, New York",18643,5628,18643,18643,6899,11744,11148,1678,8834,123,280,10,223,596,5628,5304,324
776,36103,3651418,"Northampton CDP, New York",763,246,763,763,324,439,424,262,141,9,10,0,2,15,246,227,19
777,36103,3651440,"North Babylon CDP, New York",17927,6430,17927,17927,3381,14546,14058,11154,1732,21,1007,1,143,488,6430,6229,201
778,36103,3651495,"North Bay Shore CDP, New York",19619,4742,19619,19619,13376,6243,5898,2032,2663,39,940,10,214,345,4742,4579,163
779,36103,3651528,"North Bellport CDP, New York",11900,3670,11900,11900,4451,7449,6934,3883,2532,108,322,1,88,515,3670,3484,186
780,36103,3652078,"North Great River CDP, New York",4266,1535,4266,4266,728,3538,3451,3197,137,7,94,0,16,87,1535,1505,30
781,36103,3652188,"North Haven village, New York",1162,732,1162,1162,47,1115,1095,1062,8,2,18,0,5,20,732,464,268
782,36103,3653198,"North Lindenhurst CDP, New York",12000,4016,12000,12000,3390,8610,8309,7040,719,14,445,0,91,301,4016,3861,155
783,36103,3653319,"North Patchogue CDP, New York",6751,2421,6751,6751,1792,4959,4808,4447,179,7,131,2,42,151,2421,2314,107
784,36103,3653396,"Northport village, New York",7347,3128,7347,7347,401,6946,6787,6563,53,4,146,0,21,159,3128,2983,145
785,36103,3653561,"North Sea CDP, New York",5461,3587,5461,5461,1080,4381,4210,3946,60,26,125,3,50,171,3587,2158,1429
786,36103,3653775,"Northville CDP, New York",1566,813,1566,1566,224,1342,1309,1270,19,0,18,0,2,33,813,620,193
787,36103,3653852,"Northwest Harbor CDP, New York",4637,3512,4637,4637,863,3774,3641,3378,83,26,110,7,37,133,3512,1912,1600
788,36103,3654056,"Noyack CDP, New York",4325,2832,4325,4325,578,3747,3636,3481,60,5,76,0,14,111,2832,1797,1035
789,36103,3654144,"Oakdale CDP, New York",7430,3240,7430,7430,517,6913,6760,6550,86,6,103,2,13,153,3240,3109,131
790,36103,3654430,"Ocean Beach village, New York",153,591,153,153,10,143,138,133,2,1,0,0,2,5,591,76,515
791,36103,3654617,"Old Field village, New York",893,365,893,893,42,851,827,738,2,0,74,1,12,24,365,334,31
792,36103,3655321,"Orient CDP, New York",999,800,999,999,41,958,939,920,2,4,10,0,3,19,800,470,330
793,36103,3656660,"Patchogue village, New York",12408,5776,12408,12408,3520,8888,8576,7604,662,19,242,1,48,312,5776,5456,320
794,36103,3656968,"Peconic CDP, New York",692,495,692,692,83,609,593,568,13,0,6,0,6,16,495,300,195
795,36103,3659157,"Poquott village, New York",903,374,903,903,43,860,843,743,8,0,91,0,1,17,374,364,10
796,36103,3659355,"Port Jefferson village, New York",7962,3471,7962,7962,712,7250,6957,6258,109,2,537,2,49,293,3471,3291,180
797,36103,3659377,"Port Jefferson Station CDP, New York",7950,2985,7950,7950,1570,6380,6132,5277,302,4,512,0,37,248,2985,2859,126
798,36103,3660408,"Quiogue CDP, New York",1013,625,1013,1013,279,734,702,629,40,7,20,0,6,32,625,364,261
799,36103,3660422,"Quogue village, New York",1662,1613,1662,1662,134,1528,1490,1368,41,16,58,0,7,38,1613,688,925
800,36103,3661142,"Remsenburg-Speonk CDP, New York",3110,1644,3110,3110,351,2759,2679,2599,36,0,35,0,9,80,1644,1200,444
801,36103,3661665,"Ridge CDP, New York",13271,6336,13271,13271,1145,12126,11775,10661,723,12,333,2,44,351,6336,5877,459
802,36103,3661973,"Riverhead CDP, New York",14993,5763,14993,14993,5674,9319,8933,6853,1716,37,225,3,99,386,5763,5365,398
803,36103,3662066,"Riverside CDP, New York",2882,910,2882,2882,1176,1706,1655,1054,539,16,26,3,17,51,910,838,72
804,36103,3663319,"Rocky Point CDP, New York",13633,5285,13633,13633,1651,11982,11532,11073,171,13,239,3,33,450,5285,4826,459
805,36103,3663473,"Ronkonkoma CDP, New York",18955,6701,18955,18955,2814,16141,15595,13641,548,15,1166,8,217,546,6701,6496,205
806,36103,3664452,"Sagaponack village, New York",770,718,770,770,60,710,680,624,9,8,28,0,11,30,718,305,413
807,36103,3664485,"Sag Harbor village, New York",2772,2013,2772,2772,301,2471,2370,2100,206,12,35,0,17,101,2013,1202,811
808,36103,3664584,"St. James CDP, New York",13487,4921,13487,13487,1037,12450,12164,11500,117,7,513,0,27,286,4921,4729,192
809,36103,3664881,"Saltaire village, New York",113,432,113,113,3,110,107,105,0,0,2,0,0,3,432,31,401
810,36103,3665409,"Sayville CDP, New York",16569,6228,16569,16569,1148,15421,15029,14489,186,10,283,4,57,392,6228,5935,293
811,36103,3666212,"Selden CDP, New York",21262,7167,21262,21262,4129,17133,16550,14013,885,28,1495,3,126,583,7167,6838,329
812,36103,3666481,"Setauket-East Setauket CDP, New York",14984,5569,14984,14984,1056,13928,13453,11632,177,12,1562,3,67,475,5569,5304,265
813,36103,3666828,"Shelter Island CDP, New York",1602,1145,1602,1602,181,1421,1362,1329,13,0,18,0,2,59,1145,703,442
814,36103,3666850,"Shelter Island Heights CDP, New York",1601,1552,1601,1601,92,1509,1458,1424,8,0,24,0,2,51,1552,761,791
815,36103,3667048,"Shinnecock Hills CDP, New York",2282,1537,2282,2282,702,1580,1516,1404,45,7,51,0,9,64,1537,845,692
816,36103,3667070,"Shirley CDP, New York",26360,8782,26360,26360,6200,20160,19167,16268,1907,70,724,2,196,993,8782,8262,520
817,36103,3667191,"Shoreham village, New York",561,232,561,561,45,516,492,467,11,0,13,0,1,24,232,188,44
818,36103,3667851,"Smithtown CDP, New York",25629,8800,25629,25629,2484,23145,22455,20966,351,7,1007,0,124,690,8800,8495,305
819,36103,3668374,"Sound Beach CDP, New York",7416,2943,7416,7416,758,6658,6412,6111,125,13,136,5,22,246,2943,2728,215
820,36103,3668462,"Southampton village, New York",4550,3438,4550,4550,792,3758,3636,3218,236,19,129,0,34,122,3438,1701,1737
821,36103,3669254,"South Huntington CDP, New York",9561,3418,9561,9561,1428,8133,7886,6864,210,5,773,0,34,247,3418,3290,128
822,36103,3669452,"Southold CDP, New York",6040,4222,6040,6040,779,5261,5109,4941,66,3,78,0,21,152,4222,2617,1605
823,36103,3670387,"Springs CDP, New York",8086,4482,8086,8086,2728,5358,5159,4883,112,7,128,1,28,199,4482,2973,1509
824,36103,3671608,"Stony Brook CDP, New York",13467,5033,13467,13467,826,12641,12262,10310,217,2,1667,2,64,379,5033,4831,202
825,36103,3671620,"Stony Brook University CDP, New York",10409,115,10409,10409,1748,8661,8121,2658,3516,3,1829,0,115,540,115,72,43
826,36103,3673352,"Terryville CDP, New York",11472,4006,11472,11472,2411,9061,8798,7890,392,15,430,1,70,263,4006,3853,153
827,36103,3675572,"Tuckahoe CDP, New York",1505,995,1505,1505,342,1163,1126,987,83,8,35,0,13,37,995,628,367
828,36103,3677519,"Village of the Branch village, New York",1735,573,1735,1735,92,1643,1600,1521,23,0,49,0,7,43,573,563,10
829,36103,3677772,"Wading River CDP, New York",7731,3223,7731,7731,690,7041,6809,6512,160,0,102,0,35,232,3223,2789,434
830,36103,3677805,"Wainscott CDP, New York",904,916,904,904,142,762,738,688,17,1,23,0,9,24,916,386,530
831,36103,3678575,"Water Mill CDP, New York",2506,2125,2506,2506,189,2317,2218,2079,28,4,93,1,13,99,2125,958,1167
832,36103,3679246,"West Babylon CDP, New York",43213,15139,43213,43213,8202,35011,33804,26727,5291,79,1455,4,248,1207,15139,14523,616
833,36103,3679301,"West Bay Shore CDP, New York",4625,1809,4625,4625,495,4130,3970,3680,133,2,137,0,18,160,1809,1742,67
834,36103,3680170,"Westhampton CDP, New York",3621,2206,3621,3621,654,2967,2890,2737,80,4,45,0,24,77,2206,1291,915
835,36103,3680181,"Westhampton Beach village, New York",2150,2455,2150,2150,319,1831,1787,1694,33,1,49,0,10,44,2455,858,1597
836,36103,3680186,"West Hampton Dunes village, New York",126,271,126,126,5,121,121,119,0,0,2,0,0,0,271,28,243
837,36103,3680258,"West Hills CDP, New York",5385,2024,5385,5385,530,4855,4738,4231,108,3,377,0,19,117,2024,1968,56
838,36103,3680302,"West Islip CDP, New York",27048,9021,27048,27048,2659,24389,23832,23078,166,6,528,2,52,557,9021,8763,258
839,36103,3680885,"West Sayville CDP, New York",4872,2109,4872,4872,342,4530,4412,4282,45,2,72,0,11,118,2109,1765,344
840,36103,3681419,"Wheatley Heights CDP, New York",5140,1493,5140,5140,878,4262,4012,919,2619,5,395,0,74,250,1493,1442,51
841,36103,3683294,"Wyandanch CDP, New York",12990,3548,12990,12990,5487,7503,7153,451,6352,42,163,0,145,350,3548,3290,258
842,36103,3683426,"Yaphank CDP, New York",5974,2480,5974,5974,793,5181,4960,4475,278,8,145,0,54,221,2480,2280,200
843,36105,3610506310,"Bethel town, Sullivan County, New York",3959,3703,3959,3959,503,3456,3312,3152,94,4,32,3,27,144,3703,1766,1937
844,36105,3610511759,"Callicoon town, Sullivan County, New York",2989,1852,2989,2989,232,2757,2642,2534,31,6,63,0,8,115,1852,1280,572
845,36105,3610516661,"Cochecton town, Sullivan County, New York",1448,1042,1448,1448,80,1368,1310,1272,22,0,9,0,7,58,1042,653,389
846,36105,3610520104,"Delaware town, Sullivan County, New York",2203,1458,2203,2203,171,2032,1956,1779,140,1,22,0,14,76,1458,927,531
847,36105,3610525241,"Fallsburg town, Sullivan County, New York",14192,8830,14192,14192,3845,10347,9887,7586,1811,25,306,2,157,460,8830,4148,4682
848,36105,3610526528,"Forestburgh town, Sullivan County, New York",808,552,808,808,38,770,740,695,18,0,23,1,3,30,552,347,205
849,36105,3610527573,"Fremont town, Sullivan County, New York",1161,1197,1161,1161,72,1089,1057,1014,20,10,10,0,3,32,1197,537,660
850,36105,3610534473,"Highland town, Sullivan County, New York",2196,1722,2196,2196,144,2052,1974,1918,27,4,17,0,8,78,1722,1004,718
851,36105,3610542235,"Liberty town, Sullivan County, New York",10159,5450,10159,10159,2789,7370,6853,5912,685,32,173,0,51,517,5450,3916,1534
852,36105,3610543786,"Lumberland town, Sullivan County, New York",2243,1547,2243,2243,201,2042,1924,1844,32,10,31,0,7,118,1547,911,636
853,36105,3610544809,"Mamakating town, Sullivan County, New York",12655,6157,12655,12655,1573,11082,10374,9633,428,33,189,1,90,708,6157,4731,1426
854,36105,3610549847,"Neversink town, Sullivan County, New York",3366,2020,3366,3366,222,3144,3027,2927,43,5,41,0,11,117,2020,1411,609
855,36105,3610563176,"Rockland town, Sullivan County, New York",3290,2432,3290,3290,322,2968,2809,2683,49,5,54,0,18,159,2432,1420,1012
856,36105,3610573627,"Thompson town, Sullivan County, New York",16550,10023,16550,16550,3719,12831,11987,8545,2638,36,572,3,193,844,10023,6478,3545
857,36105,3610575759,"Tusten town, Sullivan County, New York",1405,1140,1405,1405,96,1309,1263,1197,31,3,27,0,5,46,1140,654,486
858,36111,3611120247,"Denning town, Ulster County, New York",493,501,493,493,30,463,423,400,12,6,3,0,2,40,501,219,282
859,36111,3611124691,"Esopus town, Ulster County, New York",9548,4089,9548,9548,603,8945,8472,7914,401,3,111,0,43,473,4089,3668,421
860,36111,3611128255,"Gardiner town, Ulster County, New York",5610,2672,5610,5610,452,5158,4875,4657,83,3,96,0,36,283,2672,2302,370
861,36111,3611132116,"Hardenburgh town, Ulster County, New York",221,301,221,221,14,207,206,192,1,0,13,0,0,1,301,101,200
862,36111,3611137143,"Hurley town, Ulster County, New York",6178,3079,6178,6178,356,5822,5565,5287,107,37,114,1,19,257,3079,2718,361
863,36111,3611139727,"Kingston city, Ulster County, New York",24069,11571,24069,24069,4107,19962,18402,14623,2956,34,630,3,156,1560,11571,10407,1164
864,36111,3611139738,"Kingston town, Ulster County, New York",933,477,933,933,64,869,824,796,10,2,9,0,7,45,477,422,55
865,36111,3611142994,"Lloyd town, Ulster County, New York",11133,4785,11133,11133,1157,9976,9523,8429,681,14,324,11,64,453,4785,4438,347
866,36111,3611145458,"Marbletown town, Ulster County, New York",5658,3080,5658,5658,310,5348,5093,4871,66,9,112,0,35,255,3080,2503,577
867,36111,3611145722,"Marlborough town, Ulster County, New York",8712,3794,8712,8712,1022,7690,7392,6764,494,4,99,0,31,298,3794,3426,368
868,36111,3611150562,"New Paltz town, Ulster County, New York",14407,5358,14407,14407,1835,12572,12030,10246,751,20,775,9,229,542,5358,4906,452
869,36111,3611154749,"Olive town, Ulster County, New York",4226,2564,4226,4226,248,3978,3786,3640,47,6,59,1,33,192,2564,1923,641
870,36111,3611158552,"Plattekill town, Ulster County, New York",10424,4412,10424,10424,2055,8369,7879,7167,521,16,87,5,83,490,4412,4032,380
871,36111,3611163011,"Rochester town, Ulster County, New York",7272,4062,7272,7272,495,6777,6415,6118,130,10,107,2,48,362,4062,3046,1016
872,36111,3611163737,"Rosendale town, Ulster County, New York",5782,2931,5782,5782,361,5421,5146,4913,111,0,72,4,46,275,2931,2570,361
873,36111,3611165299,"Saugerties town, Ulster County, New York",19038,9370,19038,19038,1468,17570,16672,15912,386,19,280,2,73,898,9370,8300,1070
874,36111,3611166597,"Shandaken town, Ulster County, New York",2866,2482,2866,2866,230,2636,2492,2356,36,5,51,1,43,144,2482,1419,1063
875,36111,3611166674,"Shawangunk town, Ulster County, New York",13563,4418,13563,13563,1863,11700,11272,9937,1082,23,165,2,63,428,4418,4053,365
876,36111,3611175935,"Ulster town, Ulster County, New York",12660,5714,12660,12660,1176,11484,10862,9847,592,26,320,2,75,622,5714,5229,485
877,36111,3611178828,"Wawarsing town, Ulster County, New York",12771,5943,12771,12771,2925,9846,9207,7301,1569,53,193,2,89,639,5943,4504,1439
878,36111,3611183052,"Woodstock town, Ulster County, New York",6287,4250,6287,6287,348,5939,5658,5325,116,16,158,0,43,281,4250,3135,1115
879,36119,3611905320,"Bedford town, Westchester County, New York",17309,6314,17309,17309,2910,14399,13866,12424,726,19,589,0,108,533,6314,5758,556
880,36119,3611918410,"Cortlandt town, Westchester County, New York",42545,16229,42545,42545,8547,33998,32436,27941,2494,45,1679,4,273,1562,16229,15288,941
881,36119,3611921820,"Eastchester town, Westchester County, New York",34641,14410,34641,34641,3117,31524,30302,25852,1036,6,3200,2,206,1222,14410,13595,815
882,36119,3611930367,"Greenburgh town, Westchester County, New York",95397,37565,95397,95397,16821,78576,74906,52300,10141,83,11602,9,771,3670,37565,35776,1789
883,36119,3611932413,"Harrison town, Westchester County, New York",28218,9274,28218,28218,4402,23816,22952,18780,745,10,3231,4,182,864,9274,8747,527
884,36119,3611942136,"Lewisboro town, Westchester County, New York",12265,4867,12265,12265,969,11296,10812,10107,191,8,435,0,71,484,4867,4495,372
885,36119,3611944842,"Mamaroneck town, Westchester County, New York",31758,11969,31758,31758,5671,26087,24838,22090,921,12,1544,5,266,1249,11969,11423,546
886,36119,3611948895,"Mount Kisco town, Westchester County, New York",10959,4465,10959,10959,4569,6390,6116,5076,439,20,513,1,67,274,4465,4271,194
887,36119,3611949011,"Mount Pleasant town, Westchester County, New York",44436,15221,44436,44436,9259,35177,33961,29930,1260,30,2501,2,238,1216,15221,14595,626
888,36119,3611949121,"Mount Vernon city, Westchester County, New York",73893,30350,73893,73893,14003,59890,56750,9077,44655,140,1398,21,1459,3140,30350,28286,2064
889,36119,3611950078,"New Castle town, Westchester County, New York",18311,6160,18311,18311,1243,17068,16367,13824,267,3,2144,3,126,701,6160,5918,242
890,36119,3611950617,"New Rochelle city, Westchester County, New York",79726,30531,79726,79726,26257,53469,51194,32009,14324,95,3859,20,887,2275,30531,28702,1829
891,36119,3611951693,"North Castle town, Westchester County, New York",12408,4310,12408,12408,1448,10960,10560,9511,196,0,793,1,59,400,4310,4098,212
892,36119,3611953517,"North Salem town, Westchester County, New York",5243,2126,5243,5243,594,4649,4503,4270,83,4,120,0,26,146,2126,1887,239
893,36119,3611955541,"Ossining town, Westchester County, New York",40061,14975,40061,40061,14493,25568,24507,17932,4096,53,2195,5,226,1061,14975,14077,898
894,36119,3611956979,"Peekskill city, Westchester County, New York",25431,10464,25431,25431,11160,14271,13410,7720,4693,32,725,5,235,861,10464,9813,651
895,36119,3611957012,"Pelham town, Westchester County, New York",13078,4490,13078,13078,1656,11422,10779,9030,717,11,844,10,167,643,4490,4323,167
896,36119,3611959685,"Pound Ridge town, Westchester County, New York",5082,2076,5082,5082,344,4738,4516,4264,65,3,165,0,19,222,2076,1860,216
897,36119,3611964309,"Rye city, Westchester County, New York",16592,6038,16592,16592,1388,15204,14499,13052,189,12,1185,4,57,705,6038,5654,384
898,36119,3611964320,"Rye town, Westchester County, New York",49613,17678,49613,49613,23918,25695,24428,20216,1757,27,1961,0,467,1267,17678,16909,769
899,36119,3611965442,"Scarsdale town, Westchester County, New York",18253,5747,18253,18253,922,17331,16419,12249,220,7,3816,0,127,912,5747,5510,237
900,36119,3611968308,"Somers town, Westchester County, New York",21541,9010,21541,21541,1907,19634,19037,17912,278,4,776,4,63,597,9010,8457,553
901,36119,3611981677,"White Plains city, Westchester County, New York",59559,25494,59559,59559,19426,40133,38324,26242,6746,33,4747,13,543,1809,25494,24162,1332
902,36119,3611984000,"Yonkers city, Westchester County, New York",211569,85528,211569,211569,89065,122504,117591,68970,33509,330,12915,34,1833,4913,85528,80548,4980
903,36119,3611984077,"Yorktown town, Westchester County, New York",36569,13672,36569,36569,5245,31324,30346,26906,1262,30,1970,3,175,978,13672,13144,528
