,STATE,COUNTY,GEOCODE,SUMLEV,POP100,HU100,P0010001,P0020001,P0020002,P0020003,P0020004,P0020005,P0020006,P0020007,P0020008,P0020009,P0020010,P0020011,H0010001,H0010002,H0010003,NAME
0,,,,10,331449281,140498736,331449281,331449281,62080044,269369237,255820254,191697647,39940338,2251699,19618719,622018,1689833,13548983,140498736,126817580,13681156,United States
1,,,1,20,57609148,24716516,57609148,57609148,8794868,48814280,46696894,35752998,6207939,112024,4143379,15069,465485,2117386,24716516,22371124,2345392,Northeast Region
2,,,2,20,68985454,30458979,68985454,68985454,5978786,63006668,60242955,50082552,7111553,382776,2385691,38022,242361,2763713,30458979,27564312,2894667,Midwest Region
3,,,3,20,126266107,54542603,126266107,126266107,23696746,102569361,97693658,68393435,23153574,722756,4757911,100255,565727,4875703,54542603,48613340,5929263,South Region
4,,,4,20,78588572,30780638,78588572,78588572,23609644,54978928,51186747,37468662,3467272,1034143,8331738,468672,416260,3792181,30780638,28268804,2511834,West Region
5,,,1,30,15116205,6724393,15116205,15116205,1794646,13321559,12665776,10784293,925797,30882,777455,3866,143483,655783,6724393,6019252,705141,New England Division
6,,,2,30,42492943,17992123,42492943,42492943,7000222,35492721,34031118,24968705,5282142,81142,3365924,11203,322002,1461603,17992123,16351872,1640251,Middle Atlantic Division
7,,,3,30,47368533,20890027,47368533,47368533,4424621,42943912,41119085,33477559,5595258,144238,1717090,14708,170232,1824827,20890027,18944831,1945196,East North Central Division
8,,,4,30,21616921,9568952,21616921,21616921,1554165,20062756,19123870,16604993,1516295,238538,668601,23314,72129,938886,9568952,8619481,949471,West North Central Division
9,,,5,30,66089734,29133804,66089734,66089734,10147394,55942340,53343314,36365960,13714620,218141,2653826,37539,353228,2599026,29133804,25844334,3289470,South Atlantic Division
10,,,6,30,19402234,8634203,19402234,19402234,1056308,18345926,17632276,13375438,3808696,60757,316368,10705,60312,713650,8634203,7711024,923179,East South Central Division
11,,,7,30,40774139,16774596,40774139,40774139,12493044,28281095,26718068,18652037,5630258,443858,1787717,52011,152187,1563027,16774596,15057982,1716614,West South Central Division
12,,,8,30,24919150,10485244,24919150,24919150,6193275,18725875,17694866,15062974,930550,633666,863077,88309,116290,1031009,10485244,9387091,1098153,Mountain Division
13,,,9,30,53669422,20295394,53669422,53669422,17416369,36253053,33491881,22405688,2536722,400477,7468661,380363,299970,2761172,20295394,18881713,1413681,Pacific Division
14,1.0,,01,40,5024279,2288330,5024279,5024279,264047,4760232,4575614,3171351,1288159,23119,75918,2612,14455,184618,2288330,2011947,276383,Alabama
15,2.0,,02,40,733391,326200,733391,733391,49824,683567,611806,421758,20731,108838,43449,12455,4575,71761,326200,269148,57052,Alaska
16,4.0,,04,40,7151502,3082000,7151502,7151502,2192253,4959249,4692409,3816547,317161,263930,248837,14323,31611,266840,3082000,2705878,376122,Arizona
17,5.0,,05,40,3011524,1365265,3011524,3011524,256847,2754677,2607520,2063550,449884,20549,51210,14280,8047,147157,1365265,1199395,165870,Arkansas
18,6.0,,06,40,39538223,14392140,39538223,39538223,15579652,23958571,22330849,13714587,2119286,156085,5978795,138167,223929,1627722,14392140,13475623,916517,California
19,8.0,,08,40,5773714,2491404,5773714,5773714,1263390,4510324,4249526,3760663,221310,33768,195220,9005,29560,260798,2491404,2257815,233589,Colorado
20,9.0,,09,40,3605944,1530197,3605944,3605944,623293,2982651,2845082,2279232,360937,6404,170459,974,27076,137569,1530197,1418069,112128,Connecticut
21,10.0,,10,40,989948,448735,989948,989948,104290,885658,842635,579851,212960,2521,42398,304,4601,43023,448735,386375,62360,Delaware
22,11.0,,11,40,689545,350364,689545,689545,77652,611893,582408,261771,282066,1277,33192,349,3753,29485,350364,312448,37916,District of Columbia
23,12.0,,12,40,21538187,9865350,21538187,21538187,5697240,15840947,15048804,11100503,3127052,42169,629626,11521,137933,792143,9865350,8529067,1336283,Florida
24,13.0,,13,40,10711908,4410956,10711908,10711908,1123457,9588451,9198318,5362156,3278119,20375,475680,6101,55887,390133,4410956,4020808,390148,Georgia
25,15.0,,15,40,1455271,561066,1455271,1455271,138923,1316348,1024458,314365,21877,2321,531558,149054,5283,291890,561066,490267,70799,Hawaii
26,16.0,,16,40,1839106,751859,1839106,1839106,239407,1599699,1521891,1450523,14785,18903,26036,3401,8243,77808,751859,676206,75653,Idaho
27,17.0,,17,40,12812508,5426429,12812508,12812508,2337410,10475098,10060243,7472751,1775612,16561,747280,2959,45080,414855,5426429,4998395,428034,Illinois
28,18.0,,18,40,6785528,2923175,6785528,6785528,554191,6231337,5965993,5121004,637500,12938,166651,2761,25139,265344,2923175,2667542,255633,Indiana
29,19.0,,19,40,3190369,1412789,3190369,3190369,215986,2974383,2865710,2638201,129321,9079,75017,5605,8487,108673,1412789,1288560,124229,Iowa
30,20.0,,20,40,2937880,1275689,2937880,2937880,382603,2555277,2406252,2122575,163352,21921,85225,3115,10064,149025,1275689,1151360,124329,Kansas
31,21.0,,21,40,4505836,1994323,4505836,4505836,207854,4297982,4122619,3664764,357764,8080,73843,3462,14706,175363,1994323,1797937,196386,Kentucky
32,22.0,,22,40,4657757,2073200,4657757,4657757,322549,4335208,4179112,2596702,1452420,25994,85336,1706,16954,156096,2073200,1831610,241590,Louisiana
33,23.0,,23,40,1362359,739072,1362359,1362359,26609,1335750,1282177,1228264,25115,7293,16668,407,4430,53573,739072,582437,156635,Maine
34,24.0,,24,40,6177224,2530844,6177224,6177224,729745,5447479,5176715,2913782,1795027,12055,417962,2575,35314,270764,2530844,2321208,209636,Maryland
35,25.0,,25,40,7029917,2998537,7029917,7029917,887685,6142232,5813954,4748897,457055,9387,504900,1607,92108,328278,2998537,2749225,249312,Massachusetts
36,26.0,,26,40,10077331,4570173,10077331,10077331,564422,9512909,9073589,7295651,1358458,47406,332288,2603,37183,439320,4570173,4041760,528413,Michigan
37,27.0,,27,40,5706494,2485558,5706494,5706494,345640,5360854,5124820,4353880,392850,57046,297460,2621,20963,236034,2485558,2253990,231568,Minnesota
38,28.0,,28,40,2961279,1319945,2961279,2961279,105220,2856059,2772613,1639077,1079001,14019,32305,1037,7174,83446,1319945,1158193,161752,Mississippi
39,29.0,,29,40,6154913,2786621,6154913,6154913,303068,5851845,5544005,4663907,692774,23496,132158,9293,22377,307840,2786621,2479146,307475,Missouri
40,30.0,,30,40,1084225,514803,1084225,1084225,45199,1039026,984277,901318,5077,64592,8077,839,4374,54749,514803,447812,66991,Montana
41,31.0,,31,40,1961504,844278,1961504,1961504,234715,1726789,1654155,1484687,94405,15051,52359,1318,6335,72634,844278,773312,70966,Nebraska
42,32.0,,32,40,3104614,1281018,3104614,3104614,890257,2214357,2047436,1425952,291960,23392,265991,22970,17171,166921,1281018,1177649,103369,Nevada
43,33.0,,33,40,1377529,638795,1377529,1377529,59454,1318075,1263511,1200649,18655,2299,35604,388,5916,54564,638795,556357,82438,New Hampshire
44,34.0,,34,40,9288994,3761229,9288994,9288994,2002575,7286419,6996948,4816381,1154142,11206,942921,1944,70354,289471,3761229,3426102,335127,New Jersey
45,35.0,,35,40,2117522,940859,2117522,2117522,1010811,1106711,1046944,772952,38330,188610,35261,1451,10340,59767,940859,829514,111345,New Mexico
46,36.0,,36,40,20201249,8488066,20201249,20201249,3948032,16253217,15532370,10598907,2759022,54908,1916329,6097,197107,720847,8488066,7715172,772894,New York
47,37.0,,37,40,10439388,4708710,10439388,10439388,1118596,9320792,8913939,6312148,2107526,100886,340059,6980,46340,406853,4708710,4160856,547854,North Carolina
48,38.0,,38,40,779094,370642,779094,779094,33412,745682,715434,636160,26152,37350,13050,869,1853,30248,370642,322553,48089,North Dakota
49,39.0,,39,40,11799448,5242524,11799448,11799448,521308,11278140,10776578,8954135,1457180,18949,296604,4493,45217,501562,5242524,4808773,433751,Ohio
50,40.0,,40,40,3959353,1746807,3959353,3959353,471931,3487422,3113743,2407188,283242,311890,89653,8168,13602,373679,1746807,1535830,210977,Oklahoma
51,41.0,,41,40,4237256,1813747,4237256,4237256,588757,3648499,3389814,3036158,78658,42042,191797,18197,22962,258685,1813747,1671983,141764,Oregon
52,42.0,,42,40,13002700,5742828,13002700,13002700,1049615,11953085,11501800,9553417,1368978,15028,506674,3162,54541,451285,5742828,5210598,532230,Pennsylvania
53,44.0,,44,40,1097379,483474,1097379,1097379,182101,915278,863028,754050,55386,3513,38367,320,11392,52250,483474,441274,42200,Rhode Island
54,45.0,,45,40,5118425,2344963,5118425,5118425,352838,4765587,4576007,3178552,1269031,16591,89394,3085,19354,189580,2344963,2048912,296051,South Carolina
55,46.0,,46,40,886667,393375,886667,886667,38741,847926,813494,705583,17441,74595,13332,493,2050,34432,393375,350560,42815,South Dakota
56,47.0,,47,40,6910840,3031605,6910840,6910840,479187,6431653,6161430,4900246,1083772,15539,134302,3594,23977,270223,3031605,2742947,288658,Tennessee
57,48.0,,48,40,29145505,11589324,29145505,29145505,11441717,17703788,16817693,11584597,3444712,85425,1561518,27857,113584,886095,11589324,10491147,1098177,Texas
58,49.0,,49,40,3271616,1151414,3271616,3271616,492912,2778704,2658252,2465355,37192,28690,78618,35831,12566,120452,1151414,1057252,94162,Utah
59,50.0,,50,40,643077,334318,643077,643077,15504,627573,598024,573201,8649,1986,11457,170,2561,29549,334318,271890,62428,Vermont
60,51.0,,51,40,8631393,3618247,8631393,8631393,908749,7722644,7317734,5058363,1578090,19080,610612,6195,45394,404910,3618247,3321218,297029,Virginia
61,53.0,,53,40,7705281,3202241,7705281,7705281,1059213,6646068,6134954,4918820,296170,91191,723062,62490,43221,511114,3202241,2974692,227549,Washington
62,54.0,,54,40,1793716,855635,1793716,1793716,34827,1758889,1686754,1598834,64749,3187,14903,429,4652,72135,855635,743442,112193,West Virginia
63,55.0,,55,40,5893718,2727726,5893718,5893718,447290,5446428,5242682,4634018,366508,48384,174267,1892,17613,203746,2727726,2428361,299365,Wisconsin
64,56.0,,56,40,576851,271887,576851,576851,59046,517805,494131,469664,4735,11781,5037,489,2425,23674,271887,234965,36922,Wyoming
65,72.0,,72,40,3285874,1598159,3285874,3285874,3249043,36831,34491,24548,4286,312,2746,91,2508,2340,1598159,1340534,257625,Puerto Rico
66,,,0010,250,3230,1152,3230,3230,81,3149,3099,66,9,3020,4,0,0,50,1152,870,282,Acoma Pueblo and Off-Reservation Trust Land
67,,,0020,250,27090,25233,27090,27090,4426,22664,21779,19727,727,214,968,42,101,885,25233,15636,9597,Agua Caliente Indian Reservation and Off-Reservation Trust Land
68,,,0050,250,679,242,679,679,56,623,603,38,1,562,0,0,2,20,242,225,17,Alabama-Coushatta Reservation and Off-Reservation Trust Land
69,,,0080,250,6664,3245,6664,6664,266,6398,5778,3830,68,1847,21,0,12,620,3245,2786,459,Allegany Reservation
70,,,0095,250,3,1,3,3,1,2,1,0,0,1,0,0,0,1,1,1,0,Alturas Indian Rancheria
71,,,0110,250,1562,625,1562,1562,46,1516,1320,151,4,1161,0,4,0,196,625,560,65,Annette Island Reserve
72,,,0115,250,202,78,202,202,18,184,157,38,2,117,0,0,0,27,78,78,0,Aroostook Band of Micmac Trust Land
73,,,0120,250,2,2,2,2,0,2,1,0,1,0,0,0,0,1,2,0,2,Auburn Rancheria and Off-Reservation Trust Land
74,,,0125,250,0,0,0,0,0,0,0,0,0,0,0,0,0,0,0,0,0,Augustine Reservation
75,,,0140,250,1545,625,1545,1545,67,1478,1420,294,4,1121,0,1,0,58,625,551,74,Bad River Reservation
76,,,0155,250,756,255,756,756,114,642,601,80,1,516,4,0,0,41,255,249,6,Barona Reservation and Off-Reservation Trust Land
77,,,0165,250,142,65,142,142,29,113,108,10,0,96,0,1,1,5,65,49,16,Battle Mountain Reservation and Off-Reservation Trust Land
78,,,0170,250,1032,407,1032,1032,17,1015,910,148,5,756,1,0,0,105,407,378,29,Bay Mills Reservation and Off-Reservation Trust Land
79,,,0185,250,84,33,84,84,11,73,66,43,0,21,0,0,2,7,33,28,5,Benton Paiute Reservation and Off-Reservation Trust Land
80,,,0200,250,153,49,153,153,43,110,87,22,3,61,1,0,0,23,49,46,3,Berry Creek Rancheria and Off-Reservation Trust Land
81,,,0215,250,5,2,5,5,2,3,3,1,0,2,0,0,0,0,2,2,0,Big Bend Rancheria
82,,,0225,250,239,148,239,239,93,146,132,66,12,53,1,0,0,14,148,135,13,Big Cypress Reservation
83,,,0240,250,17,7,17,17,0,17,17,0,0,17,0,0,0,0,7,7,0,Big Lagoon Rancheria
84,,,0250,250,571,221,571,571,63,508,473,58,0,413,2,0,0,35,221,199,22,Big Pine Reservation and Off-Reservation Trust Land
85,,,0265,250,175,47,175,175,33,142,138,8,0,130,0,0,0,4,47,45,2,Big Sandy Rancheria and Off-Reservation Trust Land
86,,,0275,250,191,58,191,191,24,167,158,11,0,145,0,1,1,9,58,50,8,Big Valley Rancheria
87,,,0290,250,1907,693,1907,1907,387,1520,1436,223,0,1200,4,3,6,84,693,649,44,Bishop Reservation
88,,,0305,250,10764,3630,10764,10764,207,10557,10130,1190,10,8903,13,11,3,427,3630,3166,464,Blackfeet Indian Reservation and Off-Reservation Trust Land
89,,,0325,250,112,45,112,112,7,105,81,51,1,29,0,0,0,24,45,45,0,Blue Lake Rancheria and Off-Reservation Trust Land
90,,,0335,250,984,541,984,984,22,962,899,224,1,674,0,0,0,63,541,368,173,Bois Forte Reservation and Off-Reservation Trust Land
91,,,0350,250,46,26,46,46,11,35,31,15,2,14,0,0,0,4,26,18,8,Bridgeport Reservation and Off-Reservation Trust Land
92,,,0360,250,438,242,438,438,84,354,324,134,40,148,0,0,2,30,242,133,109,Brighton Reservation
93,,,0400,250,133,52,133,133,15,118,97,1,0,96,0,0,0,21,52,43,9,Burns Paiute Indian Colony and Off-Reservation Trust Land
94,,,0415,250,192,38,192,192,58,134,129,63,17,21,25,0,3,5,38,27,11,Cabazon Reservation
95,,,0435,250,229,63,229,229,11,218,217,9,3,204,1,0,0,1,63,63,0,Cahuilla Reservation
96,,,0440,250,291,97,291,291,32,259,231,38,15,177,0,1,0,28,97,91,6,Campbell Ranch
97,,,0450,250,398,133,398,398,84,314,288,63,6,219,0,0,0,26,133,129,4,Campo Indian Reservation
98,,,0495,250,0,0,0,0,0,0,0,0,0,0,0,0,0,0,0,0,0,Capitan Grande Reservation
99,,,0510,250,238,84,238,238,16,222,211,19,0,192,0,0,0,11,84,82,2,Carson Colony
100,,,0525,250,849,320,849,849,32,817,715,160,2,552,0,0,1,102,320,299,21,Catawba Reservation and Off-Reservation Trust Land
101,,,0540,250,2676,1192,2676,2676,92,2584,2438,774,38,1617,0,3,6,146,1192,1032,160,Cattaraugus Reservation
102,,,0555,250,19,10,19,19,1,18,18,8,0,10,0,0,0,0,10,10,0,Cedarville Rancheria and Off-Reservation Trust Land
103,,,0560,250,85,19,85,85,3,82,81,1,0,78,0,0,2,1,19,17,2,Celilo Village
104,,,0575,250,767,251,767,767,51,716,674,188,12,473,0,1,0,42,251,237,14,Chehalis Reservation and Off-Reservation Trust Land
105,,,0585,250,464,723,464,464,72,392,377,122,1,245,4,4,1,15,723,194,529,Chemehuevi Reservation
106,,,0605,250,7639,2798,7639,7639,114,7525,7249,1239,9,5983,9,3,6,276,2798,2437,361,Cheyenne River Reservation and Off-Reservation Trust Land
107,,,0620,250,4,1,4,4,4,0,0,0,0,0,0,0,0,0,1,0,1,Chicken Ranch Rancheria and Off-Reservation Trust Land
108,,,0635,250,644,250,644,644,15,629,594,180,8,404,0,0,2,35,250,250,0,Chitimacha Reservation
109,,,0680,250,1517,681,1517,1517,428,1089,1053,329,6,705,9,0,4,36,681,600,81,Pueblo de Cochiti
110,,,0690,250,0,0,0,0,0,0,0,0,0,0,0,0,0,0,0,0,0,Coconut Creek Trust Land
111,,,0695,250,857,685,857,857,104,753,722,285,8,427,0,0,2,31,685,342,343,Cocopah Reservation
112,,,0705,250,7567,4728,7567,7567,279,7288,6929,5638,9,1197,21,7,57,359,4728,3016,1712,Coeur d'Alene Reservation
113,,,0720,250,79,31,79,79,16,63,56,27,0,29,0,0,0,7,31,31,0,Cold Springs Rancheria
114,,,0735,250,8431,5306,8431,8431,2861,5570,5250,2774,72,2332,57,8,7,320,5306,3037,2269,Colorado River Indian Reservation
115,,,0750,250,91,24,91,91,2,89,88,5,0,83,0,0,0,1,24,23,1,Colusa Rancheria
116,,,0760,250,7807,3118,7807,7807,850,6957,6546,1751,12,4708,29,7,39,411,3118,2756,362,Colville Reservation and Off-Reservation Trust Land
117,,,0770,250,77,33,77,77,5,72,63,21,0,42,0,0,0,9,33,33,0,"Coos, Lower Umpqua, and Siuslaw Reservation and Off-Reservation Trust Land"
118,,,0775,250,343,174,343,343,7,336,293,168,0,125,0,0,0,43,174,169,5,Coquille Reservation
119,,,0780,250,8,3,8,8,1,7,5,0,0,4,1,0,0,2,3,3,0,Cortina Indian Rancheria
120,,,0795,250,94,35,94,94,11,83,62,21,3,38,0,0,0,21,35,35,0,Coushatta Reservation and Off-Reservation Trust Land
121,,,0815,250,229,90,229,229,10,219,202,141,0,61,0,0,0,17,90,89,1,Cow Creek Reservation and Off-Reservation Trust Land
122,,,0820,250,0,0,0,0,0,0,0,0,0,0,0,0,0,0,0,0,0,Cowlitz Reservation
123,,,0825,250,126,41,126,126,13,113,103,3,0,99,1,0,0,10,41,41,0,Coyote Valley Reservation
124,,,0845,250,6974,2163,6974,6974,112,6862,6657,1237,4,5402,8,5,1,205,2163,1917,246,Crow Reservation and Off-Reservation Trust Land
125,,,0855,250,2054,570,2054,2054,22,2032,1961,160,2,1795,3,1,0,71,570,508,62,Crow Creek Reservation
126,,,0940,250,403,141,403,403,24,379,364,11,0,352,1,0,0,15,141,134,7,Dresslerville Colony
127,,,0955,250,0,0,0,0,0,0,0,0,0,0,0,0,0,0,0,0,0,Dry Creek Rancheria and Off-Reservation Trust Land
128,,,0965,250,1338,527,1338,1338,47,1291,1256,54,3,1185,3,9,2,35,527,482,45,Duck Valley Reservation
129,,,0975,250,159,75,159,159,14,145,135,14,1,119,1,0,0,10,75,68,7,Duckwater Reservation
130,,,0990,250,9233,3802,9233,9233,528,8705,8121,1129,50,6882,46,2,12,584,3802,3306,496,Eastern Cherokee Reservation
131,,,1005,250,723,282,723,723,111,612,583,36,0,544,0,2,1,29,282,267,15,Elko Colony
132,,,1010,250,100,38,100,100,9,91,84,32,0,52,0,0,0,7,38,27,11,Elk Valley Rancheria and Off-Reservation Trust Land
133,,,1040,250,240,87,240,240,31,209,175,28,0,144,3,0,0,34,87,73,14,Ely Reservation
134,,,1055,250,4,6,4,4,4,0,0,0,0,0,0,0,0,0,6,5,1,Enterprise Rancheria and Off-Reservation Trust Land
135,,,1065,250,5,1,5,5,2,3,2,1,0,1,0,0,0,1,1,1,0,Ewiiaapaayp Reservation
136,,,1070,250,98,45,98,98,5,93,85,8,0,77,0,0,0,8,45,40,5,Fallon Paiute-Shoshone Colony and Off-Reservation Trust Land
137,,,1075,250,672,268,672,672,42,630,570,83,0,487,0,0,0,60,268,249,19,Fallon Paiute-Shoshone Reservation and Off-Reservation Trust Land
138,,,1100,250,415,160,415,415,6,409,338,15,2,318,3,0,0,71,160,142,18,Flandreau Reservation
139,,,1110,250,30849,15422,30849,30849,1162,29687,26942,19254,75,7336,141,23,113,2745,15422,12351,3071,Flathead Reservation
140,,,1125,250,4184,1713,4184,4184,102,4082,3793,2069,18,1697,5,0,4,289,1713,1497,216,Fond du Lac Reservation and Off-Reservation Trust Land
141,,,1135,250,594,212,594,594,26,568,536,86,2,446,0,2,0,32,212,192,20,Forest County Potawatomi Community and Off-Reservation Trust Land
142,,,1140,250,14340,3977,14340,14340,173,14167,14033,174,15,13766,68,3,7,134,3977,3473,504,Fort Apache Reservation
143,,,1150,250,3382,1075,3382,3382,76,3306,3224,123,8,3086,4,0,3,82,1075,999,76,Fort Belknap Reservation and Off-Reservation Trust Land
144,,,1160,250,8350,4116,8350,8350,528,7822,7300,1753,104,5345,84,0,14,522,4116,2861,1255,Fort Berthold Reservation
145,,,1170,250,97,59,97,97,14,83,78,13,0,65,0,0,0,5,59,50,9,Fort Bidwell Reservation and Off-Reservation Trust Land
146,,,1185,250,5977,2094,5977,5977,579,5398,5230,1500,1,3689,14,3,23,168,2094,1924,170,Fort Hall Reservation and Off-Reservation Trust Land
147,,,1195,250,94,50,94,94,11,83,56,21,0,30,4,1,0,27,50,40,10,Fort Independence Reservation
148,,,1210,250,267,112,267,267,9,258,252,3,0,249,0,0,0,6,112,96,16,Fort McDermitt Indian Reservation
149,,,1220,250,1152,347,1152,1152,156,996,947,70,2,875,0,0,0,49,347,330,17,Fort McDowell Yavapai Nation Reservation
150,,,1235,250,1697,757,1697,1697,314,1383,1300,579,7,684,5,11,14,83,757,659,98,Fort Mojave Reservation and Off-Reservation Trust Land
151,,,1250,250,9988,3582,9988,9988,226,9762,9115,2531,28,6487,51,0,18,647,3582,3218,364,Fort Peck Indian Reservation and Off-Reservation Trust Land
152,,,1260,250,52,28,52,52,4,48,44,0,8,35,1,0,0,4,28,17,11,Fort Pierce Reservation
153,,,1270,250,0,0,0,0,0,0,0,0,0,0,0,0,0,0,0,0,0,Fort Sill Apache Indian Reservation
154,,,1280,250,1898,718,1898,1898,473,1425,1348,118,5,1208,1,0,16,77,718,610,108,Fort Yuma Indian Reservation
155,,,1310,250,14053,3516,14053,14053,1690,12363,12162,137,23,11991,5,0,6,201,3516,3433,83,Gila River Indian Reservation
156,,,1340,250,116,63,116,116,9,107,101,13,0,86,2,0,0,6,63,36,27,Goshute Reservation
157,,,1355,250,618,328,618,618,11,607,543,150,1,386,5,1,0,64,328,266,62,Grand Portage Reservation and Off-Reservation Trust Land
158,,,1365,250,604,263,604,604,47,557,510,109,1,398,2,0,0,47,263,238,25,Grand Ronde Community and Off-Reservation Trust Land
159,,,1370,250,595,206,595,595,67,528,465,83,2,377,1,0,2,63,206,190,16,Grand Traverse Reservation and Off-Reservation Trust Land
160,,,1380,250,28,16,28,28,12,16,13,1,0,10,0,2,0,3,16,16,0,Greenville Rancheria
161,,,1395,250,188,54,188,188,9,179,172,12,0,160,0,0,0,7,54,52,2,Grindstone Indian Rancheria
162,,,1400,250,63,18,63,63,3,60,52,13,0,39,0,0,0,8,18,17,1,Guidiville Rancheria and Off-Reservation Trust Land
163,,,1410,250,720,262,720,720,17,703,628,92,0,536,0,0,0,75,262,253,9,Hannahville Indian Community and Off-Reservation Trust Land
164,,,1440,250,214,47,214,214,10,204,200,19,5,175,0,1,0,4,47,47,0,Havasupai Reservation
165,,,1450,250,1577,551,1577,1577,94,1483,1365,108,13,1242,0,1,1,118,551,460,91,Ho-Chunk Nation Reservation and Off-Reservation Trust Land
166,,,1460,250,93,27,93,93,10,83,73,4,0,69,0,0,0,10,27,22,5,Hoh Indian Reservation and Off-Reservation Trust Land
167,,,1475,250,1426,781,1426,1426,439,987,932,493,62,328,46,0,3,55,781,605,176,Hollywood Reservation
168,,,1490,250,3173,1044,3173,3173,131,3042,2875,261,1,2603,3,0,7,167,1044,999,45,Hoopa Valley Reservation
169,,,1505,250,6377,2483,6377,6377,62,6315,6265,84,14,6139,25,0,3,50,2483,1897,586,Hopi Reservation and Off-Reservation Trust Land
170,,,1515,250,249,80,249,249,43,206,194,29,1,164,0,0,0,12,80,80,0,Hopland Rancheria
171,,,1530,250,226,89,226,226,10,216,200,38,2,160,0,0,0,16,89,89,0,Houlton Maliseet Reservation and Off-Reservation Trust Land
172,,,1545,250,1299,405,1299,1299,70,1229,1215,18,5,1185,4,0,3,14,405,345,60,Hualapai Indian Reservation and Off-Reservation Trust Land
173,,,1550,250,62,26,62,62,2,60,53,17,3,28,0,0,5,7,26,26,0,Huron Potawatomi Reservation and Off-Reservation Trust Land
174,,,1555,250,197,69,197,197,93,104,84,10,29,42,1,0,2,20,69,69,0,Immokalee Reservation
175,,,1560,250,0,0,0,0,0,0,0,0,0,0,0,0,0,0,0,0,0,Inaja and Cosmit Reservation
176,,,1575,250,760,298,760,760,15,745,694,78,0,612,0,0,4,51,298,273,25,Indian Township Reservation
177,,,1590,250,181,81,181,181,5,176,155,58,0,97,0,0,0,21,81,69,12,Iowa (KS-NE) Reservation and Off-Reservation Trust Land
178,,,1610,250,25534,11532,25534,25534,1176,24358,23028,20921,327,1466,228,11,75,1330,11532,10456,1076,Isabella Reservation and Off-Reservation Trust Land
179,,,1625,250,3376,1387,3376,3376,422,2954,2882,87,4,2771,6,2,12,72,1387,1271,116,Isleta Pueblo
180,,,1640,250,0,0,0,0,0,0,0,0,0,0,0,0,0,0,0,0,0,Jackson Rancheria
181,,,1655,250,36,17,36,36,5,31,21,4,3,13,1,0,0,10,17,13,4,Jamestown S'Klallam Reservation and Off-Reservation Trust Land
182,,,1670,250,0,0,0,0,0,0,0,0,0,0,0,0,0,0,0,0,0,Jamul Indian Village
183,,,1685,250,1991,556,1991,1991,18,1973,1956,2,0,1953,1,0,0,17,556,527,29,Jemez Pueblo
184,,,1690,250,26,17,26,26,0,26,16,6,1,6,0,2,1,10,17,17,0,Jena Band of Choctaw Reservation
185,,,1700,250,3494,1384,3494,3494,405,3089,3034,54,27,2882,47,1,23,55,1384,1129,255,Jicarilla Apache Nation Reservation and Off-Reservation Trust Land
186,,,1720,250,221,99,221,221,14,207,200,18,6,175,0,0,1,7,99,78,21,Kaibab Indian Reservation
187,,,1735,250,753,288,753,753,89,664,569,322,11,194,9,32,1,95,288,286,2,Kalispel Reservation and Off-Reservation Trust Land
188,,,1750,250,578,209,578,578,52,526,467,43,0,423,0,0,1,59,209,196,13,Karuk Reservation and Off-Reservation Trust Land
189,,,1770,250,3849,1794,3849,3849,169,3680,3484,2837,28,597,9,6,7,196,1794,1467,327,Kickapoo (KS) Reservation
190,,,1775,250,377,120,377,377,23,354,350,6,0,344,0,0,0,4,120,113,7,Kickapoo (TX) Reservation and Off-Reservation Trust Land
191,,,1785,250,25,21,25,25,4,21,16,0,1,15,0,0,0,5,21,14,7,Klamath Reservation
192,,,1800,250,92,35,92,92,10,82,74,2,0,72,0,0,0,8,35,22,13,Kootenai Reservation and Off-Reservation Trust Land
193,,,1815,250,2968,2102,2968,2968,49,2919,2755,630,7,2111,0,2,5,164,2102,1110,992,Lac Courte Oreilles Reservation and Off-Reservation Trust Land
194,,,1825,250,3518,3202,3518,3518,96,3422,3314,1303,7,2001,0,0,3,108,3202,1340,1862,Lac du Flambeau Reservation
195,,,1830,250,221,82,221,221,3,218,207,15,1,188,0,0,3,11,82,78,4,Lac Vieux Desert Reservation
196,,,1840,250,3985,1327,3985,3985,149,3836,3789,22,0,3628,2,6,131,47,1327,1182,145,Laguna Pueblo and Off-Reservation Trust Land
197,,,1850,250,145,64,145,145,36,109,103,19,0,83,1,0,0,6,64,64,0,La Jolla Reservation
198,,,1860,250,11043,5279,11043,11043,426,10617,10131,5422,35,4621,34,0,19,486,5279,4005,1274,Lake Traverse Reservation and Off-Reservation Trust Land
199,,,1880,250,3396,1844,3396,3396,39,3357,2983,1983,5,979,0,1,15,374,1844,1473,371,L'Anse Reservation and Off-Reservation Trust Land
200,,,1895,250,50,12,50,50,11,39,28,7,1,20,0,0,0,11,12,12,0,La Posta Indian Reservation
201,,,1915,250,106,32,106,106,15,91,84,11,5,67,1,0,0,7,32,29,3,Las Vegas Indian Colony
202,,,1925,250,154,53,154,154,5,149,144,9,0,135,0,0,0,5,53,46,7,Laytonville Rancheria
203,,,1940,250,11388,7229,11388,11388,199,11189,10523,5592,17,4875,15,0,24,666,7229,4226,3003,Leech Lake Reservation and Off-Reservation Trust Land
204,,,1955,250,0,0,0,0,0,0,0,0,0,0,0,0,0,0,0,0,0,Likely Rancheria
205,,,1960,250,226,102,226,226,9,217,183,64,7,109,0,0,3,34,102,92,10,Little River Reservation and Off-Reservation Trust Land
206,,,1963,250,92,41,92,92,6,86,71,20,0,49,0,1,1,15,41,41,0,Little Traverse Bay Reservation and Off-Reservation Trust Land
207,,,1970,250,242,106,242,242,15,227,220,26,0,193,1,0,0,7,106,106,0,Lone Pine Reservation
208,,,1980,250,11,4,11,11,4,7,6,1,0,5,0,0,0,1,4,4,0,Lookout Rancheria
209,,,1995,250,15,27,15,15,7,8,8,2,1,3,2,0,0,0,27,6,21,Los Coyotes Reservation
210,,,2015,250,95,37,95,95,12,83,76,16,0,60,0,0,0,7,37,28,9,Lovelock Indian Colony
211,,,2030,250,1630,419,1630,1630,24,1606,1570,40,1,1524,4,1,0,36,419,388,31,Lower Brule Reservation and Off-Reservation Trust Land
212,,,2040,250,680,245,680,680,45,635,565,71,3,484,7,0,0,70,245,230,15,Lower Elwha Reservation and Off-Reservation Trust Land
213,,,2055,250,534,154,534,534,54,480,440,45,1,393,0,0,1,40,154,153,1,Lower Sioux Indian Community
214,,,2070,250,5748,2368,5748,5748,359,5389,5052,2155,32,2789,51,7,18,337,2368,1989,379,Lummi Reservation
215,,,2075,250,0,0,0,0,0,0,0,0,0,0,0,0,0,0,0,0,0,Lytton Rancheria
216,,,2085,250,1692,616,1692,1692,148,1544,1441,121,4,1306,7,3,0,103,616,596,20,Makah Indian Reservation
217,,,2100,250,188,67,188,188,58,130,120,20,0,100,0,0,0,10,67,62,5,Manchester-Point Arena Rancheria
218,,,2115,250,101,36,101,101,4,97,95,5,0,89,1,0,0,2,36,36,0,Manzanita Reservation and Off-Reservation Trust Land
219,,,2130,250,1070,311,1070,1070,265,805,774,17,8,748,1,0,0,31,311,300,11,Maricopa (Ak Chin) Indian Reservation and Off-Reservation Trust Land
220,,,2145,250,457,142,457,457,29,428,365,39,23,298,3,0,2,63,142,139,3,Mashantucket Pequot Reservation and Off-Reservation Trust Land
221,,,2147,250,3,33,3,3,3,0,0,0,0,0,0,0,0,0,33,33,0,Mashpee Wampanoag Trust Land
222,,,2150,250,18,10,18,18,2,16,7,0,0,7,0,0,0,9,10,10,0,Match-e-be-nash-she-wish Band of Pottawatomi Reservation and Off-Reservation Trust Land
223,,,2175,250,3293,1027,3293,3293,74,3219,3163,115,6,3041,1,0,0,56,1027,947,80,Menominee Reservation and Off-Reservation Trust Land
224,,,2190,250,87,24,87,87,21,66,62,7,0,55,0,0,0,4,24,21,3,Mesa Grande Reservation
225,,,2205,250,4022,1189,4022,4022,425,3597,3540,82,5,3444,5,0,4,57,1189,1136,53,Mescalero Reservation
226,,,2240,250,535,107,535,535,533,2,2,0,0,0,2,0,0,0,107,100,7,Miccosukee Reservation and Off-Reservation Trust Land
227,,,2255,250,33,20,33,33,4,29,27,2,0,25,0,0,0,2,20,20,0,Middletown Rancheria
228,,,2270,250,4767,3208,4767,4767,128,4639,4392,2868,11,1484,15,0,14,247,3208,2027,1181,Mille Lacs Reservation and Off-Reservation Trust Land
229,,,2285,250,8,3,8,8,4,4,1,0,0,1,0,0,0,3,3,2,1,Minnesota Chippewa Trust Land
230,,,2300,250,8080,2194,8080,8080,163,7917,7552,274,156,7120,2,0,0,365,2194,2121,73,Mississippi Choctaw Reservation and Off-Reservation Trust Land
231,,,2315,250,234,97,234,234,37,197,185,15,0,165,5,0,0,12,97,88,9,Moapa River Indian Reservation
232,,,2320,250,212,91,212,212,12,200,184,69,5,104,0,0,6,16,91,71,20,Mohegan Reservation
233,,,2330,250,33,15,33,33,1,32,28,5,0,23,0,0,0,4,15,14,1,Montgomery Creek Rancheria
234,,,2340,250,197,61,197,197,37,160,124,22,3,99,0,0,0,36,61,61,0,Mooretown Rancheria and Off-Reservation Trust Land
235,,,2360,250,1243,442,1243,1243,343,900,822,120,8,668,21,4,1,78,442,379,63,Morongo Reservation and Off-Reservation Trust Land
236,,,2375,250,4391,1510,4391,4391,929,3462,3165,1291,149,1404,198,98,25,297,1510,1437,73,Muckleshoot Reservation and Off-Reservation Trust Land
237,,,2400,250,1840,885,1840,1840,1013,827,773,320,10,422,9,6,6,54,885,805,80,Nambe Pueblo and Off-Reservation Trust Land
238,,,2415,250,0,0,0,0,0,0,0,0,0,0,0,0,0,0,0,0,0,Narragansett Reservation
239,,,2430,250,165158,57479,165158,165158,2745,162413,160060,2585,261,156391,704,51,68,2353,57479,49878,7601,Navajo Nation Reservation and Off-Reservation Trust Land
240,,,2445,250,18403,8674,18403,18403,669,17734,16994,14452,62,2337,66,5,72,740,8674,7433,1241,Nez Perce Reservation
241,,,2460,250,639,193,639,639,70,569,534,134,7,381,8,4,0,35,193,188,5,Nisqually Reservation
242,,,2475,250,876,246,876,876,65,811,657,102,5,541,2,7,0,154,246,231,15,Nooksack Reservation and Off-Reservation Trust Land
243,,,2490,250,4456,1319,4456,4456,115,4341,4192,217,5,3966,3,1,0,149,1319,1164,155,Northern Cheyenne Indian Reservation and Off-Reservation Trust Land
244,,,2495,250,51,15,51,51,8,43,40,4,0,36,0,0,0,3,15,15,0,North Fork Rancheria and Off-Reservation Trust Land
245,,,2505,250,0,0,0,0,0,0,0,0,0,0,0,0,0,0,0,0,0,Northwestern Shoshone Reservation
246,,,2510,250,6580,2594,6580,6580,4376,2204,2113,487,20,1542,38,2,24,91,2594,2447,147,Ohkay Owingeh
247,,,2535,250,20,11,20,20,1,19,15,10,0,1,1,0,3,4,11,7,4,Oil Springs Reservation
248,,,2550,250,4526,1563,4526,4526,187,4339,4275,2117,10,2121,11,3,13,64,1563,1416,147,Omaha Reservation
249,,,2555,250,62877,28843,62877,62877,1212,61665,59046,57463,522,508,376,16,161,2619,28843,26091,2752,Oneida Nation Reservation
250,,,2560,250,27110,10647,27110,27110,1380,25730,24393,19115,394,4173,631,15,65,1337,10647,10237,410,Oneida (WI) Reservation and Off-Reservation Trust Land
251,,,2570,250,831,518,831,831,56,775,769,450,1,277,0,0,41,6,518,501,17,Onondaga Nation Reservation
252,,,2580,250,0,12,0,0,0,0,0,0,0,0,0,0,0,0,12,2,10,Ontonagon Reservation
253,,,2595,250,45818,19602,45818,45818,1872,43946,38887,27443,4796,6405,128,19,96,5059,19602,17554,2048,Osage Reservation
254,,,2625,250,230,94,230,230,25,205,181,9,2,167,1,0,2,24,94,48,46,Paiute (UT) Reservation
255,,,2635,250,1541,475,1541,1541,633,908,854,85,3,758,4,1,3,54,475,445,30,Pala Reservation
256,,,2680,250,3466,892,3466,3466,849,2617,2566,36,8,2518,0,2,2,51,892,865,27,Pascua Pueblo Yaqui Reservation and Off-Reservation Trust Land
257,,,2685,250,6,3,6,6,3,3,2,1,0,0,1,0,0,1,3,3,0,Paskenta Rancheria
258,,,2695,250,4,39,4,4,1,3,1,1,0,0,0,0,0,2,39,10,29,Passamaquoddy Trust Land
259,,,2715,250,179,64,179,179,17,162,162,6,0,151,3,2,0,0,64,62,2,Pauma and Yuima Reservation
260,,,2745,250,582,221,582,582,156,426,399,58,2,331,6,0,2,27,221,196,25,Pechanga Reservation
261,,,2760,250,379,231,379,379,21,358,295,44,0,251,0,0,0,63,231,172,59,Penobscot Reservation and Off-Reservation Trust Land
262,,,2775,250,63,18,63,63,10,53,52,4,0,48,0,0,0,1,18,14,4,Picayune Rancheria and Off-Reservation Trust Land
263,,,2785,250,1623,866,1623,1623,1190,433,405,204,0,185,3,0,13,28,866,703,163,Picuris Pueblo
264,,,2810,250,18850,5141,18850,18850,535,18315,17766,1707,37,15963,51,1,7,549,5141,4751,390,Pine Ridge Reservation
265,,,2820,250,142,46,142,142,32,110,101,19,0,82,0,0,0,9,46,44,2,Pinoleville Rancheria
266,,,2835,250,24,8,24,24,0,24,23,1,0,22,0,0,0,1,8,8,0,Pit River Trust Land
267,,,2850,250,692,300,692,692,20,672,591,275,0,313,0,0,3,81,300,287,13,Pleasant Point Reservation
268,,,2865,250,287,126,287,287,11,276,260,73,6,181,0,0,0,16,126,110,16,Poarch Creek Reservation and Off-Reservation Trust Land
269,,,2890,250,202,84,202,202,8,194,154,34,5,112,0,0,3,40,84,84,0,Pokagon Reservation and Off-Reservation Trust Land
270,,,2900,250,8,2,8,8,2,6,3,0,0,3,0,0,0,3,2,0,2,Ponca (NE) Trust Land
271,,,2910,250,750,218,750,750,45,705,664,72,2,586,4,0,0,41,218,214,4,Port Gamble Reservation and Off-Reservation Trust Land
272,,,2925,250,7929,3626,7929,7929,501,7428,6816,5812,51,689,193,22,49,612,3626,3251,375,Port Madison Reservation
273,,,2980,250,1529,575,1529,1529,104,1425,1250,502,0,742,0,5,1,175,575,498,77,Prairie Band of Potawatomi Nation Reservation
274,,,2985,250,310,115,310,310,32,278,253,20,4,225,2,0,2,25,115,107,8,Prairie Island Indian Community and Off-Reservation Trust Land
275,,,2990,250,3536,1649,3536,3536,2227,1309,1232,807,13,372,18,2,20,77,1649,1495,154,Pueblo of Pojoaque and Off-Reservation Trust Land
276,,,3000,250,54416,20235,54416,54416,7827,46589,41860,27433,4253,1235,6936,1721,282,4729,20235,19435,800,Puyallup Reservation and Off-Reservation Trust Land
277,,,3010,250,1933,746,1933,1933,167,1766,1680,327,7,1335,6,5,0,86,746,690,56,Pyramid Lake Paiute Reservation
278,,,3020,250,202,83,202,202,7,195,181,74,0,106,1,0,0,14,83,74,9,Quartz Valley Reservation and Off-Reservation Trust Land
279,,,3030,250,404,157,404,404,28,376,352,33,1,316,1,1,0,24,157,147,10,Quileute Reservation
280,,,3040,250,1520,478,1520,1520,128,1392,1335,144,11,1176,4,0,0,57,478,413,65,Quinault Reservation
281,,,3070,250,0,0,0,0,0,0,0,0,0,0,0,0,0,0,0,0,0,Ramona Village
282,,,3085,250,1403,610,1403,1403,76,1327,1265,160,1,1099,1,0,4,62,610,503,107,Red Cliff Reservation and Off-Reservation Trust Land
283,,,3095,250,40,14,40,40,3,37,37,5,0,32,0,0,0,0,14,11,3,Redding Rancheria
284,,,3100,250,5506,1591,5506,5506,100,5406,5343,39,0,5302,1,0,1,63,1591,1492,99,Red Lake Reservation
285,,,3115,250,237,95,237,237,47,190,169,104,0,62,3,0,0,21,95,93,2,Redwood Valley Rancheria
286,,,3130,250,944,306,944,944,80,864,844,13,2,824,4,1,0,20,306,275,31,Reno-Sparks Indian Colony and Off-Reservation Trust Land
287,,,3145,250,33,14,33,33,9,24,21,8,0,13,0,0,0,3,14,6,8,Resighini Rancheria
288,,,3165,250,1095,365,1095,1095,545,550,526,66,0,440,5,13,2,24,365,343,22,Rincon Reservation and Off-Reservation Trust Land
289,,,3185,250,19,5,19,19,1,18,16,1,0,15,0,0,0,2,5,5,0,Roaring Creek Rancheria
290,,,3195,250,233,63,233,233,27,206,197,7,0,188,0,1,1,9,63,63,0,Robinson Rancheria and Off-Reservation Trust Land
291,,,3205,250,3639,916,3639,3639,113,3526,3471,44,0,3427,0,0,0,55,916,887,29,Rocky Boy's Reservation and Off-Reservation Trust Land
292,,,3220,250,208,48,208,208,18,190,158,38,3,112,0,0,5,32,48,48,0,Rohnerville (Rancheria) Trust Land
293,,,3235,250,10570,3213,10570,10570,246,10324,10009,753,10,9199,47,0,0,315,3213,2871,342,Rosebud Indian Reservation and Off-Reservation Trust Land
294,,,3250,250,454,149,454,454,57,397,369,59,0,310,0,0,0,28,149,142,7,Round Valley Reservation and Off-Reservation Trust Land
295,,,3265,250,41,31,41,41,19,22,14,14,0,0,0,0,0,8,31,14,17,Rumsey Indian Rancheria
296,,,3280,250,1142,345,1142,1142,100,1042,944,33,2,904,2,0,3,98,345,301,44,Sac and Fox/Meskwaki Settlement and Off-Reservation Trust Land
297,,,3285,250,168,88,168,168,11,157,147,102,0,45,0,0,0,10,88,69,19,Sac and Fox Nation Reservation and Off-Reservation Trust Land
298,,,3305,250,765,277,765,765,5,760,651,85,2,563,0,1,0,109,277,259,18,St. Croix Reservation and Off-Reservation Trust Land
299,,,3320,250,3663,1370,3663,3663,30,3633,3569,129,2,3438,0,0,0,64,1370,1313,57,St. Regis Mohawk Reservation
300,,,3340,250,6321,2041,6321,6321,1046,5275,5084,805,32,4228,11,2,6,191,2041,1924,117,Salt River Reservation
301,,,3355,250,10251,2545,10251,10251,228,10023,9948,73,4,9860,0,6,5,75,2545,2387,158,San Carlos Reservation
302,,,3370,250,4738,1855,4738,4738,3377,1361,1271,630,16,592,10,1,22,90,1855,1727,128,Sandia Pueblo
303,,,3400,250,3686,935,3686,3686,523,3163,3136,196,9,2922,4,1,4,27,935,910,25,San Felipe Pueblo
304,,,3415,250,1819,776,1819,1819,909,910,872,288,2,570,11,0,1,38,776,689,87,San Ildefonso Pueblo and Off-Reservation Trust Land
305,,,3445,250,137,58,137,137,53,84,78,38,0,39,0,0,1,6,58,41,17,San Manuel Reservation and Off-Reservation Trust Land
306,,,3460,250,1270,405,1270,1270,481,789,729,96,6,615,6,0,6,60,405,382,23,San Pasqual Reservation and Off-Reservation Trust Land
307,,,3480,250,684,281,684,684,7,677,673,1,1,668,0,0,3,4,281,191,90,Santa Ana Pueblo
308,,,3495,250,11322,4966,11322,11322,8055,3267,3105,1561,63,1348,94,3,36,162,4966,4596,370,Santa Clara Pueblo and Off-Reservation Trust Land
309,,,3520,250,898,244,898,898,219,679,661,17,0,637,3,0,4,18,244,220,24,Santa Rosa Rancheria
310,,,3525,250,131,36,131,131,14,117,114,6,1,106,1,0,0,3,36,29,7,Santa Rosa Reservation
311,,,3540,250,264,100,264,264,97,167,154,27,5,120,0,0,2,13,100,87,13,Santa Ynez Reservation
312,,,3550,250,263,106,263,263,19,244,244,19,3,222,0,0,0,0,106,102,4,Santa Ysabel Reservation
313,,,3565,250,974,366,974,974,17,957,923,176,0,743,4,0,0,34,366,274,92,Santee Reservation
314,,,3585,250,3160,666,3160,3160,335,2825,2812,11,0,2801,0,0,0,13,666,644,22,Santo Domingo Pueblo
315,,,3625,250,52,20,52,52,5,47,42,6,0,36,0,0,0,5,20,15,5,Sauk-Suiattle Reservation
316,,,3635,250,1757,661,1757,1757,51,1706,1444,431,25,984,3,0,1,262,661,605,56,Sault Ste. Marie Reservation and Off-Reservation Trust Land
317,,,3665,250,0,0,0,0,0,0,0,0,0,0,0,0,0,0,0,0,0,Seminole (FL) Trust Land
318,,,3680,250,779,280,779,779,46,733,656,157,7,474,15,2,1,77,280,273,7,Shakopee Mdewakanton Sioux Community and Off-Reservation Trust Land
319,,,3735,250,208,54,208,208,28,180,154,19,0,134,1,0,0,26,54,43,11,Sherwood Valley Rancheria and Off-Reservation Trust Land
320,,,3750,250,108,47,108,108,20,88,76,10,3,63,0,0,0,12,47,39,8,Shingle Springs Rancheria and Off-Reservation Trust Land
321,,,3780,250,82,41,82,82,5,77,71,16,0,55,0,0,0,6,41,38,3,Shoalwater Bay Indian Reservation and Off-Reservation Trust Land
322,,,3795,250,685,231,685,685,59,626,555,87,0,463,0,5,0,71,231,218,13,Siletz Reservation and Off-Reservation Trust Land
323,,,3825,250,724,290,724,724,32,692,629,155,2,460,4,5,3,63,290,227,63,Skokomish Reservation and Off-Reservation Trust Land
324,,,3840,250,13,6,13,13,0,13,12,0,0,12,0,0,0,1,6,4,2,Skull Valley Reservation
325,,,3855,250,160,79,160,160,5,155,145,29,0,116,0,0,0,10,79,63,16,Smith River Rancheria and Off-Reservation Trust Land
326,,,3860,250,0,0,0,0,0,0,0,0,0,0,0,0,0,0,0,0,0,Snoqualmie Reservation and Off-Reservation Trust Land
327,,,3870,250,567,174,567,567,81,486,473,21,0,447,3,0,2,13,174,158,16,Soboba Reservation and Off-Reservation Trust Land
328,,,3885,250,507,194,507,507,19,488,442,67,0,375,0,0,0,46,194,189,5,Sokaogon Chippewa Community and Off-Reservation Trust Land
329,,,3925,250,12321,5786,12321,12321,2017,10304,9782,8260,20,1378,48,7,69,522,5786,5034,752,Southern Ute Reservation
330,,,3930,250,98,58,98,98,3,95,91,17,2,72,0,0,0,4,58,46,12,South Fork Reservation and Off-Reservation Trust Land
331,,,3935,250,3787,1230,3787,3787,49,3738,3653,533,2,3109,7,0,2,85,1230,998,232,Spirit Lake Reservation
332,,,3940,250,2541,910,2541,2541,98,2443,2282,322,8,1944,4,0,4,161,910,866,44,Spokane Reservation and Off-Reservation Trust Land
333,,,3955,250,509,174,509,509,44,465,354,85,2,263,1,0,3,111,174,161,13,Squaxin Island Reservation and Off-Reservation Trust Land
334,,,3970,250,7819,2648,7819,7819,111,7708,7389,1372,9,5986,22,0,0,319,2648,2299,349,Standing Rock Reservation
335,,,3980,250,196,64,196,196,21,175,166,24,0,141,0,1,0,9,64,63,1,Stewart Community
336,,,3985,250,86,19,86,86,4,82,73,0,0,72,0,0,1,9,19,19,0,Stewarts Point Rancheria and Off-Reservation Trust Land
337,,,4000,250,16,7,16,16,0,16,9,3,0,6,0,0,0,7,7,2,5,Stillaguamish Reservation and Off-Reservation Trust Land
338,,,4015,250,733,321,733,733,21,712,641,82,1,558,0,0,0,71,321,285,36,Stockbridge Munsee Community and Off-Reservation Trust Land
339,,,4030,250,46,14,46,46,3,43,41,0,0,40,0,0,1,2,14,13,1,Sulphur Bank Rancheria
340,,,4045,250,0,2,0,0,0,0,0,0,0,0,0,0,0,0,2,0,2,Summit Lake Reservation and Off-Reservation Trust Land
341,,,4060,250,570,226,570,570,61,509,481,226,23,232,0,0,0,28,226,220,6,Susanville Indian Rancheria and Off-Reservation Trust Land
342,,,4075,250,3228,1569,3228,3228,114,3114,2939,2153,20,711,41,3,11,175,1569,1378,191,Swinomish Reservation and Off-Reservation Trust Land
343,,,4090,250,218,73,218,218,57,161,127,24,9,87,4,3,0,34,73,73,0,Sycuan Reservation and Off-Reservation Trust Land
344,,,4095,250,120,38,120,120,8,112,105,13,1,91,0,0,0,7,38,38,0,Table Bluff Reservation
345,,,4110,250,24,16,24,24,5,19,17,17,0,0,0,0,0,2,16,8,8,Table Mountain Rancheria and Off-Reservation Trust Land
346,,,4130,250,0,0,0,0,0,0,0,0,0,0,0,0,0,0,0,0,0,Tampa Reservation
347,,,4140,250,4704,2707,4704,4704,1636,3068,2932,1724,16,1139,21,0,32,136,2707,2220,487,Taos Pueblo and Off-Reservation Trust Land
348,,,4170,250,1173,418,1173,1173,457,716,701,218,4,475,4,0,0,15,418,383,35,Tesuque Pueblo and Off-Reservation Trust Land
349,,,4180,250,25,21,25,25,4,21,19,7,0,12,0,0,0,2,21,21,0,Timbi-Sha Shoshone Reservation and Off-Reservation Trust Land
350,,,4200,250,9561,3313,9561,9561,890,8671,8533,334,17,8177,0,3,2,138,3313,2831,482,Tohono O'odham Nation Reservation and Off-Reservation Trust Land
351,,,4225,250,261,109,261,261,8,253,232,24,0,206,0,1,1,21,109,103,6,Tonawanda Reservation
352,,,4235,250,130,49,130,130,16,114,102,11,0,91,0,0,0,12,49,37,12,Tonto Apache Reservation and Off-Reservation Trust Land
353,,,4255,250,3454,866,3454,3454,3185,269,240,45,5,140,22,0,28,29,866,820,46,Torres-Martinez Reservation
354,,,4275,250,137,45,137,137,11,126,114,12,0,102,0,0,0,12,45,40,5,Trinidad Rancheria and Off-Reservation Trust Land
355,,,4290,250,10969,4301,10969,10969,934,10035,9209,6442,94,2334,244,47,48,826,4301,3950,351,Tulalip Reservation and Off-Reservation Trust Land
356,,,4300,250,1250,352,1250,1250,218,1032,977,29,0,948,0,0,0,55,352,337,15,Tule River Reservation and Off-Reservation Trust Land
357,,,4315,250,106,65,106,106,4,102,91,38,0,51,0,1,1,11,65,65,0,Tunica-Biloxi Reservation and Off-Reservation Trust Land
358,,,4330,250,154,65,154,154,18,136,130,16,0,114,0,0,0,6,65,61,4,Tuolumne Rancheria
359,,,4345,250,7619,2525,7619,7619,80,7539,7355,268,13,7073,1,0,0,184,2525,2336,189,Turtle Mountain Reservation and Off-Reservation Trust Land
360,,,4360,250,1145,505,1145,1145,46,1099,1012,404,0,586,0,3,19,87,505,425,80,Tuscarora Nation Reservation
361,,,4375,250,5,1,5,5,1,4,2,1,0,1,0,0,0,2,1,0,1,Twenty-Nine Palms Reservation and Off-Reservation Trust Land
362,,,4390,250,25192,11169,25192,25192,1616,23576,22814,19972,32,2618,80,45,67,762,11169,8313,2856,Uintah and Ouray Reservation and Off-Reservation Trust Land
363,,,4405,250,2861,1161,2861,2861,102,2759,2576,1166,1,1398,0,8,3,183,1161,1062,99,Umatilla Reservation and Off-Reservation Trust Land
364,,,4430,250,70,35,70,70,4,66,62,38,0,23,0,0,1,4,35,27,8,Upper Lake Rancheria
365,,,4445,250,120,49,120,120,5,115,91,10,3,77,0,0,1,24,49,45,4,Upper Sioux Community and Off-Reservation Trust Land
366,,,4455,250,266,80,266,266,18,248,238,23,1,213,1,0,0,10,80,72,8,Upper Skagit Reservation and Off-Reservation Trust Land
367,,,4470,250,1656,575,1656,1656,35,1621,1595,19,2,1567,0,4,3,26,575,532,43,Ute Mountain Reservation and Off-Reservation Trust Land
368,,,4500,250,538,213,538,538,81,457,414,95,3,306,10,0,0,43,213,196,17,Viejas Reservation and Off-Reservation Trust Land
369,,,4515,250,814,385,814,814,98,716,675,61,3,611,0,0,0,41,385,329,56,Walker River Reservation
370,,,4530,250,86,40,86,86,8,78,68,16,0,52,0,0,0,10,40,40,0,Wampanoag-Aquinnah Trust Land
371,,,4545,250,3403,1035,3403,3403,271,3132,2977,95,7,2868,1,4,2,155,1035,967,68,Warm Springs Reservation and Off-Reservation Trust Land
372,,,4560,250,3223,1603,3223,3223,455,2768,2631,2527,16,58,26,1,3,137,1603,1414,189,Washoe Ranches Trust Land
373,,,4580,250,54,28,54,54,14,40,37,4,0,33,0,0,0,3,28,22,6,Wells Colony
374,,,4595,250,9726,4989,9726,9726,207,9519,8468,4169,8,4251,8,1,31,1051,4989,3635,1354,White Earth Reservation and Off-Reservation Trust Land
375,,,4610,250,25759,10445,25759,25759,1753,24006,22732,15148,111,7295,88,7,83,1274,10445,9361,1084,Wind River Reservation and Off-Reservation Trust Land
376,,,4625,250,2737,921,2737,2737,114,2623,2550,737,18,1785,2,1,7,73,921,822,99,Winnebago Reservation and Off-Reservation Trust Land
377,,,4635,250,43,23,43,43,8,35,33,4,0,28,1,0,0,2,23,22,1,Winnemucca Indian Colony
378,,,4665,250,225,64,225,225,17,208,195,9,1,184,1,0,0,13,64,64,0,Woodfords Community
379,,,4680,250,117,32,117,117,1,116,116,0,0,116,0,0,0,0,32,32,0,XL Ranch Rancheria
380,,,4690,250,31591,9132,31591,31591,18855,12736,11973,4276,93,6983,501,14,106,763,9132,8720,412,Yakama Nation Reservation and Off-Reservation Trust Land
381,,,4700,250,6588,2411,6588,6588,191,6397,6117,3084,12,2983,23,14,1,280,2411,2022,389,Yankton Reservation
382,,,4708,250,1234,454,1234,1234,169,1065,978,65,7,898,6,0,2,87,454,394,60,Yavapai-Apache Nation Reservation and Off-Reservation Trust Land
383,,,4710,250,200,75,200,200,53,147,135,23,0,112,0,0,0,12,75,63,12,Yavapai-Prescott Reservation
384,,,4725,250,144,64,144,144,30,114,100,8,0,92,0,0,0,14,64,51,13,Yerington Colony
385,,,4740,250,34,16,34,34,3,31,24,2,0,22,0,0,0,7,16,12,4,Yomba Reservation
386,,,4755,250,1124,360,1124,1124,847,277,258,15,3,235,4,1,0,19,360,304,56,Ysleta del Sur Pueblo and Off-Reservation Trust Land
387,,,4760,250,1236,587,1236,1236,69,1167,1001,367,1,626,1,0,6,166,587,467,120,Yurok Reservation
388,,,4770,250,760,205,760,760,24,736,734,0,0,734,0,0,0,2,205,182,23,Zia Pueblo and Off-Reservation Trust Land
389,,,4785,250,7461,2102,7461,7461,163,7298,7233,107,7,7039,77,1,2,65,2102,1987,115,Zuni Reservation and Off-Reservation Trust Land
390,,,4910,250,0,0,0,0,0,0,0,0,0,0,0,0,0,0,0,0,0,Kickapoo (KS) Reservation/Sac and Fox Nation Trust Land joint-use area
391,,,4930,250,0,0,0,0,0,0,0,0,0,0,0,0,0,0,0,0,0,San Felipe Pueblo/Santa Ana Pueblo joint-use area
392,,,4940,250,0,0,0,0,0,0,0,0,0,0,0,0,0,0,0,0,0,San Felipe Pueblo/Santo Domingo Pueblo joint-use area
393,,,5003,250,228,81,228,228,10,218,132,46,0,0,9,77,0,86,81,76,5,Anahola (Agricultural) Hawaiian Home Land
394,,,5004,250,1659,454,1659,1659,130,1529,911,113,0,0,62,731,5,618,454,429,25,Anahola (Residential) Hawaiian Home Land
395,,,5008,250,789,203,789,789,77,712,285,25,2,0,29,228,1,427,203,193,10,East Kapolei Hawaiian Home Land
396,,,5009,250,0,0,0,0,0,0,0,0,0,0,0,0,0,0,0,0,0,Haiku Hawaiian Home Land
397,,,5011,250,35,6,35,35,2,33,24,0,0,0,22,2,0,9,6,6,0,Hanapepe Hawaiian Home Land
398,,,5018,250,2,1,2,2,0,2,0,0,0,0,0,0,0,2,1,1,0,Homuula-Upper Piihonua Hawaiian Home Land
399,,,5026,250,5,2,5,5,2,3,1,1,0,0,0,0,0,2,2,1,1,Honokaia Hawaiian Home Land
400,,,5029,250,2,1,2,2,0,2,1,0,0,0,0,1,0,1,1,0,1,Honokowai Hawaiian Home Land
401,,,5030,250,1,0,1,1,0,1,0,0,0,0,0,0,0,1,0,0,0,Honolulu Makai Hawaiian Home Land
402,,,5031,250,0,0,0,0,0,0,0,0,0,0,0,0,0,0,0,0,0,Honomu Hawaiian Home Land
403,,,5033,250,1370,399,1370,1370,64,1306,905,27,0,1,45,832,0,401,399,377,22,Hoolehua-Palaau Hawaiian Home Land
404,,,5041,250,34,17,34,34,4,30,29,0,0,1,0,28,0,1,17,13,4,Kahikinui Hawaiian Home Land
405,,,5043,250,318,76,318,318,25,293,144,6,0,0,4,134,0,149,76,76,0,Kakaina-Kumuhau Hawaiian Home Land
406,,,5044,250,8,0,8,8,4,4,4,1,0,0,0,3,0,0,0,0,0,Kalaeloa Hawaiian Home Land
407,,,5046,250,383,137,383,383,35,348,197,7,0,0,10,178,2,151,137,124,13,Kalamaula Hawaiian Home Land
408,,,5051,250,82,110,82,82,18,64,55,27,0,0,9,15,4,9,110,57,53,Kalaupapa Hawaiian Home Land
409,,,5053,250,308,99,308,308,24,284,154,15,0,0,29,110,0,130,99,93,6,Kalawahine Hawaiian Home Land
410,,,5056,250,6,5,6,6,2,4,4,1,0,0,0,3,0,0,5,0,5,Kamaoa-Puueo Hawaiian Home Land
411,,,5061,250,81,30,81,81,6,75,51,4,0,0,4,42,1,24,30,30,0,Kamiloloa-Makakupaia Hawaiian Home Land
412,,,5066,250,55,15,55,55,2,53,20,5,0,0,1,14,0,33,15,10,5,Kamoku-Kapulena Hawaiian Home Land
413,,,5067,250,1566,371,1566,1566,172,1394,603,26,7,0,61,509,0,791,371,367,4,Kanehili Hawaiian Home Land
414,,,5069,250,0,0,0,0,0,0,0,0,0,0,0,0,0,0,0,0,0,Kaohe-Olaa Hawaiian Home Land
415,,,5071,250,0,0,0,0,0,0,0,0,0,0,0,0,0,0,0,0,0,Kapaa Hawaiian Home Land
416,,,5076,250,154,48,154,154,6,148,100,2,1,0,2,95,0,48,48,39,9,Kapaakea Hawaiian Home Land
417,,,5083,250,0,1,0,0,0,0,0,0,0,0,0,0,0,0,1,1,0,Kapolei Hawaiian Home Land
418,,,5086,250,119,42,119,119,17,102,49,1,0,0,9,39,0,53,42,39,3,Kaumana Hawaiian Home Land
419,,,5088,250,1332,327,1332,1332,201,1131,481,19,5,0,48,409,0,650,327,327,0,Kaupea Hawaiian Home Land
420,,,5091,250,500,168,500,500,46,454,279,28,0,3,17,231,0,175,168,147,21,Kawaihae Hawaiian Home Land
421,,,5098,250,0,0,0,0,0,0,0,0,0,0,0,0,0,0,0,0,0,Keahuolu Hawaiian Home Land
422,,,5101,250,990,291,990,990,116,874,476,42,0,0,25,409,0,398,291,280,11,Kealakehe Hawaiian Home Land
423,,,5104,250,7,5,7,7,3,4,4,0,0,0,0,4,0,0,5,0,5,Keanae-Wailua Hawaiian Home Land
424,,,5106,250,1617,450,1617,1617,192,1425,818,48,0,0,44,726,0,607,450,431,19,Keaukaha Hawaiian Home Land
425,,,5111,250,491,121,491,491,42,449,271,7,0,0,23,238,3,178,121,107,14,Kekaha Hawaiian Home Land
426,,,5114,250,113,39,113,113,8,105,69,22,1,2,1,43,0,36,39,37,2,Keokea (Agricultural) Hawaiian Home Land
427,,,5116,250,17,7,17,17,4,13,10,5,0,0,4,1,0,3,7,7,0,Keoniki Hawaiian Home Land
428,,,5120,250,245,52,245,245,22,223,124,5,0,0,11,108,0,99,52,50,2,Kewalo Hawaiian Home Land
429,,,5123,250,0,0,0,0,0,0,0,0,0,0,0,0,0,0,0,0,0,Kolaoa Hawaiian Home Land
430,,,5133,250,73,33,73,73,5,68,36,7,0,0,7,22,0,32,33,33,0,Lalamilo Hawaiian Home Land
431,,,5134,250,117,31,117,117,12,105,61,4,0,0,14,43,0,44,31,31,0,Lanai City Hawaiian Home Land
432,,,5135,250,422,101,422,422,42,380,218,22,0,0,15,177,4,162,101,101,0,Leialii Hawaiian Home Land
433,,,5136,250,54,11,54,54,12,42,28,1,0,0,14,10,3,14,11,8,3,Lualualei Hawaiian Home Land
434,,,5138,250,8,1,8,8,3,5,3,3,0,0,0,0,0,2,1,1,0,Maili Hawaiian Home Land
435,,,5139,250,0,0,0,0,0,0,0,0,0,0,0,0,0,0,0,0,0,Makaha Valley Hawaiian Home Land
436,,,5146,250,106,40,106,106,10,96,51,10,0,1,2,38,0,45,40,34,6,Makuu Hawaiian Home Land
437,,,5148,250,1020,228,1020,1020,89,931,453,16,2,0,49,386,0,478,228,222,6,Maluohai Hawaiian Home Land
438,,,5156,250,13,2,13,13,5,8,2,1,0,0,0,1,0,6,2,2,0,Moloaa Hawaiian Home Land
439,,,5161,250,5135,1104,5135,5135,530,4605,2632,62,10,0,123,2434,3,1973,1104,1089,15,Nanakuli Hawaiian Home Land
440,,,5166,250,7,2,7,7,0,7,6,1,0,0,0,5,0,1,2,2,0,Nienie Hawaiian Home Land
441,,,5176,250,670,191,670,670,44,626,316,40,0,0,20,256,0,310,191,191,0,Panaewa (Agricultural) Hawaiian Home Land
442,,,5177,250,1054,289,1054,1054,102,952,540,23,0,0,42,475,0,412,289,288,1,Panaewa (Residential) Hawaiian Home Land
443,,,5179,250,1091,266,1091,1091,126,965,526,21,4,0,50,451,0,439,266,255,11,Papakolea Hawaiian Home Land
444,,,5181,250,5,3,5,5,1,4,3,2,0,0,0,1,0,1,3,3,0,Pauahi Hawaiian Home Land
445,,,5186,250,729,173,729,729,62,667,343,28,2,4,18,290,1,324,173,173,0,Paukukalo Hawaiian Home Land
446,,,5188,250,3,1,3,3,1,2,1,0,0,0,1,0,0,1,1,1,0,Pearl City Hawaiian Home Land
447,,,5193,250,59,17,59,59,5,54,28,1,0,0,2,25,0,26,17,17,0,Piihonua Hawaiian Home Land
448,,,5196,250,17,4,17,17,5,12,7,0,0,0,2,5,0,5,4,4,0,Ponohawaii Hawaiian Home Land
449,,,5198,250,1068,272,1068,1068,131,937,522,42,2,0,33,445,0,415,272,272,0,Princess Kahanu Estates Hawaiian Home Land
450,,,5199,250,0,0,0,0,0,0,0,0,0,0,0,0,0,0,0,0,0,Pulehunui Hawaiian Home Land
451,,,5201,250,936,295,936,936,82,854,519,56,0,0,12,451,0,335,295,282,13,Puukapu Hawaiian Home Land
452,,,5213,250,1,2,1,1,1,0,0,0,0,0,0,0,0,0,2,0,2,South Maui Hawaiian Home Land
453,,,5216,250,0,0,0,0,0,0,0,0,0,0,0,0,0,0,0,0,0,Ualapue Hawaiian Home Land
454,,,5222,250,0,0,0,0,0,0,0,0,0,0,0,0,0,0,0,0,0,Upolu Hawaiian Home Land
455,,,5223,250,29,8,29,29,4,25,18,6,0,0,0,12,0,7,8,5,3,Waiahole Hawaiian Home Land
456,,,5236,250,14,4,14,14,3,11,9,1,0,0,8,0,0,2,4,4,0,Waiakea Hawaiian Home Land
457,,,5238,250,2114,465,2114,2114,256,1858,1035,40,1,0,63,931,0,823,465,452,13,Waianae Hawaiian Home Land
458,,,5239,250,616,152,616,616,89,527,314,9,4,0,12,289,0,213,152,145,7,Waianae Kai Hawaiian Home Land
459,,,5241,250,1441,348,1441,1441,175,1266,654,56,1,3,56,537,1,612,348,348,0,Waiehu Hawaiian Home Land
460,,,5248,250,0,0,0,0,0,0,0,0,0,0,0,0,0,0,0,0,0,Waiku-Hana Hawaiian Home Land
461,,,5251,250,0,0,0,0,0,0,0,0,0,0,0,0,0,0,0,0,0,Wailau Hawaiian Home Land
462,,,5256,250,150,0,150,150,13,137,128,41,0,0,14,73,0,9,0,0,0,Wailua Hawaiian Home Land
463,,,5271,250,3639,799,3639,3639,305,3334,2101,88,2,2,87,1918,4,1233,799,787,12,Waimanalo Hawaiian Home Land
464,,,5276,250,0,0,0,0,0,0,0,0,0,0,0,0,0,0,0,0,0,Waimanu Hawaiian Home Land
465,,,5281,250,0,0,0,0,0,0,0,0,0,0,0,0,0,0,0,0,0,Waimea Hawaiian Home Land
466,,,5283,250,17,2,17,17,2,15,15,1,0,0,0,14,0,0,2,0,2,Waiohinu Hawaiian Home Land
467,,,5286,250,1231,340,1231,1231,138,1093,616,79,4,3,26,504,0,477,340,326,14,Waiohuli (Residential) Hawaiian Home Land
468,,,5540,250,15107,6054,15107,15107,3061,12046,11194,9631,328,1166,36,7,26,852,6054,4713,1341,Caddo-Wichita-Delaware OTSA
469,,,5550,250,513178,228715,513178,513178,45659,467519,404814,281731,29148,85774,6340,472,1349,62705,228715,196249,32466,Cherokee OTSA
470,,,5560,250,186628,79900,186628,186628,22742,163886,150600,134049,5129,8637,2285,83,417,13286,79900,69501,10399,Cheyenne and Arapaho OTSA
471,,,5580,250,306460,138707,306460,306460,25369,281091,251515,213211,7541,27220,1985,185,1373,29576,138707,119171,19536,Chickasaw OTSA
472,,,5590,250,226984,105479,226984,226984,13352,213632,189780,145036,7291,35245,1202,560,446,23852,105479,88646,16833,Choctaw OTSA
473,,,5600,250,126987,50083,126987,126987,7535,119452,107073,90873,6098,8682,983,78,359,12379,50083,46065,4018,Citizen Potawatomi Nation-Absentee Shawnee OTSA
474,,,5620,250,813184,357976,813184,813184,90404,722780,638021,489053,56737,63564,25178,903,2586,84759,357976,322462,35514,Creek OTSA
475,,,5640,250,743,332,743,743,31,712,637,467,2,166,2,0,0,75,332,294,38,Eastern Shawnee OTSA
476,,,5670,250,6602,2711,6602,6602,267,6335,5804,5305,108,347,19,3,22,531,2711,2443,268,Iowa OTSA
477,,,5690,250,5692,2778,5692,5692,270,5422,4939,4354,31,533,16,2,3,483,2778,2263,515,Kaw OTSA
478,,,5700,250,26259,10235,26259,26259,1884,24375,21818,18259,908,2354,205,15,77,2557,10235,9239,996,Kickapoo OTSA
479,,,5720,250,187646,85560,187646,187646,27942,159704,145023,108647,21914,9427,3448,905,682,14681,85560,71041,14519,Kiowa-Comanche-Apache-Fort Sill Apache OTSA
480,,,5730,250,257,103,257,257,2,255,217,141,0,76,0,0,0,38,103,90,13,Miami OTSA
481,,,5740,250,233,98,233,233,9,224,209,114,0,93,2,0,0,15,98,98,0,Modoc OTSA
482,,,5760,250,810,332,810,810,38,772,704,293,1,404,1,0,5,68,332,284,48,Otoe-Missouria OTSA
483,,,5770,250,5388,2356,5388,5388,292,5096,4464,3279,156,925,29,51,24,632,2356,1976,380,Ottawa OTSA
484,,,5780,250,15412,7206,15412,15412,457,14955,13499,11426,73,1910,48,0,42,1456,7206,5999,1207,Pawnee OTSA
485,,,5795,250,5112,2189,5112,5112,216,4896,4331,3248,20,932,33,93,5,565,2189,2019,170,Peoria OTSA
486,,,5800,250,1916,796,1916,1916,87,1829,1692,1039,7,644,0,0,2,137,796,712,84,Ponca OTSA
487,,,5810,250,4810,2098,4810,4810,636,4174,3788,2812,27,932,11,4,2,386,2098,1843,255,Quapaw OTSA
488,,,5820,250,58358,25842,58358,58358,2962,55396,49853,41612,2101,5666,317,23,134,5543,25842,22651,3191,Sac and Fox OTSA
489,,,5830,250,21656,9869,21656,21656,1115,20541,17975,12948,816,4053,64,8,86,2566,9869,8263,1606,Seminole OTSA
490,,,5835,250,4241,2738,4241,4241,128,4113,3702,3102,4,577,11,6,2,411,2738,1898,840,Seneca-Cayuga OTSA
491,,,5860,250,3841,1642,3841,3841,321,3520,3246,2733,39,449,14,7,4,274,1642,1391,251,Tonkawa OTSA
492,,,5890,250,1869,836,1869,1869,60,1809,1620,1179,1,424,12,3,1,189,836,744,92,Wyandotte OTSA
493,,,5915,250,1900,843,1900,1900,61,1839,1634,1161,104,358,8,0,3,205,843,715,128,Creek/Seminole joint-use OTSA
494,,,5950,250,26146,12476,26146,26146,2430,23716,21303,17806,746,2257,185,260,49,2413,12476,10642,1834,Kaw/Ponca joint-use OTSA
495,,,5955,250,9690,4512,9690,9690,1115,8575,7661,3969,326,3331,27,1,7,914,4512,3660,852,Kiowa-Comanche-Apache-Ft Sill Apache/Caddo-Wichita-Delaware joint-use OTSA
496,,,5970,250,4029,1964,4029,4029,250,3779,3314,2541,48,624,25,68,8,465,1964,1686,278,Miami/Peoria joint-use OTSA
497,,,6015,250,63,36,63,63,0,63,60,4,1,55,0,0,0,3,36,30,6,Akhiok ANVSA
498,,,6020,250,683,256,683,683,4,679,667,27,1,639,0,0,0,12,256,188,68,Akiachak ANVSA
499,,,6025,250,462,107,462,462,0,462,460,18,0,442,0,0,0,2,107,106,1,Akiak ANVSA
500,,,6030,250,1585,48,1585,1585,561,1024,984,146,266,56,499,11,6,40,48,46,2,Akutan ANVSA
501,,,6035,250,756,181,756,756,2,754,747,20,0,718,0,0,9,7,181,171,10,Alakanuk ANVSA
502,,,6040,250,15,17,15,15,0,15,15,1,0,14,0,0,0,0,17,12,5,Alatna ANVSA
503,,,6045,250,211,102,211,211,4,207,171,38,0,131,2,0,0,36,102,72,30,Aleknagik ANVSA
504,,,6065,250,497,162,497,497,1,496,488,19,0,468,1,0,0,8,162,149,13,Algaaciq ANVSA
505,,,6070,250,177,90,177,177,0,177,170,20,0,149,1,0,0,7,90,71,19,Allakaket ANVSA
506,,,6075,250,274,100,274,274,2,272,256,17,3,236,0,0,0,16,100,79,21,Ambler ANVSA
507,,,6080,250,425,136,425,425,7,418,380,71,0,309,0,0,0,38,136,113,23,Anaktuvuk Pass ANVSA
508,,,6095,250,102,55,102,102,1,101,95,6,0,89,0,0,0,6,55,29,26,Andreafsky ANVSA
509,,,6100,250,357,192,357,357,25,332,302,23,0,269,6,1,3,30,192,130,62,Angoon ANVSA
510,,,6105,250,510,226,510,510,11,499,455,88,1,365,1,0,0,44,226,156,70,Aniak ANVSA
511,,,6125,250,70,42,70,70,0,70,65,3,0,62,0,0,0,5,42,21,21,Anvik ANVSA
512,,,6140,250,151,96,151,151,0,151,146,6,0,140,0,0,0,5,96,69,27,Arctic Village ANVSA
513,,,6150,250,53,38,53,53,0,53,51,0,1,50,0,0,0,2,38,14,24,Atka ANVSA
514,,,6160,250,386,84,386,386,1,385,381,9,1,370,1,0,0,4,84,71,13,Atmautluak ANVSA
515,,,6165,250,276,79,276,276,1,275,262,21,1,240,0,0,0,13,79,72,7,Atqasuk ANVSA
516,,,6175,250,4927,1550,4927,4927,173,4754,4210,665,70,2593,591,286,5,544,1550,1334,216,Barrow ANVSA
517,,,6190,250,48,57,48,48,1,47,47,1,0,46,0,0,0,0,57,22,35,Beaver ANVSA
518,,,6195,250,2,1,2,2,0,2,1,1,0,0,0,0,0,1,1,0,1,Belkofski ANVSA
519,,,6205,250,6325,2184,6325,6325,144,6181,5586,1177,73,4129,187,2,18,595,2184,1912,272,Bethel ANVSA
520,,,6225,250,0,2,0,0,0,0,0,0,0,0,0,0,0,0,2,2,0,Bill Moore's ANVSA
521,,,6235,250,35,17,35,35,0,35,34,3,0,31,0,0,0,1,17,16,1,Birch Creek ANVSA
522,,,6240,250,428,116,428,428,5,423,409,22,2,378,3,0,4,14,116,111,5,Brevig Mission ANVSA
523,,,6250,250,550,111,550,550,2,548,533,6,2,524,1,0,0,15,111,108,3,Buckland ANVSA
524,,,6255,250,197,203,197,197,1,196,172,134,2,36,0,0,0,24,203,120,83,Cantwell ANVSA
525,,,6257,250,0,3,0,0,0,0,0,0,0,0,0,0,0,0,3,0,3,Canyon Village ANVSA
526,,,6265,250,56,63,56,56,1,55,53,1,0,52,0,0,0,2,63,21,42,Chalkyitsik ANVSA
527,,,6275,250,506,110,506,506,2,504,475,17,0,458,0,0,0,29,110,104,6,Chefornak ANVSA
528,,,6280,250,59,32,59,59,0,59,52,13,4,34,0,0,1,7,32,26,6,Chenega ANVSA
529,,,6285,250,951,243,951,951,1,950,912,18,1,892,1,0,0,38,243,208,35,Chevak ANVSA
530,,,6290,250,25487,10715,25487,25487,1186,24301,21927,19638,219,1422,318,100,230,2374,10715,9149,1566,Chickaloon ANVSA
531,,,6295,250,97,87,97,97,5,92,80,19,0,58,3,0,0,12,87,43,44,Chignik ANVSA
532,,,6300,250,72,73,72,72,3,69,57,9,0,48,0,0,0,12,73,32,41,Chignik Lagoon ANVSA
533,,,6305,250,65,44,65,65,2,63,59,4,0,55,0,0,0,4,44,30,14,Chignik Lake ANVSA
534,,,6310,250,93,67,93,93,1,92,79,11,0,67,0,0,1,13,67,45,22,Chilkat ANVSA
535,,,6315,250,410,235,410,410,11,399,357,291,1,61,4,0,0,42,235,203,32,Chilkoot ANVSA
536,,,6325,250,50,60,50,50,1,49,42,5,0,37,0,0,0,7,60,18,42,Chistochina ANVSA
537,,,6330,250,78,107,78,78,2,76,62,25,0,36,0,0,1,14,107,44,63,Chitina ANVSA
538,,,6335,250,104,40,104,104,1,103,95,3,0,92,0,0,0,8,40,33,7,Chuathbaluk ANVSA
539,,,6340,250,1,10,1,1,1,0,0,0,0,0,0,0,0,0,10,0,10,Chuloonawick ANVSA
540,,,6350,250,91,59,91,91,0,91,91,7,0,84,0,0,0,0,59,49,10,Circle ANVSA
541,,,6360,250,67,38,67,67,0,67,66,4,0,62,0,0,0,1,38,24,14,Clarks Point ANVSA
542,,,6365,250,449,278,449,449,20,429,376,203,1,170,2,0,0,53,278,184,94,Copper Center ANVSA
543,,,6380,250,2,40,2,2,1,1,0,0,0,0,0,0,0,1,40,4,36,Council ANVSA
544,,,6385,250,1251,630,1251,1251,52,1199,1039,788,3,230,13,0,5,160,630,518,112,Craig ANVSA
545,,,6390,250,90,45,90,90,1,89,86,1,0,85,0,0,0,3,45,44,1,Crooked Creek ANVSA
546,,,6400,250,182,72,182,182,0,182,175,6,0,168,1,0,0,7,72,54,18,Deering ANVSA
547,,,6405,250,2350,1045,2350,2350,104,2246,1954,624,17,1257,40,9,7,292,1045,850,195,Dillingham ANVSA
548,,,6415,250,23,24,23,23,0,23,15,3,0,12,0,0,0,8,24,14,10,Dot Lake ANVSA
549,,,6420,250,5542,2774,5542,5542,320,5222,4590,3737,72,519,154,81,27,632,2774,2495,279,Douglas ANVSA
550,,,6430,250,54,48,54,54,2,52,47,20,0,27,0,0,0,5,48,25,23,Eagle ANVSA
551,,,6440,250,404,120,404,404,5,399,372,6,0,366,0,0,0,27,120,107,13,Eek ANVSA
552,,,6445,250,39,243,39,39,1,38,37,14,0,23,0,0,0,1,243,24,219,Egegik ANVSA
553,,,6450,250,62,19,62,62,5,57,47,8,0,38,0,0,1,10,19,19,0,Eklutna ANVSA
554,,,6455,250,2,82,2,2,0,2,2,2,0,0,0,0,0,0,82,0,82,Ekuk ANVSA
555,,,6460,250,111,52,111,111,7,104,100,9,1,89,1,0,0,4,52,36,16,Ekwok ANVSA
556,,,6470,250,366,129,366,366,5,361,343,16,0,325,2,0,0,18,129,97,32,Elim ANVSA
557,,,6480,250,825,221,825,825,2,823,785,23,1,759,2,0,0,38,221,213,8,Emmonak ANVSA
558,,,6490,250,35,63,35,35,2,33,32,23,0,9,0,0,0,1,63,21,42,Evansville ANVSA
559,,,6495,250,134,68,134,134,4,130,100,95,0,4,1,0,0,30,68,60,8,Eyak ANVSA
560,,,6500,250,394,25,394,394,41,353,331,175,18,23,109,5,1,22,25,13,12,False Pass ANVSA
561,,,6515,250,428,282,428,428,3,425,393,34,0,359,0,0,0,32,282,202,80,Fort Yukon ANVSA
562,,,6520,250,107,123,107,107,2,105,103,62,0,41,0,0,0,2,123,49,74,Gakona ANVSA
563,,,6525,250,472,269,472,472,4,468,449,114,0,326,2,0,7,19,269,178,91,Galena ANVSA
564,,,6530,250,640,206,640,640,4,636,635,19,1,614,1,0,0,1,206,171,35,Gambell ANVSA
565,,,6535,250,1,5,1,1,0,1,1,0,0,0,0,0,1,0,5,1,4,Georgetown ANVSA
566,,,6540,250,175,59,175,175,1,174,170,11,0,159,0,0,0,4,59,52,7,Golovin ANVSA
567,,,6545,250,258,84,258,258,1,257,246,13,0,233,0,0,0,11,84,84,0,Goodnews Bay ANVSA
568,,,6550,250,210,73,210,210,1,209,192,5,0,187,0,0,0,17,73,71,2,Grayling ANVSA
569,,,6560,250,121,76,121,121,11,110,104,38,0,66,0,0,0,6,76,42,34,Gulkana ANVSA
570,,,6570,250,2,1,2,2,1,1,0,0,0,0,0,0,0,1,1,1,0,Hamilton ANVSA
571,,,6575,250,24,35,24,24,1,23,21,1,0,20,0,0,0,2,35,7,28,Healy Lake ANVSA
572,,,6585,250,176,87,176,176,2,174,147,7,0,140,0,0,0,27,87,72,15,Holy Cross ANVSA
573,,,6590,250,931,398,931,931,61,870,748,300,1,435,3,3,6,122,398,347,51,Hoonah ANVSA
574,,,6595,250,1375,314,1375,1375,1,1374,1367,23,2,1330,10,0,2,7,314,280,34,Hooper Bay ANVSA
575,,,6605,250,86,48,86,86,1,85,82,5,0,77,0,0,0,3,48,33,15,Hughes ANVSA
576,,,6610,250,304,127,304,304,4,300,288,13,0,275,0,0,0,12,127,104,23,Huslia ANVSA
577,,,6615,250,380,145,380,380,13,367,357,25,1,318,1,12,0,10,145,138,7,Hydaburg ANVSA
578,,,6620,250,68,34,68,68,0,68,62,13,0,48,1,0,0,6,34,21,13,Igiugig ANVSA
579,,,6625,250,108,74,108,108,1,107,90,25,0,64,1,0,0,17,74,34,40,Iliamna ANVSA
580,,,6630,250,83,49,83,83,2,81,75,2,0,72,1,0,0,6,49,30,19,Inalik ANVSA
581,,,6650,250,1,12,1,1,0,1,0,0,0,0,0,0,0,1,12,8,4,Ivanof Bay ANVSA
582,,,6670,250,543,222,543,543,7,536,485,63,2,414,3,2,1,51,222,188,34,Kake ANVSA
583,,,6680,250,283,91,283,283,0,283,281,12,0,269,0,0,0,2,91,88,3,Kaktovik ANVSA
584,,,6685,250,212,89,212,212,1,211,197,15,0,182,0,0,0,14,89,59,30,Kalskag ANVSA
585,,,6690,250,158,90,158,158,0,158,143,11,0,132,0,0,0,15,90,62,28,Kaltag ANVSA
586,,,6700,250,27,28,27,27,1,26,25,1,0,24,0,0,0,1,28,14,14,Karluk ANVSA
587,,,6705,250,30,18,30,30,3,27,25,19,0,5,0,1,0,2,18,10,8,Kasaan ANVSA
588,,,6710,250,623,131,623,623,0,623,619,21,1,597,0,0,0,4,131,120,11,Kasigluk ANVSA
589,,,6720,250,34637,18021,34637,34637,1504,33133,29943,26668,164,2255,504,109,243,3190,18021,13971,4050,Kenaitze ANVSA
590,,,6725,250,13225,5996,13225,13225,627,12598,11206,7883,96,2003,1108,26,90,1392,5996,5202,794,Ketchikan ANVSA
591,,,6730,250,449,142,449,449,1,448,425,21,1,401,2,0,0,23,142,108,34,Kiana ANVSA
592,,,6735,250,757,208,757,757,43,714,657,208,10,324,109,6,0,57,208,165,43,King Cove ANVSA
593,,,6740,250,125,95,125,125,11,114,89,55,1,32,0,0,1,25,95,51,44,King Salmon ANVSA
594,,,6750,250,704,193,704,704,2,702,697,15,2,680,0,0,0,5,193,181,12,Kipnuk ANVSA
595,,,6755,250,444,172,444,444,1,443,442,8,0,434,0,0,0,1,172,81,91,Kivalina ANVSA
596,,,6765,250,528,245,528,528,12,516,412,121,0,283,8,0,0,104,245,201,44,Klawock ANVSA
597,,,6785,250,81495,39270,81495,81495,4055,77440,69402,61334,840,5100,1197,376,555,8038,39270,29175,10095,Knik ANVSA
598,,,6790,250,191,53,191,191,5,186,178,20,1,156,1,0,0,8,53,41,12,Kobuk ANVSA
599,,,6795,250,2,3,2,2,0,2,2,2,0,0,0,0,0,0,3,3,0,Kodiak ANVSA
600,,,6800,250,152,70,152,152,0,152,137,11,0,124,2,0,0,15,70,52,18,Kokhanok ANVSA
601,,,6810,250,486,108,486,486,1,485,471,5,1,465,0,0,0,14,108,108,0,Kongiganak ANVSA
602,,,6815,250,655,150,655,655,0,655,654,1,0,653,0,0,0,1,150,134,16,Kotlik ANVSA
603,,,6820,250,3102,1021,3102,3102,77,3025,2719,491,63,2106,48,11,0,306,1021,895,126,Kotzebue ANVSA
604,,,6825,250,312,103,312,312,4,308,292,12,1,277,2,0,0,16,103,91,12,Koyuk ANVSA
605,,,6830,250,98,58,98,98,1,97,97,0,0,97,0,0,0,0,58,37,21,Koyukuk ANVSA
606,,,6835,250,812,229,812,812,0,812,792,15,0,773,4,0,0,20,229,177,52,Kwethluk ANVSA
607,,,6840,250,380,108,380,380,1,379,372,3,0,369,0,0,0,7,108,94,14,Kwigillingok ANVSA
608,,,6845,250,776,204,776,776,3,773,743,13,0,730,0,0,0,30,204,192,12,Kwinhagak ANVSA
609,,,6850,250,16,22,16,16,2,14,12,9,1,2,0,0,0,2,22,13,9,Lake Minchumina ANVSA
610,,,6855,250,34,104,34,34,0,34,33,5,0,27,0,0,1,1,104,24,80,Larsen Bay ANVSA
611,,,6860,250,0,2,0,0,0,0,0,0,0,0,0,0,0,0,2,0,2,Lesnoi ANVSA
612,,,6865,250,69,42,69,69,0,69,66,1,0,65,0,0,0,3,42,30,12,Levelock ANVSA
613,,,6875,250,13,27,13,13,0,13,13,0,0,12,1,0,0,0,27,3,24,Lime Village ANVSA
614,,,6890,250,278,95,278,278,2,276,266,4,0,262,0,0,0,10,95,82,13,Lower Kalskag ANVSA
615,,,6895,250,301,165,301,301,7,294,276,104,3,169,0,0,0,18,165,125,40,McGrath ANVSA
616,,,6900,250,169,106,169,169,3,166,160,52,0,106,1,0,1,6,106,59,47,Manley Hot Springs ANVSA
617,,,6905,250,487,146,487,487,5,482,459,16,0,443,0,0,0,23,146,133,13,Manokotak ANVSA
618,,,6910,250,492,131,492,492,1,491,474,8,2,464,0,0,0,17,131,115,16,Marshall ANVSA
619,,,6915,250,1,3,1,1,0,1,1,0,0,0,1,0,0,0,3,2,1,Mary's Igloo ANVSA
620,,,6935,250,206,95,206,206,1,205,202,9,0,193,0,0,0,3,95,72,23,Mekoryuk ANVSA
621,,,6945,250,108,50,108,108,0,108,101,11,1,89,0,0,0,7,50,33,17,Mentasta Lake ANVSA
622,,,6965,250,150,100,150,150,0,150,145,7,0,138,0,0,0,5,100,55,45,Minto ANVSA
623,,,6975,250,621,198,621,621,0,621,614,19,6,585,3,0,1,7,198,174,24,Mountain Village ANVSA
624,,,6990,250,470,431,470,470,24,446,390,163,2,216,5,3,1,56,431,188,243,Naknek ANVSA
625,,,6995,250,247,81,247,247,7,240,190,13,0,177,0,0,0,50,81,59,22,Nanwalek ANVSA
626,,,7005,250,0,13,0,0,0,0,0,0,0,0,0,0,0,0,13,4,9,Napaimute ANVSA
627,,,7010,250,358,115,358,358,0,358,342,14,2,325,1,0,0,16,115,103,12,Napakiak ANVSA
628,,,7020,250,509,143,509,509,5,504,498,12,0,486,0,0,0,6,143,125,18,Napaskiak ANVSA
629,,,7025,250,41,30,41,41,2,39,39,1,0,38,0,0,0,0,30,20,10,Nelson Lagoon ANVSA
630,,,7030,250,358,219,358,358,0,358,354,207,0,147,0,0,0,4,219,169,50,Nenana ANVSA
631,,,7035,250,168,65,168,168,2,166,143,16,0,127,0,0,0,23,65,51,14,Newhalen ANVSA
632,,,7040,250,183,72,183,183,0,183,172,5,0,167,0,0,0,11,72,50,22,New Koliganek ANVSA
633,,,7050,250,512,125,512,512,6,506,482,24,1,457,0,0,0,24,125,125,0,New Stuyahok ANVSA
634,,,7055,250,308,80,308,308,0,308,299,6,0,293,0,0,0,9,80,67,13,Newtok ANVSA
635,,,7065,250,306,63,306,306,0,306,302,8,0,294,0,0,0,4,63,63,0,Nightmute ANVSA
636,,,7070,250,89,45,89,89,2,87,82,10,0,72,0,0,0,5,45,39,6,Nikolai ANVSA
637,,,7075,250,39,26,39,39,4,35,34,6,0,27,0,0,1,1,26,22,4,Nikolski ANVSA
638,,,7080,250,16004,9598,16004,16004,491,15513,14299,13329,53,622,159,30,106,1214,9598,6986,2612,Ninilchik ANVSA
639,,,7085,250,570,150,570,570,2,568,557,25,1,531,0,0,0,11,150,133,17,Noatak ANVSA
640,,,7095,250,3794,1716,3794,3794,121,3673,3054,998,33,1926,74,3,20,619,1716,1287,429,Nome ANVSA
641,,,7100,250,133,93,133,133,4,129,119,10,0,109,0,0,0,10,93,48,45,Nondalton ANVSA
642,,,7110,250,694,176,694,694,0,694,687,15,0,672,0,0,0,7,176,163,13,Noorvik ANVSA
643,,,7115,250,227,115,227,227,0,227,226,19,0,207,0,0,0,1,115,73,42,Northway ANVSA
644,,,7125,250,512,157,512,512,0,512,510,35,1,474,0,0,0,2,157,130,27,Nuiqsut ANVSA
645,,,7130,250,239,100,239,239,4,235,186,17,0,167,2,0,0,49,100,84,16,Nulato ANVSA
646,,,7133,250,217,58,217,217,1,216,207,2,2,203,0,0,0,9,58,44,14,Nunam Iqua ANVSA
647,,,7135,250,594,144,594,594,0,594,594,13,0,581,0,0,0,0,144,131,13,Nunapitchuk ANVSA
648,,,7145,250,1,4,1,1,0,1,1,0,0,0,1,0,0,0,4,1,3,Ohogamiut ANVSA
649,,,7150,250,216,134,216,216,6,210,201,22,0,176,1,2,0,9,134,95,39,Old Harbor ANVSA
650,,,7175,250,70,31,70,70,2,68,68,1,0,67,0,0,0,0,31,12,19,Oscarville ANVSA
651,,,7180,250,118,100,118,118,7,111,100,22,0,78,0,0,0,11,100,46,54,Ouzinkie ANVSA
652,,,7185,250,2,1,2,2,1,1,1,1,0,0,0,0,0,0,1,1,0,Paimiut ANVSA
653,,,7205,250,43,48,43,43,0,43,41,20,0,21,0,0,0,2,48,24,24,Pedro Bay ANVSA
654,,,7215,250,88,47,88,88,1,87,84,7,0,77,0,0,0,3,47,34,13,Perryville ANVSA
655,,,7220,250,2360,1044,2360,2360,118,2242,1951,1633,36,163,98,12,9,291,1044,937,107,Petersburg ANVSA
656,,,7225,250,70,66,70,70,1,69,60,10,0,50,0,0,0,9,66,21,45,Pilot Point ANVSA
657,,,7230,250,615,152,615,615,0,615,602,8,2,590,2,0,0,13,152,152,0,Pilot Station ANVSA
658,,,7235,250,120,32,120,120,0,120,118,0,0,118,0,0,0,2,32,32,0,Pitkas Point ANVSA
659,,,7245,250,55,30,55,55,1,54,47,1,0,46,0,0,0,7,30,17,13,Platinum ANVSA
660,,,7250,250,830,255,830,830,3,827,794,59,5,730,0,0,0,33,255,214,41,Point Hope ANVSA
661,,,7255,250,330,90,330,330,1,329,323,19,0,304,0,0,0,6,90,83,7,Point Lay ANVSA
662,,,7260,250,4,12,4,4,2,2,2,2,0,0,0,0,0,0,12,0,12,Portage Creek ANVSA
663,,,7263,250,186,86,186,186,7,179,161,119,1,41,0,0,0,18,86,49,37,Port Alsworth ANVSA
664,,,7265,250,162,63,162,162,3,159,142,8,0,134,0,0,0,17,63,57,6,Port Graham ANVSA
665,,,7270,250,100,56,100,100,1,99,93,14,0,79,0,0,0,6,56,40,16,Port Heiden ANVSA
666,,,7275,250,170,126,170,170,1,169,163,55,0,105,0,3,0,6,126,76,50,Port Lions ANVSA
667,,,7300,250,57,41,57,57,0,57,50,6,0,44,0,0,0,7,41,22,19,Rampart ANVSA
668,,,7305,250,22,20,22,22,1,21,17,2,0,15,0,0,0,4,20,5,15,Red Devil ANVSA
669,,,7310,250,139,103,139,139,1,138,133,8,0,125,0,0,0,5,103,56,47,Ruby ANVSA
670,,,7315,250,421,95,421,421,0,421,405,7,0,398,0,0,0,16,95,95,0,Russian Mission ANVSA
671,,,7340,250,67,52,67,67,2,65,62,2,0,60,0,0,0,3,52,26,26,St. George ANVSA
672,,,7375,250,456,114,456,456,3,453,438,25,3,410,0,0,0,15,114,95,19,St. Michael ANVSA
673,,,7390,250,413,192,413,413,5,408,392,24,1,358,6,2,1,16,192,135,57,St. Paul ANVSA
674,,,7400,250,1078,329,1078,1078,22,1056,982,757,27,189,5,3,1,74,329,244,85,Salamatof ANVSA
675,,,7410,250,536,280,536,536,14,522,475,86,0,342,35,10,2,47,280,215,65,Sand Point ANVSA
676,,,7415,250,835,204,835,835,5,830,825,18,1,803,3,0,0,5,204,188,16,Savoonga ANVSA
677,,,7420,250,384,152,384,384,10,374,319,56,2,256,2,0,3,55,152,128,24,Saxman ANVSA
678,,,7425,250,600,124,600,600,0,600,597,4,0,593,0,0,0,3,124,118,6,Scammon Bay ANVSA
679,,,7430,250,809,214,809,809,0,809,802,16,0,786,0,0,0,7,214,200,14,Selawik ANVSA
680,,,7435,250,448,412,448,448,16,432,362,289,1,60,6,0,6,70,412,206,206,Seldovia ANVSA
681,,,7440,250,100,42,100,100,3,97,94,4,0,90,0,0,0,3,42,34,8,Shageluk ANVSA
682,,,7450,250,212,85,212,212,1,211,209,20,4,185,0,0,0,2,85,77,8,Shaktoolik ANVSA
683,,,7465,250,576,166,576,576,0,576,574,15,4,555,0,0,0,2,166,154,12,Shishmaref ANVSA
684,,,7470,250,272,89,272,272,1,271,265,6,0,259,0,0,0,6,89,72,17,Shungnak ANVSA
685,,,7475,250,4459,1999,4459,4459,268,4191,3648,2382,31,763,438,8,26,543,1999,1757,242,Sitka ANVSA
686,,,7485,250,1240,760,1240,1240,41,1199,1130,1056,6,23,39,0,6,69,760,531,229,Skagway ANVSA
687,,,7495,250,95,55,95,95,2,93,76,13,1,62,0,0,0,17,55,34,21,Sleetmute ANVSA
688,,,7500,250,1,8,1,1,0,1,1,0,0,0,1,0,0,0,8,0,8,Solomon ANVSA
689,,,7505,250,67,120,67,67,3,64,49,16,0,33,0,0,0,15,120,32,88,South Naknek ANVSA
690,,,7510,250,634,199,634,634,5,629,610,31,2,577,0,0,0,19,199,181,18,Stebbins ANVSA
691,,,7520,250,37,38,37,37,0,37,37,0,0,37,0,0,0,0,38,21,17,Stevens Village ANVSA
692,,,7525,250,57,31,57,57,1,56,56,4,0,50,2,0,0,0,31,15,16,Stony River ANVSA
693,,,7530,250,56,41,56,56,7,49,42,26,0,14,0,2,0,7,41,22,19,Takotna ANVSA
694,,,7535,250,144,68,144,144,5,139,132,13,0,119,0,0,0,7,68,53,15,Tanacross ANVSA
695,,,7540,250,246,157,246,246,4,242,236,41,0,194,1,0,0,6,157,115,42,Tanana ANVSA
696,,,7555,250,90,88,90,90,0,90,86,12,0,74,0,0,0,4,88,34,54,Tatitlek ANVSA
697,,,7560,250,263,202,263,263,7,256,229,147,2,78,0,0,2,27,202,97,105,Tazlina ANVSA
698,,,7565,250,2,6,2,2,0,2,2,1,0,1,0,0,0,0,6,3,3,Telida ANVSA
699,,,7570,250,249,84,249,249,2,247,238,9,0,224,5,0,0,9,84,73,11,Teller ANVSA
700,,,7580,250,135,71,135,135,3,132,125,8,0,117,0,0,0,7,71,41,30,Tetlin ANVSA
701,,,7605,250,817,275,817,817,9,808,774,41,0,732,1,0,0,34,275,229,46,Togiak ANVSA
702,,,7625,250,658,134,658,658,1,657,653,18,0,635,0,0,0,4,134,133,1,Toksook Bay ANVSA
703,,,7630,250,444,118,444,444,1,443,429,13,0,416,0,0,0,14,118,94,24,Tuluksak ANVSA
704,,,7640,250,469,126,469,469,0,469,466,8,0,457,1,0,0,3,126,113,13,Tuntutuliak ANVSA
705,,,7645,250,411,99,411,411,1,410,400,11,0,389,0,0,0,10,99,87,12,Tununak ANVSA
706,,,7650,250,103,38,103,103,7,96,79,4,0,74,1,0,0,17,38,34,4,Twin Hills ANVSA
707,,,7655,250,161,118,161,161,18,143,125,8,1,112,0,4,0,18,118,63,55,Tyonek ANVSA
708,,,7665,250,4,25,4,4,0,4,4,1,0,3,0,0,0,0,25,1,24,Ugashik ANVSA
709,,,7690,250,806,335,806,806,7,799,791,117,1,671,2,0,0,8,335,252,83,Unalakleet ANVSA
710,,,7695,250,4254,776,4254,4254,594,3660,3441,1326,221,182,1483,221,8,219,776,641,135,Unalaska ANVSA
711,,,7705,250,1,3,1,1,0,1,1,1,0,0,0,0,0,0,3,1,2,Uyak ANVSA
712,,,7725,250,205,95,205,205,1,204,203,12,0,191,0,0,0,1,95,83,12,Venetie ANVSA
713,,,7735,250,628,177,628,628,3,625,624,21,4,599,0,0,0,1,177,156,21,Wainwright ANVSA
714,,,7740,250,168,89,168,168,3,165,160,8,0,146,3,2,1,5,89,43,46,Wales ANVSA
715,,,7745,250,185,93,185,185,0,185,183,12,0,171,0,0,0,2,93,67,26,White Mountain ANVSA
716,,,7755,250,1173,588,1173,1173,45,1128,974,685,0,259,20,2,8,154,588,521,67,Wrangell ANVSA
717,,,7765,250,657,382,657,657,28,629,531,246,2,250,32,1,0,98,382,265,117,Yakutat ANVSA
718,,,8100,250,2572,1396,2572,2572,58,2514,2391,2321,32,6,20,0,12,123,1396,1090,306,Cayuga Nation TDSA
719,,,8150,250,3239,1522,3239,3239,48,3191,3066,1391,1248,395,7,2,23,125,1522,1449,73,Chickahominy TDSA
720,,,8160,250,193,90,193,193,2,191,179,147,9,22,0,0,1,12,90,90,0,Eastern Chickahominy TDSA
721,,,8300,250,27,8,27,27,1,26,23,23,0,0,0,0,0,3,8,5,3,Ione Band of Miwok TDSA
722,,,8450,250,3227,1306,3227,3227,934,2293,2112,1730,63,114,166,18,21,181,1306,1244,62,Mechoopda TDSA
723,,,8700,250,1638,758,1638,1638,40,1598,1559,798,719,31,3,0,8,39,758,702,56,Rappahannock TDSA
724,,,8750,250,41102,25725,41102,41102,2580,38522,36189,34713,173,263,715,65,260,2333,25725,18857,6868,Samish TDSA
725,,,9100,250,4,3,4,4,0,4,4,0,0,4,0,0,0,0,3,2,1,Golden Hill Paugussett (state) Reservation
726,,,9150,250,5,1,5,5,4,1,0,0,0,0,0,0,0,1,1,1,0,Hassanamisco (state) Reservation
727,,,9230,250,48,30,48,48,4,44,42,8,0,34,0,0,0,2,30,21,9,Mattaponi (state) Reservation
728,,,9240,250,107,54,107,107,4,103,95,6,1,84,0,2,2,8,54,43,11,MOWA Choctaw (state) Reservation
729,,,9260,250,114,59,114,114,12,102,93,42,0,51,0,0,0,9,59,57,2,Pamunkey (state) Reservation
730,,,9280,250,44,20,44,44,4,40,35,17,0,16,1,0,1,5,20,15,5,Paucatuck Eastern Pequot (state) Reservation
731,,,9300,250,436,159,436,436,87,349,304,34,55,215,0,0,0,45,159,150,9,Poospatuck (state) Reservation
732,,,9350,250,0,0,0,0,0,0,0,0,0,0,0,0,0,0,0,0,0,Schaghticoke (state) Reservation
733,,,9370,250,819,349,819,819,47,772,744,28,30,684,2,0,0,28,349,300,49,Shinnecock (state) Reservation
734,,,9400,250,14,11,14,14,0,14,5,5,0,0,0,0,0,9,11,9,2,Tama (state) Reservation
735,,,9510,250,2026,1180,2026,2026,64,1962,1872,1453,348,25,4,2,40,90,1180,915,265,Adai Caddo SDTSA
736,,,9515,250,5054,3168,5054,5054,257,4797,4410,2387,752,1244,17,4,6,387,3168,2157,1011,Apache Choctaw SDTSA
737,,,9520,250,14195,6381,14195,14195,1402,12793,12232,11124,224,752,120,1,11,561,6381,5541,840,Bayou Lafourche SDTSA
738,,,9525,250,1015,491,1015,1015,13,1002,981,336,626,10,8,0,1,21,491,414,77,Beaver Creek SDTSA
739,,,9550,250,85009,39923,85009,85009,3712,81297,77994,50058,26325,234,1036,42,299,3303,39923,35867,4056,Cher-O-Creek SDTSA
740,,,9560,250,13170,5504,13170,13170,2019,11151,10668,10303,147,69,120,7,22,483,5504,5105,399,Cherokee Tribe of Northeast Alabama SDTSA
741,,,9630,250,349,196,349,349,7,342,329,236,13,76,1,0,3,13,196,185,11,Clifton Choctaw SDTSA
742,,,9635,250,58504,25262,58504,58504,7501,51003,48449,30939,15684,927,555,69,275,2554,25262,22775,2487,Coharie SDTSA
743,,,9680,250,57896,24208,57896,57896,2168,55728,51688,43401,5905,1604,525,49,204,4040,24208,22456,1752,Echota Cherokee SDTSA
744,,,9690,250,4242,1733,4242,4242,184,4058,3863,2651,987,208,2,1,14,195,1733,1550,183,Edisto Natchez Kusso SDTSA
745,,,9720,250,28785,13625,28785,28785,1963,26822,25156,17467,6602,272,573,83,159,1666,13625,11681,1944,Four Winds Cherokee SDTSA
746,,,9730,250,6340,2609,6340,6340,243,6097,5801,5694,33,25,31,1,17,296,2609,2394,215,Georgia Tribe of Eastern Cherokee SDTSA
747,,,9735,250,8884,4166,8884,8884,376,8508,8059,5973,592,1418,61,0,15,449,4166,3230,936,Grand Caillou/Dulac SDTSA
748,,,9745,250,6947,3576,6947,6947,146,6801,6505,857,3502,2117,9,1,19,296,3576,3000,576,Haliwa-Saponi SDTSA
749,,,9775,250,737,321,737,737,39,698,670,299,298,63,5,0,5,28,321,241,80,Isle de Jean Charles SDTSA
750,,,9800,250,666,298,666,666,52,614,577,428,67,68,12,0,2,37,298,274,24,Lenape Indian Tribe of Delaware SDTSA
751,,,9815,250,510711,218617,510711,510711,54442,456269,427660,181881,175999,55491,9990,1381,2918,28609,218617,198296,20321,Lumbee SDTSA
752,,,9820,250,22131,10222,22131,22131,1430,20701,19763,18006,1334,247,97,12,67,938,10222,8829,1393,MaChis Lower Creek SDTSA
753,,,9825,250,6901,3513,6901,6901,148,6753,6548,1475,4874,110,58,2,29,205,3513,2931,582,Meherrin SDTSA
754,,,9830,250,9971,5302,9971,9971,791,9180,8713,7616,727,162,166,4,38,467,5302,4324,978,Nanticoke Indian Tribe SDTSA
755,,,9835,250,5171,2136,5171,5171,996,4175,3936,1299,2381,219,16,0,21,239,2136,1887,249,Nanticoke Lenni Lenape SDTSA
756,,,9836,250,26528,12424,26528,26528,1174,25354,24414,11417,12509,144,153,11,180,940,12424,10590,1834,Natchitoches SDTSA
757,,,9838,250,8812,3817,8812,8812,864,7948,7574,5346,2084,43,48,0,53,374,3817,3532,285,Occaneechi-Saponi SDTSA
758,,,9844,250,2767,694,2767,2767,267,2500,2419,836,1493,76,7,0,7,81,694,575,119,Pee Dee SDTSA
759,,,9849,250,4579,1828,4579,4579,177,4402,4068,3088,106,849,21,2,2,334,1828,1625,203,Pointe-au-Chien SDTSA
760,,,9850,250,828,288,828,828,107,721,638,389,55,125,57,0,12,83,288,281,7,Ramapough SDTSA
761,,,9865,250,2343,1161,2343,2343,68,2275,2190,1550,544,70,1,2,23,85,1161,984,177,Sappony SDTSA
762,,,9875,250,452,203,452,452,5,447,419,167,220,32,0,0,0,28,203,143,60,Santee SDTSA
763,,,9880,250,5482,2800,5482,5482,207,5275,5081,2927,2058,37,40,3,16,194,2800,2475,325,Southeastern Mvskoke Nation SDTSA
764,,,9950,250,6184,3010,6184,6184,403,5781,5524,4790,642,24,60,0,8,257,3010,2717,293,United Cherokee Ani-Yun-Wiya Nation SDTSA
765,,,9960,250,186056,78821,186056,186056,13877,172179,164913,120983,35892,5259,2255,76,448,7266,78821,70910,7911,United Houma Nation SDTSA
766,,,9963,250,1292,530,1292,1292,62,1230,1178,586,480,101,4,0,7,52,530,477,53,Upper South Carolina Pee Dee SDTSA
767,,,9967,250,39,10,39,39,6,33,31,28,1,0,2,0,0,2,10,7,3,Waccamaw SDTSA
768,,,9970,250,1482,687,1482,1482,15,1467,1416,240,187,981,2,0,6,51,687,604,83,Waccamaw Siouan SDTSA
769,,,9975,250,6269,3108,6269,6269,598,5671,5235,3683,1345,63,101,0,43,436,3108,2458,650,Wassamasaw SDTSA
770,,,0010R,252,3224,1148,3224,3224,79,3145,3097,65,8,3020,4,0,0,48,1148,868,280,Acoma Pueblo
771,,,0020R,252,26849,25040,26849,26849,4331,22518,21643,19622,704,213,961,42,101,875,25040,15523,9517,Agua Caliente Indian Reservation
772,,,0050R,252,579,210,579,579,39,540,525,31,1,493,0,0,0,15,210,193,17,Alabama-Coushatta Reservation
773,,,0080R,252,6664,3245,6664,6664,266,6398,5778,3830,68,1847,21,0,12,620,3245,2786,459,Allegany Reservation
774,,,0095R,252,3,1,3,3,1,2,1,0,0,1,0,0,0,1,1,1,0,Alturas Indian Rancheria
775,,,0110R,252,1562,625,1562,1562,46,1516,1320,151,4,1161,0,4,0,196,625,560,65,Annette Island Reserve
776,,,0120R,252,0,0,0,0,0,0,0,0,0,0,0,0,0,0,0,0,0,Auburn Rancheria
777,,,0125R,252,0,0,0,0,0,0,0,0,0,0,0,0,0,0,0,0,0,Augustine Reservation
778,,,0140R,252,1545,625,1545,1545,67,1478,1420,294,4,1121,0,1,0,58,625,551,74,Bad River Reservation
779,,,0155R,252,756,255,756,756,114,642,601,80,1,516,4,0,0,41,255,249,6,Barona Reservation
780,,,0165R,252,142,65,142,142,29,113,108,10,0,96,0,1,1,5,65,49,16,Battle Mountain Reservation
781,,,0170R,252,1027,405,1027,1027,17,1010,906,145,5,755,1,0,0,104,405,376,29,Bay Mills Reservation
782,,,0185R,252,75,29,75,75,10,65,58,37,0,19,0,0,2,7,29,24,5,Benton Paiute Reservation
783,,,0200R,252,4,2,4,4,2,2,0,0,0,0,0,0,0,2,2,2,0,Berry Creek Rancheria
784,,,0215R,252,5,2,5,5,2,3,3,1,0,2,0,0,0,0,2,2,0,Big Bend Rancheria
785,,,0225R,252,239,148,239,239,93,146,132,66,12,53,1,0,0,14,148,135,13,Big Cypress Reservation
786,,,0240R,252,17,7,17,17,0,17,17,0,0,17,0,0,0,0,7,7,0,Big Lagoon Rancheria
787,,,0250R,252,571,221,571,571,63,508,473,58,0,413,2,0,0,35,221,199,22,Big Pine Reservation
788,,,0265R,252,175,47,175,175,33,142,138,8,0,130,0,0,0,4,47,45,2,Big Sandy Rancheria
789,,,0275R,252,191,58,191,191,24,167,158,11,0,145,0,1,1,9,58,50,8,Big Valley Rancheria
790,,,0290R,252,1907,693,1907,1907,387,1520,1436,223,0,1200,4,3,6,84,693,649,44,Bishop Reservation
791,,,0305R,252,10764,3630,10764,10764,207,10557,10130,1190,10,8903,13,11,3,427,3630,3166,464,Blackfeet Indian Reservation
792,,,0325R,252,72,30,72,72,2,70,55,34,1,20,0,0,0,15,30,30,0,Blue Lake Rancheria
793,,,0335R,252,902,502,902,902,17,885,825,207,1,617,0,0,0,60,502,339,163,Bois Forte Reservation
794,,,0350R,252,46,26,46,46,11,35,31,15,2,14,0,0,0,4,26,18,8,Bridgeport Reservation
795,,,0360R,252,438,242,438,438,84,354,324,134,40,148,0,0,2,30,242,133,109,Brighton Reservation
796,,,0400R,252,130,50,130,130,14,116,97,1,0,96,0,0,0,19,50,43,7,Burns Paiute Indian Colony
797,,,0415R,252,192,38,192,192,58,134,129,63,17,21,25,0,3,5,38,27,11,Cabazon Reservation
798,,,0435R,252,229,63,229,229,11,218,217,9,3,204,1,0,0,1,63,63,0,Cahuilla Reservation
799,,,0440R,252,291,97,291,291,32,259,231,38,15,177,0,1,0,28,97,91,6,Campbell Ranch
800,,,0450R,252,398,133,398,398,84,314,288,63,6,219,0,0,0,26,133,129,4,Campo Indian Reservation
801,,,0495R,252,0,0,0,0,0,0,0,0,0,0,0,0,0,0,0,0,0,Capitan Grande Reservation
802,,,0510R,252,238,84,238,238,16,222,211,19,0,192,0,0,0,11,84,82,2,Carson Colony
803,,,0525R,252,849,320,849,849,32,817,715,160,2,552,0,0,1,102,320,299,21,Catawba Reservation
804,,,0540R,252,2676,1192,2676,2676,92,2584,2438,774,38,1617,0,3,6,146,1192,1032,160,Cattaraugus Reservation
805,,,0555R,252,15,9,15,15,1,14,14,4,0,10,0,0,0,0,9,9,0,Cedarville Rancheria
806,,,0575R,252,680,227,680,680,42,638,609,158,7,444,0,0,0,29,227,216,11,Chehalis Reservation
807,,,0585R,252,464,723,464,464,72,392,377,122,1,245,4,4,1,15,723,194,529,Chemehuevi Reservation
808,,,0605R,252,7633,2796,7633,7633,113,7520,7244,1239,9,5978,9,3,6,276,2796,2437,359,Cheyenne River Reservation
809,,,0620R,252,4,1,4,4,4,0,0,0,0,0,0,0,0,0,1,0,1,Chicken Ranch Rancheria
810,,,0635R,252,644,250,644,644,15,629,594,180,8,404,0,0,2,35,250,250,0,Chitimacha Reservation
811,,,0680R,252,1517,681,1517,1517,428,1089,1053,329,6,705,9,0,4,36,681,600,81,Pueblo de Cochiti
812,,,0695R,252,857,685,857,857,104,753,722,285,8,427,0,0,2,31,685,342,343,Cocopah Reservation
813,,,0705R,252,7567,4728,7567,7567,279,7288,6929,5638,9,1197,21,7,57,359,4728,3016,1712,Coeur d'Alene Reservation
814,,,0720R,252,79,31,79,79,16,63,56,27,0,29,0,0,0,7,31,31,0,Cold Springs Rancheria
815,,,0735R,252,8431,5306,8431,8431,2861,5570,5250,2774,72,2332,57,8,7,320,5306,3037,2269,Colorado River Indian Reservation
816,,,0750R,252,91,24,91,91,2,89,88,5,0,83,0,0,0,1,24,23,1,Colusa Rancheria
817,,,0760R,252,7804,3117,7804,7804,849,6955,6545,1751,12,4707,29,7,39,410,3117,2755,362,Colville Reservation
818,,,0770R,252,0,0,0,0,0,0,0,0,0,0,0,0,0,0,0,0,0,"Coos, Lower Umpqua, and Siuslaw Reservation"
819,,,0775R,252,343,174,343,343,7,336,293,168,0,125,0,0,0,43,174,169,5,Coquille Reservation
820,,,0780R,252,8,3,8,8,1,7,5,0,0,4,1,0,0,2,3,3,0,Cortina Indian Rancheria
821,,,0795R,252,34,8,34,34,5,29,21,7,2,12,0,0,0,8,8,8,0,Coushatta Reservation
822,,,0815R,252,177,74,177,177,7,170,157,107,0,50,0,0,0,13,74,74,0,Cow Creek Reservation
823,,,0820R,252,0,0,0,0,0,0,0,0,0,0,0,0,0,0,0,0,0,Cowlitz Reservation
824,,,0825R,252,126,41,126,126,13,113,103,3,0,99,1,0,0,10,41,41,0,Coyote Valley Reservation
825,,,0845R,252,6932,2146,6932,6932,112,6820,6621,1204,4,5400,8,4,1,199,2146,1903,243,Crow Reservation
826,,,0855R,252,2054,570,2054,2054,22,2032,1961,160,2,1795,3,1,0,71,570,508,62,Crow Creek Reservation
827,,,0940R,252,403,141,403,403,24,379,364,11,0,352,1,0,0,15,141,134,7,Dresslerville Colony
828,,,0955R,252,0,0,0,0,0,0,0,0,0,0,0,0,0,0,0,0,0,Dry Creek Rancheria
829,,,0965R,252,1338,527,1338,1338,47,1291,1256,54,3,1185,3,9,2,35,527,482,45,Duck Valley Reservation
830,,,0975R,252,159,75,159,159,14,145,135,14,1,119,1,0,0,10,75,68,7,Duckwater Reservation
831,,,0990R,252,9233,3802,9233,9233,528,8705,8121,1129,50,6882,46,2,12,584,3802,3306,496,Eastern Cherokee Reservation
832,,,1005R,252,723,282,723,723,111,612,583,36,0,544,0,2,1,29,282,267,15,Elko Colony
833,,,1010R,252,93,37,93,93,4,89,82,30,0,52,0,0,0,7,37,27,10,Elk Valley Rancheria
834,,,1040R,252,240,87,240,240,31,209,175,28,0,144,3,0,0,34,87,73,14,Ely Reservation
835,,,1055R,252,4,6,4,4,4,0,0,0,0,0,0,0,0,0,6,5,1,Enterprise Rancheria
836,,,1065R,252,5,1,5,5,2,3,2,1,0,1,0,0,0,1,1,1,0,Ewiiaapaayp Reservation
837,,,1070R,252,98,45,98,98,5,93,85,8,0,77,0,0,0,8,45,40,5,Fallon Paiute-Shoshone Colony
838,,,1075R,252,672,268,672,672,42,630,570,83,0,487,0,0,0,60,268,249,19,Fallon Paiute-Shoshone Reservation
839,,,1100R,252,415,160,415,415,6,409,338,15,2,318,3,0,0,71,160,142,18,Flandreau Reservation
840,,,1110R,252,30849,15422,30849,30849,1162,29687,26942,19254,75,7336,141,23,113,2745,15422,12351,3071,Flathead Reservation
841,,,1125R,252,4180,1708,4180,4180,100,4080,3792,2068,18,1697,5,0,4,288,1708,1496,212,Fond du Lac Reservation
842,,,1135R,252,576,206,576,576,26,550,522,83,2,437,0,0,0,28,206,186,20,Forest County Potawatomi Community
843,,,1140R,252,14340,3977,14340,14340,173,14167,14033,174,15,13766,68,3,7,134,3977,3473,504,Fort Apache Reservation
844,,,1150R,252,3382,1075,3382,3382,76,3306,3224,123,8,3086,4,0,3,82,1075,999,76,Fort Belknap Reservation
845,,,1160R,252,8350,4116,8350,8350,528,7822,7300,1753,104,5345,84,0,14,522,4116,2861,1255,Fort Berthold Reservation
846,,,1170R,252,97,59,97,97,14,83,78,13,0,65,0,0,0,5,59,50,9,Fort Bidwell Reservation
847,,,1185R,252,5976,2093,5976,5976,579,5397,5230,1500,1,3689,14,3,23,167,2093,1924,169,Fort Hall Reservation
848,,,1195R,252,94,50,94,94,11,83,56,21,0,30,4,1,0,27,50,40,10,Fort Independence Reservation
849,,,1210R,252,267,112,267,267,9,258,252,3,0,249,0,0,0,6,112,96,16,Fort McDermitt Indian Reservation
850,,,1220R,252,1152,347,1152,1152,156,996,947,70,2,875,0,0,0,49,347,330,17,Fort McDowell Yavapai Nation Reservation
851,,,1235R,252,1460,667,1460,1460,273,1187,1118,566,7,517,5,9,14,69,667,578,89,Fort Mojave Reservation
852,,,1250R,252,9988,3582,9988,9988,226,9762,9115,2531,28,6487,51,0,18,647,3582,3218,364,Fort Peck Indian Reservation
853,,,1260R,252,52,28,52,52,4,48,44,0,8,35,1,0,0,4,28,17,11,Fort Pierce Reservation
854,,,1270R,252,0,0,0,0,0,0,0,0,0,0,0,0,0,0,0,0,0,Fort Sill Apache Indian Reservation
855,,,1280R,252,1898,718,1898,1898,473,1425,1348,118,5,1208,1,0,16,77,718,610,108,Fort Yuma Indian Reservation
856,,,1310R,252,14053,3516,14053,14053,1690,12363,12162,137,23,11991,5,0,6,201,3516,3433,83,Gila River Indian Reservation
857,,,1340R,252,116,63,116,116,9,107,101,13,0,86,2,0,0,6,63,36,27,Goshute Reservation
858,,,1355R,252,618,328,618,618,11,607,543,150,1,386,5,1,0,64,328,266,62,Grand Portage Reservation
859,,,1365R,252,604,263,604,604,47,557,510,109,1,398,2,0,0,47,263,238,25,Grand Ronde Community
860,,,1370R,252,5,1,5,5,0,5,4,0,0,4,0,0,0,1,1,1,0,Grand Traverse Reservation
861,,,1380R,252,28,16,28,28,12,16,13,1,0,10,0,2,0,3,16,16,0,Greenville Rancheria
862,,,1395R,252,188,54,188,188,9,179,172,12,0,160,0,0,0,7,54,52,2,Grindstone Indian Rancheria
863,,,1400R,252,50,16,50,50,2,48,41,6,0,35,0,0,0,7,16,16,0,Guidiville Rancheria
864,,,1410R,252,325,129,325,325,7,318,284,47,0,237,0,0,0,34,129,122,7,Hannahville Indian Community
865,,,1440R,252,214,47,214,214,10,204,200,19,5,175,0,1,0,4,47,47,0,Havasupai Reservation
866,,,1450R,252,847,285,847,847,37,810,762,39,9,714,0,0,0,48,285,248,37,Ho-Chunk Nation Reservation
867,,,1460R,252,93,27,93,93,10,83,73,4,0,69,0,0,0,10,27,22,5,Hoh Indian Reservation
868,,,1475R,252,1426,781,1426,1426,439,987,932,493,62,328,46,0,3,55,781,605,176,Hollywood Reservation
869,,,1490R,252,3173,1044,3173,3173,131,3042,2875,261,1,2603,3,0,7,167,1044,999,45,Hoopa Valley Reservation
870,,,1505R,252,6270,2443,6270,6270,56,6214,6167,84,14,6041,25,0,3,47,2443,1863,580,Hopi Reservation
871,,,1515R,252,249,80,249,249,43,206,194,29,1,164,0,0,0,12,80,80,0,Hopland Rancheria
872,,,1530R,252,219,86,219,219,5,214,198,36,2,160,0,0,0,16,86,86,0,Houlton Maliseet Reservation
873,,,1545R,252,1299,405,1299,1299,70,1229,1215,18,5,1185,4,0,3,14,405,345,60,Hualapai Indian Reservation
874,,,1550R,252,60,24,60,60,2,58,51,15,3,28,0,0,5,7,24,24,0,Huron Potawatomi Reservation
875,,,1555R,252,197,69,197,197,93,104,84,10,29,42,1,0,2,20,69,69,0,Immokalee Reservation
876,,,1560R,252,0,0,0,0,0,0,0,0,0,0,0,0,0,0,0,0,0,Inaja and Cosmit Reservation
877,,,1575R,252,760,298,760,760,15,745,694,78,0,612,0,0,4,51,298,273,25,Indian Township Reservation
878,,,1590R,252,181,81,181,181,5,176,155,58,0,97,0,0,0,21,81,69,12,Iowa (KS-NE) Reservation
879,,,1610R,252,25473,11516,25473,25473,1167,24306,22989,20901,326,1452,225,10,75,1317,11516,10441,1075,Isabella Reservation
880,,,1625R,252,3376,1387,3376,3376,422,2954,2882,87,4,2771,6,2,12,72,1387,1271,116,Isleta Pueblo
881,,,1640R,252,0,0,0,0,0,0,0,0,0,0,0,0,0,0,0,0,0,Jackson Rancheria
882,,,1655R,252,0,0,0,0,0,0,0,0,0,0,0,0,0,0,0,0,0,Jamestown S'Klallam Reservation
883,,,1670R,252,0,0,0,0,0,0,0,0,0,0,0,0,0,0,0,0,0,Jamul Indian Village
884,,,1685R,252,1991,556,1991,1991,18,1973,1956,2,0,1953,1,0,0,17,556,527,29,Jemez Pueblo
885,,,1690R,252,26,17,26,26,0,26,16,6,1,6,0,2,1,10,17,17,0,Jena Band of Choctaw Reservation
886,,,1700R,252,3488,1380,3488,3488,401,3087,3034,54,27,2882,47,1,23,53,1380,1125,255,Jicarilla Apache Nation Reservation
887,,,1720R,252,221,99,221,221,14,207,200,18,6,175,0,0,1,7,99,78,21,Kaibab Indian Reservation
888,,,1735R,252,223,71,223,223,10,213,188,40,0,147,0,0,1,25,71,69,2,Kalispel Reservation
889,,,1750R,252,39,16,39,39,0,39,33,0,0,33,0,0,0,6,16,16,0,Karuk Reservation
890,,,1770R,252,3849,1794,3849,3849,169,3680,3484,2837,28,597,9,6,7,196,1794,1467,327,Kickapoo (KS) Reservation
891,,,1775R,252,362,111,362,362,21,341,341,6,0,335,0,0,0,0,111,104,7,Kickapoo (TX) Reservation
892,,,1785R,252,25,21,25,25,4,21,16,0,1,15,0,0,0,5,21,14,7,Klamath Reservation
893,,,1800R,252,63,25,63,63,5,58,54,0,0,54,0,0,0,4,25,20,5,Kootenai Reservation
894,,,1815R,252,2959,2100,2959,2959,48,2911,2748,628,7,2106,0,2,5,163,2100,1109,991,Lac Courte Oreilles Reservation
895,,,1825R,252,3518,3202,3518,3518,96,3422,3314,1303,7,2001,0,0,3,108,3202,1340,1862,Lac du Flambeau Reservation
896,,,1830R,252,221,82,221,221,3,218,207,15,1,188,0,0,3,11,82,78,4,Lac Vieux Desert Reservation
897,,,1840R,252,3985,1327,3985,3985,149,3836,3789,22,0,3628,2,6,131,47,1327,1182,145,Laguna Pueblo
898,,,1850R,252,145,64,145,145,36,109,103,19,0,83,1,0,0,6,64,64,0,La Jolla Reservation
899,,,1860R,252,11043,5279,11043,11043,426,10617,10131,5422,35,4621,34,0,19,486,5279,4005,1274,Lake Traverse Reservation
900,,,1880R,252,3274,1794,3274,3274,35,3239,2901,1946,5,934,0,1,15,338,1794,1423,371,L'Anse Reservation
901,,,1895R,252,50,12,50,50,11,39,28,7,1,20,0,0,0,11,12,12,0,La Posta Indian Reservation
902,,,1915R,252,106,32,106,106,15,91,84,11,5,67,1,0,0,7,32,29,3,Las Vegas Indian Colony
903,,,1925R,252,154,53,154,154,5,149,144,9,0,135,0,0,0,5,53,46,7,Laytonville Rancheria
904,,,1940R,252,11388,7229,11388,11388,199,11189,10523,5592,17,4875,15,0,24,666,7229,4226,3003,Leech Lake Reservation
905,,,1955R,252,0,0,0,0,0,0,0,0,0,0,0,0,0,0,0,0,0,Likely Rancheria
906,,,1960R,252,8,1,8,8,0,8,7,0,0,4,0,0,3,1,1,0,1,Little River Reservation
907,,,1963R,252,83,36,83,83,6,77,64,20,0,43,0,1,0,13,36,36,0,Little Traverse Bay Reservation
908,,,1970R,252,242,106,242,242,15,227,220,26,0,193,1,0,0,7,106,106,0,Lone Pine Reservation
909,,,1980R,252,11,4,11,11,4,7,6,1,0,5,0,0,0,1,4,4,0,Lookout Rancheria
910,,,1995R,252,15,27,15,15,7,8,8,2,1,3,2,0,0,0,27,6,21,Los Coyotes Reservation
911,,,2015R,252,95,37,95,95,12,83,76,16,0,60,0,0,0,7,37,28,9,Lovelock Indian Colony
912,,,2030R,252,1627,418,1627,1627,22,1605,1570,40,1,1524,4,1,0,35,418,387,31,Lower Brule Reservation
913,,,2040R,252,316,114,316,316,16,300,279,30,1,245,3,0,0,21,114,109,5,Lower Elwha Reservation
914,,,2055R,252,534,154,534,534,54,480,440,45,1,393,0,0,1,40,154,153,1,Lower Sioux Indian Community
915,,,2070R,252,5748,2368,5748,5748,359,5389,5052,2155,32,2789,51,7,18,337,2368,1989,379,Lummi Reservation
916,,,2075R,252,0,0,0,0,0,0,0,0,0,0,0,0,0,0,0,0,0,Lytton Rancheria
917,,,2085R,252,1692,616,1692,1692,148,1544,1441,121,4,1306,7,3,0,103,616,596,20,Makah Indian Reservation
918,,,2100R,252,188,67,188,188,58,130,120,20,0,100,0,0,0,10,67,62,5,Manchester-Point Arena Rancheria
919,,,2115R,252,101,36,101,101,4,97,95,5,0,89,1,0,0,2,36,36,0,Manzanita Reservation
920,,,2130R,252,1070,311,1070,1070,265,805,774,17,8,748,1,0,0,31,311,300,11,Maricopa (Ak Chin) Indian Reservation
921,,,2145R,252,410,135,410,410,20,390,349,36,23,285,3,0,2,41,135,132,3,Mashantucket Pequot Reservation
922,,,2150R,252,0,0,0,0,0,0,0,0,0,0,0,0,0,0,0,0,0,Match-e-be-nash-she-wish Band of Pottawatomi Reservation
923,,,2175R,252,3032,954,3032,3032,69,2963,2912,110,2,2800,0,0,0,51,954,874,80,Menominee Reservation
924,,,2190R,252,87,24,87,87,21,66,62,7,0,55,0,0,0,4,24,21,3,Mesa Grande Reservation
925,,,2205R,252,4022,1189,4022,4022,425,3597,3540,82,5,3444,5,0,4,57,1189,1136,53,Mescalero Reservation
926,,,2240R,252,535,107,535,535,533,2,2,0,0,0,2,0,0,0,107,100,7,Miccosukee Reservation
927,,,2255R,252,33,20,33,33,4,29,27,2,0,25,0,0,0,2,20,20,0,Middletown Rancheria
928,,,2270R,252,4618,3147,4618,4618,126,4492,4253,2860,11,1353,15,0,14,239,3147,1975,1172,Mille Lacs Reservation
929,,,2300R,252,7749,2120,7749,7749,140,7609,7272,252,152,6866,2,0,0,337,2120,2049,71,Mississippi Choctaw Reservation
930,,,2315R,252,234,97,234,234,37,197,185,15,0,165,5,0,0,12,97,88,9,Moapa River Indian Reservation
931,,,2320R,252,212,91,212,212,12,200,184,69,5,104,0,0,6,16,91,71,20,Mohegan Reservation
932,,,2330R,252,33,15,33,33,1,32,28,5,0,23,0,0,0,4,15,14,1,Montgomery Creek Rancheria
933,,,2340R,252,131,44,131,131,25,106,80,14,3,63,0,0,0,26,44,44,0,Mooretown Rancheria
934,,,2360R,252,1243,442,1243,1243,343,900,822,120,8,668,21,4,1,78,442,379,63,Morongo Reservation
935,,,2375R,252,4366,1504,4366,4366,919,3447,3154,1282,149,1404,197,98,24,293,1504,1431,73,Muckleshoot Reservation
936,,,2400R,252,1840,885,1840,1840,1013,827,773,320,10,422,9,6,6,54,885,805,80,Nambe Pueblo
937,,,2415R,252,0,0,0,0,0,0,0,0,0,0,0,0,0,0,0,0,0,Narragansett Reservation
938,,,2430R,252,140766,49485,140766,140766,2172,138594,136577,2392,225,133244,612,44,60,2017,49485,42711,6774,Navajo Nation Reservation
939,,,2445R,252,18403,8674,18403,18403,669,17734,16994,14452,62,2337,66,5,72,740,8674,7433,1241,Nez Perce Reservation
940,,,2460R,252,639,193,639,639,70,569,534,134,7,381,8,4,0,35,193,188,5,Nisqually Reservation
941,,,2475R,252,0,0,0,0,0,0,0,0,0,0,0,0,0,0,0,0,0,Nooksack Reservation
942,,,2490R,252,4450,1317,4450,4450,114,4336,4190,217,5,3964,3,1,0,146,1317,1163,154,Northern Cheyenne Indian Reservation
943,,,2495R,252,34,13,34,34,0,34,33,4,0,29,0,0,0,1,13,13,0,North Fork Rancheria
944,,,2505R,252,0,0,0,0,0,0,0,0,0,0,0,0,0,0,0,0,0,Northwestern Shoshone Reservation
945,,,2510R,252,6580,2594,6580,6580,4376,2204,2113,487,20,1542,38,2,24,91,2594,2447,147,Ohkay Owingeh
946,,,2535R,252,20,11,20,20,1,19,15,10,0,1,1,0,3,4,11,7,4,Oil Springs Reservation
947,,,2550R,252,4526,1563,4526,4526,187,4339,4275,2117,10,2121,11,3,13,64,1563,1416,147,Omaha Reservation
948,,,2555R,252,62877,28843,62877,62877,1212,61665,59046,57463,522,508,376,16,161,2619,28843,26091,2752,Oneida Nation Reservation
949,,,2560R,252,27110,10647,27110,27110,1380,25730,24393,19115,394,4173,631,15,65,1337,10647,10237,410,Oneida (WI) Reservation
950,,,2570R,252,831,518,831,831,56,775,769,450,1,277,0,0,41,6,518,501,17,Onondaga Nation Reservation
951,,,2580R,252,0,12,0,0,0,0,0,0,0,0,0,0,0,0,12,2,10,Ontonagon Reservation
952,,,2595R,252,45818,19602,45818,45818,1872,43946,38887,27443,4796,6405,128,19,96,5059,19602,17554,2048,Osage Reservation
953,,,2625R,252,230,94,230,230,25,205,181,9,2,167,1,0,2,24,94,48,46,Paiute (UT) Reservation
954,,,2635R,252,1541,475,1541,1541,633,908,854,85,3,758,4,1,3,54,475,445,30,Pala Reservation
955,,,2680R,252,3466,892,3466,3466,849,2617,2566,36,8,2518,0,2,2,51,892,865,27,Pascua Pueblo Yaqui Reservation
956,,,2685R,252,6,3,6,6,3,3,2,1,0,0,1,0,0,1,3,3,0,Paskenta Rancheria
957,,,2715R,252,179,64,179,179,17,162,162,6,0,151,3,2,0,0,64,62,2,Pauma and Yuima Reservation
958,,,2745R,252,582,221,582,582,156,426,399,58,2,331,6,0,2,27,221,196,25,Pechanga Reservation
959,,,2760R,252,370,173,370,370,18,352,291,40,0,251,0,0,0,61,173,161,12,Penobscot Reservation
960,,,2775R,252,53,16,53,53,3,50,49,3,0,46,0,0,0,1,16,13,3,Picayune Rancheria
961,,,2785R,252,1623,866,1623,1623,1190,433,405,204,0,185,3,0,13,28,866,703,163,Picuris Pueblo
962,,,2810R,252,18850,5141,18850,18850,535,18315,17766,1707,37,15963,51,1,7,549,5141,4751,390,Pine Ridge Reservation
963,,,2820R,252,142,46,142,142,32,110,101,19,0,82,0,0,0,9,46,44,2,Pinoleville Rancheria
964,,,2850R,252,692,300,692,692,20,672,591,275,0,313,0,0,3,81,300,287,13,Pleasant Point Reservation
965,,,2865R,252,185,87,185,185,7,178,169,36,6,127,0,0,0,9,87,72,15,Poarch Creek Reservation
966,,,2890R,252,6,2,6,6,2,4,2,0,2,0,0,0,0,2,2,2,0,Pokagon Reservation
967,,,2910R,252,745,217,745,745,44,701,661,72,2,584,3,0,0,40,217,214,3,Port Gamble Reservation
968,,,2925R,252,7929,3626,7929,7929,501,7428,6816,5812,51,689,193,22,49,612,3626,3251,375,Port Madison Reservation
969,,,2980R,252,1529,575,1529,1529,104,1425,1250,502,0,742,0,5,1,175,575,498,77,Prairie Band of Potawatomi Nation Reservation
970,,,2985R,252,161,59,161,161,11,150,138,9,3,124,1,0,1,12,59,54,5,Prairie Island Indian Community
971,,,2990R,252,3529,1645,3529,3529,2221,1308,1231,806,13,372,18,2,20,77,1645,1495,150,Pueblo of Pojoaque
972,,,3000R,252,54402,20233,54402,54402,7823,46579,41855,27431,4253,1235,6936,1718,282,4724,20233,19433,800,Puyallup Reservation
973,,,3010R,252,1933,746,1933,1933,167,1766,1680,327,7,1335,6,5,0,86,746,690,56,Pyramid Lake Paiute Reservation
974,,,3020R,252,112,57,112,112,5,107,100,67,0,32,1,0,0,7,57,50,7,Quartz Valley Reservation
975,,,3030R,252,404,157,404,404,28,376,352,33,1,316,1,1,0,24,157,147,10,Quileute Reservation
976,,,3040R,252,1520,478,1520,1520,128,1392,1335,144,11,1176,4,0,0,57,478,413,65,Quinault Reservation
977,,,3070R,252,0,0,0,0,0,0,0,0,0,0,0,0,0,0,0,0,0,Ramona Village
978,,,3085R,252,1362,595,1362,1362,75,1287,1227,160,1,1061,1,0,4,60,595,488,107,Red Cliff Reservation
979,,,3095R,252,40,14,40,40,3,37,37,5,0,32,0,0,0,0,14,11,3,Redding Rancheria
980,,,3100R,252,5506,1591,5506,5506,100,5406,5343,39,0,5302,1,0,1,63,1591,1492,99,Red Lake Reservation
981,,,3115R,252,237,95,237,237,47,190,169,104,0,62,3,0,0,21,95,93,2,Redwood Valley Rancheria
982,,,3130R,252,944,306,944,944,80,864,844,13,2,824,4,1,0,20,306,275,31,Reno-Sparks Indian Colony
983,,,3145R,252,33,14,33,33,9,24,21,8,0,13,0,0,0,3,14,6,8,Resighini Rancheria
984,,,3165R,252,1095,365,1095,1095,545,550,526,66,0,440,5,13,2,24,365,343,22,Rincon Reservation
985,,,3185R,252,19,5,19,19,1,18,16,1,0,15,0,0,0,2,5,5,0,Roaring Creek Rancheria
986,,,3195R,252,219,58,219,219,24,195,188,7,0,181,0,0,0,7,58,58,0,Robinson Rancheria
987,,,3205R,252,2007,507,2007,2007,36,1971,1946,24,0,1922,0,0,0,25,507,500,7,Rocky Boy's Reservation
988,,,3235R,252,9319,2875,9319,9319,222,9097,8862,685,10,8122,45,0,0,235,2875,2570,305,Rosebud Indian Reservation
989,,,3250R,252,103,41,103,103,7,96,92,6,0,86,0,0,0,4,41,40,1,Round Valley Reservation
990,,,3265R,252,41,31,41,41,19,22,14,14,0,0,0,0,0,8,31,14,17,Rumsey Indian Rancheria
991,,,3280R,252,1120,342,1120,1120,98,1022,927,30,2,890,2,0,3,95,342,301,41,Sac and Fox/Meskwaki Settlement
992,,,3285R,252,147,68,147,147,11,136,129,98,0,31,0,0,0,7,68,56,12,Sac and Fox Nation Reservation
993,,,3305R,252,633,223,633,633,5,628,542,69,2,470,0,1,0,86,223,207,16,St. Croix Reservation
994,,,3320R,252,3663,1370,3663,3663,30,3633,3569,129,2,3438,0,0,0,64,1370,1313,57,St. Regis Mohawk Reservation
995,,,3340R,252,6321,2041,6321,6321,1046,5275,5084,805,32,4228,11,2,6,191,2041,1924,117,Salt River Reservation
996,,,3355R,252,10251,2545,10251,10251,228,10023,9948,73,4,9860,0,6,5,75,2545,2387,158,San Carlos Reservation
997,,,3370R,252,4738,1855,4738,4738,3377,1361,1271,630,16,592,10,1,22,90,1855,1727,128,Sandia Pueblo
998,,,3400R,252,3686,935,3686,3686,523,3163,3136,196,9,2922,4,1,4,27,935,910,25,San Felipe Pueblo
999,,,3415R,252,1819,776,1819,1819,909,910,872,288,2,570,11,0,1,38,776,689,87,San Ildefonso Pueblo
1000,,,3445R,252,129,56,129,129,48,81,75,36,0,39,0,0,0,6,56,39,17,San Manuel Reservation
1001,,,3460R,252,1249,404,1249,1249,470,779,723,95,6,612,4,0,6,56,404,381,23,San Pasqual Reservation
1002,,,3480R,252,684,281,684,684,7,677,673,1,1,668,0,0,3,4,281,191,90,Santa Ana Pueblo
1003,,,3495R,252,11322,4966,11322,11322,8055,3267,3105,1561,63,1348,94,3,36,162,4966,4596,370,Santa Clara Pueblo
1004,,,3520R,252,898,244,898,898,219,679,661,17,0,637,3,0,4,18,244,220,24,Santa Rosa Rancheria
1005,,,3525R,252,131,36,131,131,14,117,114,6,1,106,1,0,0,3,36,29,7,Santa Rosa Reservation
1006,,,3540R,252,264,100,264,264,97,167,154,27,5,120,0,0,2,13,100,87,13,Santa Ynez Reservation
1007,,,3550R,252,263,106,263,263,19,244,244,19,3,222,0,0,0,0,106,102,4,Santa Ysabel Reservation
1008,,,3565R,252,974,366,974,974,17,957,923,176,0,743,4,0,0,34,366,274,92,Santee Reservation
1009,,,3585R,252,3160,666,3160,3160,335,2825,2812,11,0,2801,0,0,0,13,666,644,22,Santo Domingo Pueblo
1010,,,3625R,252,52,20,52,52,5,47,42,6,0,36,0,0,0,5,20,15,5,Sauk-Suiattle Reservation
1011,,,3635R,252,308,125,308,308,2,306,266,22,1,243,0,0,0,40,125,123,2,Sault Ste. Marie Reservation
1012,,,3680R,252,325,121,325,325,10,315,283,56,2,217,6,1,1,32,121,121,0,Shakopee Mdewakanton Sioux Community
1013,,,3735R,252,119,36,119,119,14,105,88,9,0,78,1,0,0,17,36,29,7,Sherwood Valley Rancheria
1014,,,3750R,252,108,47,108,108,20,88,76,10,3,63,0,0,0,12,47,39,8,Shingle Springs Rancheria
1015,,,3780R,252,61,32,61,61,1,60,58,12,0,46,0,0,0,2,32,31,1,Shoalwater Bay Indian Reservation
1016,,,3795R,252,361,132,361,361,20,341,308,46,0,260,0,2,0,33,132,129,3,Siletz Reservation
1017,,,3825R,252,724,290,724,724,32,692,629,155,2,460,4,5,3,63,290,227,63,Skokomish Reservation
1018,,,3840R,252,13,6,13,13,0,13,12,0,0,12,0,0,0,1,6,4,2,Skull Valley Reservation
1019,,,3855R,252,141,72,141,141,2,139,131,27,0,104,0,0,0,8,72,56,16,Smith River Rancheria
1020,,,3860R,252,0,0,0,0,0,0,0,0,0,0,0,0,0,0,0,0,0,Snoqualmie Reservation
1021,,,3870R,252,567,174,567,567,81,486,473,21,0,447,3,0,2,13,174,158,16,Soboba Reservation
1022,,,3885R,252,479,187,479,479,15,464,421,57,0,364,0,0,0,43,187,182,5,Sokaogon Chippewa Community
1023,,,3925R,252,12321,5786,12321,12321,2017,10304,9782,8260,20,1378,48,7,69,522,5786,5034,752,Southern Ute Reservation
1024,,,3930R,252,69,42,69,69,2,67,63,7,2,54,0,0,0,4,42,33,9,South Fork Reservation
1025,,,3935R,252,3787,1230,3787,3787,49,3738,3653,533,2,3109,7,0,2,85,1230,998,232,Spirit Lake Reservation
1026,,,3940R,252,2541,909,2541,2541,98,2443,2282,322,8,1944,4,0,4,161,909,865,44,Spokane Reservation
1027,,,3955R,252,274,103,274,274,20,254,194,46,0,147,1,0,0,60,103,94,9,Squaxin Island Reservation
1028,,,3970R,252,7819,2648,7819,7819,111,7708,7389,1372,9,5986,22,0,0,319,2648,2299,349,Standing Rock Reservation
1029,,,3980R,252,196,64,196,196,21,175,166,24,0,141,0,1,0,9,64,63,1,Stewart Community
1030,,,3985R,252,86,19,86,86,4,82,73,0,0,72,0,0,1,9,19,19,0,Stewarts Point Rancheria
1031,,,4000R,252,2,1,2,2,0,2,1,0,0,1,0,0,0,1,1,0,1,Stillaguamish Reservation
1032,,,4015R,252,625,272,625,625,10,615,559,73,1,485,0,0,0,56,272,244,28,Stockbridge Munsee Community
1033,,,4030R,252,46,14,46,46,3,43,41,0,0,40,0,0,1,2,14,13,1,Sulphur Bank Rancheria
1034,,,4045R,252,0,2,0,0,0,0,0,0,0,0,0,0,0,0,2,0,2,Summit Lake Reservation
1035,,,4060R,252,334,111,334,334,53,281,262,40,5,217,0,0,0,19,111,111,0,Susanville Indian Rancheria
1036,,,4075R,252,3228,1569,3228,3228,114,3114,2939,2153,20,711,41,3,11,175,1569,1378,191,Swinomish Reservation
1037,,,4090R,252,99,38,99,99,25,74,66,12,4,47,0,3,0,8,38,38,0,Sycuan Reservation
1038,,,4095R,252,120,38,120,120,8,112,105,13,1,91,0,0,0,7,38,38,0,Table Bluff Reservation
1039,,,4110R,252,13,10,13,13,2,11,9,9,0,0,0,0,0,2,10,6,4,Table Mountain Rancheria
1040,,,4130R,252,0,0,0,0,0,0,0,0,0,0,0,0,0,0,0,0,0,Tampa Reservation
1041,,,4140R,252,4649,2670,4649,4649,1611,3038,2906,1705,16,1136,19,0,30,132,2670,2198,472,Taos Pueblo
1042,,,4170R,252,1173,418,1173,1173,457,716,701,218,4,475,4,0,0,15,418,383,35,Tesuque Pueblo
1043,,,4180R,252,0,0,0,0,0,0,0,0,0,0,0,0,0,0,0,0,0,Timbi-Sha Shoshone Reservation
1044,,,4200R,252,9225,3237,9225,9225,877,8348,8228,332,16,7876,0,3,1,120,3237,2755,482,Tohono O'odham Nation Reservation
1045,,,4225R,252,261,109,261,261,8,253,232,24,0,206,0,1,1,21,109,103,6,Tonawanda Reservation
1046,,,4235R,252,130,49,130,130,16,114,102,11,0,91,0,0,0,12,49,37,12,Tonto Apache Reservation
1047,,,4255R,252,3454,866,3454,3454,3185,269,240,45,5,140,22,0,28,29,866,820,46,Torres-Martinez Reservation
1048,,,4275R,252,55,17,55,55,2,53,43,8,0,35,0,0,0,10,17,17,0,Trinidad Rancheria
1049,,,4290R,252,10969,4301,10969,10969,934,10035,9209,6442,94,2334,244,47,48,826,4301,3950,351,Tulalip Reservation
1050,,,4300R,252,1250,352,1250,1250,218,1032,977,29,0,948,0,0,0,55,352,337,15,Tule River Reservation
1051,,,4315R,252,77,57,77,77,2,75,66,16,0,49,0,0,1,9,57,57,0,Tunica-Biloxi Reservation
1052,,,4330R,252,154,65,154,154,18,136,130,16,0,114,0,0,0,6,65,61,4,Tuolumne Rancheria
1053,,,4345R,252,5113,1748,5113,5113,45,5068,4949,195,10,4743,1,0,0,119,1748,1602,146,Turtle Mountain Reservation
1054,,,4360R,252,1145,505,1145,1145,46,1099,1012,404,0,586,0,3,19,87,505,425,80,Tuscarora Nation Reservation
1055,,,4375R,252,3,1,3,3,0,3,1,0,0,1,0,0,0,2,1,0,1,Twenty-Nine Palms Reservation
1056,,,4390R,252,25192,11169,25192,25192,1616,23576,22814,19972,32,2618,80,45,67,762,11169,8313,2856,Uintah and Ouray Reservation
1057,,,4405R,252,2861,1161,2861,2861,102,2759,2576,1166,1,1398,0,8,3,183,1161,1062,99,Umatilla Reservation
1058,,,4430R,252,70,35,70,70,4,66,62,38,0,23,0,0,1,4,35,27,8,Upper Lake Rancheria
1059,,,4445R,252,117,48,117,117,5,112,90,10,2,77,0,0,1,22,48,44,4,Upper Sioux Community
1060,,,4455R,252,262,79,262,262,18,244,234,20,1,212,1,0,0,10,79,72,7,Upper Skagit Reservation
1061,,,4470R,252,1656,575,1656,1656,35,1621,1595,19,2,1567,0,4,3,26,575,532,43,Ute Mountain Reservation
1062,,,4500R,252,538,213,538,538,81,457,414,95,3,306,10,0,0,43,213,196,17,Viejas Reservation
1063,,,4515R,252,814,385,814,814,98,716,675,61,3,611,0,0,0,41,385,329,56,Walker River Reservation
1064,,,4545R,252,3395,1034,3395,3395,268,3127,2973,95,7,2864,1,4,2,154,1034,967,67,Warm Springs Reservation
1065,,,4580R,252,54,28,54,54,14,40,37,4,0,33,0,0,0,3,28,22,6,Wells Colony
1066,,,4595R,252,9695,4981,9695,9695,207,9488,8437,4146,8,4243,8,1,31,1051,4981,3633,1348,White Earth Reservation
1067,,,4610R,252,25757,10442,25757,25757,1752,24005,22731,15147,111,7295,88,7,83,1274,10442,9360,1082,Wind River Reservation
1068,,,4625R,252,2737,921,2737,2737,114,2623,2550,737,18,1785,2,1,7,73,921,822,99,Winnebago Reservation
1069,,,4635R,252,43,23,43,43,8,35,33,4,0,28,1,0,0,2,23,22,1,Winnemucca Indian Colony
1070,,,4665R,252,225,64,225,225,17,208,195,9,1,184,1,0,0,13,64,64,0,Woodfords Community
1071,,,4680R,252,117,32,117,117,1,116,116,0,0,116,0,0,0,0,32,32,0,XL Ranch Rancheria
1072,,,4690R,252,31469,9104,31469,31469,18849,12620,11864,4270,93,6881,500,14,106,756,9104,8694,410,Yakama Nation Reservation
1073,,,4700R,252,6588,2411,6588,6588,191,6397,6117,3084,12,2983,23,14,1,280,2411,2022,389,Yankton Reservation
1074,,,4708R,252,657,247,657,657,81,576,533,27,6,499,0,0,1,43,247,206,41,Yavapai-Apache Nation Reservation
1075,,,4710R,252,200,75,200,200,53,147,135,23,0,112,0,0,0,12,75,63,12,Yavapai-Prescott Reservation
1076,,,4725R,252,144,64,144,144,30,114,100,8,0,92,0,0,0,14,64,51,13,Yerington Colony
1077,,,4740R,252,34,16,34,34,3,31,24,2,0,22,0,0,0,7,16,12,4,Yomba Reservation
1078,,,4755R,252,303,122,303,303,202,101,92,10,1,79,1,1,0,9,122,95,27,Ysleta del Sur Pueblo
1079,,,4760R,252,1236,587,1236,1236,69,1167,1001,367,1,626,1,0,6,166,587,467,120,Yurok Reservation
1080,,,4770R,252,760,205,760,760,24,736,734,0,0,734,0,0,0,2,205,182,23,Zia Pueblo
1081,,,4785R,252,7461,2102,7461,7461,163,7298,7233,107,7,7039,77,1,2,65,2102,1987,115,Zuni Reservation
1082,,,4910R,252,0,0,0,0,0,0,0,0,0,0,0,0,0,0,0,0,0,Kickapoo (KS) Reservation/Sac and Fox Nation Trust Land joint-use area
1083,,,4930R,252,0,0,0,0,0,0,0,0,0,0,0,0,0,0,0,0,0,San Felipe Pueblo/Santa Ana Pueblo joint-use area
1084,,,4940R,252,0,0,0,0,0,0,0,0,0,0,0,0,0,0,0,0,0,San Felipe Pueblo/Santo Domingo Pueblo joint-use area
1085,,,5540R,252,15107,6054,15107,15107,3061,12046,11194,9631,328,1166,36,7,26,852,6054,4713,1341,Caddo-Wichita-Delaware OTSA
1086,,,5550R,252,513178,228715,513178,513178,45659,467519,404814,281731,29148,85774,6340,472,1349,62705,228715,196249,32466,Cherokee OTSA
1087,,,5560R,252,186628,79900,186628,186628,22742,163886,150600,134049,5129,8637,2285,83,417,13286,79900,69501,10399,Cheyenne and Arapaho OTSA
1088,,,5580R,252,306460,138707,306460,306460,25369,281091,251515,213211,7541,27220,1985,185,1373,29576,138707,119171,19536,Chickasaw OTSA
1089,,,5590R,252,226984,105479,226984,226984,13352,213632,189780,145036,7291,35245,1202,560,446,23852,105479,88646,16833,Choctaw OTSA
1090,,,5600R,252,126987,50083,126987,126987,7535,119452,107073,90873,6098,8682,983,78,359,12379,50083,46065,4018,Citizen Potawatomi Nation-Absentee Shawnee OTSA
1091,,,5620R,252,813184,357976,813184,813184,90404,722780,638021,489053,56737,63564,25178,903,2586,84759,357976,322462,35514,Creek OTSA
1092,,,5640R,252,743,332,743,743,31,712,637,467,2,166,2,0,0,75,332,294,38,Eastern Shawnee OTSA
1093,,,5670R,252,6602,2711,6602,6602,267,6335,5804,5305,108,347,19,3,22,531,2711,2443,268,Iowa OTSA
1094,,,5690R,252,5692,2778,5692,5692,270,5422,4939,4354,31,533,16,2,3,483,2778,2263,515,Kaw OTSA
1095,,,5700R,252,26259,10235,26259,26259,1884,24375,21818,18259,908,2354,205,15,77,2557,10235,9239,996,Kickapoo OTSA
1096,,,5720R,252,187646,85560,187646,187646,27942,159704,145023,108647,21914,9427,3448,905,682,14681,85560,71041,14519,Kiowa-Comanche-Apache-Fort Sill Apache OTSA
1097,,,5730R,252,257,103,257,257,2,255,217,141,0,76,0,0,0,38,103,90,13,Miami OTSA
1098,,,5740R,252,233,98,233,233,9,224,209,114,0,93,2,0,0,15,98,98,0,Modoc OTSA
1099,,,5760R,252,810,332,810,810,38,772,704,293,1,404,1,0,5,68,332,284,48,Otoe-Missouria OTSA
1100,,,5770R,252,5388,2356,5388,5388,292,5096,4464,3279,156,925,29,51,24,632,2356,1976,380,Ottawa OTSA
1101,,,5780R,252,15412,7206,15412,15412,457,14955,13499,11426,73,1910,48,0,42,1456,7206,5999,1207,Pawnee OTSA
1102,,,5795R,252,5112,2189,5112,5112,216,4896,4331,3248,20,932,33,93,5,565,2189,2019,170,Peoria OTSA
1103,,,5800R,252,1916,796,1916,1916,87,1829,1692,1039,7,644,0,0,2,137,796,712,84,Ponca OTSA
1104,,,5810R,252,4810,2098,4810,4810,636,4174,3788,2812,27,932,11,4,2,386,2098,1843,255,Quapaw OTSA
1105,,,5820R,252,58358,25842,58358,58358,2962,55396,49853,41612,2101,5666,317,23,134,5543,25842,22651,3191,Sac and Fox OTSA
1106,,,5830R,252,21656,9869,21656,21656,1115,20541,17975,12948,816,4053,64,8,86,2566,9869,8263,1606,Seminole OTSA
1107,,,5835R,252,4241,2738,4241,4241,128,4113,3702,3102,4,577,11,6,2,411,2738,1898,840,Seneca-Cayuga OTSA
1108,,,5860R,252,3841,1642,3841,3841,321,3520,3246,2733,39,449,14,7,4,274,1642,1391,251,Tonkawa OTSA
1109,,,5890R,252,1869,836,1869,1869,60,1809,1620,1179,1,424,12,3,1,189,836,744,92,Wyandotte OTSA
1110,,,5915R,252,1900,843,1900,1900,61,1839,1634,1161,104,358,8,0,3,205,843,715,128,Creek/Seminole joint-use OTSA
1111,,,5950R,252,26146,12476,26146,26146,2430,23716,21303,17806,746,2257,185,260,49,2413,12476,10642,1834,Kaw/Ponca joint-use OTSA
1112,,,5955R,252,9690,4512,9690,9690,1115,8575,7661,3969,326,3331,27,1,7,914,4512,3660,852,Kiowa-Comanche-Apache-Ft Sill Apache/Caddo-Wichita-Delaware joint-use OTSA
1113,,,5970R,252,4029,1964,4029,4029,250,3779,3314,2541,48,624,25,68,8,465,1964,1686,278,Miami/Peoria joint-use OTSA
1114,,,6015R,252,63,36,63,63,0,63,60,4,1,55,0,0,0,3,36,30,6,Akhiok ANVSA
1115,,,6020R,252,683,256,683,683,4,679,667,27,1,639,0,0,0,12,256,188,68,Akiachak ANVSA
1116,,,6025R,252,462,107,462,462,0,462,460,18,0,442,0,0,0,2,107,106,1,Akiak ANVSA
1117,,,6030R,252,1585,48,1585,1585,561,1024,984,146,266,56,499,11,6,40,48,46,2,Akutan ANVSA
1118,,,6035R,252,756,181,756,756,2,754,747,20,0,718,0,0,9,7,181,171,10,Alakanuk ANVSA
1119,,,6040R,252,15,17,15,15,0,15,15,1,0,14,0,0,0,0,17,12,5,Alatna ANVSA
1120,,,6045R,252,211,102,211,211,4,207,171,38,0,131,2,0,0,36,102,72,30,Aleknagik ANVSA
1121,,,6065R,252,497,162,497,497,1,496,488,19,0,468,1,0,0,8,162,149,13,Algaaciq ANVSA
1122,,,6070R,252,177,90,177,177,0,177,170,20,0,149,1,0,0,7,90,71,19,Allakaket ANVSA
1123,,,6075R,252,274,100,274,274,2,272,256,17,3,236,0,0,0,16,100,79,21,Ambler ANVSA
1124,,,6080R,252,425,136,425,425,7,418,380,71,0,309,0,0,0,38,136,113,23,Anaktuvuk Pass ANVSA
1125,,,6095R,252,102,55,102,102,1,101,95,6,0,89,0,0,0,6,55,29,26,Andreafsky ANVSA
1126,,,6100R,252,357,192,357,357,25,332,302,23,0,269,6,1,3,30,192,130,62,Angoon ANVSA
1127,,,6105R,252,510,226,510,510,11,499,455,88,1,365,1,0,0,44,226,156,70,Aniak ANVSA
1128,,,6125R,252,70,42,70,70,0,70,65,3,0,62,0,0,0,5,42,21,21,Anvik ANVSA
1129,,,6140R,252,151,96,151,151,0,151,146,6,0,140,0,0,0,5,96,69,27,Arctic Village ANVSA
1130,,,6150R,252,53,38,53,53,0,53,51,0,1,50,0,0,0,2,38,14,24,Atka ANVSA
1131,,,6160R,252,386,84,386,386,1,385,381,9,1,370,1,0,0,4,84,71,13,Atmautluak ANVSA
1132,,,6165R,252,276,79,276,276,1,275,262,21,1,240,0,0,0,13,79,72,7,Atqasuk ANVSA
1133,,,6175R,252,4927,1550,4927,4927,173,4754,4210,665,70,2593,591,286,5,544,1550,1334,216,Barrow ANVSA
1134,,,6190R,252,48,57,48,48,1,47,47,1,0,46,0,0,0,0,57,22,35,Beaver ANVSA
1135,,,6195R,252,2,1,2,2,0,2,1,1,0,0,0,0,0,1,1,0,1,Belkofski ANVSA
1136,,,6205R,252,6325,2184,6325,6325,144,6181,5586,1177,73,4129,187,2,18,595,2184,1912,272,Bethel ANVSA
1137,,,6225R,252,0,2,0,0,0,0,0,0,0,0,0,0,0,0,2,2,0,Bill Moore's ANVSA
1138,,,6235R,252,35,17,35,35,0,35,34,3,0,31,0,0,0,1,17,16,1,Birch Creek ANVSA
1139,,,6240R,252,428,116,428,428,5,423,409,22,2,378,3,0,4,14,116,111,5,Brevig Mission ANVSA
1140,,,6250R,252,550,111,550,550,2,548,533,6,2,524,1,0,0,15,111,108,3,Buckland ANVSA
1141,,,6255R,252,197,203,197,197,1,196,172,134,2,36,0,0,0,24,203,120,83,Cantwell ANVSA
1142,,,6257R,252,0,3,0,0,0,0,0,0,0,0,0,0,0,0,3,0,3,Canyon Village ANVSA
1143,,,6265R,252,56,63,56,56,1,55,53,1,0,52,0,0,0,2,63,21,42,Chalkyitsik ANVSA
1144,,,6275R,252,506,110,506,506,2,504,475,17,0,458,0,0,0,29,110,104,6,Chefornak ANVSA
1145,,,6280R,252,59,32,59,59,0,59,52,13,4,34,0,0,1,7,32,26,6,Chenega ANVSA
1146,,,6285R,252,951,243,951,951,1,950,912,18,1,892,1,0,0,38,243,208,35,Chevak ANVSA
1147,,,6290R,252,25487,10715,25487,25487,1186,24301,21927,19638,219,1422,318,100,230,2374,10715,9149,1566,Chickaloon ANVSA
1148,,,6295R,252,97,87,97,97,5,92,80,19,0,58,3,0,0,12,87,43,44,Chignik ANVSA
1149,,,6300R,252,72,73,72,72,3,69,57,9,0,48,0,0,0,12,73,32,41,Chignik Lagoon ANVSA
1150,,,6305R,252,65,44,65,65,2,63,59,4,0,55,0,0,0,4,44,30,14,Chignik Lake ANVSA
1151,,,6310R,252,93,67,93,93,1,92,79,11,0,67,0,0,1,13,67,45,22,Chilkat ANVSA
1152,,,6315R,252,410,235,410,410,11,399,357,291,1,61,4,0,0,42,235,203,32,Chilkoot ANVSA
1153,,,6325R,252,50,60,50,50,1,49,42,5,0,37,0,0,0,7,60,18,42,Chistochina ANVSA
1154,,,6330R,252,78,107,78,78,2,76,62,25,0,36,0,0,1,14,107,44,63,Chitina ANVSA
1155,,,6335R,252,104,40,104,104,1,103,95,3,0,92,0,0,0,8,40,33,7,Chuathbaluk ANVSA
1156,,,6340R,252,1,10,1,1,1,0,0,0,0,0,0,0,0,0,10,0,10,Chuloonawick ANVSA
1157,,,6350R,252,91,59,91,91,0,91,91,7,0,84,0,0,0,0,59,49,10,Circle ANVSA
1158,,,6360R,252,67,38,67,67,0,67,66,4,0,62,0,0,0,1,38,24,14,Clarks Point ANVSA
1159,,,6365R,252,449,278,449,449,20,429,376,203,1,170,2,0,0,53,278,184,94,Copper Center ANVSA
1160,,,6380R,252,2,40,2,2,1,1,0,0,0,0,0,0,0,1,40,4,36,Council ANVSA
1161,,,6385R,252,1251,630,1251,1251,52,1199,1039,788,3,230,13,0,5,160,630,518,112,Craig ANVSA
1162,,,6390R,252,90,45,90,90,1,89,86,1,0,85,0,0,0,3,45,44,1,Crooked Creek ANVSA
1163,,,6400R,252,182,72,182,182,0,182,175,6,0,168,1,0,0,7,72,54,18,Deering ANVSA
1164,,,6405R,252,2350,1045,2350,2350,104,2246,1954,624,17,1257,40,9,7,292,1045,850,195,Dillingham ANVSA
1165,,,6415R,252,23,24,23,23,0,23,15,3,0,12,0,0,0,8,24,14,10,Dot Lake ANVSA
1166,,,6420R,252,5542,2774,5542,5542,320,5222,4590,3737,72,519,154,81,27,632,2774,2495,279,Douglas ANVSA
1167,,,6430R,252,54,48,54,54,2,52,47,20,0,27,0,0,0,5,48,25,23,Eagle ANVSA
1168,,,6440R,252,404,120,404,404,5,399,372,6,0,366,0,0,0,27,120,107,13,Eek ANVSA
1169,,,6445R,252,39,243,39,39,1,38,37,14,0,23,0,0,0,1,243,24,219,Egegik ANVSA
1170,,,6450R,252,62,19,62,62,5,57,47,8,0,38,0,0,1,10,19,19,0,Eklutna ANVSA
1171,,,6455R,252,2,82,2,2,0,2,2,2,0,0,0,0,0,0,82,0,82,Ekuk ANVSA
1172,,,6460R,252,111,52,111,111,7,104,100,9,1,89,1,0,0,4,52,36,16,Ekwok ANVSA
1173,,,6470R,252,366,129,366,366,5,361,343,16,0,325,2,0,0,18,129,97,32,Elim ANVSA
1174,,,6480R,252,825,221,825,825,2,823,785,23,1,759,2,0,0,38,221,213,8,Emmonak ANVSA
1175,,,6490R,252,35,63,35,35,2,33,32,23,0,9,0,0,0,1,63,21,42,Evansville ANVSA
1176,,,6495R,252,134,68,134,134,4,130,100,95,0,4,1,0,0,30,68,60,8,Eyak ANVSA
1177,,,6500R,252,394,25,394,394,41,353,331,175,18,23,109,5,1,22,25,13,12,False Pass ANVSA
1178,,,6515R,252,428,282,428,428,3,425,393,34,0,359,0,0,0,32,282,202,80,Fort Yukon ANVSA
1179,,,6520R,252,107,123,107,107,2,105,103,62,0,41,0,0,0,2,123,49,74,Gakona ANVSA
1180,,,6525R,252,472,269,472,472,4,468,449,114,0,326,2,0,7,19,269,178,91,Galena ANVSA
1181,,,6530R,252,640,206,640,640,4,636,635,19,1,614,1,0,0,1,206,171,35,Gambell ANVSA
1182,,,6535R,252,1,5,1,1,0,1,1,0,0,0,0,0,1,0,5,1,4,Georgetown ANVSA
1183,,,6540R,252,175,59,175,175,1,174,170,11,0,159,0,0,0,4,59,52,7,Golovin ANVSA
1184,,,6545R,252,258,84,258,258,1,257,246,13,0,233,0,0,0,11,84,84,0,Goodnews Bay ANVSA
1185,,,6550R,252,210,73,210,210,1,209,192,5,0,187,0,0,0,17,73,71,2,Grayling ANVSA
1186,,,6560R,252,121,76,121,121,11,110,104,38,0,66,0,0,0,6,76,42,34,Gulkana ANVSA
1187,,,6570R,252,2,1,2,2,1,1,0,0,0,0,0,0,0,1,1,1,0,Hamilton ANVSA
1188,,,6575R,252,24,35,24,24,1,23,21,1,0,20,0,0,0,2,35,7,28,Healy Lake ANVSA
1189,,,6585R,252,176,87,176,176,2,174,147,7,0,140,0,0,0,27,87,72,15,Holy Cross ANVSA
1190,,,6590R,252,931,398,931,931,61,870,748,300,1,435,3,3,6,122,398,347,51,Hoonah ANVSA
1191,,,6595R,252,1375,314,1375,1375,1,1374,1367,23,2,1330,10,0,2,7,314,280,34,Hooper Bay ANVSA
1192,,,6605R,252,86,48,86,86,1,85,82,5,0,77,0,0,0,3,48,33,15,Hughes ANVSA
1193,,,6610R,252,304,127,304,304,4,300,288,13,0,275,0,0,0,12,127,104,23,Huslia ANVSA
1194,,,6615R,252,380,145,380,380,13,367,357,25,1,318,1,12,0,10,145,138,7,Hydaburg ANVSA
1195,,,6620R,252,68,34,68,68,0,68,62,13,0,48,1,0,0,6,34,21,13,Igiugig ANVSA
1196,,,6625R,252,108,74,108,108,1,107,90,25,0,64,1,0,0,17,74,34,40,Iliamna ANVSA
1197,,,6630R,252,83,49,83,83,2,81,75,2,0,72,1,0,0,6,49,30,19,Inalik ANVSA
1198,,,6650R,252,1,12,1,1,0,1,0,0,0,0,0,0,0,1,12,8,4,Ivanof Bay ANVSA
1199,,,6670R,252,543,222,543,543,7,536,485,63,2,414,3,2,1,51,222,188,34,Kake ANVSA
1200,,,6680R,252,283,91,283,283,0,283,281,12,0,269,0,0,0,2,91,88,3,Kaktovik ANVSA
1201,,,6685R,252,212,89,212,212,1,211,197,15,0,182,0,0,0,14,89,59,30,Kalskag ANVSA
1202,,,6690R,252,158,90,158,158,0,158,143,11,0,132,0,0,0,15,90,62,28,Kaltag ANVSA
1203,,,6700R,252,27,28,27,27,1,26,25,1,0,24,0,0,0,1,28,14,14,Karluk ANVSA
1204,,,6705R,252,30,18,30,30,3,27,25,19,0,5,0,1,0,2,18,10,8,Kasaan ANVSA
1205,,,6710R,252,623,131,623,623,0,623,619,21,1,597,0,0,0,4,131,120,11,Kasigluk ANVSA
1206,,,6720R,252,34637,18021,34637,34637,1504,33133,29943,26668,164,2255,504,109,243,3190,18021,13971,4050,Kenaitze ANVSA
1207,,,6725R,252,13225,5996,13225,13225,627,12598,11206,7883,96,2003,1108,26,90,1392,5996,5202,794,Ketchikan ANVSA
1208,,,6730R,252,449,142,449,449,1,448,425,21,1,401,2,0,0,23,142,108,34,Kiana ANVSA
1209,,,6735R,252,757,208,757,757,43,714,657,208,10,324,109,6,0,57,208,165,43,King Cove ANVSA
1210,,,6740R,252,125,95,125,125,11,114,89,55,1,32,0,0,1,25,95,51,44,King Salmon ANVSA
1211,,,6750R,252,704,193,704,704,2,702,697,15,2,680,0,0,0,5,193,181,12,Kipnuk ANVSA
1212,,,6755R,252,444,172,444,444,1,443,442,8,0,434,0,0,0,1,172,81,91,Kivalina ANVSA
1213,,,6765R,252,528,245,528,528,12,516,412,121,0,283,8,0,0,104,245,201,44,Klawock ANVSA
1214,,,6785R,252,81495,39270,81495,81495,4055,77440,69402,61334,840,5100,1197,376,555,8038,39270,29175,10095,Knik ANVSA
1215,,,6790R,252,191,53,191,191,5,186,178,20,1,156,1,0,0,8,53,41,12,Kobuk ANVSA
1216,,,6795R,252,2,3,2,2,0,2,2,2,0,0,0,0,0,0,3,3,0,Kodiak ANVSA
1217,,,6800R,252,152,70,152,152,0,152,137,11,0,124,2,0,0,15,70,52,18,Kokhanok ANVSA
1218,,,6810R,252,486,108,486,486,1,485,471,5,1,465,0,0,0,14,108,108,0,Kongiganak ANVSA
1219,,,6815R,252,655,150,655,655,0,655,654,1,0,653,0,0,0,1,150,134,16,Kotlik ANVSA
1220,,,6820R,252,3102,1021,3102,3102,77,3025,2719,491,63,2106,48,11,0,306,1021,895,126,Kotzebue ANVSA
1221,,,6825R,252,312,103,312,312,4,308,292,12,1,277,2,0,0,16,103,91,12,Koyuk ANVSA
1222,,,6830R,252,98,58,98,98,1,97,97,0,0,97,0,0,0,0,58,37,21,Koyukuk ANVSA
1223,,,6835R,252,812,229,812,812,0,812,792,15,0,773,4,0,0,20,229,177,52,Kwethluk ANVSA
1224,,,6840R,252,380,108,380,380,1,379,372,3,0,369,0,0,0,7,108,94,14,Kwigillingok ANVSA
1225,,,6845R,252,776,204,776,776,3,773,743,13,0,730,0,0,0,30,204,192,12,Kwinhagak ANVSA
1226,,,6850R,252,16,22,16,16,2,14,12,9,1,2,0,0,0,2,22,13,9,Lake Minchumina ANVSA
1227,,,6855R,252,34,104,34,34,0,34,33,5,0,27,0,0,1,1,104,24,80,Larsen Bay ANVSA
1228,,,6860R,252,0,2,0,0,0,0,0,0,0,0,0,0,0,0,2,0,2,Lesnoi ANVSA
1229,,,6865R,252,69,42,69,69,0,69,66,1,0,65,0,0,0,3,42,30,12,Levelock ANVSA
1230,,,6875R,252,13,27,13,13,0,13,13,0,0,12,1,0,0,0,27,3,24,Lime Village ANVSA
1231,,,6890R,252,278,95,278,278,2,276,266,4,0,262,0,0,0,10,95,82,13,Lower Kalskag ANVSA
1232,,,6895R,252,301,165,301,301,7,294,276,104,3,169,0,0,0,18,165,125,40,McGrath ANVSA
1233,,,6900R,252,169,106,169,169,3,166,160,52,0,106,1,0,1,6,106,59,47,Manley Hot Springs ANVSA
1234,,,6905R,252,487,146,487,487,5,482,459,16,0,443,0,0,0,23,146,133,13,Manokotak ANVSA
1235,,,6910R,252,492,131,492,492,1,491,474,8,2,464,0,0,0,17,131,115,16,Marshall ANVSA
1236,,,6915R,252,1,3,1,1,0,1,1,0,0,0,1,0,0,0,3,2,1,Mary's Igloo ANVSA
1237,,,6935R,252,206,95,206,206,1,205,202,9,0,193,0,0,0,3,95,72,23,Mekoryuk ANVSA
1238,,,6945R,252,108,50,108,108,0,108,101,11,1,89,0,0,0,7,50,33,17,Mentasta Lake ANVSA
1239,,,6965R,252,150,100,150,150,0,150,145,7,0,138,0,0,0,5,100,55,45,Minto ANVSA
1240,,,6975R,252,621,198,621,621,0,621,614,19,6,585,3,0,1,7,198,174,24,Mountain Village ANVSA
1241,,,6990R,252,470,431,470,470,24,446,390,163,2,216,5,3,1,56,431,188,243,Naknek ANVSA
1242,,,6995R,252,247,81,247,247,7,240,190,13,0,177,0,0,0,50,81,59,22,Nanwalek ANVSA
1243,,,7005R,252,0,13,0,0,0,0,0,0,0,0,0,0,0,0,13,4,9,Napaimute ANVSA
1244,,,7010R,252,358,115,358,358,0,358,342,14,2,325,1,0,0,16,115,103,12,Napakiak ANVSA
1245,,,7020R,252,509,143,509,509,5,504,498,12,0,486,0,0,0,6,143,125,18,Napaskiak ANVSA
1246,,,7025R,252,41,30,41,41,2,39,39,1,0,38,0,0,0,0,30,20,10,Nelson Lagoon ANVSA
1247,,,7030R,252,358,219,358,358,0,358,354,207,0,147,0,0,0,4,219,169,50,Nenana ANVSA
1248,,,7035R,252,168,65,168,168,2,166,143,16,0,127,0,0,0,23,65,51,14,Newhalen ANVSA
1249,,,7040R,252,183,72,183,183,0,183,172,5,0,167,0,0,0,11,72,50,22,New Koliganek ANVSA
1250,,,7050R,252,512,125,512,512,6,506,482,24,1,457,0,0,0,24,125,125,0,New Stuyahok ANVSA
1251,,,7055R,252,308,80,308,308,0,308,299,6,0,293,0,0,0,9,80,67,13,Newtok ANVSA
1252,,,7065R,252,306,63,306,306,0,306,302,8,0,294,0,0,0,4,63,63,0,Nightmute ANVSA
1253,,,7070R,252,89,45,89,89,2,87,82,10,0,72,0,0,0,5,45,39,6,Nikolai ANVSA
1254,,,7075R,252,39,26,39,39,4,35,34,6,0,27,0,0,1,1,26,22,4,Nikolski ANVSA
1255,,,7080R,252,16004,9598,16004,16004,491,15513,14299,13329,53,622,159,30,106,1214,9598,6986,2612,Ninilchik ANVSA
1256,,,7085R,252,570,150,570,570,2,568,557,25,1,531,0,0,0,11,150,133,17,Noatak ANVSA
1257,,,7095R,252,3794,1716,3794,3794,121,3673,3054,998,33,1926,74,3,20,619,1716,1287,429,Nome ANVSA
1258,,,7100R,252,133,93,133,133,4,129,119,10,0,109,0,0,0,10,93,48,45,Nondalton ANVSA
1259,,,7110R,252,694,176,694,694,0,694,687,15,0,672,0,0,0,7,176,163,13,Noorvik ANVSA
1260,,,7115R,252,227,115,227,227,0,227,226,19,0,207,0,0,0,1,115,73,42,Northway ANVSA
1261,,,7125R,252,512,157,512,512,0,512,510,35,1,474,0,0,0,2,157,130,27,Nuiqsut ANVSA
1262,,,7130R,252,239,100,239,239,4,235,186,17,0,167,2,0,0,49,100,84,16,Nulato ANVSA
1263,,,7133R,252,217,58,217,217,1,216,207,2,2,203,0,0,0,9,58,44,14,Nunam Iqua ANVSA
1264,,,7135R,252,594,144,594,594,0,594,594,13,0,581,0,0,0,0,144,131,13,Nunapitchuk ANVSA
1265,,,7145R,252,1,4,1,1,0,1,1,0,0,0,1,0,0,0,4,1,3,Ohogamiut ANVSA
1266,,,7150R,252,216,134,216,216,6,210,201,22,0,176,1,2,0,9,134,95,39,Old Harbor ANVSA
1267,,,7175R,252,70,31,70,70,2,68,68,1,0,67,0,0,0,0,31,12,19,Oscarville ANVSA
1268,,,7180R,252,118,100,118,118,7,111,100,22,0,78,0,0,0,11,100,46,54,Ouzinkie ANVSA
1269,,,7185R,252,2,1,2,2,1,1,1,1,0,0,0,0,0,0,1,1,0,Paimiut ANVSA
1270,,,7205R,252,43,48,43,43,0,43,41,20,0,21,0,0,0,2,48,24,24,Pedro Bay ANVSA
1271,,,7215R,252,88,47,88,88,1,87,84,7,0,77,0,0,0,3,47,34,13,Perryville ANVSA
1272,,,7220R,252,2360,1044,2360,2360,118,2242,1951,1633,36,163,98,12,9,291,1044,937,107,Petersburg ANVSA
1273,,,7225R,252,70,66,70,70,1,69,60,10,0,50,0,0,0,9,66,21,45,Pilot Point ANVSA
1274,,,7230R,252,615,152,615,615,0,615,602,8,2,590,2,0,0,13,152,152,0,Pilot Station ANVSA
1275,,,7235R,252,120,32,120,120,0,120,118,0,0,118,0,0,0,2,32,32,0,Pitkas Point ANVSA
1276,,,7245R,252,55,30,55,55,1,54,47,1,0,46,0,0,0,7,30,17,13,Platinum ANVSA
1277,,,7250R,252,830,255,830,830,3,827,794,59,5,730,0,0,0,33,255,214,41,Point Hope ANVSA
1278,,,7255R,252,330,90,330,330,1,329,323,19,0,304,0,0,0,6,90,83,7,Point Lay ANVSA
1279,,,7260R,252,4,12,4,4,2,2,2,2,0,0,0,0,0,0,12,0,12,Portage Creek ANVSA
1280,,,7263R,252,186,86,186,186,7,179,161,119,1,41,0,0,0,18,86,49,37,Port Alsworth ANVSA
1281,,,7265R,252,162,63,162,162,3,159,142,8,0,134,0,0,0,17,63,57,6,Port Graham ANVSA
1282,,,7270R,252,100,56,100,100,1,99,93,14,0,79,0,0,0,6,56,40,16,Port Heiden ANVSA
1283,,,7275R,252,170,126,170,170,1,169,163,55,0,105,0,3,0,6,126,76,50,Port Lions ANVSA
1284,,,7300R,252,57,41,57,57,0,57,50,6,0,44,0,0,0,7,41,22,19,Rampart ANVSA
1285,,,7305R,252,22,20,22,22,1,21,17,2,0,15,0,0,0,4,20,5,15,Red Devil ANVSA
1286,,,7310R,252,139,103,139,139,1,138,133,8,0,125,0,0,0,5,103,56,47,Ruby ANVSA
1287,,,7315R,252,421,95,421,421,0,421,405,7,0,398,0,0,0,16,95,95,0,Russian Mission ANVSA
1288,,,7340R,252,67,52,67,67,2,65,62,2,0,60,0,0,0,3,52,26,26,St. George ANVSA
1289,,,7375R,252,456,114,456,456,3,453,438,25,3,410,0,0,0,15,114,95,19,St. Michael ANVSA
1290,,,7390R,252,413,192,413,413,5,408,392,24,1,358,6,2,1,16,192,135,57,St. Paul ANVSA
1291,,,7400R,252,1078,329,1078,1078,22,1056,982,757,27,189,5,3,1,74,329,244,85,Salamatof ANVSA
1292,,,7410R,252,536,280,536,536,14,522,475,86,0,342,35,10,2,47,280,215,65,Sand Point ANVSA
1293,,,7415R,252,835,204,835,835,5,830,825,18,1,803,3,0,0,5,204,188,16,Savoonga ANVSA
1294,,,7420R,252,384,152,384,384,10,374,319,56,2,256,2,0,3,55,152,128,24,Saxman ANVSA
1295,,,7425R,252,600,124,600,600,0,600,597,4,0,593,0,0,0,3,124,118,6,Scammon Bay ANVSA
1296,,,7430R,252,809,214,809,809,0,809,802,16,0,786,0,0,0,7,214,200,14,Selawik ANVSA
1297,,,7435R,252,448,412,448,448,16,432,362,289,1,60,6,0,6,70,412,206,206,Seldovia ANVSA
1298,,,7440R,252,100,42,100,100,3,97,94,4,0,90,0,0,0,3,42,34,8,Shageluk ANVSA
1299,,,7450R,252,212,85,212,212,1,211,209,20,4,185,0,0,0,2,85,77,8,Shaktoolik ANVSA
1300,,,7465R,252,576,166,576,576,0,576,574,15,4,555,0,0,0,2,166,154,12,Shishmaref ANVSA
1301,,,7470R,252,272,89,272,272,1,271,265,6,0,259,0,0,0,6,89,72,17,Shungnak ANVSA
1302,,,7475R,252,4459,1999,4459,4459,268,4191,3648,2382,31,763,438,8,26,543,1999,1757,242,Sitka ANVSA
1303,,,7485R,252,1240,760,1240,1240,41,1199,1130,1056,6,23,39,0,6,69,760,531,229,Skagway ANVSA
1304,,,7495R,252,95,55,95,95,2,93,76,13,1,62,0,0,0,17,55,34,21,Sleetmute ANVSA
1305,,,7500R,252,1,8,1,1,0,1,1,0,0,0,1,0,0,0,8,0,8,Solomon ANVSA
1306,,,7505R,252,67,120,67,67,3,64,49,16,0,33,0,0,0,15,120,32,88,South Naknek ANVSA
1307,,,7510R,252,634,199,634,634,5,629,610,31,2,577,0,0,0,19,199,181,18,Stebbins ANVSA
1308,,,7520R,252,37,38,37,37,0,37,37,0,0,37,0,0,0,0,38,21,17,Stevens Village ANVSA
1309,,,7525R,252,57,31,57,57,1,56,56,4,0,50,2,0,0,0,31,15,16,Stony River ANVSA
1310,,,7530R,252,56,41,56,56,7,49,42,26,0,14,0,2,0,7,41,22,19,Takotna ANVSA
1311,,,7535R,252,144,68,144,144,5,139,132,13,0,119,0,0,0,7,68,53,15,Tanacross ANVSA
1312,,,7540R,252,246,157,246,246,4,242,236,41,0,194,1,0,0,6,157,115,42,Tanana ANVSA
1313,,,7555R,252,90,88,90,90,0,90,86,12,0,74,0,0,0,4,88,34,54,Tatitlek ANVSA
1314,,,7560R,252,263,202,263,263,7,256,229,147,2,78,0,0,2,27,202,97,105,Tazlina ANVSA
1315,,,7565R,252,2,6,2,2,0,2,2,1,0,1,0,0,0,0,6,3,3,Telida ANVSA
1316,,,7570R,252,249,84,249,249,2,247,238,9,0,224,5,0,0,9,84,73,11,Teller ANVSA
1317,,,7580R,252,135,71,135,135,3,132,125,8,0,117,0,0,0,7,71,41,30,Tetlin ANVSA
1318,,,7605R,252,817,275,817,817,9,808,774,41,0,732,1,0,0,34,275,229,46,Togiak ANVSA
1319,,,7625R,252,658,134,658,658,1,657,653,18,0,635,0,0,0,4,134,133,1,Toksook Bay ANVSA
1320,,,7630R,252,444,118,444,444,1,443,429,13,0,416,0,0,0,14,118,94,24,Tuluksak ANVSA
1321,,,7640R,252,469,126,469,469,0,469,466,8,0,457,1,0,0,3,126,113,13,Tuntutuliak ANVSA
1322,,,7645R,252,411,99,411,411,1,410,400,11,0,389,0,0,0,10,99,87,12,Tununak ANVSA
1323,,,7650R,252,103,38,103,103,7,96,79,4,0,74,1,0,0,17,38,34,4,Twin Hills ANVSA
1324,,,7655R,252,161,118,161,161,18,143,125,8,1,112,0,4,0,18,118,63,55,Tyonek ANVSA
1325,,,7665R,252,4,25,4,4,0,4,4,1,0,3,0,0,0,0,25,1,24,Ugashik ANVSA
1326,,,7690R,252,806,335,806,806,7,799,791,117,1,671,2,0,0,8,335,252,83,Unalakleet ANVSA
1327,,,7695R,252,4254,776,4254,4254,594,3660,3441,1326,221,182,1483,221,8,219,776,641,135,Unalaska ANVSA
1328,,,7705R,252,1,3,1,1,0,1,1,1,0,0,0,0,0,0,3,1,2,Uyak ANVSA
1329,,,7725R,252,205,95,205,205,1,204,203,12,0,191,0,0,0,1,95,83,12,Venetie ANVSA
1330,,,7735R,252,628,177,628,628,3,625,624,21,4,599,0,0,0,1,177,156,21,Wainwright ANVSA
1331,,,7740R,252,168,89,168,168,3,165,160,8,0,146,3,2,1,5,89,43,46,Wales ANVSA
1332,,,7745R,252,185,93,185,185,0,185,183,12,0,171,0,0,0,2,93,67,26,White Mountain ANVSA
1333,,,7755R,252,1173,588,1173,1173,45,1128,974,685,0,259,20,2,8,154,588,521,67,Wrangell ANVSA
1334,,,7765R,252,657,382,657,657,28,629,531,246,2,250,32,1,0,98,382,265,117,Yakutat ANVSA
1335,,,8100R,252,2572,1396,2572,2572,58,2514,2391,2321,32,6,20,0,12,123,1396,1090,306,Cayuga Nation TDSA
1336,,,8150R,252,3239,1522,3239,3239,48,3191,3066,1391,1248,395,7,2,23,125,1522,1449,73,Chickahominy TDSA
1337,,,8160R,252,193,90,193,193,2,191,179,147,9,22,0,0,1,12,90,90,0,Eastern Chickahominy TDSA
1338,,,8300R,252,27,8,27,27,1,26,23,23,0,0,0,0,0,3,8,5,3,Ione Band of Miwok TDSA
1339,,,8450R,252,3227,1306,3227,3227,934,2293,2112,1730,63,114,166,18,21,181,1306,1244,62,Mechoopda TDSA
1340,,,8700R,252,1638,758,1638,1638,40,1598,1559,798,719,31,3,0,8,39,758,702,56,Rappahannock TDSA
1341,,,8750R,252,41102,25725,41102,41102,2580,38522,36189,34713,173,263,715,65,260,2333,25725,18857,6868,Samish TDSA
1342,,,9100R,252,4,3,4,4,0,4,4,0,0,4,0,0,0,0,3,2,1,Golden Hill Paugussett (state) Reservation
1343,,,9150R,252,5,1,5,5,4,1,0,0,0,0,0,0,0,1,1,1,0,Hassanamisco (state) Reservation
1344,,,9230R,252,48,30,48,48,4,44,42,8,0,34,0,0,0,2,30,21,9,Mattaponi (state) Reservation
1345,,,9240R,252,107,54,107,107,4,103,95,6,1,84,0,2,2,8,54,43,11,MOWA Choctaw (state) Reservation
1346,,,9260R,252,114,59,114,114,12,102,93,42,0,51,0,0,0,9,59,57,2,Pamunkey (state) Reservation
1347,,,9280R,252,44,20,44,44,4,40,35,17,0,16,1,0,1,5,20,15,5,Paucatuck Eastern Pequot (state) Reservation
1348,,,9300R,252,436,159,436,436,87,349,304,34,55,215,0,0,0,45,159,150,9,Poospatuck (state) Reservation
1349,,,9350R,252,0,0,0,0,0,0,0,0,0,0,0,0,0,0,0,0,0,Schaghticoke (state) Reservation
1350,,,9370R,252,819,349,819,819,47,772,744,28,30,684,2,0,0,28,349,300,49,Shinnecock (state) Reservation
1351,,,9400R,252,14,11,14,14,0,14,5,5,0,0,0,0,0,9,11,9,2,Tama (state) Reservation
1352,,,9510R,252,2026,1180,2026,2026,64,1962,1872,1453,348,25,4,2,40,90,1180,915,265,Adai Caddo SDTSA
1353,,,9515R,252,5054,3168,5054,5054,257,4797,4410,2387,752,1244,17,4,6,387,3168,2157,1011,Apache Choctaw SDTSA
1354,,,9520R,252,14195,6381,14195,14195,1402,12793,12232,11124,224,752,120,1,11,561,6381,5541,840,Bayou Lafourche SDTSA
1355,,,9525R,252,1015,491,1015,1015,13,1002,981,336,626,10,8,0,1,21,491,414,77,Beaver Creek SDTSA
1356,,,9550R,252,85009,39923,85009,85009,3712,81297,77994,50058,26325,234,1036,42,299,3303,39923,35867,4056,Cher-O-Creek SDTSA
1357,,,9560R,252,13170,5504,13170,13170,2019,11151,10668,10303,147,69,120,7,22,483,5504,5105,399,Cherokee Tribe of Northeast Alabama SDTSA
1358,,,9630R,252,349,196,349,349,7,342,329,236,13,76,1,0,3,13,196,185,11,Clifton Choctaw SDTSA
1359,,,9635R,252,58504,25262,58504,58504,7501,51003,48449,30939,15684,927,555,69,275,2554,25262,22775,2487,Coharie SDTSA
1360,,,9680R,252,57896,24208,57896,57896,2168,55728,51688,43401,5905,1604,525,49,204,4040,24208,22456,1752,Echota Cherokee SDTSA
1361,,,9690R,252,4242,1733,4242,4242,184,4058,3863,2651,987,208,2,1,14,195,1733,1550,183,Edisto Natchez Kusso SDTSA
1362,,,9720R,252,28785,13625,28785,28785,1963,26822,25156,17467,6602,272,573,83,159,1666,13625,11681,1944,Four Winds Cherokee SDTSA
1363,,,9730R,252,6340,2609,6340,6340,243,6097,5801,5694,33,25,31,1,17,296,2609,2394,215,Georgia Tribe of Eastern Cherokee SDTSA
1364,,,9735R,252,8884,4166,8884,8884,376,8508,8059,5973,592,1418,61,0,15,449,4166,3230,936,Grand Caillou/Dulac SDTSA
1365,,,9745R,252,6947,3576,6947,6947,146,6801,6505,857,3502,2117,9,1,19,296,3576,3000,576,Haliwa-Saponi SDTSA
1366,,,9775R,252,737,321,737,737,39,698,670,299,298,63,5,0,5,28,321,241,80,Isle de Jean Charles SDTSA
1367,,,9800R,252,666,298,666,666,52,614,577,428,67,68,12,0,2,37,298,274,24,Lenape Indian Tribe of Delaware SDTSA
1368,,,9815R,252,510711,218617,510711,510711,54442,456269,427660,181881,175999,55491,9990,1381,2918,28609,218617,198296,20321,Lumbee SDTSA
1369,,,9820R,252,22131,10222,22131,22131,1430,20701,19763,18006,1334,247,97,12,67,938,10222,8829,1393,MaChis Lower Creek SDTSA
1370,,,9825R,252,6901,3513,6901,6901,148,6753,6548,1475,4874,110,58,2,29,205,3513,2931,582,Meherrin SDTSA
1371,,,9830R,252,9971,5302,9971,9971,791,9180,8713,7616,727,162,166,4,38,467,5302,4324,978,Nanticoke Indian Tribe SDTSA
1372,,,9835R,252,5171,2136,5171,5171,996,4175,3936,1299,2381,219,16,0,21,239,2136,1887,249,Nanticoke Lenni Lenape SDTSA
1373,,,9836R,252,26528,12424,26528,26528,1174,25354,24414,11417,12509,144,153,11,180,940,12424,10590,1834,Natchitoches SDTSA
1374,,,9838R,252,8812,3817,8812,8812,864,7948,7574,5346,2084,43,48,0,53,374,3817,3532,285,Occaneechi-Saponi SDTSA
1375,,,9844R,252,2767,694,2767,2767,267,2500,2419,836,1493,76,7,0,7,81,694,575,119,Pee Dee SDTSA
1376,,,9849R,252,4579,1828,4579,4579,177,4402,4068,3088,106,849,21,2,2,334,1828,1625,203,Pointe-au-Chien SDTSA
1377,,,9850R,252,828,288,828,828,107,721,638,389,55,125,57,0,12,83,288,281,7,Ramapough SDTSA
1378,,,9865R,252,2343,1161,2343,2343,68,2275,2190,1550,544,70,1,2,23,85,1161,984,177,Sappony SDTSA
1379,,,9875R,252,452,203,452,452,5,447,419,167,220,32,0,0,0,28,203,143,60,Santee SDTSA
1380,,,9880R,252,5482,2800,5482,5482,207,5275,5081,2927,2058,37,40,3,16,194,2800,2475,325,Southeastern Mvskoke Nation SDTSA
1381,,,9950R,252,6184,3010,6184,6184,403,5781,5524,4790,642,24,60,0,8,257,3010,2717,293,United Cherokee Ani-Yun-Wiya Nation SDTSA
1382,,,9960R,252,186056,78821,186056,186056,13877,172179,164913,120983,35892,5259,2255,76,448,7266,78821,70910,7911,United Houma Nation SDTSA
1383,,,9963R,252,1292,530,1292,1292,62,1230,1178,586,480,101,4,0,7,52,530,477,53,Upper South Carolina Pee Dee SDTSA
1384,,,9967R,252,39,10,39,39,6,33,31,28,1,0,2,0,0,2,10,7,3,Waccamaw SDTSA
1385,,,9970R,252,1482,687,1482,1482,15,1467,1416,240,187,981,2,0,6,51,687,604,83,Waccamaw Siouan SDTSA
1386,,,9975R,252,6269,3108,6269,6269,598,5671,5235,3683,1345,63,101,0,43,436,3108,2458,650,Wassamasaw SDTSA
1387,,,0010T,254,6,4,6,6,2,4,2,1,1,0,0,0,0,2,4,2,2,Acoma Off-Reservation Trust Land
1388,,,0020T,254,241,193,241,241,95,146,136,105,23,1,7,0,0,10,193,113,80,Agua Caliente Off-Reservation Trust Land
1389,,,0050T,254,100,32,100,100,17,83,78,7,0,69,0,0,2,5,32,32,0,Alabama-Coushatta Off-Reservation Trust Land
1390,,,0115T,254,202,78,202,202,18,184,157,38,2,117,0,0,0,27,78,78,0,Aroostook Band of Micmac Trust Land
1391,,,0120T,254,2,2,2,2,0,2,1,0,1,0,0,0,0,1,2,0,2,Auburn Off-Reservation Trust Land
1392,,,0155T,254,0,0,0,0,0,0,0,0,0,0,0,0,0,0,0,0,0,Barona Off-Reservation Trust Land
1393,,,0165T,254,0,0,0,0,0,0,0,0,0,0,0,0,0,0,0,0,0,Battle Mountain Off-Reservation Trust Land
1394,,,0170T,254,5,2,5,5,0,5,4,3,0,1,0,0,0,1,2,2,0,Bay Mills Off-Reservation Trust Land
1395,,,0185T,254,9,4,9,9,1,8,8,6,0,2,0,0,0,0,4,4,0,Benton Paiute Off-Reservation Trust Land
1396,,,0200T,254,149,47,149,149,41,108,87,22,3,61,1,0,0,21,47,44,3,Berry Creek Off-Reservation Trust Land
1397,,,0250T,254,0,0,0,0,0,0,0,0,0,0,0,0,0,0,0,0,0,Big Pine Off-Reservation Trust Land
1398,,,0265T,254,0,0,0,0,0,0,0,0,0,0,0,0,0,0,0,0,0,Big Sandy Off-Reservation Trust Land
1399,,,0305T,254,0,0,0,0,0,0,0,0,0,0,0,0,0,0,0,0,0,Blackfeet Off-Reservation Trust Land
1400,,,0325T,254,40,15,40,40,5,35,26,17,0,9,0,0,0,9,15,15,0,Blue Lake Off-Reservation Trust Land
1401,,,0335T,254,82,39,82,82,5,77,74,17,0,57,0,0,0,3,39,29,10,Bois Forte Off-Reservation Trust Land
1402,,,0350T,254,0,0,0,0,0,0,0,0,0,0,0,0,0,0,0,0,0,Bridgeport Off-Reservation Trust Land
1403,,,0400T,254,3,2,3,3,1,2,0,0,0,0,0,0,0,2,2,0,2,Burns Paiute Off-Reservation Trust Land
1404,,,0525T,254,0,0,0,0,0,0,0,0,0,0,0,0,0,0,0,0,0,Catawba Off-Reservation Trust Land
1405,,,0555T,254,4,1,4,4,0,4,4,4,0,0,0,0,0,0,1,1,0,Cedarville Off-Reservation Trust Land
1406,,,0560T,254,85,19,85,85,3,82,81,1,0,78,0,0,2,1,19,17,2,Celilo Village
1407,,,0575T,254,87,24,87,87,9,78,65,30,5,29,0,1,0,13,24,21,3,Chehalis Off-Reservation Trust Land
1408,,,0605T,254,6,2,6,6,1,5,5,0,0,5,0,0,0,0,2,0,2,Cheyenne River Off-Reservation Trust Land
1409,,,0620T,254,0,0,0,0,0,0,0,0,0,0,0,0,0,0,0,0,0,Chicken Ranch Off-Reservation Trust Land
1410,,,0690T,254,0,0,0,0,0,0,0,0,0,0,0,0,0,0,0,0,0,Coconut Creek Trust Land
1411,,,0760T,254,3,1,3,3,1,2,1,0,0,1,0,0,0,1,1,1,0,Colville Off-Reservation Trust Land
1412,,,0770T,254,77,33,77,77,5,72,63,21,0,42,0,0,0,9,33,33,0,"Coos, Lower Umpqua, and Siuslaw Off-Reservation Trust Land"
1413,,,0795T,254,60,27,60,60,6,54,41,14,1,26,0,0,0,13,27,27,0,Coushatta Off-Reservation Trust Land
1414,,,0815T,254,52,16,52,52,3,49,45,34,0,11,0,0,0,4,16,15,1,Cow Creek Off-Reservation Trust Land
1415,,,0845T,254,42,17,42,42,0,42,36,33,0,2,0,1,0,6,17,14,3,Crow Off-Reservation Trust Land
1416,,,0955T,254,0,0,0,0,0,0,0,0,0,0,0,0,0,0,0,0,0,Dry Creek Off-Reservation Trust Land
1417,,,1010T,254,7,1,7,7,5,2,2,2,0,0,0,0,0,0,1,0,1,Elk Valley Off-Reservation Trust Land
1418,,,1055T,254,0,0,0,0,0,0,0,0,0,0,0,0,0,0,0,0,0,Enterprise Off-Reservation Trust Land
1419,,,1070T,254,0,0,0,0,0,0,0,0,0,0,0,0,0,0,0,0,0,Fallon Paiute-Shoshone (Colony) Off-Reservation Trust Land
1420,,,1075T,254,0,0,0,0,0,0,0,0,0,0,0,0,0,0,0,0,0,Fallon Paiute-Shoshone (Reservation) Off-Reservation Trust Land
1421,,,1125T,254,4,5,4,4,2,2,1,1,0,0,0,0,0,1,5,1,4,Fond du Lac Off-Reservation Trust Land
1422,,,1135T,254,18,6,18,18,0,18,14,3,0,9,0,2,0,4,6,6,0,Forest County Potawatomi Off-Reservation Trust Land
1423,,,1150T,254,0,0,0,0,0,0,0,0,0,0,0,0,0,0,0,0,0,Fort Belknap Off-Reservation Trust Land
1424,,,1170T,254,0,0,0,0,0,0,0,0,0,0,0,0,0,0,0,0,0,Fort Bidwell Off-Reservation Trust Land
1425,,,1185T,254,1,1,1,1,0,1,0,0,0,0,0,0,0,1,1,0,1,Fort Hall Off-Reservation Trust Land
1426,,,1235T,254,237,90,237,237,41,196,182,13,0,167,0,2,0,14,90,81,9,Fort Mojave Off-Reservation Trust Land
1427,,,1250T,254,0,0,0,0,0,0,0,0,0,0,0,0,0,0,0,0,0,Fort Peck Off-Reservation Trust Land
1428,,,1355T,254,0,0,0,0,0,0,0,0,0,0,0,0,0,0,0,0,0,Grand Portage Off-Reservation Trust Land
1429,,,1365T,254,0,0,0,0,0,0,0,0,0,0,0,0,0,0,0,0,0,Grand Ronde Off-Reservation Trust Land
1430,,,1370T,254,590,205,590,590,67,523,461,83,2,373,1,0,2,62,205,189,16,Grand Traverse Off-Reservation Trust Land
1431,,,1400T,254,13,2,13,13,1,12,11,7,0,4,0,0,0,1,2,1,1,Guidiville Off-Reservation Trust Land
1432,,,1410T,254,395,133,395,395,10,385,344,45,0,299,0,0,0,41,133,131,2,Hannahville Off-Reservation Trust Land
1433,,,1450T,254,730,266,730,730,57,673,603,69,4,528,0,1,1,70,266,212,54,Ho-Chunk Nation Off-Reservation Trust Land
1434,,,1460T,254,0,0,0,0,0,0,0,0,0,0,0,0,0,0,0,0,0,Hoh Off-Reservation Trust Land
1435,,,1505T,254,107,40,107,107,6,101,98,0,0,98,0,0,0,3,40,34,6,Hopi Off-Reservation Trust Land
1436,,,1530T,254,7,3,7,7,5,2,2,2,0,0,0,0,0,0,3,3,0,Houlton Maliseet Off-Reservation Trust Land
1437,,,1545T,254,0,0,0,0,0,0,0,0,0,0,0,0,0,0,0,0,0,Hualapai Off-Reservation Trust Land
1438,,,1550T,254,2,2,2,2,0,2,2,2,0,0,0,0,0,0,2,2,0,Huron Potawatomi Off-Reservation Trust Land
1439,,,1590T,254,0,0,0,0,0,0,0,0,0,0,0,0,0,0,0,0,0,Iowa (KS-NE) Off-Reservation Trust Land
1440,,,1610T,254,61,16,61,61,9,52,39,20,1,14,3,1,0,13,16,15,1,Isabella Off-Reservation Trust Land
1441,,,1655T,254,36,17,36,36,5,31,21,4,3,13,1,0,0,10,17,13,4,Jamestown S'Klallam Off-Reservation Trust Land
1442,,,1700T,254,6,4,6,6,4,2,0,0,0,0,0,0,0,2,4,4,0,Jicarilla Apache Nation Off-Reservation Trust Land
1443,,,1735T,254,530,217,530,530,79,451,381,282,11,47,9,32,0,70,217,217,0,Kalispel Off-Reservation Trust Land
1444,,,1750T,254,539,193,539,539,52,487,434,43,0,390,0,0,1,53,193,180,13,Karuk Off-Reservation Trust Land
1445,,,1775T,254,15,9,15,15,2,13,9,0,0,9,0,0,0,4,9,9,0,Kickapoo (TX) Off-Reservation Trust Land
1446,,,1800T,254,29,10,29,29,5,24,20,2,0,18,0,0,0,4,10,2,8,Kootenai Off-Reservation Trust Land
1447,,,1815T,254,9,2,9,9,1,8,7,2,0,5,0,0,0,1,2,1,1,Lac Courte Oreilles Off-Reservation Trust Land
1448,,,1840T,254,0,0,0,0,0,0,0,0,0,0,0,0,0,0,0,0,0,Laguna Off-Reservation Trust Land
1449,,,1860T,254,0,0,0,0,0,0,0,0,0,0,0,0,0,0,0,0,0,Lake Traverse Off-Reservation Trust Land
1450,,,1880T,254,122,50,122,122,4,118,82,37,0,45,0,0,0,36,50,50,0,L'Anse Off-Reservation Trust Land
1451,,,1940T,254,0,0,0,0,0,0,0,0,0,0,0,0,0,0,0,0,0,Leech Lake Off-Reservation Trust Land
1452,,,1960T,254,218,101,218,218,9,209,176,64,7,105,0,0,0,33,101,92,9,Little River Off-Reservation Trust Land
1453,,,1963T,254,9,5,9,9,0,9,7,0,0,6,0,0,1,2,5,5,0,Little Traverse Bay Off-Reservation Trust Land
1454,,,2030T,254,3,1,3,3,2,1,0,0,0,0,0,0,0,1,1,1,0,Lower Brule Off-Reservation Trust Land
1455,,,2040T,254,364,131,364,364,29,335,286,41,2,239,4,0,0,49,131,121,10,Lower Elwha Off-Reservation Trust Land
1456,,,2115T,254,0,0,0,0,0,0,0,0,0,0,0,0,0,0,0,0,0,Manzanita Off-Reservation Trust Land
1457,,,2130T,254,0,0,0,0,0,0,0,0,0,0,0,0,0,0,0,0,0,Maricopa (Ak Chin) Off-Reservation Trust Land
1458,,,2145T,254,47,7,47,47,9,38,16,3,0,13,0,0,0,22,7,7,0,Mashantucket Pequot Off-Reservation Trust Land
1459,,,2147T,254,3,33,3,3,3,0,0,0,0,0,0,0,0,0,33,33,0,Mashpee Wampanoag Trust Land
1460,,,2150T,254,18,10,18,18,2,16,7,0,0,7,0,0,0,9,10,10,0,Match-e-be-nash-she-wish Band of Pottawatomi Off-Reservation Trust Land
1461,,,2175T,254,261,73,261,261,5,256,251,5,4,241,1,0,0,5,73,73,0,Menominee Off-Reservation Trust Land
1462,,,2240T,254,0,0,0,0,0,0,0,0,0,0,0,0,0,0,0,0,0,Miccosukee Off-Reservation Trust Land
1463,,,2270T,254,149,61,149,149,2,147,139,8,0,131,0,0,0,8,61,52,9,Mille Lacs Off-Reservation Trust Land
1464,,,2285T,254,8,3,8,8,4,4,1,0,0,1,0,0,0,3,3,2,1,Minnesota Chippewa Trust Land
1465,,,2300T,254,331,74,331,331,23,308,280,22,4,254,0,0,0,28,74,72,2,Mississippi Choctaw Off-Reservation Trust Land
1466,,,2340T,254,66,17,66,66,12,54,44,8,0,36,0,0,0,10,17,17,0,Mooretown Off-Reservation Trust Land
1467,,,2360T,254,0,0,0,0,0,0,0,0,0,0,0,0,0,0,0,0,0,Morongo Off-Reservation Trust Land
1468,,,2375T,254,25,6,25,25,10,15,11,9,0,0,1,0,1,4,6,6,0,Muckleshoot Off-Reservation Trust Land
1469,,,2400T,254,0,0,0,0,0,0,0,0,0,0,0,0,0,0,0,0,0,Nambe Off-Reservation Trust Land
1470,,,2430T,254,24392,7994,24392,24392,573,23819,23483,193,36,23147,92,7,8,336,7994,7167,827,Navajo Nation Off-Reservation Trust Land
1471,,,2475T,254,876,246,876,876,65,811,657,102,5,541,2,7,0,154,246,231,15,Nooksack Off-Reservation Trust Land
1472,,,2490T,254,6,2,6,6,1,5,2,0,0,2,0,0,0,3,2,1,1,Northern Cheyenne Off-Reservation Trust Land
1473,,,2495T,254,17,2,17,17,8,9,7,0,0,7,0,0,0,2,2,2,0,North Fork Off-Reservation Trust Land
1474,,,2560T,254,0,0,0,0,0,0,0,0,0,0,0,0,0,0,0,0,0,Oneida (WI) Off-Reservation Trust Land
1475,,,2680T,254,0,0,0,0,0,0,0,0,0,0,0,0,0,0,0,0,0,Pascua Pueblo Yaqui Off-Reservation Trust Land
1476,,,2695T,254,4,39,4,4,1,3,1,1,0,0,0,0,0,2,39,10,29,Passamaquoddy Trust Land
1477,,,2760T,254,9,58,9,9,3,6,4,4,0,0,0,0,0,2,58,11,47,Penobscot Off-Reservation Trust Land
1478,,,2775T,254,10,2,10,10,7,3,3,1,0,2,0,0,0,0,2,1,1,Picayune Off-Reservation Trust Land
1479,,,2835T,254,24,8,24,24,0,24,23,1,0,22,0,0,0,1,8,8,0,Pit River Trust Land
1480,,,2865T,254,102,39,102,102,4,98,91,37,0,54,0,0,0,7,39,38,1,Poarch Creek Off-Reservation Trust Land
1481,,,2890T,254,196,82,196,196,6,190,152,34,3,112,0,0,3,38,82,82,0,Pokagon Off-Reservation Trust Land
1482,,,2900T,254,8,2,8,8,2,6,3,0,0,3,0,0,0,3,2,0,2,Ponca (NE) Trust Land
1483,,,2910T,254,5,1,5,5,1,4,3,0,0,2,1,0,0,1,1,0,1,Port Gamble Off-Reservation Trust Land
1484,,,2985T,254,149,56,149,149,21,128,115,11,1,101,1,0,1,13,56,53,3,Prairie Island Off-Reservation Trust Land
1485,,,2990T,254,7,4,7,7,6,1,1,1,0,0,0,0,0,0,4,0,4,Pojoaque Off-Reservation Trust Land
1486,,,3000T,254,14,2,14,14,4,10,5,2,0,0,0,3,0,5,2,2,0,Puyallup Off-Reservation Trust Land
1487,,,3020T,254,90,26,90,90,2,88,81,7,0,74,0,0,0,7,26,24,2,Quartz Valley Off-Reservation Trust Land
1488,,,3085T,254,41,15,41,41,1,40,38,0,0,38,0,0,0,2,15,15,0,Red Cliff Off-Reservation Trust Land
1489,,,3130T,254,0,0,0,0,0,0,0,0,0,0,0,0,0,0,0,0,0,Reno-Sparks Off-Reservation Trust Land
1490,,,3165T,254,0,0,0,0,0,0,0,0,0,0,0,0,0,0,0,0,0,Rincon Off-Reservation Trust Land
1491,,,3195T,254,14,5,14,14,3,11,9,0,0,7,0,1,1,2,5,5,0,Robinson Off-Reservation Trust Land
1492,,,3205T,254,1632,409,1632,1632,77,1555,1525,20,0,1505,0,0,0,30,409,387,22,Rocky Boy's Off-Reservation Trust Land
1493,,,3220T,254,208,48,208,208,18,190,158,38,3,112,0,0,5,32,48,48,0,Rohnerville (Rancheria) Trust Land
1494,,,3235T,254,1251,338,1251,1251,24,1227,1147,68,0,1077,2,0,0,80,338,301,37,Rosebud Off-Reservation Trust Land
1495,,,3250T,254,351,108,351,351,50,301,277,53,0,224,0,0,0,24,108,102,6,Round Valley Off-Reservation Trust Land
1496,,,3280T,254,22,3,22,22,2,20,17,3,0,14,0,0,0,3,3,0,3,Sac and Fox/Meskwaki Off-Reservation Trust Land
1497,,,3285T,254,21,20,21,21,0,21,18,4,0,14,0,0,0,3,20,13,7,Sac and Fox Nation Off-Reservation Trust Land
1498,,,3305T,254,132,54,132,132,0,132,109,16,0,93,0,0,0,23,54,52,2,St. Croix Off-Reservation Trust Land
1499,,,3415T,254,0,0,0,0,0,0,0,0,0,0,0,0,0,0,0,0,0,San Ildefonso Off-Reservation Trust Land
1500,,,3445T,254,8,2,8,8,5,3,3,2,0,0,0,0,1,0,2,2,0,San Manuel Off-Reservation Trust Land
1501,,,3460T,254,21,1,21,21,11,10,6,1,0,3,2,0,0,4,1,1,0,San Pasqual Off-Reservation Trust Land
1502,,,3495T,254,0,0,0,0,0,0,0,0,0,0,0,0,0,0,0,0,0,Santa Clara Off-Reservation Trust Land
1503,,,3635T,254,1449,536,1449,1449,49,1400,1178,409,24,741,3,0,1,222,536,482,54,Sault Ste. Marie Off-Reservation Trust Land
1504,,,3665T,254,0,0,0,0,0,0,0,0,0,0,0,0,0,0,0,0,0,Seminole (FL) Trust Land
1505,,,3680T,254,454,159,454,454,36,418,373,101,5,257,9,1,0,45,159,152,7,Shakopee Mdewakanton Sioux Off-Reservation Trust Land
1506,,,3735T,254,89,18,89,89,14,75,66,10,0,56,0,0,0,9,18,14,4,Sherwood Valley Off-Reservation Trust Land
1507,,,3750T,254,0,0,0,0,0,0,0,0,0,0,0,0,0,0,0,0,0,Shingle Springs Off-Reservation Trust Land
1508,,,3780T,254,21,9,21,21,4,17,13,4,0,9,0,0,0,4,9,7,2,Shoalwater Bay Off-Reservation Trust Land
1509,,,3795T,254,324,99,324,324,39,285,247,41,0,203,0,3,0,38,99,89,10,Siletz Off-Reservation Trust Land
1510,,,3825T,254,0,0,0,0,0,0,0,0,0,0,0,0,0,0,0,0,0,Skokomish Off-Reservation Trust Land
1511,,,3855T,254,19,7,19,19,3,16,14,2,0,12,0,0,0,2,7,7,0,Smith River Off-Reservation Trust Land
1512,,,3860T,254,0,0,0,0,0,0,0,0,0,0,0,0,0,0,0,0,0,Snoqualmie Off-Reservation Trust Land
1513,,,3870T,254,0,0,0,0,0,0,0,0,0,0,0,0,0,0,0,0,0,Soboba Off-Reservation Trust Land
1514,,,3885T,254,28,7,28,28,4,24,21,10,0,11,0,0,0,3,7,7,0,Sokaogon Chippewa Off-Reservation Trust Land
1515,,,3930T,254,29,16,29,29,1,28,28,10,0,18,0,0,0,0,16,13,3,South Fork Off-Reservation Trust Land
1516,,,3940T,254,0,1,0,0,0,0,0,0,0,0,0,0,0,0,1,1,0,Spokane Off-Reservation Trust Land
1517,,,3955T,254,235,71,235,235,24,211,160,39,2,116,0,0,3,51,71,67,4,Squaxin Island Off-Reservation Trust Land
1518,,,3985T,254,0,0,0,0,0,0,0,0,0,0,0,0,0,0,0,0,0,Stewarts Point Off-Reservation Trust Land
1519,,,4000T,254,14,6,14,14,0,14,8,3,0,5,0,0,0,6,6,2,4,Stillaguamish Off-Reservation Trust Land
1520,,,4015T,254,108,49,108,108,11,97,82,9,0,73,0,0,0,15,49,41,8,Stockbridge Munsee Off-Reservation Trust Land
1521,,,4045T,254,0,0,0,0,0,0,0,0,0,0,0,0,0,0,0,0,0,Summit Lake Off-Reservation Trust Land
1522,,,4060T,254,236,115,236,236,8,228,219,186,18,15,0,0,0,9,115,109,6,Susanville Off-Reservation Trust Land
1523,,,4075T,254,0,0,0,0,0,0,0,0,0,0,0,0,0,0,0,0,0,Swinomish Off-Reservation Trust Land
1524,,,4090T,254,119,35,119,119,32,87,61,12,5,40,4,0,0,26,35,35,0,Sycuan Off-Reservation Trust Land
1525,,,4110T,254,11,6,11,11,3,8,8,8,0,0,0,0,0,0,6,2,4,Table Mountain Off-Reservation Trust Land
1526,,,4140T,254,55,37,55,55,25,30,26,19,0,3,2,0,2,4,37,22,15,Taos Off-Reservation Trust Land
1527,,,4170T,254,0,0,0,0,0,0,0,0,0,0,0,0,0,0,0,0,0,Tesuque Off-Reservation Trust Land
1528,,,4180T,254,25,21,25,25,4,21,19,7,0,12,0,0,0,2,21,21,0,Timbi-Sha Shoshone Off-Reservation Trust Land
1529,,,4200T,254,336,76,336,336,13,323,305,2,1,301,0,0,1,18,76,76,0,Tohono O'odham Nation Off-Reservation Trust Land
1530,,,4235T,254,0,0,0,0,0,0,0,0,0,0,0,0,0,0,0,0,0,Tonto Apache Off-Reservation Trust Land
1531,,,4275T,254,82,28,82,82,9,73,71,4,0,67,0,0,0,2,28,23,5,Trinidad Off-Reservation Trust Land
1532,,,4290T,254,0,0,0,0,0,0,0,0,0,0,0,0,0,0,0,0,0,Tulalip Off-Reservation Trust Land
1533,,,4300T,254,0,0,0,0,0,0,0,0,0,0,0,0,0,0,0,0,0,Tule River Off-Reservation Trust Land
1534,,,4315T,254,29,8,29,29,2,27,25,22,0,2,0,1,0,2,8,8,0,Tunica-Biloxi Off-Reservation Trust Land
1535,,,4345T,254,2506,777,2506,2506,35,2471,2406,73,3,2330,0,0,0,65,777,734,43,Turtle Mountain Off-Reservation Trust Land
1536,,,4375T,254,2,0,2,2,1,1,1,1,0,0,0,0,0,0,0,0,0,Twenty-Nine Palms Off-Reservation Trust Land
1537,,,4390T,254,0,0,0,0,0,0,0,0,0,0,0,0,0,0,0,0,0,Uintah and Ouray Off-Reservation Trust Land
1538,,,4405T,254,0,0,0,0,0,0,0,0,0,0,0,0,0,0,0,0,0,Umatilla Off-Reservation Trust Land
1539,,,4445T,254,3,1,3,3,0,3,1,0,1,0,0,0,0,2,1,1,0,Upper Sioux Off-Reservation Trust Land
1540,,,4455T,254,4,1,4,4,0,4,4,3,0,1,0,0,0,0,1,0,1,Upper Skagit Off-Reservation Trust Land
1541,,,4470T,254,0,0,0,0,0,0,0,0,0,0,0,0,0,0,0,0,0,Ute Mountain Off-Reservation Trust Land
1542,,,4500T,254,0,0,0,0,0,0,0,0,0,0,0,0,0,0,0,0,0,Viejas Off-Reservation Trust Land
1543,,,4530T,254,86,40,86,86,8,78,68,16,0,52,0,0,0,10,40,40,0,Wampanoag-Aquinnah Trust Land
1544,,,4545T,254,8,1,8,8,3,5,4,0,0,4,0,0,0,1,1,0,1,Warm Springs Off-Reservation Trust Land
1545,,,4560T,254,3223,1603,3223,3223,455,2768,2631,2527,16,58,26,1,3,137,1603,1414,189,Washoe Ranches Trust Land
1546,,,4595T,254,31,8,31,31,0,31,31,23,0,8,0,0,0,0,8,2,6,White Earth Off-Reservation Trust Land
1547,,,4610T,254,2,3,2,2,1,1,1,1,0,0,0,0,0,0,3,1,2,Wind River Off-Reservation Trust Land
1548,,,4625T,254,0,0,0,0,0,0,0,0,0,0,0,0,0,0,0,0,0,Winnebago Off-Reservation Trust Land
1549,,,4690T,254,122,28,122,122,6,116,109,6,0,102,1,0,0,7,28,26,2,Yakama Nation Off-Reservation Trust Land
1550,,,4708T,254,577,207,577,577,88,489,445,38,1,399,6,0,1,44,207,188,19,Yavapai-Apache Nation Off-Reservation Trust Land
1551,,,4755T,254,821,238,821,821,645,176,166,5,2,156,3,0,0,10,238,209,29,Ysleta del Sur Off-Reservation Trust Land
1552,,,4770T,254,0,0,0,0,0,0,0,0,0,0,0,0,0,0,0,0,0,Zia Off-Reservation Trust Land
1553,,,4785T,254,0,0,0,0,0,0,0,0,0,0,0,0,0,0,0,0,0,Zuni Off-Reservation Trust Land
1554,,,5003T,254,228,81,228,228,10,218,132,46,0,0,9,77,0,86,81,76,5,Anahola (Agricultural) Hawaiian Home Land
1555,,,5004T,254,1659,454,1659,1659,130,1529,911,113,0,0,62,731,5,618,454,429,25,Anahola (Residential) Hawaiian Home Land
1556,,,5008T,254,789,203,789,789,77,712,285,25,2,0,29,228,1,427,203,193,10,East Kapolei Hawaiian Home Land
1557,,,5009T,254,0,0,0,0,0,0,0,0,0,0,0,0,0,0,0,0,0,Haiku Hawaiian Home Land
1558,,,5011T,254,35,6,35,35,2,33,24,0,0,0,22,2,0,9,6,6,0,Hanapepe Hawaiian Home Land
1559,,,5018T,254,2,1,2,2,0,2,0,0,0,0,0,0,0,2,1,1,0,Homuula-Upper Piihonua Hawaiian Home Land
1560,,,5026T,254,5,2,5,5,2,3,1,1,0,0,0,0,0,2,2,1,1,Honokaia Hawaiian Home Land
1561,,,5029T,254,2,1,2,2,0,2,1,0,0,0,0,1,0,1,1,0,1,Honokowai Hawaiian Home Land
1562,,,5030T,254,1,0,1,1,0,1,0,0,0,0,0,0,0,1,0,0,0,Honolulu Makai Hawaiian Home Land
1563,,,5031T,254,0,0,0,0,0,0,0,0,0,0,0,0,0,0,0,0,0,Honomu Hawaiian Home Land
1564,,,5033T,254,1370,399,1370,1370,64,1306,905,27,0,1,45,832,0,401,399,377,22,Hoolehua-Palaau Hawaiian Home Land
1565,,,5041T,254,34,17,34,34,4,30,29,0,0,1,0,28,0,1,17,13,4,Kahikinui Hawaiian Home Land
1566,,,5043T,254,318,76,318,318,25,293,144,6,0,0,4,134,0,149,76,76,0,Kakaina-Kumuhau Hawaiian Home Land
1567,,,5044T,254,8,0,8,8,4,4,4,1,0,0,0,3,0,0,0,0,0,Kalaeloa Hawaiian Home Land
1568,,,5046T,254,383,137,383,383,35,348,197,7,0,0,10,178,2,151,137,124,13,Kalamaula Hawaiian Home Land
1569,,,5051T,254,82,110,82,82,18,64,55,27,0,0,9,15,4,9,110,57,53,Kalaupapa Hawaiian Home Land
1570,,,5053T,254,308,99,308,308,24,284,154,15,0,0,29,110,0,130,99,93,6,Kalawahine Hawaiian Home Land
1571,,,5056T,254,6,5,6,6,2,4,4,1,0,0,0,3,0,0,5,0,5,Kamaoa-Puueo Hawaiian Home Land
1572,,,5061T,254,81,30,81,81,6,75,51,4,0,0,4,42,1,24,30,30,0,Kamiloloa-Makakupaia Hawaiian Home Land
1573,,,5066T,254,55,15,55,55,2,53,20,5,0,0,1,14,0,33,15,10,5,Kamoku-Kapulena Hawaiian Home Land
1574,,,5067T,254,1566,371,1566,1566,172,1394,603,26,7,0,61,509,0,791,371,367,4,Kanehili Hawaiian Home Land
1575,,,5069T,254,0,0,0,0,0,0,0,0,0,0,0,0,0,0,0,0,0,Kaohe-Olaa Hawaiian Home Land
1576,,,5071T,254,0,0,0,0,0,0,0,0,0,0,0,0,0,0,0,0,0,Kapaa Hawaiian Home Land
1577,,,5076T,254,154,48,154,154,6,148,100,2,1,0,2,95,0,48,48,39,9,Kapaakea Hawaiian Home Land
1578,,,5083T,254,0,1,0,0,0,0,0,0,0,0,0,0,0,0,1,1,0,Kapolei Hawaiian Home Land
1579,,,5086T,254,119,42,119,119,17,102,49,1,0,0,9,39,0,53,42,39,3,Kaumana Hawaiian Home Land
1580,,,5088T,254,1332,327,1332,1332,201,1131,481,19,5,0,48,409,0,650,327,327,0,Kaupea Hawaiian Home Land
1581,,,5091T,254,500,168,500,500,46,454,279,28,0,3,17,231,0,175,168,147,21,Kawaihae Hawaiian Home Land
1582,,,5098T,254,0,0,0,0,0,0,0,0,0,0,0,0,0,0,0,0,0,Keahuolu Hawaiian Home Land
1583,,,5101T,254,990,291,990,990,116,874,476,42,0,0,25,409,0,398,291,280,11,Kealakehe Hawaiian Home Land
1584,,,5104T,254,7,5,7,7,3,4,4,0,0,0,0,4,0,0,5,0,5,Keanae-Wailua Hawaiian Home Land
1585,,,5106T,254,1617,450,1617,1617,192,1425,818,48,0,0,44,726,0,607,450,431,19,Keaukaha Hawaiian Home Land
1586,,,5111T,254,491,121,491,491,42,449,271,7,0,0,23,238,3,178,121,107,14,Kekaha Hawaiian Home Land
1587,,,5114T,254,113,39,113,113,8,105,69,22,1,2,1,43,0,36,39,37,2,Keokea (Agricultural) Hawaiian Home Land
1588,,,5116T,254,17,7,17,17,4,13,10,5,0,0,4,1,0,3,7,7,0,Keoniki Hawaiian Home Land
1589,,,5120T,254,245,52,245,245,22,223,124,5,0,0,11,108,0,99,52,50,2,Kewalo Hawaiian Home Land
1590,,,5123T,254,0,0,0,0,0,0,0,0,0,0,0,0,0,0,0,0,0,Kolaoa Hawaiian Home Land
1591,,,5133T,254,73,33,73,73,5,68,36,7,0,0,7,22,0,32,33,33,0,Lalamilo Hawaiian Home Land
1592,,,5134T,254,117,31,117,117,12,105,61,4,0,0,14,43,0,44,31,31,0,Lanai City Hawaiian Home Land
1593,,,5135T,254,422,101,422,422,42,380,218,22,0,0,15,177,4,162,101,101,0,Leialii Hawaiian Home Land
1594,,,5136T,254,54,11,54,54,12,42,28,1,0,0,14,10,3,14,11,8,3,Lualualei Hawaiian Home Land
1595,,,5138T,254,8,1,8,8,3,5,3,3,0,0,0,0,0,2,1,1,0,Maili Hawaiian Home Land
1596,,,5139T,254,0,0,0,0,0,0,0,0,0,0,0,0,0,0,0,0,0,Makaha Valley Hawaiian Home Land
1597,,,5146T,254,106,40,106,106,10,96,51,10,0,1,2,38,0,45,40,34,6,Makuu Hawaiian Home Land
1598,,,5148T,254,1020,228,1020,1020,89,931,453,16,2,0,49,386,0,478,228,222,6,Maluohai Hawaiian Home Land
1599,,,5156T,254,13,2,13,13,5,8,2,1,0,0,0,1,0,6,2,2,0,Moloaa Hawaiian Home Land
1600,,,5161T,254,5135,1104,5135,5135,530,4605,2632,62,10,0,123,2434,3,1973,1104,1089,15,Nanakuli Hawaiian Home Land
1601,,,5166T,254,7,2,7,7,0,7,6,1,0,0,0,5,0,1,2,2,0,Nienie Hawaiian Home Land
1602,,,5176T,254,670,191,670,670,44,626,316,40,0,0,20,256,0,310,191,191,0,Panaewa (Agricultural) Hawaiian Home Land
1603,,,5177T,254,1054,289,1054,1054,102,952,540,23,0,0,42,475,0,412,289,288,1,Panaewa (Residential) Hawaiian Home Land
1604,,,5179T,254,1091,266,1091,1091,126,965,526,21,4,0,50,451,0,439,266,255,11,Papakolea Hawaiian Home Land
1605,,,5181T,254,5,3,5,5,1,4,3,2,0,0,0,1,0,1,3,3,0,Pauahi Hawaiian Home Land
1606,,,5186T,254,729,173,729,729,62,667,343,28,2,4,18,290,1,324,173,173,0,Paukukalo Hawaiian Home Land
1607,,,5188T,254,3,1,3,3,1,2,1,0,0,0,1,0,0,1,1,1,0,Pearl City Hawaiian Home Land
1608,,,5193T,254,59,17,59,59,5,54,28,1,0,0,2,25,0,26,17,17,0,Piihonua Hawaiian Home Land
1609,,,5196T,254,17,4,17,17,5,12,7,0,0,0,2,5,0,5,4,4,0,Ponohawaii Hawaiian Home Land
1610,,,5198T,254,1068,272,1068,1068,131,937,522,42,2,0,33,445,0,415,272,272,0,Princess Kahanu Estates Hawaiian Home Land
1611,,,5199T,254,0,0,0,0,0,0,0,0,0,0,0,0,0,0,0,0,0,Pulehunui Hawaiian Home Land
1612,,,5201T,254,936,295,936,936,82,854,519,56,0,0,12,451,0,335,295,282,13,Puukapu Hawaiian Home Land
1613,,,5213T,254,1,2,1,1,1,0,0,0,0,0,0,0,0,0,2,0,2,South Maui Hawaiian Home Land
1614,,,5216T,254,0,0,0,0,0,0,0,0,0,0,0,0,0,0,0,0,0,Ualapue Hawaiian Home Land
1615,,,5222T,254,0,0,0,0,0,0,0,0,0,0,0,0,0,0,0,0,0,Upolu Hawaiian Home Land
1616,,,5223T,254,29,8,29,29,4,25,18,6,0,0,0,12,0,7,8,5,3,Waiahole Hawaiian Home Land
1617,,,5236T,254,14,4,14,14,3,11,9,1,0,0,8,0,0,2,4,4,0,Waiakea Hawaiian Home Land
1618,,,5238T,254,2114,465,2114,2114,256,1858,1035,40,1,0,63,931,0,823,465,452,13,Waianae Hawaiian Home Land
1619,,,5239T,254,616,152,616,616,89,527,314,9,4,0,12,289,0,213,152,145,7,Waianae Kai Hawaiian Home Land
1620,,,5241T,254,1441,348,1441,1441,175,1266,654,56,1,3,56,537,1,612,348,348,0,Waiehu Hawaiian Home Land
1621,,,5248T,254,0,0,0,0,0,0,0,0,0,0,0,0,0,0,0,0,0,Waiku-Hana Hawaiian Home Land
1622,,,5251T,254,0,0,0,0,0,0,0,0,0,0,0,0,0,0,0,0,0,Wailau Hawaiian Home Land
1623,,,5256T,254,150,0,150,150,13,137,128,41,0,0,14,73,0,9,0,0,0,Wailua Hawaiian Home Land
1624,,,5271T,254,3639,799,3639,3639,305,3334,2101,88,2,2,87,1918,4,1233,799,787,12,Waimanalo Hawaiian Home Land
1625,,,5276T,254,0,0,0,0,0,0,0,0,0,0,0,0,0,0,0,0,0,Waimanu Hawaiian Home Land
1626,,,5281T,254,0,0,0,0,0,0,0,0,0,0,0,0,0,0,0,0,0,Waimea Hawaiian Home Land
1627,,,5283T,254,17,2,17,17,2,15,15,1,0,0,0,14,0,0,2,0,2,Waiohinu Hawaiian Home Land
1628,,,5286T,254,1231,340,1231,1231,138,1093,616,79,4,3,26,504,0,477,340,326,14,Waiohuli (Residential) Hawaiian Home Land
1629,,,10100,310,42287,19825,42287,42287,1720,40567,39254,36484,547,1142,941,44,96,1313,19825,17676,2149,"Aberdeen, SD Micro Area"
1630,,,10140,310,75636,36058,75636,75636,7834,67802,63097,57068,972,3495,1024,127,411,4705,36058,29869,6189,"Aberdeen, WA Micro Area"
1631,,,10180,310,176579,74341,176579,176579,41566,135013,127862,110356,13076,721,2978,172,559,7151,74341,65806,8535,"Abilene, TX Metro Area"
1632,,,10220,310,38065,17406,38065,38065,2208,35857,30889,22703,861,6842,372,13,98,4968,17406,15179,2227,"Ada, OK Micro Area"
1633,,,10300,310,99423,43577,99423,99423,8494,90929,86688,83126,2437,342,476,8,299,4241,43577,38581,4996,"Adrian, MI Micro Area"
1634,,,10380,310,310160,150383,310160,310160,306642,3518,3306,2659,239,28,145,9,226,212,150383,125759,24624,"Aguadilla-Isabela, PR Metro Area"
1635,,,10420,310,702219,317145,702219,702219,16711,685508,652923,536310,86856,1010,25906,187,2654,32585,317145,294385,22760,"Akron, OH Metro Area"
1636,,,10460,310,67839,32210,67839,67839,26152,41687,38926,30931,2299,4173,1001,145,377,2761,32210,25932,6278,"Alamogordo, NM Micro Area"
1637,,,10500,310,148922,66756,148922,148922,3924,144998,141171,61005,77846,245,1641,38,396,3827,66756,59070,7686,"Albany, GA Metro Area"
1638,,,10540,310,128610,51921,128610,128610,12571,116039,108396,104118,623,1283,1434,280,658,7643,51921,49344,2577,"Albany-Lebanon, OR Metro Area"
1639,,,10580,310,899262,417490,899262,899262,53324,845938,799691,670812,72439,2103,46009,376,7952,46247,417490,376039,41451,"Albany-Schenectady-Troy, NY Metro Area"
1640,,,10620,310,62504,27685,62504,62504,3086,59418,57135,48645,7000,210,1140,9,131,2283,27685,24742,2943,"Albemarle, NC Micro Area"
1641,,,10660,310,30895,14114,30895,30895,3183,27712,26826,25071,460,76,1135,5,79,886,14114,13076,1038,"Albert Lea, MN Micro Area"
1642,,,10700,310,97612,41245,97612,97612,15658,81954,78283,74666,2293,418,579,128,199,3671,41245,37257,3988,"Albertville, AL Micro Area"
1643,,,10740,310,916528,395152,916528,916528,439138,477390,448287,349193,21562,50109,21938,764,4721,29103,395152,367863,27289,"Albuquerque, NM Metro Area"
1644,,,10760,310,51698,28685,51698,51698,1345,50353,48902,35059,13366,109,230,0,138,1451,28685,21827,6858,"Alexander City, AL Micro Area"
1645,,,10780,310,152192,66906,152192,152192,6423,145769,139828,93001,43321,1094,1872,39,501,5941,66906,59091,7815,"Alexandria, LA Metro Area"
1646,,,10820,310,39006,21769,39006,39006,815,38191,37254,36629,223,104,227,11,60,937,21769,16557,5212,"Alexandria, MN Micro Area"
1647,,,10860,310,48722,20552,48722,48722,38797,9925,8599,7900,325,71,185,15,103,1326,20552,17271,3281,"Alice, TX Micro Area"
1648,,,10900,310,861889,358023,861889,861889,157445,704444,677042,598061,47022,779,26830,208,4142,27402,358023,334162,23861,"Allentown-Bethlehem-Easton, PA-NJ Metro Area"
1649,,,10940,310,41761,16032,41761,41761,3153,38608,37448,34812,2195,156,161,28,96,1160,16032,14764,1268,"Alma, MI Micro Area"
1650,,,10980,310,28907,15645,28907,28907,417,28490,27416,27006,99,120,112,12,67,1074,15645,12901,2744,"Alpena, MI Micro Area"
1651,,,11020,310,122822,55700,122822,122822,1708,121114,116860,113016,2463,134,868,12,367,4254,55700,51227,4473,"Altoona, PA Metro Area"
1652,,,11060,310,24785,12017,24785,24785,5937,18848,17333,14883,1614,382,320,77,57,1515,12017,9795,2222,"Altus, OK Micro Area"
1653,,,11100,310,268691,113641,268691,268691,77791,190900,181312,153401,16624,1499,8679,75,1034,9588,113641,102068,11573,"Amarillo, TX Metro Area"
1654,,,11140,310,34163,15419,34163,34163,1945,32218,31434,14885,15914,44,523,6,62,784,15419,13411,2008,"Americus, GA Micro Area"
1655,,,11180,310,125252,53282,125252,125252,5741,119511,114163,104664,3269,277,5544,32,377,5348,53282,49254,4028,"Ames, IA Metro Area"
1656,,,11220,310,49532,22857,49532,49532,7312,42220,40005,38237,987,83,479,9,210,2215,22857,19968,2889,"Amsterdam, NY Micro Area"
1657,,,11260,310,398328,169717,398328,398328,31682,366646,324952,239282,14836,29011,28796,10320,2707,41694,169717,147723,21994,"Anchorage, AK Metro Area"
1658,,,11380,310,18610,7020,18610,18610,10400,8210,7844,7405,192,96,102,0,49,366,7020,6262,758,"Andrews, TX Micro Area"
1659,,,11420,310,34435,18837,34435,34435,1427,33008,32019,31438,234,64,187,2,94,989,18837,13766,5071,"Angola, IN Micro Area"
1660,,,11460,310,372258,156882,372258,372258,20731,351527,330811,252220,42125,715,33517,183,2051,20716,156882,147847,9035,"Ann Arbor, MI Metro Area"
1661,,,11500,310,116441,53052,116441,116441,5010,111431,106863,79519,25365,386,1164,112,317,4568,53052,46437,6615,"Anniston-Oxford, AL Metro Area"
1662,,,11540,310,243147,100642,243147,243147,12280,230867,222765,207935,3348,2932,7857,154,539,8102,100642,96790,3852,"Appleton, WI Metro Area"
1663,,,11580,310,33976,15548,33976,33976,10011,23965,23184,18624,4203,80,189,8,80,781,15548,11941,3607,"Arcadia, FL Micro Area"
1664,,,11620,310,58149,26264,58149,58149,5307,52842,47290,38033,3020,4816,659,44,718,5552,26264,22933,3331,"Ardmore, OK Micro Area"
1665,,,11640,310,182705,84970,182705,182705,181254,1451,1367,1074,123,5,78,2,85,84,84970,73515,11455,"Arecibo, PR Metro Area"
1666,,,11660,310,21446,9977,21446,21446,1092,20354,19490,14093,5068,76,150,16,87,864,9977,8170,1807,"Arkadelphia, AR Micro Area"
1667,,,11700,310,469015,231509,469015,469015,40498,428517,409806,381527,19169,1375,5014,710,2011,18711,231509,201667,29842,"Asheville, NC Metro Area"
1668,,,11740,310,52447,22471,52447,52447,862,51585,49871,48948,383,82,322,33,103,1714,22471,20700,1771,"Ashland, OH Micro Area"
1669,,,11780,310,97574,46237,97574,97574,4489,93085,88320,84064,3492,154,338,12,260,4765,46237,39329,6908,"Ashtabula, OH Micro Area"
1670,,,11820,310,41072,23017,41072,41072,3848,37224,34968,33526,224,344,552,91,231,2256,23017,17533,5484,"Astoria, OR Micro Area"
1671,,,11860,310,16348,6814,16348,16348,583,15765,14923,13925,785,78,80,6,49,842,6814,6109,705,"Atchison, KS Micro Area"
1672,,,11900,310,62431,26386,62431,62431,1450,60981,58544,54086,2768,223,1210,1,256,2437,26386,23696,2690,"Athens, OH Micro Area"
1673,,,11940,310,53276,23934,53276,53276,2161,51115,48529,45993,1842,140,430,17,107,2586,23934,21340,2594,"Athens, TN Micro Area"
1674,,,11980,310,82150,40643,82150,82150,11242,70908,67725,61854,4705,414,510,31,211,3183,40643,32748,7895,"Athens, TX Micro Area"
1675,,,12020,310,215415,89257,215415,215415,19508,195907,188242,140539,38265,412,7641,75,1310,7665,89257,83071,6186,"Athens-Clarke County, GA Metro Area"
1676,,,12060,310,6089815,2414292,6089815,6089815,730470,5359345,5130254,2661835,2019208,10562,397009,2386,39254,229091,2414292,2258264,156028,"Atlanta-Sandy Springs-Alpharetta, GA Metro Area"
1677,,,12100,310,274534,132038,274534,274534,53713,220821,211225,148858,39022,357,21563,82,1343,9596,132038,106716,25322,"Atlantic City-Hammonton, NJ Metro Area"
1678,,,12120,310,36757,16684,36757,36757,751,36006,34593,22004,10922,1488,108,22,49,1413,16684,14499,2185,"Atmore, AL Micro Area"
1679,,,12140,310,43265,18096,43265,43265,1185,42080,40825,40232,183,67,225,39,79,1255,18096,16868,1228,"Auburn, IN Micro Area"
1680,,,12180,310,76248,36660,76248,76248,2636,73612,69950,66313,2727,224,379,54,253,3662,36660,31328,5332,"Auburn, NY Micro Area"
1681,,,12220,310,174241,74856,174241,174241,9135,165106,158526,109795,39252,365,8544,108,462,6580,74856,68728,6128,"Auburn-Opelika, AL Metro Area"
1682,,,12260,310,611000,263559,611000,611000,37863,573137,547051,318870,210051,1570,13093,790,2677,26086,263559,238635,24924,"Augusta-Richmond County, GA-SC Metro Area"
1683,,,12300,310,123642,62607,123642,123642,2552,121090,115621,112682,850,460,1215,29,385,5469,62607,53223,9384,"Augusta-Waterville, ME Micro Area"
1684,,,12380,310,40029,16928,40029,40029,5081,34948,33904,29804,1613,57,2052,255,123,1044,16928,15700,1228,"Austin, MN Micro Area"
1685,,,12420,310,2283371,946764,2283371,2283371,728021,1555350,1462317,1133113,151516,5461,159409,1577,11241,93033,946764,880668,66096,"Austin-Round Rock-Georgetown, TX Metro Area"
1686,,,12460,310,29367,13036,29367,29367,1911,27456,26807,14280,12200,64,183,16,64,649,13036,11466,1570,"Bainbridge, GA Micro Area"
1687,,,12540,310,909235,301009,909235,909235,499158,410077,381514,279600,46776,5197,44257,1127,4557,28563,301009,281498,19511,"Bakersfield, CA Metro Area"
1688,,,12580,310,2844510,1190095,2844510,2844510,215867,2628643,2501380,1499155,800885,5632,179428,1154,15126,127263,1190095,1100767,89328,"Baltimore-Columbia-Towson, MD Metro Area"
1689,,,12620,310,152199,74878,152199,152199,2715,149484,143408,138306,1443,1349,1853,37,420,6076,74878,64250,10628,"Bangor, ME Metro Area"
1690,,,12660,310,65763,30784,65763,65763,4050,61713,59767,57868,578,764,394,15,148,1946,30784,27094,3690,"Baraboo, WI Micro Area"
1691,,,12680,310,46738,19716,46738,46738,1214,45524,43758,41113,2183,62,267,8,125,1766,19716,18462,1254,"Bardstown, KY Micro Area"
1692,,,12700,310,228996,164885,228996,228996,7908,221088,208758,194561,6409,1092,3183,65,3448,12330,164885,103368,61517,"Barnstable Town, MA Metro Area"
1693,,,12740,310,59807,30645,59807,59807,1569,58238,55425,53704,612,135,632,23,319,2813,30645,25842,4803,"Barre, VT Micro Area"
1694,,,12780,310,52455,23713,52455,52455,3360,49095,42829,35208,1322,5194,974,10,121,6266,23713,21071,2642,"Bartlesville, OK Micro Area"
1695,,,12860,310,58388,26013,58388,58388,2752,55636,53280,50960,1358,361,412,16,173,2356,26013,24213,1800,"Batavia, NY Micro Area"
1696,,,12900,310,55209,26166,55209,55209,3620,51589,49002,47240,944,254,397,50,117,2587,26166,22290,3876,"Batesville, AR Micro Area"
1697,,,12940,310,870569,375423,870569,870569,55184,815385,790110,466937,300790,1834,17738,215,2596,25275,375423,333688,41735,"Baton Rouge, LA Metro Area"
1698,,,12980,310,134310,59518,134310,134310,7426,126884,119640,100385,14275,683,3715,29,553,7244,59518,54406,5112,"Battle Creek, MI Metro Area"
1699,,,13020,310,103856,48562,103856,103856,5930,97926,93563,90811,1598,359,538,0,257,4363,48562,45005,3557,"Bay City, MI Metro Area"
1700,,,13060,310,36255,18476,36255,36255,15455,20800,19998,15355,3734,99,700,7,103,802,18476,13716,4760,"Bay City, TX Micro Area"
1701,,,13100,310,21704,10327,21704,21704,635,21069,20396,20053,122,78,99,1,43,673,10327,9284,1043,"Beatrice, NE Micro Area"
1702,,,13140,310,397565,169646,397565,397565,69597,327968,316720,207916,94874,1155,11450,113,1212,11248,169646,150085,19561,"Beaumont-Port Arthur, TX Metro Area"
1703,,,13180,310,89396,38123,89396,89396,5490,83906,81643,77845,2701,371,511,11,204,2263,38123,35437,2686,"Beaver Dam, WI Micro Area"
1704,,,13220,310,115079,53670,115079,115079,1722,113357,108713,99818,7452,232,924,17,270,4644,53670,46767,6903,"Beckley, WV Metro Area"
1705,,,13260,310,45011,20484,45011,45011,765,44246,42850,42224,191,131,207,4,93,1396,20484,18542,1942,"Bedford, IN Micro Area"
1706,,,13300,310,31047,10562,31047,31047,19392,11655,11248,8600,2316,54,211,2,65,407,10562,8896,1666,"Beeville, TX Micro Area"
1707,,,13340,310,46150,23657,46150,46150,1004,45146,43024,41749,673,83,327,11,181,2122,23657,19062,4595,"Bellefontaine, OH Micro Area"
1708,,,13380,310,226847,100064,226847,226847,22825,204022,190027,170385,2221,5459,9952,672,1338,13995,100064,90123,9941,"Bellingham, WA Metro Area"
1709,,,13420,310,46228,21271,46228,46228,1108,45120,42579,32445,519,9198,268,15,134,2541,21271,17678,3593,"Bemidji, MN Micro Area"
1710,,,13460,310,198253,94110,198253,198253,17237,181016,170227,164595,786,1139,2421,258,1028,10789,94110,80217,13893,"Bend, OR Metro Area"
1711,,,13500,310,26667,12029,26667,26667,575,26092,25133,10556,13302,1130,99,7,39,959,12029,10241,1788,"Bennettsville, SC Micro Area"
1712,,,13540,310,37347,20815,37347,37347,939,36408,34886,33897,405,63,397,5,119,1522,20815,15699,5116,"Bennington, VT Micro Area"
1713,,,13620,310,31268,20444,31268,31268,672,30596,29474,28629,494,84,193,3,71,1122,20444,13908,6536,"Berlin, NH Micro Area"
1714,,,13660,310,39714,20884,39714,39714,1026,38688,36927,35521,772,190,312,14,118,1761,20884,16013,4871,"Big Rapids, MI Micro Area"
1715,,,13700,310,34860,14000,34860,34860,16174,18686,17869,15672,1520,211,386,12,68,817,14000,11674,2326,"Big Spring, TX Micro Area"
1716,,,13720,310,39817,18578,39817,39817,533,39284,38099,35809,1950,52,177,11,100,1185,18578,16045,2533,"Big Stone Gap, VA Micro Area"
1717,,,13740,310,184167,82822,184167,184167,10645,173522,164355,154227,1213,6728,1322,211,654,9167,82822,76049,6773,"Billings, MT Metro Area"
1718,,,13780,310,247138,114356,247138,247138,11402,235736,223629,200368,11981,475,9707,76,1022,12107,114356,101966,12390,"Binghamton, NY Metro Area"
1719,,,13820,310,1115289,487824,1115289,1115289,64820,1050469,1014880,663010,326696,2273,19188,447,3266,35589,487824,440912,46912,"Birmingham-Hoover, AL Metro Area"
1720,,,13900,310,133626,58711,133626,133626,4424,129202,124768,114900,2692,5314,1219,358,285,4434,58711,54514,4197,"Bismarck, ND Metro Area"
1721,,,13940,310,47992,16905,47992,47992,8331,39661,38312,34937,115,2892,192,38,138,1349,16905,15891,1014,"Blackfoot, ID Micro Area"
1722,,,13980,310,166378,72858,166378,166378,6364,160014,153105,135313,8050,233,8766,48,695,6909,72858,65445,7413,"Blacksburg-Christiansburg, VA Metro Area"
1723,,,14010,310,170954,74855,170954,170954,10524,160430,153161,129440,14699,258,8108,38,618,7269,74855,69096,5759,"Bloomington, IL Metro Area"
1724,,,14020,310,161039,73401,161039,161039,6655,154384,146765,132364,5095,269,8412,37,588,7619,73401,66913,6488,"Bloomington, IN Metro Area"
1725,,,14100,310,82863,37737,82863,82863,2627,80236,77835,74936,1187,98,1416,17,181,2401,37737,33899,3838,"Bloomsburg-Berwick, PA Metro Area"
1726,,,14140,310,106363,52335,106363,106363,1272,105091,101257,95457,4822,215,509,21,233,3834,52335,44827,7508,"Bluefield, WV-VA Micro Area"
1727,,,14160,310,28180,11938,28180,28180,1019,27161,26445,26000,220,50,130,5,40,716,11938,11134,804,"Bluffton, IN Micro Area"
1728,,,14180,310,40685,19075,40685,40685,1771,38914,37522,22861,14251,67,242,3,98,1392,19075,16036,3039,"Blytheville, AR Micro Area"
1729,,,14220,310,45463,21341,45463,45463,1410,44053,42721,29588,12758,134,161,0,80,1332,21341,17944,3397,"Bogalusa, LA Micro Area"
1730,,,14260,310,764718,295639,764718,764718,109350,655368,619129,584342,9264,3998,15801,1871,3853,36239,295639,280112,15527,"Boise City, ID Metro Area"
1731,,,14300,310,35662,14640,35662,35662,4218,31444,29827,27042,2199,309,145,20,112,1617,14640,12857,1783,"Bonham, TX Micro Area"
1732,,,14380,310,54086,32637,54086,54086,3521,50565,48556,44986,2101,82,938,11,438,2009,32637,21413,11224,"Boone, NC Micro Area"
1733,,,14420,310,20617,10166,20617,20617,4961,15656,14631,13783,416,273,105,2,52,1025,10166,8171,1995,"Borger, TX Micro Area"
1734,,,14460,310,4941632,2032387,4941632,4941632,580852,4360780,4132297,3292281,339635,5433,426194,1121,67633,228483,2032387,1912456,119931,"Boston-Cambridge-Newton, MA-NH Metro Area"
1735,,,14500,310,330758,140848,330758,330758,48168,282590,267816,245203,3149,1112,16291,241,1820,14774,140848,132551,8297,"Boulder, CO Metro Area"
1736,,,14540,310,179639,77863,179639,179639,10763,168876,161809,139587,13121,326,7396,678,701,7067,77863,69245,8618,"Bowling Green, KY Metro Area"
1737,,,14580,310,118960,52835,118960,118960,5895,113065,107447,104003,493,922,1389,91,549,5618,52835,47117,5718,"Bozeman, MT Micro Area"
1738,,,14620,310,40432,19416,40432,40432,642,39790,38219,36991,849,102,193,2,82,1571,19416,16470,2946,"Bradford, PA Micro Area"
1739,,,14660,310,96189,65440,96189,96189,1338,94851,91219,85927,447,4047,443,19,336,3632,65440,40486,24954,"Brainerd, MN Micro Area"
1740,,,14700,310,56066,29391,56066,56066,4329,51737,48689,46468,837,407,608,187,182,3048,29391,22486,6905,"Branson, MO Micro Area"
1741,,,14720,310,31055,31342,31055,31055,5335,25720,24658,23782,232,67,407,20,150,1062,31342,12939,18403,"Breckenridge, CO Micro Area"
1742,,,14740,310,275611,113248,275611,275611,24184,251427,228460,199020,7338,3491,14015,2814,1782,22967,113248,105803,7445,"Bremerton-Silverdale-Port Orchard, WA Metro Area"
1743,,,14780,310,35805,16838,35805,35805,6425,29380,28354,22023,5555,75,547,14,140,1026,16838,13906,2932,"Brenham, TX Micro Area"
1744,,,14820,310,32986,19025,32986,32986,1698,31288,29981,28542,1027,102,173,22,115,1307,19025,14385,4640,"Brevard, NC Micro Area"
1745,,,14860,310,957419,378479,957419,957419,205351,752068,715131,552125,99992,858,50751,173,11232,36937,378479,354084,24395,"Bridgeport-Stamford-Norwalk, CT Metro Area"
1746,,,15020,310,34907,15744,34907,34907,406,34501,33791,22996,10484,63,163,8,77,710,15744,13939,1805,"Brookhaven, MS Micro Area"
1747,,,15060,310,23446,13018,23446,23446,1674,21772,20330,19428,77,461,214,25,125,1442,13018,10953,2065,"Brookings, OR Micro Area"
1748,,,15100,310,34375,14849,34375,34375,1427,32948,31911,29922,628,372,912,13,64,1037,14849,13120,1729,"Brookings, SD Micro Area"
1749,,,15140,310,17864,8240,17864,17864,838,17026,16668,7554,8993,33,26,6,56,358,8240,7424,816,"Brownsville, TN Micro Area"
1750,,,15180,310,421017,154905,421017,421017,376680,44337,42399,37107,1405,365,2596,80,846,1938,154905,132507,22398,"Brownsville-Harlingen, TX Metro Area"
1751,,,15220,310,38095,18897,38095,38095,8211,29884,28551,26672,1353,134,269,27,96,1333,18897,15074,3823,"Brownwood, TX Micro Area"
1752,,,15260,310,113495,56914,113495,113495,6893,106602,102599,76364,24207,252,1260,95,421,4003,56914,45935,10979,"Brunswick, GA Metro Area"
1753,,,15340,310,42025,19865,42025,42025,638,41387,39946,39388,305,40,131,12,70,1441,19865,18069,1796,"Bucyrus-Galion, OH Micro Area"
1754,,,15380,310,1166902,538903,1166902,1166902,67476,1099426,1057732,851927,146080,6961,48529,244,3991,41694,538903,495456,43447,"Buffalo-Cheektowaga, NY Metro Area"
1755,,,15420,310,46268,17056,46268,46268,15095,31173,30131,29468,91,214,182,39,137,1042,17056,15870,1186,"Burley, ID Micro Area"
1756,,,15460,310,45297,22139,45297,45297,1357,43940,41981,38813,2530,72,412,26,128,1959,22139,19585,2554,"Burlington, IA-IL Micro Area"
1757,,,15500,310,171415,73385,171415,171415,24703,146712,140285,102487,33555,584,2811,86,762,6427,73385,67925,5460,"Burlington, NC Metro Area"
1758,,,15540,310,225562,100992,225562,225562,5793,219769,209264,194816,5127,813,7545,65,898,10505,100992,92140,8852,"Burlington-South Burlington, VT Metro Area"
1759,,,15580,310,35133,17247,35133,35133,1638,33495,32055,31081,126,480,214,20,134,1440,17247,15450,1797,"Butte-Silver Bow, MT Micro Area"
1760,,,15620,310,48725,25033,48725,48725,1289,47436,45520,44723,220,211,229,2,135,1916,25033,19533,5500,"Cadillac, MI Micro Area"
1761,,,15660,310,57544,22736,57544,57544,8957,48587,46371,43317,2075,122,719,15,123,2216,22736,21210,1526,"Calhoun, GA Micro Area"
1762,,,15680,310,113777,45560,113777,113777,6545,107232,100465,80233,15994,318,3301,86,533,6767,45560,41845,3715,"California-Lexington Park, MD Metro Area"
1763,,,15700,310,32531,16383,32531,32531,1777,30754,29490,19891,9017,91,355,6,130,1264,16383,13721,2662,"Cambridge, MD Micro Area"
1764,,,15740,310,38438,19009,38438,38438,444,37994,36545,35717,520,87,149,7,65,1449,19009,16100,2909,"Cambridge, OH Micro Area"
1765,,,15780,310,27389,14281,27389,27389,643,26746,25603,15591,9769,52,128,12,51,1143,14281,11963,2318,"Camden, AR Micro Area"
1766,,,15820,310,37130,16469,37130,37130,919,36211,34962,33085,1412,43,272,12,138,1249,16469,14777,1692,"Campbellsville, KY Micro Area"
1767,,,15860,310,48939,20243,48939,48939,6049,42890,40809,37713,1809,691,332,30,234,2081,20243,17871,2372,"Cañon City, CO Micro Area"
1768,,,15940,310,401574,180194,401574,401574,10815,390759,370412,335739,28845,794,3227,100,1707,20347,180194,166457,13737,"Canton-Massillon, OH Metro Area"
1769,,,15980,310,760822,416332,760822,760822,173161,587661,564669,490476,55958,1228,12789,244,3974,22992,416332,318303,98029,"Cape Coral-Fort Myers, FL Metro Area"
1770,,,16020,310,97517,43679,97517,97517,2469,95048,90432,80529,8106,222,1326,17,232,4616,43679,39105,4574,"Cape Girardeau, MO-IL Metro Area"
1771,,,16060,310,133435,65087,133435,133435,5168,128267,122028,106601,11731,364,2837,37,458,6239,65087,55915,9172,"Carbondale-Marion, IL Metro Area"
1772,,,16100,310,62314,26277,62314,62314,31307,31007,29473,27139,791,518,578,43,404,1534,26277,22751,3526,"Carlsbad-Artesia, NM Micro Area"
1773,,,16140,310,20760,9490,20760,20760,594,20166,19783,19409,262,19,75,0,18,383,9490,8764,726,"Carroll, IA Micro Area"
1774,,,16180,310,58639,24564,58639,58639,14870,43769,40975,37064,1079,1072,1358,110,292,2794,24564,23419,1145,"Carson City, NV Metro Area"
1775,,,16220,310,79955,36808,79955,79955,7169,72786,69127,66614,729,767,633,78,306,3659,36808,32699,4109,"Casper, WY Metro Area"
1776,,,16260,310,57289,21752,57289,57289,5482,51807,49955,47620,375,948,621,237,154,1852,21752,18731,3021,"Cedar City, UT Micro Area"
1777,,,16300,310,276520,121177,276520,276520,9870,266650,254990,230990,16749,464,5482,526,779,11660,121177,113146,8031,"Cedar Rapids, IA Metro Area"
1778,,,16340,310,42853,17274,42853,42853,5585,37268,35797,30161,5119,101,239,21,156,1471,17274,15999,1275,"Cedartown, GA Micro Area"
1779,,,16380,310,42528,17888,42528,42528,928,41600,40837,39752,191,63,189,564,78,763,17888,16288,1600,"Celina, OH Micro Area"
1780,,,16420,310,30928,13491,30928,30928,569,30359,29594,28204,1203,64,58,3,62,765,13491,11955,1536,"Central City, KY Micro Area"
1781,,,16460,310,37729,17358,37729,37729,712,37017,35200,33150,1509,94,349,1,97,1817,17358,15620,1738,"Centralia, IL Micro Area"
1782,,,16500,310,82149,35412,82149,82149,8830,73319,68360,65496,530,978,796,157,403,4959,35412,31693,3719,"Centralia, WA Micro Area"
1783,,,16540,310,155932,66368,155932,155932,10764,145168,139755,132566,4998,242,1408,40,501,5413,66368,62067,4301,"Chambersburg-Waynesboro, PA Metro Area"
1784,,,16580,310,222538,100435,222538,222538,16913,205625,194989,140880,28298,302,24500,61,948,10636,100435,91237,9198,"Champaign-Urbana, IL Metro Area"
1785,,,16620,310,258859,126770,258859,258859,3306,255553,244597,227211,13706,490,2304,51,835,10956,126770,111213,15557,"Charleston, WV Metro Area"
1786,,,16660,310,57313,27467,57313,57313,1880,55433,53355,50299,2071,95,638,24,228,2078,27467,24137,3330,"Charleston-Mattoon, IL Micro Area"
1787,,,16700,310,799636,360115,799636,799636,60469,739167,705968,500545,181808,2778,16100,691,4046,33199,360115,319353,40762,"Charleston-North Charleston, SC Metro Area"
1788,,,16740,310,2660329,1108163,2660329,2660329,312184,2348145,2246940,1537545,572695,8186,114333,1089,13092,101205,1108163,1034018,74145,"Charlotte-Concord-Gastonia, NC-SC Metro Area"
1789,,,16820,310,221524,98166,221524,221524,14760,206764,196757,158797,23460,303,12985,75,1137,10007,98166,87743,10423,"Charlottesville, VA Metro Area"
1790,,,16860,310,562647,247266,562647,562647,32687,529960,506722,423757,69873,1310,9799,251,1732,23238,247266,225594,21672,"Chattanooga, TN-GA Metro Area"
1791,,,16940,310,100512,44181,100512,100512,15602,84910,79957,75279,2200,596,1228,136,518,4953,44181,41433,2748,"Cheyenne, WY Metro Area"
1792,,,16980,310,9618502,3943945,9618502,9618502,2239376,7379126,7097559,4825000,1545811,10670,678669,2014,35395,281567,3943945,3672824,271121,"Chicago-Naperville-Elgin, IL-IN-WI Metro Area"
1793,,,17020,310,211632,90133,211632,211632,40112,171520,158046,139651,3320,3050,10333,508,1184,13474,90133,83268,6865,"Chico, CA Metro Area"
1794,,,17060,310,77093,32066,77093,77093,1031,76062,72484,67705,4005,189,369,20,196,3578,32066,29386,2680,"Chillicothe, OH Micro Area"
1795,,,17140,310,2256884,957458,2256884,2256884,95073,2161811,2064802,1712872,270805,3236,67282,1955,8652,97009,957458,890439,67019,"Cincinnati, OH-KY-IN Metro Area"
1796,,,17220,310,90434,41162,90434,90434,1659,88775,85109,82788,1390,169,545,28,189,3666,41162,36794,4368,"Clarksburg, WV Micro Area"
1797,,,17260,310,21390,10162,21390,21390,350,21040,20676,4285,16209,26,112,0,44,364,10162,8452,1710,"Clarksdale, MS Micro Area"
1798,,,17300,310,320535,129115,320535,320535,29339,291196,271847,202217,59691,1137,6081,1155,1566,19349,129115,117514,11601,"Clarksville, TN-KY Metro Area"
1799,,,17340,310,68163,34220,68163,68163,15442,52721,48512,44202,1158,1737,940,89,386,4209,34220,27622,6598,"Clearlake, CA Micro Area"
1800,,,17380,310,30985,13628,30985,30985,794,30191,29539,9946,19257,22,262,0,52,652,13628,11994,1634,"Cleveland, MS Micro Area"
1801,,,17420,310,126164,53342,126164,126164,8758,117406,111358,104143,5166,330,1221,127,371,6048,53342,49007,4335,"Cleveland, TN Metro Area"
1802,,,17460,310,2088251,968069,2088251,2088251,133862,1954389,1874994,1407943,402294,2793,53413,373,8178,79395,968069,887924,80145,"Cleveland-Elyria, OH Metro Area"
1803,,,17500,310,39619,14971,39619,39619,22112,17507,16902,12089,4195,155,339,4,120,605,14971,12644,2327,"Clewiston, FL Micro Area"
1804,,,17540,310,46460,21517,46460,46460,1539,44921,43087,41226,1392,103,252,10,104,1834,21517,19483,2034,"Clinton, IA Micro Area"
1805,,,17580,310,48430,21102,48430,48430,21796,26634,24793,21052,2513,249,733,35,211,1841,21102,18563,2539,"Clovis, NM Micro Area"
1806,,,17620,310,34668,16420,34668,34668,34464,204,185,95,17,3,14,3,53,19,16420,14060,2360,"Coamo, PR Micro Area"
1807,,,17640,310,25789,13496,25789,25789,25577,212,201,161,23,0,0,0,17,11,13496,10757,2739,"Coco, PR Micro Area"
1808,,,17660,310,171362,74736,171362,171362,8756,162606,153778,149107,463,1715,1371,195,927,8828,74736,67278,7458,"Coeur d'Alene, ID Metro Area"
1809,,,17700,310,31486,15569,31486,31486,2414,29072,26337,23571,1533,946,191,24,72,2735,15569,12968,2601,"Coffeyville, KS Micro Area"
1810,,,17740,310,44862,20749,44862,44862,2583,42279,40692,39025,1124,132,266,10,135,1587,20749,16780,3969,"Coldwater, MI Micro Area"
1811,,,17780,310,268248,114483,268248,268248,70307,197941,189016,143798,28516,596,14795,231,1080,8925,114483,99027,15456,"College Station-Bryan, TX Metro Area"
1812,,,17820,310,755105,300775,755105,755105,131700,623405,575669,501501,40891,3938,21830,2762,4747,47736,300775,283304,17471,"Colorado Springs, CO Metro Area"
1813,,,17860,310,210864,91485,210864,210864,8582,202282,190303,161327,19344,539,7866,129,1098,11979,91485,83927,7558,"Columbia, MO Metro Area"
1814,,,17900,310,829470,366298,829470,829470,55280,774190,743264,452439,266196,2098,18554,654,3323,30926,366298,331048,35250,"Columbia, SC Metro Area"
1815,,,17980,310,328883,143697,328883,328883,24624,304259,290279,145341,134903,831,6885,791,1528,13980,143697,128919,14778,"Columbus, GA-AL Metro Area"
1816,,,18020,310,82208,35317,82208,82208,7257,74951,72013,64395,1768,132,5383,45,290,2938,35317,32607,2710,"Columbus, IN Metro Area"
1817,,,18060,310,58879,26882,58879,58879,1323,57556,55998,29363,25885,110,514,16,110,1558,26882,23680,3202,"Columbus, MS Micro Area"
1818,,,18100,310,34296,14094,34296,34296,7252,27044,26335,25583,346,98,198,9,101,709,14094,13313,781,"Columbus, NE Micro Area"
1819,,,18140,310,2138926,902082,2138926,2138926,110967,2027959,1928662,1478968,330686,3553,104754,603,10098,99297,902082,841636,60446,"Columbus, OH Metro Area"
1820,,,18180,310,153808,65565,153808,153808,3880,149928,143745,137252,2536,310,3013,59,575,6183,65565,60420,5145,"Concord, NH Micro Area"
1821,,,18220,310,23398,10886,23398,23398,273,23125,22429,22014,275,32,58,2,48,696,10886,9720,1166,"Connersville, IN Micro Area"
1822,,,18260,310,113982,51443,113982,113982,6845,107137,102752,98783,2278,256,1164,33,238,4385,51443,46179,5264,"Cookeville, TN Micro Area"
1823,,,18300,310,64929,31378,64929,64929,4292,60637,56281,53538,259,1320,728,120,316,4356,31378,27662,3716,"Coos Bay, OR Micro Area"
1824,,,18380,310,20128,9854,20128,20128,634,19494,18979,9892,8821,18,180,4,64,515,9854,8346,1508,"Cordele, GA Micro Area"
1825,,,18420,310,34740,16159,34740,34740,1248,33492,32364,27738,4316,61,180,19,50,1128,16159,14395,1764,"Corinth, MS Micro Area"
1826,,,18460,310,46031,18340,46031,46031,6880,39151,37633,34694,1722,83,990,35,109,1518,18340,16408,1932,"Cornelia, GA Micro Area"
1827,,,18500,310,93584,47327,93584,93584,1718,91866,87886,84338,1416,203,1616,12,301,3980,47327,39737,7590,"Corning, NY Micro Area"
1828,,,18580,310,421933,180679,421933,421933,255272,166661,157923,132778,13645,1105,8557,347,1491,8738,180679,155483,25196,"Corpus Christi, TX Metro Area"
1829,,,18620,310,52624,21385,52624,52624,16049,36575,34709,26996,6286,163,393,734,137,1866,21385,18660,2725,"Corsicana, TX Micro Area"
1830,,,18660,310,46809,20814,46809,46809,1658,45151,42971,40801,829,113,1018,6,204,2180,20814,18378,2436,"Cortland, NY Micro Area"
1831,,,18700,310,95184,40150,95184,95184,8524,86660,80864,72209,938,528,6375,276,538,5796,40150,37447,2703,"Corvallis, OR Metro Area"
1832,,,18740,310,36612,16324,36612,36612,401,36211,35180,34582,389,57,98,7,47,1031,16324,14621,1703,"Coshocton, OH Micro Area"
1833,,,18780,310,13292,6091,13292,13292,2124,11168,10602,10313,77,98,52,2,60,566,6091,5352,739,"Craig, CO Micro Area"
1834,,,18820,310,37936,16464,37936,37936,2281,35655,34490,33748,343,73,236,13,77,1165,16464,15210,1254,"Crawfordsville, IN Micro Area"
1835,,,18860,310,27743,11090,27743,27743,5321,22422,20215,16262,841,2136,826,28,122,2207,11090,9807,1283,"Crescent City, CA Micro Area"
1836,,,18880,310,286973,157394,286973,286973,28765,258208,239803,206915,22190,1214,7485,486,1513,18405,157394,113938,43456,"Crestview-Fort Walton Beach-Destin, FL Metro Area"
1837,,,18900,310,61145,30479,61145,61145,1936,59209,57222,56313,299,130,366,12,102,1987,30479,26933,3546,"Crossville, TN Micro Area"
1838,,,18980,310,87866,39145,87866,87866,4146,83720,80236,78298,914,287,522,64,151,3484,39145,34723,4422,"Cullman, AL Micro Area"
1839,,,19000,310,57226,34990,57226,57226,3884,53342,50777,41341,838,7879,550,20,149,2565,34990,22610,12380,"Cullowhee, NC Micro Area"
1840,,,19060,310,95044,45364,95044,95044,1458,93586,89812,82556,5997,151,846,27,235,3774,45364,38710,6654,"Cumberland, MD-WV Metro Area"
1841,,,19100,310,7637387,2947189,7637387,7637387,2235234,5402153,5128806,3266374,1196881,25958,601218,8121,30254,273347,2947189,2760991,186198,"Dallas-Fort Worth-Arlington, TX Metro Area"
1842,,,19140,310,142837,54914,142837,142837,42830,100007,96020,90039,3816,261,1521,21,362,3987,54914,50852,4062,"Dalton, GA Metro Area"
1843,,,19180,310,74188,34407,74188,74188,3816,70372,67400,56186,10247,140,568,10,249,2972,34407,30568,3839,"Danville, IL Metro Area"
1844,,,19220,310,54889,23706,54889,54889,1965,52924,50821,47567,2614,71,421,5,143,2103,23706,21457,2249,"Danville, KY Micro Area"
1845,,,19260,310,103091,51628,103091,103091,3786,99305,96510,61161,34087,181,792,18,271,2795,51628,44330,7298,"Danville, VA Micro Area"
1846,,,19300,310,231767,124148,231767,231767,12686,219081,208713,186495,18001,1291,2029,122,775,10368,124148,93116,31032,"Daphne-Fairhope-Foley, AL Metro Area"
1847,,,19340,310,384324,174002,384324,384324,35572,348752,331867,289939,30967,653,9086,106,1116,16885,174002,159261,14741,"Davenport-Moline-Rock Island, IA-IL Metro Area"
1848,,,19420,310,32870,15163,32870,32870,1960,30910,29609,28641,598,100,195,6,69,1301,15163,13082,2081,"Dayton, TN Micro Area"
1849,,,19430,310,814049,369625,814049,814049,28594,785455,745217,592963,126662,1419,19874,352,3947,40238,369625,339453,30172,"Dayton-Kettering, OH Metro Area"
1850,,,19460,310,156494,68490,156494,156494,13272,143222,135076,112952,18609,2071,913,86,445,8146,68490,62758,5732,"Decatur, AL Metro Area"
1851,,,19500,310,103998,49727,103998,103998,2733,101265,96139,75117,18886,178,1512,31,415,5126,49727,44549,5178,"Decatur, IL Metro Area"
1852,,,19540,310,35809,13172,35809,35809,1637,34172,33520,33080,171,80,135,4,50,652,13172,12386,786,"Decatur, IN Micro Area"
1853,,,19580,310,38286,16539,38286,38286,3950,34336,33189,32276,598,79,133,15,88,1147,16539,15482,1057,"Defiance, OH Micro Area"
1854,,,19620,310,47586,18455,47586,47586,38207,9379,8902,7836,538,57,351,35,85,477,18455,15796,2659,"Del Rio, TX Micro Area"
1855,,,19660,310,668921,327890,668921,668921,94951,573970,547895,463818,65875,1553,12928,325,3396,26075,327890,280751,47139,"Deltona-Daytona Beach-Ormond Beach, FL Metro Area"
1856,,,19700,310,25427,11508,25427,25427,16670,8757,8264,7671,228,143,160,12,50,493,11508,9822,1686,"Deming, NM Micro Area"
1857,,,19740,310,2963821,1242492,2963821,2963821,691711,2272110,2139831,1814213,157965,13639,134683,4657,14674,132279,1242492,1167462,75030,"Denver-Aurora-Lakewood, CO Metro Area"
1858,,,19760,310,36549,15771,36549,36549,1271,35278,33734,29039,4082,273,222,27,91,1544,15771,13797,1974,"DeRidder, LA Micro Area"
1859,,,19780,310,709466,300984,709466,709466,57905,651561,624883,551774,38853,1425,30015,384,2432,26678,300984,280757,20227,"Des Moines-West Des Moines, IA Metro Area"
1860,,,19820,310,4392041,1901256,4392041,4392041,219953,4172088,3991312,2799533,952462,9617,211344,953,17403,180776,1901256,1760892,140364,"Detroit-Warren-Dearborn, MI Metro Area"
1861,,,19860,310,34591,15948,34591,34591,2296,32295,31130,29209,1037,395,350,51,88,1165,15948,13967,1981,"Dickinson, ND Micro Area"
1862,,,19940,310,34145,14985,34145,34145,2324,31821,30649,28435,1831,30,248,10,95,1172,14985,13589,1396,"Dixon, IL Micro Area"
1863,,,19980,310,34287,12550,34287,34287,19666,14621,13931,12455,885,101,394,6,90,690,12550,11376,1174,"Dodge City, KS Micro Area"
1864,,,20020,310,151007,70792,151007,151007,6111,144896,138939,101747,34695,537,1419,66,475,5957,70792,62411,8381,"Dothan, AL Metro Area"
1865,,,20060,310,51378,20801,51378,51378,7478,43900,42545,28959,13080,92,311,18,85,1355,20801,18341,2460,"Douglas, GA Micro Area"
1866,,,20100,310,181851,72708,181851,181851,13981,167870,156943,104845,45737,864,4362,107,1028,10927,72708,68290,4418,"Dover, DE Metro Area"
1867,,,20140,310,65165,28334,65165,65165,1711,63454,61836,37746,23235,122,542,29,162,1618,28334,25050,3284,"Dublin, GA Micro Area"
1868,,,20180,310,80562,38078,80562,80562,2637,77925,75772,73338,1760,78,450,0,146,2153,38078,32435,5643,"DuBois, PA Micro Area"
1869,,,20220,310,99266,42630,99266,99266,2977,96289,93601,87349,4035,131,1018,813,255,2688,42630,39891,2739,"Dubuque, IA Metro Area"
1870,,,20260,310,291638,149586,291638,291638,5096,286542,272520,256720,5218,7266,2395,88,833,14022,149586,124417,25169,"Duluth, MN-WI Metro Area"
1871,,,20300,310,21358,8188,21358,21358,12647,8711,8316,6499,654,97,982,1,83,395,8188,7258,930,"Dumas, TX Micro Area"
1872,,,20340,310,42848,20322,42848,42848,3452,39396,35616,32383,799,2034,244,13,143,3780,20322,17268,3054,"Duncan, OK Micro Area"
1873,,,20420,310,55638,28198,55638,55638,7008,48630,46174,42392,182,2809,381,33,377,2456,28198,23487,4711,"Durango, CO Micro Area"
1874,,,20460,310,46067,20366,46067,46067,3428,42639,37737,30076,715,6574,285,14,73,4902,20366,17954,2412,"Durant, OK Micro Area"
1875,,,20500,310,649903,282215,649903,649903,84694,565209,539401,342134,160758,1656,31428,182,3243,25808,282215,261637,20578,"Durham-Chapel Hill, NC Metro Area"
1876,,,20540,310,36801,16218,36801,36801,1303,35498,34012,28272,5335,81,213,11,100,1486,16218,14787,1431,"Dyersburg, TN Micro Area"
1877,,,20580,310,57887,20072,57887,57887,54936,2951,2834,1574,129,835,182,4,110,117,20072,18034,2038,"Eagle Pass, TX Micro Area"
1878,,,20660,310,37526,19538,37526,37526,3352,34174,33005,28065,4186,45,536,11,162,1169,19538,16296,3242,"Easton, MD Micro Area"
1879,,,20700,310,168327,79114,168327,168327,28558,139769,133238,104716,22823,289,3947,56,1407,6531,79114,62284,16830,"East Stroudsburg, PA Metro Area"
1880,,,20740,310,172007,73654,172007,172007,4375,167632,161586,152745,2253,763,5324,97,404,6046,73654,69167,4487,"Eau Claire, WI Metro Area"
1881,,,20780,310,55731,32967,55731,55731,16858,38873,37542,36202,296,118,712,27,187,1331,32967,20760,12207,"Edwards, CO Micro Area"
1882,,,20820,310,34668,15314,34668,34668,872,33796,32845,32361,151,36,246,6,45,951,15314,14117,1197,"Effingham, IL Micro Area"
1883,,,20900,310,41570,17296,41570,41570,16967,24603,23936,18130,5469,69,164,0,104,667,17296,15446,1850,"El Campo, TX Micro Area"
1884,,,20940,310,179702,56625,179702,179702,153027,26675,25088,16813,3846,1584,2244,82,519,1587,56625,52050,4575,"El Centro, CA Metro Area"
1885,,,20980,310,39054,18599,39054,39054,1754,37300,36087,22904,12670,108,273,16,116,1213,18599,16182,2417,"El Dorado, AR Micro Area"
1886,,,21020,310,53573,24276,53573,53573,2546,51027,48845,30910,17002,185,494,35,219,2182,24276,21182,3094,"Elizabeth City, NC Micro Area"
1887,,,21060,310,155572,65086,155572,155572,8307,147265,138434,120296,13839,557,2489,488,765,8831,65086,59857,5229,"Elizabethtown-Fort Knox, KY Metro Area"
1888,,,21120,310,22410,10123,22410,22410,2684,19726,18593,16526,1119,770,128,12,38,1133,10123,8034,2089,"Elk City, OK Micro Area"
1889,,,21140,310,207047,79594,207047,207047,39594,167453,159469,145039,11051,373,2236,54,716,7984,79594,74631,4963,"Elkhart-Goshen, IN Metro Area"
1890,,,21180,310,27932,13035,27932,27932,312,27620,26695,26033,424,56,96,1,85,925,13035,10980,2055,"Elkins, WV Micro Area"
1891,,,21220,310,55557,22732,55557,55557,13770,41787,39522,35722,496,2399,559,88,258,2265,22732,20433,2299,"Elko, NV Micro Area"
1892,,,21260,310,44337,23743,44337,44337,4594,39743,37350,35323,380,407,907,87,246,2393,23743,18650,5093,"Ellensburg, WA Micro Area"
1893,,,21300,310,84148,38985,84148,84148,2938,81210,76435,69559,5009,198,1426,15,228,4775,38985,35242,3743,"Elmira, NY Metro Area"
1894,,,21340,310,868859,319001,868859,868859,717387,151472,140763,99313,24421,2371,10702,1527,2429,10709,319001,297233,21768,"El Paso, TX Metro Area"
1895,,,21380,310,34751,16354,34751,34751,7478,27273,26008,24447,617,130,574,6,234,1265,16354,14239,2115,"Emporia, KS Micro Area"
1896,,,21420,310,62846,27846,62846,62846,8982,53864,49662,42939,1661,1307,685,2920,150,4202,27846,24198,3648,"Enid, OK Metro Area"
1897,,,21460,310,53465,24105,53465,53465,4887,48578,45951,35759,8643,405,892,57,195,2627,24105,21263,2842,"Enterprise, AL Micro Area"
1898,,,21500,310,270876,119791,270876,270876,12030,258846,246806,219180,19821,343,6358,58,1046,12040,119791,109371,10420,"Erie, PA Metro Area"
1899,,,21540,310,36903,19786,36903,36903,543,36360,34595,33441,93,818,153,8,82,1765,19786,16290,3496,"Escanaba, MI Micro Area"
1900,,,21580,310,40363,19545,40363,40363,27159,13204,12662,5945,160,6135,233,5,184,542,19545,16122,3423,"Española, NM Micro Area"
1901,,,21640,310,27458,13296,27458,27458,1541,25917,25301,12276,12767,71,115,0,72,616,13296,10675,2621,"Eufaula, AL-GA Micro Area"
1902,,,21660,310,382971,166226,382971,382971,37780,345191,318942,298507,4352,3355,9404,947,2377,26249,166226,156594,9632,"Eugene-Springfield, OR Metro Area"
1903,,,21700,310,136463,62120,136463,136463,18535,117928,107521,93316,1729,7454,3495,436,1091,10407,62120,56422,5698,"Eureka-Arcata, CA Micro Area"
1904,,,21740,310,20450,8798,20450,20450,1986,18464,17827,17444,50,122,108,27,76,637,8798,7733,1065,"Evanston, WY Micro Area"
1905,,,21780,310,314049,141244,314049,314049,9439,304610,290882,261753,22340,545,4396,732,1116,13728,141244,129180,12064,"Evansville, IN-KY Metro Area"
1906,,,21820,310,95655,42659,95655,95655,7320,88335,78708,63178,3804,7299,3031,584,812,9627,42659,36521,6138,"Fairbanks, AK Metro Area"
1907,,,21840,310,15663,7689,15663,15663,610,15053,14470,13425,409,43,500,9,84,583,7689,6902,787,"Fairfield, IA Micro Area"
1908,,,21860,310,20025,9748,20025,20025,1320,18705,18235,17947,112,32,92,6,46,470,9748,8748,1000,"Fairmont, MN Micro Area"
1909,,,21900,310,56205,26280,56205,56205,875,55330,52601,50223,1844,119,256,43,116,2729,26280,23223,3057,"Fairmont, WV Micro Area"
1910,,,21980,310,25516,10772,25516,25516,3586,21930,20174,17870,428,1006,640,87,143,1756,10772,10017,755,"Fallon, NV Micro Area"
1911,,,22020,310,249843,112241,249843,249843,9193,240650,230653,203866,15902,3399,6798,95,593,9997,112241,103603,8638,"Fargo, ND-MN Metro Area"
1912,,,22060,310,67097,25018,67097,67097,6783,60314,58162,51523,4353,297,1554,10,425,2152,25018,23416,1602,"Faribault-Northfield, MN Micro Area"
1913,,,22100,310,66922,28636,66922,66922,1089,65833,62923,59474,2645,192,403,21,188,2910,28636,24792,3844,"Farmington, MO Micro Area"
1914,,,22140,310,121661,47744,121661,121661,23630,98031,93943,43583,554,48413,872,67,454,4088,47744,42536,5208,"Farmington, NM Metro Area"
1915,,,22180,310,520378,215134,520378,520378,66084,454294,423603,230744,167327,9428,11067,1788,3249,30691,215134,195651,19483,"Fayetteville, NC Metro Area"
1916,,,22220,310,546725,221207,546725,546725,96185,450540,418292,366402,12889,6447,19335,11570,1649,32248,221207,203096,18111,"Fayetteville-Springdale-Rogers, AR Metro Area"
1917,,,22260,310,60081,36506,60081,60081,2216,57865,55989,54362,843,284,334,17,149,1876,36506,25123,11383,"Fergus Falls, MN Micro Area"
1918,,,22280,310,59235,24401,59235,59235,10339,48896,45265,42350,488,1083,924,168,252,3631,24401,22704,1697,"Fernley, NV Micro Area"
1919,,,22300,310,74920,33655,74920,74920,4198,70722,68188,65107,1363,79,1393,26,220,2534,33655,31107,2548,"Findlay, OH Micro Area"
1920,,,22340,310,17194,8124,17194,17194,1054,16140,15662,9219,6222,57,116,0,48,478,8124,7074,1050,"Fitzgerald, GA Micro Area"
1921,,,22380,310,145101,69108,145101,145101,21719,123382,117276,76904,1777,35143,2582,254,616,6106,69108,51320,17788,"Flagstaff, AZ Metro Area"
1922,,,22420,310,406211,183087,406211,406211,16259,389952,369501,283483,79080,1391,4041,116,1390,20451,183087,167118,15969,"Flint, MI Metro Area"
1923,,,22500,310,199964,89973,199964,199964,5679,194285,188714,102842,82263,466,2599,52,492,5571,89973,80276,9697,"Florence, SC Metro Area"
1924,,,22520,310,150791,72251,150791,150791,4810,145981,140195,119732,18386,518,1180,40,339,5786,72251,63969,8282,"Florence-Muscle Shoals, AL Metro Area"
1925,,,22540,310,104154,45740,104154,104154,6717,97437,94312,90150,2321,355,1241,31,214,3125,45740,42824,2916,"Fond du Lac, WI Metro Area"
1926,,,22580,310,64444,32444,64444,64444,3286,61158,58590,52026,5836,152,343,23,210,2568,32444,26652,5792,"Forest City, NC Micro Area"
1927,,,22620,310,23090,9565,23090,23090,686,22404,21929,9206,12501,65,122,0,35,475,9565,8470,1095,"Forrest City, AR Micro Area"
1928,,,22660,310,359066,158769,359066,359066,44662,314404,297973,282581,3448,1495,8365,265,1819,16431,158769,144360,14409,"Fort Collins, CO Metro Area"
1929,,,22700,310,36999,16937,36999,36999,2063,34936,33647,31372,1773,112,295,16,79,1289,16937,15046,1891,"Fort Dodge, IA Micro Area"
1930,,,22780,310,53955,19315,53955,53955,6079,47876,44636,35865,6039,334,1776,402,220,3240,19315,16902,2413,"Fort Leonard Wood, MO Micro Area"
1931,,,22800,310,57809,28026,57809,57809,1478,56331,54237,52824,990,95,208,12,108,2094,28026,24344,3682,"Fort Madison-Keokuk, IA-IL-MO Micro Area"
1932,,,22820,310,29111,11493,29111,29111,10566,18545,17832,16546,935,110,153,11,77,713,11493,10519,974,"Fort Morgan, CO Micro Area"
1933,,,22840,310,71608,30584,71608,71608,11744,59864,56602,54529,1019,715,237,16,86,3262,30584,27145,3439,"Fort Payne, AL Micro Area"
1934,,,22860,310,48750,21953,48750,48750,4175,44575,41833,33599,6325,484,862,289,274,2742,21953,18761,3192,"Fort Polk South, LA Micro Area"
1935,,,22900,310,244310,107795,244310,244310,26112,218198,198215,168110,9411,12898,7089,142,565,19983,107795,96313,11482,"Fort Smith, AR-OK Metro Area"
1936,,,23060,310,419601,177268,419601,419601,33764,385837,367257,301981,43779,974,18364,141,2018,18580,177268,165547,11721,"Fort Wayne, IN Metro Area"
1937,,,23140,310,33190,13450,33190,33190,6142,27048,26195,25808,196,62,70,13,46,853,13450,12421,1029,"Frankfort, IN Micro Area"
1938,,,23180,310,75393,34044,75393,75393,2568,72825,69436,62936,4926,141,1135,18,280,3389,34044,31207,2837,"Frankfort, KY Micro Area"
1939,,,23240,310,26725,14128,26725,26725,5766,20959,20265,19884,84,69,127,1,100,694,14128,11486,2642,"Fredericksburg, TX Micro Area"
1940,,,23300,310,44630,21369,44630,44630,2254,42376,40331,35405,4374,80,306,11,155,2045,21369,19184,2185,"Freeport, IL Micro Area"
1941,,,23340,310,37167,16191,37167,37167,6083,31084,30137,29501,215,133,183,12,93,947,16191,14813,1378,"Fremont, NE Micro Area"
1942,,,23380,310,58896,26479,58896,58896,6055,52841,50424,48219,1762,75,202,7,159,2417,26479,24444,2035,"Fremont, OH Micro Area"
1943,,,23420,310,1008654,338441,1008654,1008654,540743,467911,438365,271889,44295,6074,109665,1233,5209,29546,338441,319296,19145,"Fresno, CA Metro Area"
1944,,,23460,310,103436,47306,103436,103436,4895,98541,94282,77731,14999,332,921,39,260,4259,47306,41974,5332,"Gadsden, AL Metro Area"
1945,,,23500,310,56216,24713,56216,56216,2777,53439,51579,39576,11292,161,341,14,195,1860,24713,22349,2364,"Gaffney, SC Micro Area"
1946,,,23540,310,339247,151720,339247,339247,39042,300205,284702,208164,55556,746,18239,114,1883,15503,151720,137030,14690,"Gainesville, FL Metro Area"
1947,,,23580,310,203136,76865,203136,203136,57010,146126,140006,120418,14256,341,4198,85,708,6120,76865,71022,5843,"Gainesville, GA Metro Area"
1948,,,23620,310,41668,17716,41668,41668,8519,33149,31390,29404,1181,360,307,13,125,1759,17716,15738,1978,"Gainesville, TX Micro Area"
1949,,,23660,310,49967,23817,49967,49967,3051,46916,44622,39615,4354,73,361,12,207,2294,23817,20851,2966,"Galesburg, IL Micro Area"
1950,,,23700,310,72902,25057,72902,72902,8611,64291,62766,5946,323,55401,935,34,127,1525,25057,22659,2398,"Gallup, NM Micro Area"
1951,,,23780,310,42453,15766,42453,42453,21279,21174,20140,16892,1396,174,1517,4,157,1034,15766,14491,1275,"Garden City, KS Micro Area"
1952,,,23820,310,49488,24309,49488,49488,6141,43347,41065,38856,183,807,898,81,240,2282,24309,21400,2909,"Gardnerville Ranchos, NV Micro Area"
1953,,,23860,310,63404,35916,63404,63404,2225,61179,59763,41186,18051,111,258,27,130,1416,35916,27231,8685,"Georgetown, SC Micro Area"
1954,,,23900,310,103852,43007,103852,103852,7790,96062,92883,89945,1473,147,952,33,333,3179,43007,40270,2737,"Gettysburg, PA Metro Area"
1955,,,23940,310,61045,26894,61045,61045,4690,56355,53998,52473,247,644,355,41,238,2357,26894,23561,3333,"Gillette, WY Micro Area"
1956,,,23980,310,54771,24485,54771,54771,2119,52652,50819,48424,1811,76,262,53,193,1833,24485,21866,2619,"Glasgow, KY Micro Area"
1957,,,24020,310,127039,68926,127039,127039,3513,123526,117893,113904,2299,288,1048,22,332,5633,68926,53574,15352,"Glens Falls, NY Metro Area"
1958,,,24060,310,79043,37336,79043,79043,21456,57587,54885,53069,371,336,677,41,391,2702,37336,30391,6945,"Glenwood Springs, CO Micro Area"
1959,,,24100,310,53324,28087,53324,53324,2134,51190,48613,47051,966,89,343,0,164,2577,28087,22390,5697,"Gloversville, NY Micro Area"
1960,,,24140,310,117333,52551,117333,117333,14927,102406,97930,60199,35329,335,1542,71,454,4476,52551,45997,6554,"Goldsboro, NC Metro Area"
1961,,,24180,310,61598,28321,61598,61598,7958,53640,51351,49815,495,340,468,53,180,2289,28321,24811,3510,"Granbury, TX Micro Area"
1962,,,24220,310,104362,48051,104362,104362,5656,98706,94204,85293,3967,2013,2635,56,240,4502,48051,43192,4859,"Grand Forks, ND-MN Metro Area"
1963,,,24260,310,77038,31572,77038,77038,19699,57339,55591,52515,1869,254,729,29,195,1748,31572,29493,2079,"Grand Island, NE Metro Area"
1964,,,24300,310,155703,67407,155703,155703,23278,132425,125392,120749,1020,933,1613,188,889,7033,67407,63133,4274,"Grand Junction, CO Metro Area"
1965,,,24330,310,45014,25375,45014,45014,618,44396,42109,40166,174,1497,145,2,125,2287,25375,18968,6407,"Grand Rapids, MN Micro Area"
1966,,,24340,310,1087592,431852,1087592,1087592,110671,976921,933153,823508,72758,3002,30148,298,3439,43768,431852,406158,25694,"Grand Rapids-Kentwood, MI Metro Area"
1967,,,24380,310,27172,11099,27172,27172,8644,18528,17963,5538,254,11767,201,7,196,565,11099,9080,2019,"Grants, NM Micro Area"
1968,,,24420,310,88090,38748,88090,88090,7037,81053,75467,72730,368,883,870,123,493,5586,38748,36024,2724,"Grants Pass, OR Metro Area"
1969,,,24460,310,25493,12370,25493,25493,4127,21366,20440,19911,293,90,80,3,63,926,12370,10640,1730,"Great Bend, KS Micro Area"
1970,,,24500,310,84414,38937,84414,84414,4012,80402,75058,68794,1085,3725,908,105,441,5344,38937,35011,3926,"Great Falls, MT Metro Area"
1971,,,24540,310,328981,119962,328981,328981,98462,230519,218652,205881,4154,1327,5682,303,1305,11867,119962,113995,5967,"Greeley, CO Metro Area"
1972,,,24580,310,328268,145929,328268,328268,27898,300370,288230,263602,8302,6847,8619,116,744,12140,145929,133007,12922,"Green Bay, WI Metro Area"
1973,,,24620,310,70152,32154,70152,70152,2535,67617,65100,63143,1308,142,299,14,194,2517,32154,28738,3416,"Greeneville, TN Micro Area"
1974,,,24660,310,776566,337732,776566,776566,77289,699277,670878,428212,204626,2866,31370,255,3549,28399,337732,312232,25500,"Greensboro-High Point, NC Metro Area"
1975,,,24700,310,26472,11512,26472,26472,614,25858,25095,24769,90,35,154,8,39,763,11512,10472,1040,"Greensburg, IN Micro Area"
1976,,,24740,310,44922,20879,44922,44922,584,44338,43523,11180,31919,48,302,5,69,815,20879,17954,2925,"Greenville, MS Micro Area"
1977,,,24780,310,170243,80515,170243,170243,12968,157275,151046,86837,59813,494,3056,94,752,6229,80515,70016,10499,"Greenville, NC Metro Area"
1978,,,24820,310,51881,22599,51881,51881,859,51022,49717,48994,302,92,181,26,122,1305,22599,20925,1674,"Greenville, OH Micro Area"
1979,,,24860,310,928195,402999,928195,928195,78318,849877,813869,647898,141696,1766,18297,505,3707,36008,402999,366509,36490,"Greenville-Anderson, SC Metro Area"
1980,,,24900,310,38337,17546,38337,38337,994,37343,36639,12492,23839,30,234,0,44,704,17546,15098,2448,"Greenwood, MS Micro Area"
1981,,,24940,310,69351,31323,69351,69351,4749,64602,62451,40625,20820,102,678,41,185,2151,31323,28123,3200,"Greenwood, SC Micro Area"
1982,,,24980,310,21629,10405,21629,21629,310,21319,20751,11258,9352,29,84,2,26,568,10405,9030,1375,"Grenada, MS Micro Area"
1983,,,25020,310,68442,35158,68442,68442,67957,485,431,277,61,3,27,3,60,54,35158,28396,6762,"Guayama, PR Metro Area"
1984,,,25060,310,416259,183583,416259,416259,26388,389871,370164,269136,88006,1681,9599,366,1376,19707,183583,162916,20667,"Gulfport-Biloxi, MS Metro Area"
1985,,,25100,310,21384,8443,21384,21384,10823,10561,9916,8263,975,162,448,0,68,645,8443,7376,1067,"Guymon, OK Micro Area"
1986,,,25180,310,293844,123729,293844,293844,17418,276426,260724,227678,26467,567,4611,106,1295,15702,123729,112998,10731,"Hagerstown-Martinsburg, MD-WV Metro Area"
1987,,,25200,310,25349,16127,25349,25349,5080,20269,19398,18962,47,34,219,15,121,871,16127,10711,5416,"Hailey, ID Micro Area"
1988,,,25220,310,133157,56685,133157,133157,7242,125915,121345,79825,39770,409,942,23,376,4570,56685,50961,5724,"Hammond, LA Metro Area"
1989,,,25260,310,152486,46287,152486,152486,86607,65879,60906,44361,8300,1690,5511,331,713,4973,46287,44100,2187,"Hanford-Corcoran, CA Metro Area"
1990,,,25300,310,38880,17875,38880,38880,612,38268,36552,34643,1477,93,182,20,137,1716,17875,15616,2259,"Hannibal, MO Micro Area"
1991,,,25420,310,591712,255481,591712,591712,44138,547574,524081,430003,59274,764,31158,204,2678,23493,255481,238249,17232,"Harrisburg-Carlisle, PA Metro Area"
1992,,,25460,310,44598,21454,44598,44598,1055,43543,41230,40411,102,331,257,28,101,2313,21454,18624,2830,"Harrison, AR Micro Area"
1993,,,25500,310,135571,54062,135571,135571,19138,116433,112123,102821,5674,151,3009,29,439,4310,54062,49426,4636,"Harrisonburg, VA Metro Area"
1994,,,25540,310,1213531,522472,1213531,1213531,187902,1025629,981855,775080,131229,1562,66686,259,7039,43774,522472,487600,34872,"Hartford-East Hartford-Middletown, CT Metro Area"
1995,,,25580,310,31205,13806,31205,31205,3659,27546,26636,25779,247,119,415,9,67,910,13806,12690,1116,"Hastings, NE Micro Area"
1996,,,25620,310,172231,74640,172231,172231,6192,166039,160822,106901,50928,350,1992,86,565,5217,74640,66945,7695,"Hattiesburg, MS Metro Area"
1997,,,25700,310,28934,13166,28934,28934,2016,26918,25839,25109,318,65,265,0,82,1079,13166,11853,1313,"Hays, KS Micro Area"
1998,,,25720,310,77145,40136,77145,77145,9783,67362,65087,63276,304,134,1070,83,220,2275,40136,26728,13408,"Heber, UT Micro Area"
1999,,,25740,310,83058,38974,83058,83058,2890,80168,75638,72989,281,1394,600,44,330,4530,38974,35098,3876,"Helena, MT Micro Area"
2000,,,25760,310,16568,8315,16568,16568,264,16304,15971,5541,10305,38,64,4,19,333,8315,6890,1425,"Helena-West Helena, AR Micro Area"
2001,,,25780,310,42578,19276,42578,42578,3717,38861,37818,16243,21081,91,284,9,110,1043,19276,17038,2238,"Henderson, NC Micro Area"
2002,,,25820,310,18583,6974,18583,18583,13925,4658,4471,4233,107,47,44,0,40,187,6974,6263,711,"Hereford, TX Micro Area"
2003,,,25840,310,92261,35815,92261,92261,27610,64651,60883,56353,689,2653,714,135,339,3768,35815,32586,3229,"Hermiston-Pendleton, OR Micro Area"
2004,,,25860,310,365276,163160,365276,365276,31320,333956,319883,283545,23152,924,11004,158,1100,14073,163160,147185,15975,"Hickory-Lenoir-Morganton, NC Metro Area"
2005,,,25880,310,45746,21396,45746,45746,1172,44574,42803,42145,196,143,176,6,137,1771,21396,18062,3334,"Hillsdale, MI Micro Area"
2006,,,25900,310,200629,88691,200629,200629,22275,178354,132032,64688,1159,649,38351,26185,1000,46322,88691,73021,15670,"Hilo, HI Micro Area"
2007,,,25940,310,215908,110930,215908,215908,28490,187418,180770,139760,37104,413,2568,142,783,6648,110930,87645,23285,"Hilton Head Island-Bluffton, SC Metro Area"
2008,,,25980,310,81424,32744,81424,81424,9765,71659,66829,32778,31337,287,1489,525,413,4830,32744,28905,3839,"Hinesville, GA Metro Area"
2009,,,26020,310,74455,27950,74455,74455,45193,29262,27700,23775,2497,477,636,21,294,1562,27950,25049,2901,"Hobbs, NM Micro Area"
2010,,,26090,310,120502,51789,120502,120502,9389,111113,106387,103088,1446,561,839,20,433,4726,51789,45545,6244,"Holland, MI Micro Area"
2011,,,26140,310,153843,81687,153843,153843,9241,144602,138806,131477,3891,466,2412,43,517,5796,81687,69438,12249,"Homosassa Springs, FL Metro Area"
2012,,,26220,310,23977,10126,23977,23977,7148,16829,15664,14935,47,149,381,33,119,1165,10126,8965,1161,"Hood River, OR Micro Area"
2013,,,26260,310,28375,13899,28375,28375,3307,25068,24092,15703,8077,118,129,5,60,976,13899,11419,2480,"Hope, AR Micro Area"
2014,,,26300,310,100180,52326,100180,100180,7047,93133,87224,77239,8034,623,960,71,297,5909,52326,42997,9329,"Hot Springs, AR Metro Area"
2015,,,26340,310,39407,20902,39407,39407,696,38711,37278,35802,284,160,855,21,156,1433,20902,15299,5603,"Houghton, MI Micro Area"
2016,,,26380,310,207137,88254,207137,207137,13030,194107,185932,139524,35591,8235,2053,70,459,8175,88254,78523,9731,"Houma-Thibodaux, LA Metro Area"
2017,,,26420,310,7122240,2740182,7122240,7122240,2669503,4452737,4249597,2399789,1209074,14383,588227,4491,33633,203140,2740182,2509945,230237,"Houston-The Woodlands-Sugar Land, TX Metro Area"
2018,,,26460,310,61570,33226,61570,61570,3542,58028,55073,50795,2421,70,1423,16,348,2955,33226,26590,6636,"Hudson, NY Micro Area"
2019,,,26500,310,44092,20807,44092,44092,852,43240,42055,39420,2267,49,210,9,100,1185,20807,16804,4003,"Huntingdon, PA Micro Area"
2020,,,26540,310,36662,16217,36662,36662,1050,35612,34488,33874,221,140,163,7,83,1124,16217,14765,1452,"Huntington, IN Micro Area"
2021,,,26580,310,359862,165754,359862,359862,4595,355267,342636,329883,8399,655,2772,56,871,12631,165754,147207,18547,"Huntington-Ashland, WV-KY-OH Metro Area"
2022,,,26620,310,491723,212512,491723,491723,32184,459539,434612,313189,104256,2590,12036,520,2021,24927,212512,197135,15377,"Huntsville, AL Metro Area"
2023,,,26660,310,76400,28632,76400,76400,16578,59822,57939,39823,16382,251,1126,39,318,1883,28632,24568,4064,"Huntsville, TX Micro Area"
2024,,,26700,310,20812,9348,20812,20812,2815,17997,17466,14914,142,254,2071,57,28,531,9348,8116,1232,"Huron, SD Micro Area"
2025,,,26740,310,61898,28289,61898,61898,6096,55802,53004,50316,1744,397,333,41,173,2798,28289,25189,3100,"Hutchinson, KS Micro Area"
2026,,,26780,310,36771,15820,36771,36771,2555,34216,33208,32559,226,102,230,27,64,1008,15820,15004,816,"Hutchinson, MN Micro Area"
2027,,,26820,310,157429,56637,157429,157429,20484,136945,132389,128709,668,819,1513,177,503,4556,56637,53326,3311,"Idaho Falls, ID Metro Area"
2028,,,26860,310,83246,37626,83246,83246,1476,81770,79214,75718,2409,116,816,7,148,2556,37626,33286,4340,"Indiana, PA Micro Area"
2029,,,26900,310,2111040,893492,2111040,2111040,177787,1933253,1847557,1439031,313376,3561,81180,779,9630,85696,893492,826470,67022,"Indianapolis-Carmel-Anderson, IN Metro Area"
2030,,,26940,310,25971,9412,25971,25971,661,25310,24946,6729,18077,19,84,0,37,364,9412,8474,938,"Indianola, MS Micro Area"
2031,,,26980,310,175419,75489,175419,175419,11810,163609,156809,134449,12820,212,8668,44,616,6800,75489,70251,5238,"Iowa City, IA Metro Area"
2032,,,27020,310,30505,18518,30505,30505,506,29999,28925,28494,70,147,152,8,54,1074,18518,13721,4797,"Iron Mountain, MI-WI Micro Area"
2033,,,27060,310,105740,46884,105740,105740,7077,98663,92403,76737,4274,248,10487,35,622,6260,46884,42273,4611,"Ithaca, NY Metro Area"
2034,,,27100,310,160366,69025,160366,160366,6184,154182,145975,131097,12385,515,1475,30,473,8207,69025,62567,6458,"Jackson, MI Metro Area"
2035,,,27140,310,591978,257634,591978,591978,16433,575545,561885,269917,281512,886,7924,182,1464,13660,257634,230831,26803,"Jackson, MS Metro Area"
2036,,,27160,310,32653,14399,32653,32653,306,32347,31233,30835,158,88,101,1,50,1114,14399,12936,1463,"Jackson, OH Micro Area"
2037,,,27180,310,180504,79252,180504,180504,8187,172317,166337,115721,48139,343,1522,29,583,5980,79252,71713,7539,"Jackson, TN Metro Area"
2038,,,27220,310,34961,19048,34961,34961,5315,29646,28550,27895,65,91,360,3,136,1096,19048,13969,5079,"Jackson, WY-ID Micro Area"
2039,,,27260,310,1605848,690609,1605848,1605848,163852,1441996,1368096,953455,333675,3861,66062,1540,9503,73900,690609,628344,62265,"Jacksonville, FL Metro Area"
2040,,,27300,310,37864,17419,37864,37864,886,36978,35640,33236,1966,55,277,17,89,1338,17419,15613,1806,"Jacksonville, IL Micro Area"
2041,,,27340,310,204576,84180,204576,204576,27641,176935,163890,129499,26939,1019,4508,777,1148,13045,84180,69576,14604,"Jacksonville, NC Metro Area"
2042,,,27380,310,50412,20838,50412,50412,11797,38615,36986,30095,6359,128,263,18,123,1629,20838,17992,2846,"Jacksonville, TX Micro Area"
2043,,,27420,310,21593,10374,21593,21593,593,21000,20409,19504,444,296,137,4,24,591,10374,9084,1290,"Jamestown, ND Micro Area"
2044,,,27460,310,127657,66247,127657,127657,11769,115888,110659,106063,2891,497,796,49,363,5229,66247,53223,13024,"Jamestown-Dunkirk-Fredonia, NY Micro Area"
2045,,,27500,310,163687,70068,163687,163687,15800,147887,140837,129796,8060,386,2022,50,523,7050,70068,65937,4131,"Janesville-Beloit, WI Metro Area"
2046,,,27530,310,65342,29975,65342,65342,2152,63190,60891,56394,3889,187,283,2,136,2299,29975,26423,3552,"Jasper, AL Micro Area"
2047,,,27540,310,55887,24199,55887,55887,4326,51561,50485,49803,221,94,262,5,100,1076,24199,22384,1815,"Jasper, IN Micro Area"
2048,,,27580,310,14779,6340,14779,14779,14703,76,75,55,9,0,3,0,8,1,6340,5590,750,"Jayuya, PR Micro Area"
2049,,,27600,310,75907,27699,75907,75907,6712,69195,66395,59064,5136,127,1744,30,294,2800,27699,26174,1525,"Jefferson, GA Micro Area"
2050,,,27620,310,150309,64421,150309,150309,4615,145694,138825,126303,10290,384,1232,112,504,6869,64421,58013,6408,"Jefferson City, MO Metro Area"
2051,,,27660,310,32250,13936,32250,32250,734,31516,30354,24855,5130,147,100,4,118,1162,13936,12197,1739,"Jennings, LA Micro Area"
2052,,,27700,310,30144,12460,30144,30144,1732,28412,27542,21301,5877,58,174,2,130,870,12460,11141,1319,"Jesup, GA Micro Area"
2053,,,27740,310,207285,97027,207285,207285,8424,198861,190351,180571,6257,480,2248,60,735,8510,97027,87383,9644,"Johnson City, TN Metro Area"
2054,,,27780,310,133472,64395,133472,133472,2465,131007,126260,119380,5665,96,764,35,320,4747,64395,56370,8025,"Johnstown, PA Metro Area"
2055,,,27860,310,134196,57066,134196,134196,7556,126640,120888,98300,20104,361,1740,55,328,5752,57066,52475,4591,"Jonesboro, AR Metro Area"
2056,,,27900,310,181409,77309,181409,181409,14984,166425,154012,143939,2783,3245,2289,1230,526,12413,77309,70518,6791,"Joplin, MO Metro Area"
2057,,,27940,310,32255,14093,32255,32255,2077,30178,26136,19673,328,3397,2086,469,183,4042,14093,12940,1153,"Juneau, AK Micro Area"
2058,,,27980,310,164754,71439,164754,164754,16914,147840,116408,51926,1010,400,43284,18966,822,31432,71439,56063,15376,"Kahului-Wailuku-Lahaina, HI Metro Area"
2059,,,28020,310,261670,114021,261670,261670,14776,246894,232340,193428,29686,819,6983,57,1367,14554,114021,106906,7115,"Kalamazoo-Portage, MI Metro Area"
2060,,,28060,310,104357,49875,104357,104357,3329,101028,95855,93416,269,931,703,77,459,5173,49875,42481,7394,"Kalispell, MT Micro Area"
2061,,,28100,310,107502,45270,107502,107502,12520,94982,90635,73591,15417,173,1069,13,372,4347,45270,41528,3742,"Kankakee, IL Metro Area"
2062,,,28140,310,2192035,938503,2192035,2192035,229233,1962802,1846992,1501275,257939,8190,66670,4409,8509,115810,938503,868375,70128,"Kansas City, MO-KS Metro Area"
2063,,,28180,310,73298,30157,73298,73298,7394,65904,50314,22194,352,156,20504,6825,283,15590,30157,24712,5445,"Kapaa, HI Micro Area"
2064,,,28260,310,56772,23913,56772,56772,5447,51325,49750,48172,603,163,672,35,105,1575,23913,22317,1596,"Kearney, NE Micro Area"
2065,,,28300,310,76458,35612,76458,76458,1802,74656,71476,69264,648,146,1067,46,305,3180,35612,31372,4240,"Keene, NH Micro Area"
2066,,,28340,310,47457,20049,47457,47457,5250,42207,40851,40235,217,71,223,1,104,1356,20049,17981,2068,"Kendallville, IN Micro Area"
2067,,,28380,310,28283,13409,28283,28283,2042,26241,25022,21629,3176,70,78,4,65,1219,13409,11573,1836,"Kennett, MO Micro Area"
2068,,,28420,310,303622,109816,303622,303622,101784,201838,188953,172943,4224,1628,8040,731,1387,12885,109816,105117,4699,"Kennewick-Richland, WA Metro Area"
2069,,,28500,310,52598,25200,52598,52598,13598,39000,37439,35791,690,156,576,39,187,1561,25200,22060,3140,"Kerrville, TX Micro Area"
2070,,,28540,310,13948,6614,13948,13948,650,13298,11822,8221,100,2264,1118,26,93,1476,6614,5479,1135,"Ketchikan, AK Micro Area"
2071,,,28580,310,82874,53961,82874,82874,19432,63442,61022,54731,4517,169,1137,61,407,2420,53961,36436,17525,"Key West, FL Micro Area"
2072,,,28620,310,36915,34237,36915,36915,2554,34361,33108,31921,678,99,260,10,140,1253,34237,15966,18271,"Kill Devil Hills, NC Micro Area"
2073,,,28660,310,475367,186020,475367,475367,114128,361239,333396,218125,93219,1977,12942,4581,2552,27843,186020,169916,16104,"Killeen-Temple, TX Metro Area"
2074,,,28700,310,307614,148388,307614,307614,6038,301576,290842,281696,5661,626,2039,55,765,10734,148388,131113,17275,"Kingsport-Bristol, TN-VA Metro Area"
2075,,,28740,310,181851,85853,181851,181851,21119,160732,152194,136695,10152,306,3778,45,1218,8538,85853,73321,12532,"Kingston, NY Metro Area"
2076,,,28780,310,31390,14144,31390,31390,22181,9209,8771,6801,995,90,784,2,99,438,14144,11661,2483,"Kingsville, TX Micro Area"
2077,,,28820,310,55122,26577,55122,55122,4365,50757,49239,26582,22034,134,332,22,135,1518,26577,22930,3647,"Kinston, NC Micro Area"
2078,,,28860,310,29346,13225,29346,29346,708,28638,27534,25454,1265,42,700,14,59,1104,13225,11489,1736,"Kirksville, MO Micro Area"
2079,,,28900,310,69413,32730,69413,69413,8772,60641,56163,51919,497,2493,754,104,396,4478,32730,28634,4096,"Klamath Falls, OR Micro Area"
2080,,,28940,310,879773,393836,879773,879773,44667,835106,796911,727071,49280,2055,15098,410,2997,38195,393836,358473,35363,"Knoxville, TN Metro Area"
2081,,,29020,310,83658,39605,83658,83658,3060,80598,76447,68470,6416,209,1027,19,306,4151,39605,35711,3894,"Kokomo, IN Metro Area"
2082,,,29060,310,63705,38252,63705,63705,1261,62444,59941,58714,324,122,582,11,188,2503,38252,27027,11225,"Laconia, NH Micro Area"
2083,,,29100,310,139627,61505,139627,139627,3294,136333,131782,123147,2017,482,5700,20,416,4551,61505,58101,3404,"La Crosse-Onalaska, WI-MN Metro Area"
2084,,,29180,310,478384,212942,478384,478384,25496,452888,438729,310101,116516,1456,9001,85,1570,14159,212942,188906,24036,"Lafayette, LA Metro Area"
2085,,,29200,310,223716,94722,223716,223716,20292,203424,192291,165999,11259,401,13700,45,887,11133,94722,86517,8205,"Lafayette-West Lafayette, IN Metro Area"
2086,,,29260,310,26196,11649,26196,26196,1347,24849,23272,22075,145,219,216,488,129,1577,11649,10779,870,"La Grande, OR Micro Area"
2087,,,29300,310,104198,45094,104198,104198,4193,100005,96905,56715,37598,198,1993,47,354,3100,45094,40555,4539,"LaGrange, GA-AL Micro Area"
2088,,,29340,310,222402,97407,222402,222402,11581,210821,202919,142284,54896,930,3810,138,861,7902,97407,85986,11421,"Lake Charles, LA Metro Area"
2089,,,29380,310,69698,29775,69698,69698,5063,64635,61962,49096,11441,236,867,27,295,2673,29775,26424,3351,"Lake City, FL Micro Area"
2090,,,29420,310,213267,117650,213267,213267,34126,179141,169936,160165,2063,4053,2600,365,690,9205,117650,91270,26380,"Lake Havasu City-Kingman, AZ Metro Area"
2091,,,29460,310,725046,316381,725046,725046,187695,537351,512359,392621,100950,1623,13181,300,3684,24992,316381,272418,43963,"Lakeland-Winter Haven, FL Metro Area"
2092,,,29500,310,12456,4859,12456,12456,6767,5689,5537,4590,847,23,56,4,17,152,4859,4079,780,"Lamesa, TX Micro Area"
2093,,,29540,310,552984,216502,552984,552984,61171,491813,476642,440613,19536,522,13939,110,1922,15171,216502,206467,10035,"Lancaster, PA Metro Area"
2094,,,29620,310,541297,235800,541297,541297,36913,504384,477907,408905,43868,1717,21026,165,2226,26477,235800,219517,16283,"Lansing-East Lansing, MI Metro Area"
2095,,,29660,310,37066,18494,37066,37066,3910,33156,31496,29584,384,282,1028,30,188,1660,18494,15993,2501,"Laramie, WY Micro Area"
2096,,,29700,310,267114,84763,267114,267114,254354,12760,12201,9495,788,135,1300,25,458,559,84763,78282,6481,"Laredo, TX Metro Area"
2097,,,29740,310,219561,89804,219561,219561,147672,71889,67796,59749,3172,1463,2458,115,839,4093,89804,82366,7438,"Las Cruces, NM Metro Area"
2098,,,29780,310,31390,17634,31390,31390,23791,7599,7075,6211,274,300,146,2,142,524,17634,13246,4388,"Las Vegas, NM Micro Area"
2099,,,29820,310,2265461,917656,2265461,2265461,701416,1564045,1440030,892802,275002,8487,231972,18877,12890,124015,917656,845888,71768,"Las Vegas-Henderson-Paradise, NV Metro Area"
2100,,,29860,310,83613,36517,83613,83613,4308,79305,77539,49217,27459,392,280,24,167,1766,36517,32100,4417,"Laurel, MS Micro Area"
2101,,,29900,310,34174,14348,34174,34174,1106,33068,31512,14247,13094,3705,339,15,112,1556,14348,12870,1478,"Laurinburg, NC Micro Area"
2102,,,29940,310,118785,52846,118785,118785,8295,110490,103228,90281,5104,2579,4657,84,523,7262,52846,48553,4293,"Lawrence, KS Metro Area"
2103,,,29980,310,44159,18658,44159,44159,1117,43042,41442,40368,694,92,167,1,120,1600,18658,17075,1583,"Lawrenceburg, TN Micro Area"
2104,,,30020,310,126652,55292,126652,126652,17006,109646,98733,68563,18939,6862,3022,812,535,10913,55292,46927,8365,"Lawton, OK Metro Area"
2105,,,30060,310,36039,15908,36039,36039,955,35084,33219,32482,262,197,190,17,71,1865,15908,14325,1583,"Lebanon, MO Micro Area"
2106,,,30100,310,221211,122215,221211,221211,5108,216103,205977,198882,1570,571,3957,51,946,10126,122215,94070,28145,"Lebanon, NH-VT Micro Area"
2107,,,30140,310,143257,59084,143257,143257,20348,122909,119369,114004,2555,119,2192,39,460,3540,59084,55808,3276,"Lebanon, PA Metro Area"
2108,,,30220,310,21537,9173,21537,21537,10624,10913,10511,9752,565,82,49,4,59,402,9173,7954,1219,"Levelland, TX Micro Area"
2109,,,30260,310,42681,16082,42681,42681,2000,40681,39525,36050,2459,82,814,8,112,1156,16082,14523,1559,"Lewisburg, PA Micro Area"
2110,,,30280,310,34318,14302,34318,34318,2235,32083,30618,28255,2018,103,142,7,93,1465,14302,13279,1023,"Lewisburg, TN Micro Area"
2111,,,30300,310,64375,28398,64375,64375,2545,61830,58614,54909,297,2598,530,66,214,3216,28398,26580,1818,"Lewiston, ID-WA Metro Area"
2112,,,30340,310,111139,49837,111139,111139,2222,108917,104014,95875,6436,382,895,50,376,4903,49837,45393,4444,"Lewiston-Auburn, ME Metro Area"
2113,,,30380,310,46143,21313,46143,46143,979,45164,43982,43343,350,51,160,0,78,1182,21313,18823,2490,"Lewistown, PA Micro Area"
2114,,,30420,310,26004,10940,26004,26004,8738,17266,16816,15275,1189,48,203,41,60,450,10940,9657,1283,"Lexington, NE Micro Area"
2115,,,30460,310,516811,226278,516811,516811,40213,476598,454454,379636,56534,761,15062,211,2250,22144,226278,209217,17061,"Lexington-Fayette, KY Metro Area"
2116,,,30580,310,21964,8268,21964,21964,14406,7558,7165,5928,611,66,517,1,42,393,8268,7359,909,"Liberal, KS Micro Area"
2117,,,30620,310,102206,44563,102206,102206,3272,98934,93817,79691,12475,233,835,42,541,5117,44563,40935,3628,"Lima, OH Metro Area"
2118,,,30660,310,27987,11984,27987,27987,818,27169,26249,24452,1494,48,178,1,76,920,11984,10749,1235,"Lincoln, IL Micro Area"
2119,,,30700,310,340217,142545,340217,340217,26340,313877,299169,268344,13471,1751,14032,176,1395,14708,142545,134442,8103,"Lincoln, NE Metro Area"
2120,,,30780,310,748031,336959,748031,748031,52786,695245,659949,469142,171667,2680,13651,389,2420,35296,336959,305493,31466,"Little Rock-North Little Rock-Conway, AR Metro Area"
2121,,,30820,310,37450,18603,37450,37450,662,36788,35688,34933,416,51,211,7,70,1100,18603,15199,3404,"Lock Haven, PA Micro Area"
2122,,,30860,310,147348,48759,147348,147348,16099,131249,127279,122077,1067,695,2331,667,442,3970,48759,46259,2500,"Logan, UT-ID Metro Area"
2123,,,30900,310,37870,16379,37870,37870,6675,31195,30070,28744,560,109,573,8,76,1125,16379,14900,1479,"Logansport, IN Micro Area"
2124,,,30940,310,149863,64306,149863,149863,2398,147465,143146,139774,2068,340,736,26,202,4319,64306,57696,6610,"London, KY Micro Area"
2125,,,30980,310,286184,120889,286184,286184,47444,238740,227626,173398,49570,1174,2505,102,877,11114,120889,107325,13564,"Longview, TX Metro Area"
2126,,,31020,310,110730,45424,110730,110730,10802,99928,93071,88067,746,1409,1721,643,485,6857,45424,42787,2637,"Longview, WA Metro Area"
2127,,,31060,310,19419,8634,19419,19419,3435,15984,15095,13446,157,116,1223,15,138,889,8634,8147,487,"Los Alamos, NM Micro Area"
2128,,,31080,310,13200998,4721766,13200998,13200998,5891597,7309401,6871106,3762264,809993,23751,2173361,28236,73501,438295,4721766,4494733,227033,"Los Angeles-Long Beach-Anaheim, CA Metro Area"
2129,,,31140,310,1285439,560778,1285439,1285439,82964,1202475,1146373,918741,187481,2455,31597,808,5291,56102,560778,520270,40508,"Louisville/Jefferson County, KY-IN Metro Area"
2130,,,31180,310,321368,137388,321368,321368,114351,207017,198056,160030,25885,1459,9512,184,986,8961,137388,123566,13822,"Lubbock, TX Metro Area"
2131,,,31220,310,29052,17392,29052,29052,1290,27762,26573,25944,167,219,154,8,81,1189,17392,12319,5073,"Ludington, MI Micro Area"
2132,,,31260,310,86395,36480,86395,86395,19732,66663,64159,49970,12872,200,891,30,196,2504,36480,32134,4346,"Lufkin, TX Micro Area"
2133,,,31300,310,116530,48426,116530,116530,11757,104773,100284,29159,26218,43536,897,63,411,4489,48426,43402,5024,"Lumberton, NC Micro Area"
2134,,,31340,310,261593,117674,261593,261593,8932,252661,241808,193788,42076,829,3544,103,1468,10853,117674,104926,12748,"Lynchburg, VA Metro Area"
2135,,,31380,310,27238,13609,27238,27238,962,26276,25246,23062,1498,47,560,6,73,1030,13609,11479,2130,"Macomb, IL Micro Area"
2136,,,31420,310,233802,103752,233802,233802,8466,225336,218542,110168,103423,422,3654,52,823,6794,103752,91708,12044,"Macon-Bibb County, GA Metro Area"
2137,,,31460,310,156255,49572,156255,156255,93178,63077,58694,48399,4131,1738,3581,122,723,4383,49572,45607,3965,"Madera, CA Metro Area"
2138,,,31500,310,33147,14386,33147,33147,1111,32036,31018,30023,510,79,290,10,106,1018,14386,12992,1394,"Madison, IN Micro Area"
2139,,,31540,310,680796,302538,680796,680796,46048,634748,607371,535921,30923,1620,36316,240,2351,27377,302538,287601,14937,"Madison, WI Metro Area"
2140,,,31580,310,45423,20888,45423,45423,1126,44297,42404,39054,2902,70,230,29,119,1893,20888,18595,2293,"Madisonville, KY Micro Area"
2141,,,31620,310,22801,10999,22801,22801,773,22028,21375,13236,7834,71,163,0,71,653,10999,9082,1917,"Magnolia, AR Micro Area"
2142,,,31660,310,47555,25318,47555,47555,1387,46168,44629,38559,1686,4102,191,0,91,1539,25318,18974,6344,"Malone, NY Micro Area"
2143,,,31680,310,33040,14179,33040,33040,1265,31775,30036,26221,3450,165,114,11,75,1739,14179,12473,1706,"Malvern, AR Micro Area"
2144,,,31700,310,422937,175571,422937,422937,33498,389439,372234,342652,10044,630,16413,112,2383,17205,175571,167875,7696,"Manchester-Nashua, NH Metro Area"
2145,,,31740,310,134046,56271,134046,134046,14675,119371,111619,93829,11092,621,4702,703,672,7752,56271,49249,7022,"Manhattan, KS Metro Area"
2146,,,31820,310,81359,37818,81359,81359,4050,77309,74823,70951,1027,371,2247,15,212,2486,37818,34995,2823,"Manitowoc, WI Micro Area"
2147,,,31860,310,103566,42540,103566,103566,5021,98545,95147,86509,5545,349,2392,34,318,3398,42540,39921,2619,"Mankato, MN Metro Area"
2148,,,31900,310,124936,54522,124936,124936,2615,122321,116961,104231,11216,192,791,58,473,5360,54522,50303,4219,"Mansfield, OH Metro Area"
2149,,,31930,310,59771,27987,59771,59771,717,59054,56852,55663,600,114,309,8,158,2202,27987,25254,2733,"Marietta, OH Micro Area"
2150,,,31940,310,65374,42401,65374,65374,1565,63809,61715,60079,290,930,274,13,129,2094,42401,29460,12941,"Marinette, WI-MI Micro Area"
2151,,,31980,310,66674,29810,66674,66674,3412,63262,60009,54500,4566,157,524,22,240,3253,29810,26487,3323,"Marion, IN Micro Area"
2152,,,32000,310,44578,21242,44578,44578,2947,41631,40148,37788,1707,136,388,0,129,1483,21242,18058,3184,"Marion, NC Micro Area"
2153,,,32020,310,65359,27348,65359,65359,1956,63403,60845,56114,4051,140,358,15,167,2558,27348,24932,2416,"Marion, OH Micro Area"
2154,,,32100,310,66017,33454,66017,66017,1344,64673,61434,59038,790,1011,400,17,178,3239,33454,27681,5773,"Marquette, MI Micro Area"
2155,,,32140,310,25269,11180,25269,25269,1744,23525,22832,20535,906,84,1263,3,41,693,11180,10137,1043,"Marshall, MN Micro Area"
2156,,,32180,310,23333,9836,23333,23333,2830,20503,19495,17473,1149,68,175,397,233,1008,9836,8469,1367,"Marshall, MO Micro Area"
2157,,,32260,310,40105,16745,40105,40105,9140,30965,29982,27438,785,153,1514,33,59,983,16745,15358,1387,"Marshalltown, IA Micro Area"
2158,,,32280,310,32902,14945,32902,32902,905,31997,30732,27813,2593,52,192,3,79,1265,14945,13373,1572,"Martin, TN Micro Area"
2159,,,32300,310,64433,32475,64433,64433,4326,60107,57844,40039,17105,91,400,10,199,2263,32475,28108,4367,"Martinsville, VA Micro Area"
2160,,,32340,310,21241,9449,21241,21241,427,20814,20122,19290,363,31,390,2,46,692,9449,8376,1073,"Maryville, MO Micro Area"
2161,,,32380,310,50570,26083,50570,50570,2454,48116,46571,44765,908,103,561,138,96,1545,26083,22351,3732,"Mason City, IA Micro Area"
2162,,,32420,310,97605,52750,97605,97605,96446,1159,1093,809,130,5,95,0,54,66,52750,41964,10786,"Mayagüez, PR Metro Area"
2163,,,32460,310,36649,16472,36649,36649,2773,33876,32426,30527,1551,96,173,3,76,1450,16472,14742,1730,"Mayfield, KY Micro Area"
2164,,,32500,310,17120,8160,17120,17120,356,16764,15973,14777,1017,29,107,0,43,791,8160,7136,1024,"Maysville, KY Micro Area"
2165,,,32540,310,43773,22046,43773,43773,2266,41507,36380,28388,1227,6388,280,35,62,5127,22046,17339,4707,"McAlester, OK Micro Area"
2166,,,32580,310,870781,294902,870781,870781,800001,70780,67934,53338,3364,635,8604,78,1915,2846,294902,258542,36360,"McAllen-Edinburg-Mission, TX Metro Area"
2167,,,32620,310,40324,19017,40324,40324,627,39697,38709,16769,21457,113,254,7,109,988,19017,16232,2785,"McComb, MS Micro Area"
2168,,,32660,310,40953,18088,40953,40953,3943,37010,35560,33980,1090,84,258,10,138,1450,18088,16336,1752,"McMinnville, TN Micro Area"
2169,,,32700,310,30223,13019,30223,30223,1592,28631,27448,26519,475,93,213,8,140,1183,13019,11897,1122,"McPherson, KS Micro Area"
2170,,,32740,310,83938,42063,83938,83938,1241,82697,79572,77347,1496,109,365,26,229,3125,42063,33930,8133,"Meadville, PA Micro Area"
2171,,,32780,310,223259,96239,223259,223259,30399,192860,179178,170232,1574,1775,3293,808,1496,13682,96239,90467,5772,"Medford, OR Metro Area"
2172,,,32820,310,1337779,565930,1337779,1337779,94948,1242831,1201907,552793,609275,2333,32131,488,4887,40924,565930,516751,49179,"Memphis, TN-MS-AR Metro Area"
2173,,,32860,310,45440,18693,45440,45440,1035,44405,43009,40912,388,157,1451,13,88,1396,18693,17414,1279,"Menomonie, WI Micro Area"
2174,,,32900,310,281202,87783,281202,281202,173857,107345,99767,68729,8191,1164,19824,617,1242,7578,87783,83464,4319,"Merced, CA Metro Area"
2175,,,32940,310,97587,44946,97587,97587,1988,95599,93316,49296,42569,577,585,35,254,2283,44946,39222,5724,"Meridian, MS Micro Area"
2176,,,33020,310,24962,10542,24962,24962,731,24231,23014,21450,1304,63,114,2,81,1217,10542,9414,1128,"Mexico, MO Micro Area"
2177,,,33060,310,30285,13714,30285,30285,1708,28577,25135,18850,287,5563,154,231,50,3442,13714,11859,1855,"Miami, OK Micro Area"
2178,,,33100,310,6138333,2641002,6138333,6138333,2815574,3322759,3151111,1785506,1152098,6042,159068,1575,46822,171648,2641002,2331951,309051,"Miami-Fort Lauderdale-Pompano Beach, FL Metro Area"
2179,,,33140,310,112417,49780,112417,112417,7985,104432,99309,85957,11874,250,743,18,467,5123,49780,43799,5981,"Michigan City-La Porte, IN Metro Area"
2180,,,33180,310,24097,11517,24097,24097,244,23853,23079,22311,552,32,122,4,58,774,11517,9928,1589,"Middlesborough, KY Micro Area"
2181,,,33220,310,83494,36867,83494,83494,2659,80835,77173,73825,942,293,1710,83,320,3662,36867,34288,2579,"Midland, MI Metro Area"
2182,,,33260,310,175220,72423,175220,175220,75586,99634,95214,79267,10546,708,3900,153,640,4420,72423,62728,9695,"Midland, TX Metro Area"
2183,,,33300,310,52534,24884,52534,52534,1202,51332,50142,24845,24343,87,636,28,203,1190,24884,19809,5075,"Milledgeville, GA Micro Area"
2184,,,33340,310,1574731,693765,1574731,1574731,182777,1391954,1337421,1009707,250219,5124,65831,425,6115,54533,693765,651032,42733,"Milwaukee-Waukesha, WI Metro Area"
2185,,,33380,310,36967,18236,36967,36967,688,36279,35058,22554,12142,136,138,12,76,1221,18236,15684,2552,"Minden, LA Micro Area"
2186,,,33420,310,28409,15079,28409,28409,5614,22795,21771,20778,552,149,211,12,69,1024,15079,11250,3829,"Mineral Wells, TX Micro Area"
2187,,,33460,310,3690261,1503829,3690261,3690261,242621,3447640,3282601,2648247,333171,20136,264240,1172,15635,165039,1503829,1434315,69514,"Minneapolis-St. Paul-Bloomington, MN-WI Metro Area"
2188,,,33500,310,77546,36276,77546,77546,4725,72821,68809,62843,2869,1611,1099,135,252,4012,36276,32121,4155,"Minot, ND Micro Area"
2189,,,33540,310,117922,54542,117922,117922,6004,111918,105722,99953,706,3009,1423,122,509,6196,54542,50645,3897,"Missoula, MT Metro Area"
2190,,,33580,310,23417,10763,23417,23417,946,22471,21842,20941,132,608,117,0,44,629,10763,9727,1036,"Mitchell, SD Micro Area"
2191,,,33620,310,24716,10773,24716,24716,572,24144,22903,21271,1351,102,95,9,75,1241,10773,9424,1349,"Moberly, MO Micro Area"
2192,,,33660,310,430197,192153,430197,430197,13563,416634,400640,236970,148753,4845,8529,218,1325,15994,192153,170071,22082,"Mobile, AL Metro Area"
2193,,,33700,310,552878,183140,552878,552878,265978,286900,264447,207908,14302,2621,33169,3713,2734,22453,183140,176738,6402,"Modesto, CA Metro Area"
2194,,,33740,310,207104,92225,207104,207104,7174,199930,193156,113935,75760,552,2403,39,467,6774,92225,81715,10510,"Monroe, LA Metro Area"
2195,,,33780,310,154809,65845,154809,154809,6231,148578,141285,135369,4036,414,952,24,490,7293,65845,62152,3693,"Monroe, MI Metro Area"
2196,,,33860,310,386047,171240,386047,386047,15734,370313,358403,180283,166428,827,9509,169,1187,11910,171240,152474,18766,"Montgomery, AL Metro Area"
2197,,,33940,310,47553,22266,47553,47553,9319,38234,36484,35434,175,278,362,28,207,1750,22266,19779,2487,"Montrose, CO Micro Area"
2198,,,33980,310,67686,50846,67686,67686,3119,64567,61897,57538,3208,252,584,63,252,2670,50846,30112,20734,"Morehead City, NC Micro Area"
2199,,,34020,310,49406,22407,49406,49406,4524,44882,43034,26334,14950,911,647,13,179,1848,22407,19321,3086,"Morgan City, LA Micro Area"
2200,,,34060,310,140038,65055,140038,140038,4003,136035,129861,119307,6069,216,3782,68,419,6174,65055,57330,7725,"Morgantown, WV Metro Area"
2201,,,34100,310,142709,63848,142709,142709,12648,130061,124916,119920,3011,331,1022,290,342,5145,63848,56389,7459,"Morristown, TN Metro Area"
2202,,,34140,310,39517,17259,39517,39517,2073,37444,35300,33476,318,263,968,48,227,2144,17259,16063,1196,"Moscow, ID Micro Area"
2203,,,34180,310,99123,38635,99123,99123,42401,56722,53377,50250,651,830,1153,96,397,3345,38635,34078,4557,"Moses Lake, WA Micro Area"
2204,,,34220,310,45898,19105,45898,45898,8709,37189,36175,25588,9995,83,388,15,106,1014,19105,17172,1933,"Moultrie, GA Micro Area"
2205,,,34260,310,41627,22699,41627,41627,1058,40569,38692,38049,88,218,234,9,94,1877,22699,18936,3763,"Mountain Home, AR Micro Area"
2206,,,34300,310,28666,12049,28666,28666,5097,23569,21930,19996,688,234,766,101,145,1639,12049,10663,1386,"Mountain Home, ID Micro Area"
2207,,,34340,310,71359,33436,71359,71359,8496,62863,60843,57771,2413,130,370,11,148,2020,33436,29659,3777,"Mount Airy, NC Micro Area"
2208,,,34350,310,32567,14738,32567,32567,224,32343,31504,30785,580,41,63,1,34,839,14738,13033,1705,"Mount Gay-Shamrock, WV Micro Area"
2209,,,34380,310,64394,28489,64394,64394,3006,61388,58386,52970,2076,2025,1116,17,182,3002,28489,25191,3298,"Mount Pleasant, MI Micro Area"
2210,,,34420,310,43711,17787,43711,43711,16902,26809,25519,20144,4761,129,367,11,107,1290,17787,15620,2167,"Mount Pleasant, TX Micro Area"
2211,,,34460,310,46977,20847,46977,46977,1164,45813,44422,43361,771,42,163,4,81,1391,20847,18475,2372,"Mount Sterling, KY Micro Area"
2212,,,34500,310,37113,16632,37113,37113,899,36214,34469,31182,2783,77,352,7,68,1745,16632,14945,1687,"Mount Vernon, IL Micro Area"
2213,,,34540,310,62721,25797,62721,62721,1196,61525,59360,58058,565,118,365,17,237,2165,25797,23429,2368,"Mount Vernon, OH Micro Area"
2214,,,34580,310,129523,55744,129523,129523,23792,105731,99074,92347,793,2052,2771,388,723,6657,55744,50371,5373,"Mount Vernon-Anacortes, WA Metro Area"
2215,,,34620,310,111903,51464,111903,111903,3533,108370,103555,93333,8141,218,1388,58,417,4815,51464,45453,6011,"Muncie, IN Metro Area"
2216,,,34660,310,37103,17874,37103,37103,1353,35750,34135,32235,1293,53,433,11,110,1615,17874,15108,2766,"Murray, KY Micro Area"
2217,,,34700,310,43235,18366,43235,43235,7769,35466,34285,32633,1086,58,404,0,104,1181,18366,16908,1458,"Muscatine, IA Micro Area"
2218,,,34740,310,175824,74591,175824,175824,10283,165541,156510,130141,23622,1106,1073,31,537,9031,74591,68610,5981,"Muskegon, MI Metro Area"
2219,,,34780,310,66339,29278,66339,66339,4499,61840,53865,34857,6545,11747,512,39,165,7975,29278,25525,3753,"Muskogee, OK Micro Area"
2220,,,34820,310,487722,292032,487722,487722,31724,455998,436755,376445,50759,1917,5468,378,1788,19243,292032,211717,80315,"Myrtle Beach-Conway-North Myrtle Beach, SC-NC Metro Area"
2221,,,34860,310,64653,28877,64653,64653,13597,51056,48876,37158,10567,191,760,10,190,2180,28877,24713,4164,"Nacogdoches, TX Micro Area"
2222,,,34900,310,138019,55448,138019,138019,48829,89190,83462,68909,2300,507,10520,316,910,5728,55448,49738,5710,"Napa, CA Metro Area"
2223,,,34940,310,375752,228390,375752,375752,102249,273503,265542,235455,22554,551,5419,61,1502,7961,228390,157921,70469,"Naples-Marco Island, FL Metro Area"
2224,,,34980,310,1989519,828009,1989519,1989519,193873,1795646,1715416,1359362,281767,4204,61019,904,8160,80230,828009,772530,55479,"Nashville-Davidson--Murfreesboro--Franklin, TN Metro Area"
2225,,,35020,310,48225,23849,48225,48225,1471,46754,45702,21083,24186,95,280,7,51,1052,23849,19911,3938,"Natchez, MS-LA Micro Area"
2226,,,35060,310,37515,18513,37515,37515,1490,36025,34525,18898,14857,284,166,19,301,1500,18513,15213,3300,"Natchitoches, LA Micro Area"
2227,,,35100,310,122168,58553,122168,122168,8085,114083,108592,79824,24522,418,3141,155,532,5491,58553,49998,8555,"New Bern, NC Metro Area"
2228,,,35140,310,37719,18213,37719,37719,3305,34414,33313,22635,10360,107,135,4,72,1101,18213,15039,3174,"Newberry, SC Micro Area"
2229,,,35220,310,48914,20952,48914,48914,977,47937,46546,45105,1066,67,197,5,106,1391,20952,18954,1998,"New Castle, IN Micro Area"
2230,,,35260,310,86070,39492,86070,86070,1655,84415,80008,75811,3546,75,321,4,251,4407,39492,35939,3553,"New Castle, PA Micro Area"
2231,,,35300,310,864835,369178,864835,864835,170081,694754,664569,509688,110273,1413,36995,247,5953,30185,369178,343437,25741,"New Haven-Milford, CT Metro Area"
2232,,,35380,310,1271845,571914,1271845,1271845,146939,1124906,1081008,614816,418564,3772,36826,408,6622,43898,571914,512253,59661,"New Orleans-Metairie, LA Metro Area"
2233,,,35420,310,93263,40817,93263,93263,3962,89301,86297,84979,697,117,306,29,169,3004,40817,37711,3106,"New Philadelphia-Dover, OH Micro Area"
2234,,,35440,310,50395,32066,50395,50395,4851,45544,42223,39498,189,1521,646,93,276,3321,32066,22707,9359,"Newport, OR Micro Area"
2235,,,35460,310,35999,17808,35999,35999,954,35045,33646,32733,582,126,150,9,46,1399,17808,15246,2562,"Newport, TN Micro Area"
2236,,,35580,310,25912,11780,25912,25912,1171,24741,24277,23968,118,39,126,6,20,464,11780,10970,810,"New Ulm, MN Micro Area"
2237,,,35620,310,20140470,7982384,20140470,20140470,5067627,15072843,14451777,8712176,2998607,33078,2488759,5296,213861,621066,7982384,7405418,576966,"New York-Newark-Jersey City, NY-NJ-PA Metro Area"
2238,,,35660,310,154316,76821,154316,154316,9210,145106,137478,111603,21199,740,3159,109,668,7628,76821,63955,12866,"Niles, MI Metro Area"
2239,,,35700,310,47669,18729,47669,47669,39632,8037,7745,7119,114,78,271,13,150,292,18729,16670,2059,"Nogales, AZ Micro Area"
2240,,,35740,310,48744,20672,48744,48744,6008,42736,41488,39988,456,410,475,16,143,1248,20672,19150,1522,"Norfolk, NE Micro Area"
2241,,,35820,310,35791,17125,35791,35791,3037,32754,31668,30686,382,151,331,6,112,1086,17125,15137,1988,"North Platte, NE Micro Area"
2242,,,35840,310,833716,459864,833716,833716,114215,719501,692326,622801,47312,1474,16840,414,3485,27175,459864,368648,91216,"North Port-Sarasota-Bradenton, FL Metro Area"
2243,,,35860,310,27613,11574,27613,27613,859,26754,25974,25665,175,39,49,2,44,780,11574,10582,992,"North Vernon, IN Micro Area"
2244,,,35900,310,65969,31545,65969,65969,4654,61315,59442,56316,2580,86,324,5,131,1873,31545,27612,3933,"North Wilkesboro, NC Micro Area"
2245,,,35940,310,58565,25499,58565,58565,4084,54481,52277,51242,562,139,216,12,106,2204,25499,23406,2093,"Norwalk, OH Micro Area"
2246,,,35980,310,268555,122863,268555,268555,30920,237635,223556,194894,14422,1977,10633,215,1415,14079,122863,109572,13291,"Norwich-New London, CT Metro Area"
2247,,,36020,310,86857,41922,86857,86857,7118,79739,73556,65856,2265,543,3916,414,562,6183,41922,35917,6005,"Oak Harbor, WA Micro Area"
2248,,,36100,310,375908,177380,375908,375908,55910,319998,305486,253837,42795,986,5973,148,1747,14512,177380,156906,20474,"Ocala, FL Metro Area"
2249,,,36140,310,95263,99606,95263,95263,7465,87798,84678,80040,3305,99,893,22,319,3120,99606,41012,58594,"Ocean City, NJ Metro Area"
2250,,,36220,310,165171,66086,165171,165171,100051,65120,62097,51023,7430,568,2257,327,492,3023,66086,57336,8750,"Odessa, TX Metro Area"
2251,,,36260,310,694863,234051,694863,694863,93912,600951,575556,547270,7390,3272,11005,4250,2369,25395,234051,223399,10652,"Ogden-Clearfield, UT Metro Area"
2252,,,36300,310,108505,51612,108505,108505,2832,105673,101893,96556,2788,1143,1089,19,298,3780,51612,41235,10377,"Ogdensburg-Massena, NY Micro Area"
2253,,,36340,310,50454,26156,50454,50454,577,49877,47897,47117,434,68,172,10,96,1980,26156,21506,4650,"Oil City, PA Micro Area"
2254,,,36380,310,39644,18484,39644,39644,9857,29787,28744,24671,3318,263,332,14,146,1043,18484,14433,4051,"Okeechobee, FL Micro Area"
2255,,,36420,310,1425695,607725,1425695,1425695,212546,1213149,1092684,845718,143297,49924,46085,1637,6023,120465,607725,552514,55211,"Oklahoma City, OK Metro Area"
2256,,,36460,310,77042,40152,77042,77042,1615,75427,71992,67554,996,2661,560,9,212,3435,40152,31863,8289,"Olean, NY Micro Area"
2257,,,36500,310,294793,121438,294793,294793,29024,265769,242400,207985,8893,3621,16878,3241,1782,23369,121438,115397,6041,"Olympia-Lacey-Tumwater, WA Metro Area"
2258,,,36540,310,967604,400945,967604,967604,111481,856123,813872,699143,73122,3832,33478,734,3563,42251,400945,375433,25512,"Omaha-Council Bluffs, NE-IA Metro Area"
2259,,,36580,310,58524,29838,58524,58524,2392,56132,53788,51490,1189,109,813,7,180,2344,29838,23414,6424,"Oneonta, NY Micro Area"
2260,,,36620,310,56957,21299,56957,56957,14588,42369,40083,38215,499,458,592,71,248,2286,21299,19728,1571,"Ontario, OR-ID Micro Area"
2261,,,36660,310,82540,36723,82540,82540,2178,80362,78264,43225,34218,153,374,12,282,2098,36723,32499,4224,"Opelousas, LA Micro Area"
2262,,,36700,310,84223,41197,84223,84223,1967,82256,80185,27787,50802,467,892,37,200,2071,41197,33825,7372,"Orangeburg, SC Micro Area"
2263,,,36740,310,2673376,1087949,2673376,2673376,856028,1817348,1703292,1162010,386928,4550,121766,1914,26124,114056,1087949,989354,98595,"Orlando-Kissimmee-Sanford, FL Metro Area"
2264,,,36780,310,171730,76046,171730,171730,8328,163402,157422,145581,4931,935,5560,53,362,5980,76046,71473,4573,"Oshkosh-Neenah, WI Metro Area"
2265,,,36820,310,22190,9680,22190,22190,480,21710,20983,20259,384,41,250,15,34,727,9680,8799,881,"Oskaloosa, IA Micro Area"
2266,,,36830,310,20613,6735,20613,20613,13120,7493,7135,6829,24,63,129,3,87,358,6735,6228,507,"Othello, WA Micro Area"
2267,,,36837,310,148539,68485,148539,148539,14899,133640,128597,124029,2799,209,1171,33,356,5043,68485,61808,6677,"Ottawa, IL Micro Area"
2268,,,36840,310,25996,11149,25996,25996,1147,24849,23499,22818,303,190,103,7,78,1350,11149,10233,916,"Ottawa, KS Micro Area"
2269,,,36900,310,35437,15734,35437,35437,4332,31105,30032,27295,1443,66,622,518,88,1073,15734,14167,1567,"Ottumwa, IA Micro Area"
2270,,,36940,310,37406,15691,37406,37406,3140,34266,33206,31376,1359,65,330,18,58,1060,15691,14823,868,"Owatonna, MN Micro Area"
2271,,,36980,310,121559,51918,121559,121559,4471,117088,112579,104604,4953,144,2464,61,353,4509,51918,48373,3545,"Owensboro, KY Metro Area"
2272,,,37060,310,55813,28208,55813,55813,2142,53671,51973,38766,11300,68,1685,24,130,1698,28208,22362,5846,"Oxford, MS Micro Area"
2273,,,37100,310,843843,293080,843843,843843,365285,478558,445692,360850,13704,2020,63252,1415,4451,32866,293080,279715,13365,"Oxnard-Thousand Oaks-Ventura, CA Metro Area"
2274,,,37120,310,49326,22761,49326,49326,3254,46072,43773,32602,10100,217,648,42,164,2299,22761,20159,2602,"Ozark, AL Micro Area"
2275,,,37140,310,98660,47110,98660,98660,2747,95913,91139,81184,8647,231,744,30,303,4774,47110,41820,5290,"Paducah, KY-IL Micro Area"
2276,,,37220,310,51591,25191,51591,51591,7927,43664,40965,37313,1496,620,1028,217,291,2699,25191,21763,3428,"Pahrump, NV Micro Area"
2277,,,37260,310,73321,36014,73321,73321,7816,65505,62849,50541,11274,280,469,37,248,2656,36014,29569,6445,"Palatka, FL Micro Area"
2278,,,37300,310,57922,20131,57922,57922,11111,46811,45228,33098,11430,193,381,13,113,1583,20131,17371,2760,"Palestine, TX Micro Area"
2279,,,37340,310,606612,288794,606612,606612,67907,538705,508461,430936,56498,1569,15587,482,3389,30244,288794,257026,31768,"Palm Bay-Melbourne-Titusville, FL Metro Area"
2280,,,37420,310,22054,10426,22054,22054,6397,15657,14887,13742,837,143,127,0,38,770,10426,8278,2148,"Pampa, TX Micro Area"
2281,,,37460,310,175216,102971,175216,175216,13846,161370,151674,128348,17549,795,4068,194,720,9696,102971,70134,32837,"Panama City, FL Metro Area"
2282,,,37500,310,45736,19159,45736,45736,1596,44140,42145,40509,926,138,181,287,104,1995,19159,17673,1486,"Paragould, AR Micro Area"
2283,,,37540,310,32199,16937,32199,32199,877,31322,29967,27250,2307,76,202,7,125,1355,16937,13742,3195,"Paris, TN Micro Area"
2284,,,37580,310,50088,22644,50088,50088,4412,45676,43101,35354,6378,751,474,25,119,2575,22644,20186,2458,"Paris, TX Micro Area"
2285,,,37620,310,89490,43006,89490,89490,1196,88294,84693,82717,1022,152,564,21,217,3601,43006,38403,4603,"Parkersburg-Vienna, WV Metro Area"
2286,,,37660,310,20184,9524,20184,20184,939,19245,17482,16077,838,425,90,9,43,1763,9524,8222,1302,"Parsons, KS Micro Area"
2287,,,37740,310,53272,32373,53272,53272,9283,43989,42326,32757,239,8655,427,45,203,1663,32373,22312,10061,"Payson, AZ Micro Area"
2288,,,37770,310,18385,6340,18385,18385,14171,4214,4096,3053,705,49,199,9,81,118,6340,5190,1150,"Pearsall, TX Micro Area"
2289,,,37780,310,14812,5102,14812,14812,12511,2301,2213,1753,224,28,165,3,40,88,5102,4203,899,"Pecos, TX Micro Area"
2290,,,37800,310,33414,14073,33414,33414,700,32714,31771,30918,281,64,401,21,86,943,14073,13145,928,"Pella, IA Micro Area"
2291,,,37860,310,509905,221244,509905,509905,32683,477222,447502,348480,78838,3110,13684,772,2618,29720,221244,197614,23630,"Pensacola-Ferry Pass-Brent, FL Metro Area"
2292,,,37900,310,402391,183579,402391,402391,15185,387206,370968,322899,36738,748,9162,118,1303,16238,183579,165642,17937,"Peoria, IL Metro Area"
2293,,,37940,310,35962,14852,35962,35962,1186,34776,33432,31123,1792,281,130,4,102,1344,14852,13348,1504,"Peru, IN Micro Area"
2294,,,37980,310,6245051,2586947,6245051,6245051,636151,5608900,5378944,3690540,1234464,8036,411368,1743,32793,229956,2586947,2413835,173112,"Philadelphia-Camden-Wilmington, PA-NJ-DE-MD Metro Area"
2295,,,38060,310,4845832,1985705,4845832,4845832,1472948,3372884,3186248,2597577,265951,85509,204200,10660,22351,186636,1985705,1790242,195463,"Phoenix-Mesa-Chandler, AZ Metro Area"
2296,,,38100,310,56145,24641,56145,56145,2284,53861,51463,44101,6666,256,275,0,165,2398,24641,21703,2938,"Picayune, MS Micro Area"
2297,,,38180,310,20745,9349,20745,20745,521,20224,19196,16638,95,2261,133,13,56,1028,9349,8484,865,"Pierre, SD Micro Area"
2298,,,38220,310,87751,38509,87751,87751,2289,85462,83134,39847,42037,260,694,103,193,2328,38509,33172,5337,"Pine Bluff, AR Metro Area"
2299,,,38240,310,99727,48237,99727,99727,7365,92362,88271,75391,10545,688,1237,59,351,4091,48237,41881,6356,"Pinehurst-Southern Pines, NC Micro Area"
2300,,,38260,310,38972,17997,38972,38972,2716,36256,33928,31937,899,320,461,191,120,2328,17997,15668,2329,"Pittsburg, KS Micro Area"
2301,,,38300,310,2370930,1124531,2370930,2370930,52920,2318010,2224936,1947870,196784,2402,67954,666,9260,93074,1124531,1024382,100149,"Pittsburgh, PA Metro Area"
2302,,,38340,310,129026,69759,129026,129026,7064,121962,116141,109263,4064,165,1999,18,632,5821,69759,57015,12744,"Pittsfield, MA Metro Area"
2303,,,38380,310,32522,13396,32522,32522,19489,13033,12421,10693,1381,99,149,30,69,612,13396,11396,2000,"Plainview, TX Micro Area"
2304,,,38420,310,51938,22110,51938,51938,1236,50702,49576,48325,679,95,411,8,58,1126,22110,19956,2154,"Platteville, WI Micro Area"
2305,,,38460,310,79843,37315,79843,79843,2856,76987,73493,69251,2753,238,957,24,270,3494,37315,32583,4732,"Plattsburgh, NY Micro Area"
2306,,,38500,310,46095,19654,46095,46095,5251,40844,39570,38910,204,63,274,7,112,1274,19654,17480,2174,"Plymouth, IN Micro Area"
2307,,,38540,310,94896,37840,94896,94896,10617,84279,80566,75273,705,2772,1166,257,393,3713,37840,35127,2713,"Pocatello, ID Metro Area"
2308,,,38580,310,54673,25583,54673,54673,432,54241,52485,51277,790,87,222,10,99,1756,25583,22235,3348,"Point Pleasant, WV-OH Micro Area"
2309,,,38620,310,43700,20968,43700,43700,3652,40048,36313,30728,856,4127,253,274,75,3735,20968,17571,3397,"Ponca City, OK Micro Area"
2310,,,38660,310,224142,104029,224142,224142,222554,1588,1476,1058,160,20,118,1,119,112,104029,88500,15529,"Ponce, PR Metro Area"
2311,,,38700,310,35815,15920,35815,35815,1859,33956,32898,31518,1081,38,171,1,89,1058,15920,14396,1524,"Pontiac, IL Micro Area"
2312,,,38740,310,52809,24432,52809,52809,1028,51781,48812,45630,2494,242,332,13,101,2969,24432,21496,2936,"Poplar Bluff, MO Micro Area"
2313,,,38780,310,19191,8483,19191,19191,8397,10794,10239,9328,443,163,173,18,114,555,8483,7159,1324,"Portales, NM Micro Area"
2314,,,38820,310,77155,37930,77155,77155,4732,72423,67445,61164,571,3931,1234,113,432,4978,37930,34113,3817,"Port Angeles, WA Micro Area"
2315,,,38860,310,551740,280588,551740,551740,12757,538983,517604,490011,14229,1325,9916,157,1966,21379,280588,233160,47428,"Portland-South Portland, ME Metro Area"
2316,,,38900,310,2512859,1033420,2512859,2512859,332155,2180704,2019779,1726583,72963,15305,176283,15009,13636,160925,1033420,979213,54207,"Portland-Vancouver-Hillsboro, OR-WA Metro Area"
2317,,,38920,310,20106,10539,20106,20106,9858,10248,9937,8374,361,34,1112,0,56,311,10539,7614,2925,"Port Lavaca, TX Micro Area"
2318,,,38940,310,487657,229255,487657,487657,90507,397150,379511,295749,71874,786,7924,183,2995,17639,229255,197747,31508,"Port St. Lucie, FL Metro Area"
2319,,,39020,310,74008,33108,74008,74008,1052,72956,70316,67531,2038,254,274,9,210,2640,33108,29612,3496,"Portsmouth, OH Micro Area"
2320,,,39060,310,143049,67128,143049,143049,8064,134985,131510,126192,4115,155,748,13,287,3475,67128,57950,9178,"Pottsville, PA Micro Area"
2321,,,39100,310,697221,268888,697221,697221,131968,565253,539390,430343,71467,1141,22300,171,13968,25863,268888,247673,21215,"Poughkeepsie-Newburgh-Middletown, NY Metro Area"
2322,,,39150,310,236209,121154,236209,236209,34390,201819,192172,183296,1415,3319,2802,269,1071,9647,121154,104425,16729,"Prescott Valley-Prescott, AZ Metro Area"
2323,,,39220,310,20412,9579,20412,20412,2677,17735,17044,16645,50,199,63,29,58,691,9579,7950,1629,"Price, UT Micro Area"
2324,,,39260,310,24738,11159,24738,24738,1803,22935,21453,20874,78,262,114,23,102,1482,11159,9975,1184,"Prineville, OR Micro Area"
2325,,,39300,310,1676579,726938,1676579,1676579,236852,1439727,1355230,1199708,78509,4451,52018,422,20122,84497,726938,670567,56371,"Providence-Warwick, RI-MA Metro Area"
2326,,,39340,310,671185,196386,671185,671185,89105,582080,555140,529241,4121,2622,10143,6582,2431,26940,196386,188087,8299,"Provo-Orem, UT Metro Area"
2327,,,39380,310,168162,71981,168162,168162,69921,98241,92412,85527,2995,1246,1562,138,944,5829,71981,67095,4886,"Pueblo, CO Metro Area"
2328,,,39420,310,47973,20922,47973,47973,4052,43921,40999,35557,1163,266,3616,139,258,2922,20922,18650,2272,"Pullman, WA Micro Area"
2329,,,39460,310,186847,110046,186847,186847,14079,172768,166366,153700,8870,385,2566,63,782,6402,110046,85846,24200,"Punta Gorda, FL Metro Area"
2330,,,39500,310,75769,34547,75769,75769,1452,74317,71263,67704,2649,122,522,33,233,3054,34547,31102,3445,"Quincy, IL-MO Micro Area"
2331,,,39540,310,197727,84490,197727,197727,27911,169816,161502,135333,22531,538,2261,47,792,8314,84490,78959,5531,"Racine, WI Metro Area"
2332,,,39580,310,1413982,576280,1413982,1413982,169603,1244379,1187918,823769,253361,3899,98948,541,7400,56461,576280,542396,33884,"Raleigh-Cary, NC Metro Area"
2333,,,39660,310,139074,61510,139074,139074,6876,132198,123881,108037,1771,11711,1738,126,498,8317,61510,56274,5236,"Rapid City, SD Metro Area"
2334,,,39700,310,20164,6770,20164,20164,17611,2553,2493,1805,445,47,160,2,34,60,6770,5714,1056,"Raymondville, TX Micro Area"
2335,,,39740,310,428849,170742,428849,428849,99550,329299,317632,291258,18087,450,6225,61,1551,11667,170742,161485,9257,"Reading, PA Metro Area"
2336,,,39780,310,65829,27341,65829,65829,17938,47891,44303,41340,391,1167,985,96,324,3588,27341,24910,2431,"Red Bluff, CA Micro Area"
2337,,,39820,310,182155,79380,182155,182155,19730,162425,149901,136894,1761,4047,5839,323,1037,12524,79380,72836,6544,"Redding, CA Metro Area"
2338,,,39860,310,47582,20864,47582,47582,1797,45785,44253,42516,661,540,348,33,155,1532,20864,19499,1365,"Red Wing, MN Micro Area"
2339,,,39900,310,490596,209196,490596,490596,122544,368052,342486,291200,11551,5828,28130,3258,2519,25566,209196,193692,15504,"Reno, NV Metro Area"
2340,,,39940,310,66301,22576,66301,66301,6838,59463,57643,55277,730,221,977,239,199,1820,22576,17388,5188,"Rexburg, ID Micro Area"
2341,,,39980,310,66553,30752,66553,66553,2495,64058,60907,56689,3027,142,707,12,330,3151,30752,27409,3343,"Richmond, IN Micro Area"
2342,,,40060,310,1314434,551968,1314434,1314434,104488,1209946,1155226,726834,359605,4196,56725,661,7205,54720,551968,518667,33301,"Richmond, VA Metro Area"
2343,,,40080,310,106864,46146,106864,106864,3195,103669,98673,93210,3910,213,1013,56,271,4996,46146,42023,4123,"Richmond-Berea, KY Micro Area"
2344,,,40100,310,65920,22980,65920,65920,64393,1527,1408,1171,31,8,100,0,98,119,22980,19868,3112,"Rio Grande City-Roma, TX Micro Area"
2345,,,40140,310,4599839,1580448,4599839,4599839,2373208,2226631,2073319,1354348,320084,20372,341093,12940,24482,153312,1580448,1431119,149329,"Riverside-San Bernardino-Ontario, CA Metro Area"
2346,,,40180,310,39234,17407,39234,39234,2421,36813,34898,26586,166,7798,205,7,136,1915,17407,15146,2261,"Riverton, WY Micro Area"
2347,,,40220,310,315251,147601,315251,315251,15863,299388,286199,237907,39404,531,6969,97,1291,13189,147601,132722,14879,"Roanoke, VA Metro Area"
2348,,,40260,310,66093,35305,66093,66093,1807,64286,62468,25905,34386,1636,308,15,218,1818,35305,28508,6797,"Roanoke Rapids, NC Micro Area"
2349,,,40300,310,51788,22632,51788,51788,5797,45991,44098,43120,543,72,259,0,104,1893,22632,20870,1762,"Rochelle, IL Micro Area"
2350,,,40340,310,226329,97302,226329,226329,11302,215027,206654,183659,11304,456,10462,75,698,8373,97302,90673,6629,"Rochester, MN Metro Area"
2351,,,40380,310,1090135,489463,1090135,1090135,88854,1001281,956450,794477,120602,2018,35041,243,4069,44831,489463,450845,38618,"Rochester, NY Metro Area"
2352,,,40420,310,338798,145140,338798,338798,53832,284966,269896,219924,39411,631,8575,75,1280,15070,145140,134568,10572,"Rockford, IL Metro Area"
2353,,,40460,310,42946,19605,42946,42946,3072,39874,37908,23610,12770,994,360,7,167,1966,19605,17454,2151,"Rockingham, NC Micro Area"
2354,,,40530,310,23830,15500,23830,23830,6158,17672,16772,15816,241,142,480,15,78,900,15500,10236,5264,"Rockport, TX Micro Area"
2355,,,40540,310,42272,19145,42272,42272,6957,35315,33463,32362,351,259,283,61,147,1852,19145,16625,2520,"Rock Springs, WY Micro Area"
2356,,,40580,310,143870,66213,143870,143870,10028,133842,129976,63657,63978,743,1016,37,545,3866,66213,59064,7149,"Rocky Mount, NC Metro Area"
2357,,,40620,310,44638,20174,44638,44638,1259,43379,40956,37941,1028,231,1506,20,230,2423,20174,17815,2359,"Rolla, MO Micro Area"
2358,,,40660,310,98584,40475,98584,98584,11466,87118,83560,67747,13940,191,1287,24,371,3558,40475,36883,3592,"Rome, GA Metro Area"
2359,,,40700,310,111201,49774,111201,111201,6654,104547,97470,93525,383,1694,1185,151,532,7077,49774,45817,3957,"Roseburg, OR Micro Area"
2360,,,40740,310,65157,26658,65157,65157,37097,28060,26701,24445,947,411,611,29,258,1359,26658,23521,3137,"Roswell, NM Micro Area"
2361,,,40760,310,20269,17624,20269,20269,6496,13773,13119,12339,68,429,138,8,137,654,17624,9148,8476,"Ruidoso, NM Micro Area"
2362,,,40780,310,83644,36148,83644,83644,10619,73025,68706,64747,2286,567,866,34,206,4319,36148,31918,4230,"Russellville, AR Micro Area"
2363,,,40820,310,48396,20370,48396,48396,1754,46642,45236,25672,18626,145,682,5,106,1406,20370,18075,2295,"Ruston, LA Micro Area"
2364,,,40860,310,60572,33869,60572,60572,1225,59347,56374,55092,493,146,458,14,171,2973,33869,26651,7218,"Rutland, VT Micro Area"
2365,,,40900,310,2397382,933562,2397382,2397382,533221,1864161,1712767,1156794,159322,11663,349967,20333,14688,151394,933562,868460,65102,"Sacramento-Roseville-Folsom, CA Metro Area"
2366,,,40940,310,38533,13704,38533,38533,11428,27105,26281,20398,453,5143,169,16,102,824,13704,12150,1554,"Safford, AZ Micro Area"
2367,,,40980,310,190124,85953,190124,190124,16904,173220,165959,128722,33548,462,2373,85,769,7261,85953,78442,7511,"Saginaw, MI Metro Area"
2368,,,41060,310,199671,82999,199671,199671,8167,191504,185170,165097,15215,623,3622,69,544,6334,82999,76927,6072,"St. Cloud, MN Metro Area"
2369,,,41100,310,180279,74530,180279,180279,20482,159797,153981,147462,913,1566,1802,1607,631,5816,74530,62416,12114,"St. George, UT Metro Area"
2370,,,41140,310,121467,53437,121467,121467,6422,115045,109243,101414,5379,459,1211,447,333,5802,53437,47703,5734,"St. Joseph, MO-KS Metro Area"
2371,,,41180,310,2820253,1258862,2820253,2820253,106269,2713984,2585965,1983321,503344,5296,81630,974,11400,128019,1258862,1149824,109038,"St. Louis, MO-IL Metro Area"
2372,,,41220,310,54768,22541,54768,54768,3658,51110,48121,37203,9497,185,845,66,325,2989,22541,20374,2167,"St. Marys, GA Micro Area"
2373,,,41260,310,30990,16836,30990,30990,294,30696,29727,29466,74,16,113,12,46,969,16836,13590,3246,"St. Marys, PA Micro Area"
2374,,,41400,310,101877,46091,101877,101877,1752,100125,96287,93466,2082,161,345,16,217,3838,46091,41706,4385,"Salem, OH Micro Area"
2375,,,41420,310,433353,162369,433353,433353,108470,324883,302639,278369,4469,4703,8972,4013,2113,22244,162369,154721,7648,"Salem, OR Metro Area"
2376,,,41460,310,60038,26757,60038,60038,6786,53252,50113,46774,1762,255,1119,26,177,3139,26757,24568,2189,"Salina, KS Micro Area"
2377,,,41500,310,439035,143631,439035,439035,265321,173714,159594,120077,9051,1314,25123,1859,2170,14120,143631,131789,11842,"Salinas, CA Metro Area"
2378,,,41540,310,418046,253120,418046,418046,37037,381009,364463,286350,68036,1143,7123,115,1696,16546,253120,169737,83383,"Salisbury, MD-DE Metro Area"
2379,,,41620,310,1257936,451281,1257936,1257936,241610,1016326,967577,859113,22412,7650,50752,21831,5819,48749,451281,427316,23965,"Salt Lake City, UT Metro Area"
2380,,,41660,310,122888,52770,122888,122888,47864,75024,70990,64369,4019,379,1705,146,372,4034,52770,47794,4976,"San Angelo, TX Metro Area"
2381,,,41700,310,2558143,1015678,2558143,2558143,1389685,1168458,1096025,838674,166108,6205,71191,3330,10517,72433,1015678,925609,90069,"San Antonio-New Braunfels, TX Metro Area"
2382,,,41740,310,3298634,1228505,3298634,3298634,1119629,2179005,2011765,1422205,145014,12841,400589,12991,18125,167240,1228505,1158764,69741,"San Diego-Chula Vista-Carlsbad, CA Metro Area"
2383,,,41760,310,47110,26312,47110,47110,1504,45606,43352,42344,115,307,252,39,295,2254,26312,19619,6693,"Sandpoint, ID Micro Area"
2384,,,41780,310,75622,38262,75622,75622,3130,72492,68553,61061,6655,121,474,10,232,3939,38262,32360,5902,"Sandusky, OH Micro Area"
2385,,,41820,310,63285,26583,63285,63285,13122,50163,47900,36055,10701,231,643,43,227,2263,26583,24575,2008,"Sanford, NC Micro Area"
2386,,,41860,310,4749008,1847185,4749008,4749008,1086206,3662802,3408982,1718055,323385,9830,1293209,31470,33033,253820,1847185,1744100,103085,"San Francisco-Oakland-Berkeley, CA Metro Area"
2387,,,41900,310,125100,67255,125100,125100,123990,1110,1059,807,102,5,61,1,83,51,67255,52203,15052,"San Germán, PR Metro Area"
2388,,,41940,310,2000468,708400,2000468,2000468,526598,1473870,1393768,575493,42627,3461,755588,6072,10527,80102,708400,675547,32853,"San Jose-Sunnyvale-Santa Clara, CA Metro Area"
2389,,,41980,310,2081265,1006503,2081265,2081265,2055711,25554,23902,16436,3324,223,2159,67,1693,1652,1006503,851651,154852,"San Juan-Bayamón-Caguas, PR Metro Area"
2390,,,42020,310,282424,123715,282424,282424,67921,214503,200889,183468,4330,1136,10001,340,1614,13614,123715,107797,15918,"San Luis Obispo-Paso Robles, CA Metro Area"
2391,,,42100,310,270861,106345,270861,270861,94299,176562,163252,145551,2850,853,12072,277,1649,13310,106345,96261,10084,"Santa Cruz-Watsonville, CA Metro Area"
2392,,,42140,310,154823,76877,154823,154823,74377,80446,76230,67861,1221,3869,2238,72,969,4216,76877,68020,8857,"Santa Fe, NM Metro Area"
2393,,,42180,310,20281,9345,20281,20281,20166,115,102,62,11,2,14,1,12,13,9345,8094,1251,"Santa Isabel, PR Micro Area"
2394,,,42200,310,448229,158279,448229,448229,210584,237645,221242,184746,6467,1731,25378,542,2378,16403,158279,148353,9926,"Santa Maria-Santa Barbara, CA Metro Area"
2395,,,42220,310,488863,204742,488863,488863,141438,347425,322826,285792,7125,3053,22239,1708,2909,24599,204742,187701,17041,"Santa Rosa-Petaluma, CA Metro Area"
2396,,,42300,310,36785,20268,36785,36785,757,36028,33048,24544,2611,5601,193,12,87,2980,20268,13837,6431,"Sault Ste. Marie, MI Micro Area"
2397,,,42340,310,404798,175166,404798,404798,30551,374247,357666,218958,123088,902,12329,489,1900,16581,175166,156817,18349,"Savannah, GA Metro Area"
2398,,,42380,310,59967,29363,59967,59967,873,59094,56834,55717,394,117,460,13,133,2260,29363,24789,4574,"Sayre, PA Micro Area"
2399,,,42420,310,37893,17526,37893,37893,8297,29596,28487,27366,234,473,283,27,104,1109,17526,15471,2055,"Scottsbluff, NE Micro Area"
2400,,,42460,310,52579,24627,52579,52579,1681,50898,47752,45123,1624,680,214,2,109,3146,24627,21733,2894,"Scottsboro, AL Micro Area"
2401,,,42500,310,24384,10715,24384,24384,535,23849,23090,22829,92,27,87,11,44,759,10715,9717,998,"Scottsburg, IN Micro Area"
2402,,,42540,310,567559,263327,567559,567559,65746,501813,484741,449692,21660,603,10837,96,1853,17072,263327,233994,29333,"Scranton--Wilkes-Barre, PA Metro Area"
2403,,,42620,310,76822,33270,76822,76822,3499,73323,69214,64363,3677,319,616,25,214,4109,33270,29705,3565,"Searcy, AR Micro Area"
2404,,,42660,310,4018762,1650246,4018762,4018762,450476,3568286,3276389,2328818,239282,29445,612509,42432,23903,291897,1650246,1564432,85814,"Seattle-Tacoma-Bellevue, WA Metro Area"
2405,,,42680,310,159788,83529,159788,159788,20832,138956,133897,117422,13079,273,2341,52,730,5059,83529,71177,12352,"Sebastian-Vero Beach, FL Metro Area"
2406,,,42700,310,101235,57486,101235,101235,20943,80292,77244,65511,9484,291,1602,49,307,3048,57486,44376,13110,"Sebring-Avon Park, FL Metro Area"
2407,,,42740,310,42980,18563,42980,42980,4016,38964,36796,34751,1353,159,294,120,119,2168,18563,16588,1975,"Sedalia, MO Micro Area"
2408,,,42780,310,39736,15978,39736,39736,977,38759,37893,36992,504,32,296,11,58,866,15978,14753,1225,"Selinsgrove, PA Micro Area"
2409,,,42820,310,38462,18880,38462,38462,296,38166,37426,10363,26812,56,145,12,38,740,18880,16037,2843,"Selma, AL Micro Area"
2410,,,42860,310,78607,40788,78607,78607,4384,74223,70780,64696,5119,176,591,16,182,3443,40788,33241,7547,"Seneca, SC Micro Area"
2411,,,42900,310,33814,16096,33814,33814,1367,32447,31038,29273,1263,151,268,3,80,1409,16096,13414,2682,"Seneca Falls, NY Micro Area"
2412,,,42940,310,98380,56240,98380,98380,8614,89766,86260,83801,766,312,1103,24,254,3506,56240,39520,16720,"Sevierville, TN Micro Area"
2413,,,42980,310,46428,19069,46428,46428,6251,40177,38936,37815,485,68,469,5,94,1241,19069,17809,1260,"Seymour, IN Micro Area"
2414,,,43020,310,45136,22499,45136,45136,1312,43824,42098,34887,119,6858,167,8,59,1726,22499,18500,3999,"Shawano, WI Micro Area"
2415,,,43060,310,72454,29973,72454,72454,4288,68166,60750,49158,2194,8693,495,39,171,7416,29973,26817,3156,"Shawnee, OK Micro Area"
2416,,,43100,310,118034,52303,118034,118034,8662,109372,105889,95837,2434,362,6875,21,360,3483,52303,48702,3601,"Sheboygan, WI Metro Area"
2417,,,43140,310,99519,43630,99519,99519,4039,95480,91623,70163,20034,222,854,23,327,3857,43630,39887,3743,"Shelby, NC Micro Area"
2418,,,43180,310,50237,19685,50237,50237,7665,42572,40679,36499,3563,127,337,13,140,1893,19685,18350,1335,"Shelbyville, TN Micro Area"
2419,,,43220,310,65726,33269,65726,65726,7595,58131,53634,49591,688,1959,758,216,422,4497,33269,25505,7764,"Shelton, WA Micro Area"
2420,,,43260,310,30921,14884,30921,30921,1416,29505,28266,27509,110,324,180,17,126,1239,14884,13349,1535,"Sheridan, WY Micro Area"
2421,,,43300,310,135543,58572,135543,135543,20868,114675,106899,95211,7448,1876,1958,58,348,7776,58572,52307,6265,"Sherman-Denison, TX Metro Area"
2422,,,43320,310,106717,56180,106717,106717,10887,95830,92880,44786,674,46572,548,68,232,2950,56180,36836,19344,"Show Low, AZ Micro Area"
2423,,,43340,310,393406,179915,393406,393406,19380,374026,359024,195831,154223,1710,5619,233,1408,15002,179915,159810,20105,"Shreveport-Bossier City, LA Metro Area"
2424,,,43380,310,48230,20059,48230,48230,787,47443,45654,44067,839,81,450,29,188,1789,20059,18803,1256,"Sidney, OH Micro Area"
2425,,,43420,310,125447,58648,125447,125447,42615,82832,77122,68256,4371,762,2587,421,725,5710,58648,50936,7712,"Sierra Vista-Douglas, AZ Metro Area"
2426,,,43460,310,38059,16746,38059,38059,935,37124,35403,30595,4476,84,149,2,97,1721,16746,15306,1440,"Sikeston, MO Micro Area"
2427,,,43500,310,28185,14584,28185,28185,13466,14719,14008,13117,249,265,191,18,168,711,14584,12269,2315,"Silver City, NM Micro Area"
2428,,,43580,310,149940,60201,149940,149940,29014,120926,115727,101221,6865,2558,3823,832,428,5199,60201,56332,3869,"Sioux City, IA-NE-SD Metro Area"
2429,,,43620,310,276730,116263,276730,276730,14137,262593,251876,227569,12573,5344,5577,82,731,10717,116263,109218,7045,"Sioux Falls, SD Metro Area"
2430,,,43660,310,16932,6889,16932,16932,7139,9793,9410,8637,599,60,82,5,27,383,6889,5925,964,"Snyder, TX Micro Area"
2431,,,43700,310,65034,31552,65034,65034,1877,63157,61033,59600,677,160,436,10,150,2124,31552,26405,5147,"Somerset, KY Micro Area"
2432,,,43740,310,74129,37713,74129,74129,1037,73092,71284,69044,1863,50,194,7,126,1808,37713,30208,7505,"Somerset, PA Micro Area"
2433,,,43760,310,55620,31415,55620,55620,7124,48496,45220,42254,989,784,770,110,313,3276,31415,22711,8704,"Sonora, CA Micro Area"
2434,,,43780,310,324501,143414,324501,324501,28737,295764,279491,231865,37692,1294,6902,170,1568,16273,143414,128014,15400,"South Bend-Mishawaka, IN-MI Metro Area"
2435,,,43900,310,327997,137009,327997,327997,27732,300265,288172,214440,63565,699,8176,190,1102,12093,137009,125836,11173,"Spartanburg, SC Metro Area"
2436,,,43940,310,25768,14163,25768,25768,922,24846,23814,22935,128,486,196,18,51,1032,14163,11444,2719,"Spearfish, SD Micro Area"
2437,,,43980,310,16384,8109,16384,16384,704,15680,15280,15025,99,37,105,2,12,400,8109,7222,887,"Spencer, IA Micro Area"
2438,,,44020,310,17703,13691,17703,17703,406,17297,16905,16709,76,14,80,1,25,392,13691,7976,5715,"Spirit Lake, IA Micro Area"
2439,,,44060,310,585784,246261,585784,585784,37035,548749,510477,470528,10627,9420,12684,4286,2932,38272,246261,231275,14986,"Spokane-Spokane Valley, WA Metro Area"
2440,,,44100,310,208640,98573,208640,208640,5469,203171,193260,161969,25766,367,4349,57,752,9911,98573,89506,9067,"Springfield, IL Metro Area"
2441,,,44140,310,699162,297623,699162,699162,136533,562629,537103,467506,41311,985,24036,235,3030,25526,297623,278127,19496,"Springfield, MA Metro Area"
2442,,,44180,310,475432,207779,475432,475432,19305,456127,428426,405529,11064,2728,7103,471,1531,27701,207779,192076,15703,"Springfield, MO Metro Area"
2443,,,44220,310,136001,60987,136001,136001,5313,130688,123709,109794,12074,314,898,91,538,6979,60987,55844,5143,"Springfield, OH Metro Area"
2444,,,44260,310,61714,30438,61714,61714,1423,60291,58814,36915,20010,107,1519,11,252,1477,30438,25077,5361,"Starkville, MS Micro Area"
2445,,,44300,310,158172,65408,158172,158172,5651,152521,147102,129668,5306,120,11373,39,596,5419,65408,59357,6051,"State College, PA Metro Area"
2446,,,44340,310,81099,32983,81099,81099,4180,76919,74240,49712,22775,159,1283,62,249,2679,32983,29747,3236,"Statesboro, GA Micro Area"
2447,,,44420,310,125433,55174,125433,125433,5761,119672,114754,104408,8564,228,1039,58,457,4918,55174,51164,4010,"Staunton, VA Metro Area"
2448,,,44460,310,24829,16511,24829,24829,2200,22629,21758,21242,153,67,169,35,92,871,16511,10388,6123,"Steamboat Springs, CO Micro Area"
2449,,,44500,310,42545,18325,42545,42545,9254,33291,31880,30006,1194,215,348,13,104,1411,18325,15858,2467,"Stephenville, TX Micro Area"
2450,,,44540,310,21528,8668,21528,21528,3511,18017,17439,16337,753,161,119,17,52,578,8668,7919,749,"Sterling, CO Micro Area"
2451,,,44580,310,55691,25855,55691,55691,7131,48560,46606,45341,741,60,306,9,149,1954,25855,23556,2299,"Sterling, IL Micro Area"
2452,,,44620,310,70377,31148,70377,70377,2620,67757,65767,62212,903,242,2252,16,142,1990,31148,29138,2010,"Stevens Point, WI Micro Area"
2453,,,44660,310,81646,36708,81646,81646,5373,76273,68673,58926,3123,3613,2662,53,296,7600,36708,30958,5750,"Stillwater, OK Micro Area"
2454,,,44700,310,779233,251453,779233,779233,325725,453508,419416,215530,56898,3135,134684,4977,4192,34092,251453,241119,10334,"Stockton, CA Metro Area"
2455,,,44740,310,20823,8141,20823,20823,5925,14898,14546,11377,560,29,1889,614,77,352,8141,7447,694,"Storm Lake, IA Micro Area"
2456,,,44780,310,60939,27081,60939,60939,5427,55512,52763,50674,1341,151,414,9,174,2749,27081,23557,3524,"Sturgis, MI Micro Area"
2457,,,44860,310,36787,15671,36787,36787,6484,30303,28913,25976,2373,198,277,4,85,1390,15671,13947,1724,"Sulphur Springs, TX Micro Area"
2458,,,44900,310,24965,10854,24965,24965,1297,23668,22698,20079,2391,45,102,0,81,970,10854,9520,1334,"Summerville, GA Micro Area"
2459,,,44940,310,136700,62569,136700,136700,5209,131491,126675,61751,62357,458,1625,95,389,4816,62569,54514,8055,"Sumter, SC Metro Area"
2460,,,44980,310,91647,43300,91647,91647,4151,87496,84858,81689,2392,110,444,24,199,2638,43300,37932,5368,"Sunbury, PA Micro Area"
2461,,,45000,310,32730,12216,32730,32730,7531,25199,23614,19534,2244,939,472,283,142,1585,12216,9888,2328,"Susanville, CA Micro Area"
2462,,,45020,310,14738,7123,14738,14738,5354,9384,8952,8138,625,53,103,2,31,432,7123,5857,1266,"Sweetwater, TX Micro Area"
2463,,,45060,310,662057,296364,662057,662057,31861,630196,598881,513965,56851,3832,21653,136,2444,31315,296364,268611,27753,"Syracuse, NY Metro Area"
2464,,,45140,310,47078,22033,47078,47078,3437,43641,36963,20231,519,15745,308,21,139,6678,22033,18023,4010,"Tahlequah, OK Micro Area"
2465,,,45180,310,82149,37948,82149,82149,1779,80370,77884,50732,26340,184,395,27,206,2486,37948,33090,4858,"Talladega-Sylacauga, AL Micro Area"
2466,,,45220,310,384298,172730,384298,384298,30242,354056,339367,206258,119631,892,10844,181,1561,14689,172730,155677,17053,"Tallahassee, FL Metro Area"
2467,,,45300,310,3175275,1465158,3175275,3175275,652022,2523253,2395243,1888689,357018,6700,122602,2105,18129,128010,1465158,1307725,157433,"Tampa-St. Petersburg-Clearwater, FL Metro Area"
2468,,,45340,310,34489,20904,34489,34489,17430,17059,16140,13706,130,1830,196,4,274,919,20904,15747,5157,"Taos, NM Micro Area"
2469,,,45380,310,34032,15184,34032,34032,1094,32938,31905,31226,380,59,179,1,60,1033,15184,13721,1463,"Taylorville, IL Micro Area"
2470,,,45460,310,185031,82185,185031,185031,4426,180605,173667,161894,8320,479,2203,50,721,6938,82185,72746,9439,"Terre Haute, IN Metro Area"
2471,,,45500,310,147519,65358,147519,147519,9594,137925,131051,92041,36170,961,1306,82,491,6874,65358,57684,7674,"Texarkana, TX-AR Metro Area"
2472,,,45520,310,26670,11996,26670,26670,5017,21653,20344,18703,115,983,248,185,110,1309,11996,10553,1443,"The Dalles, OR Micro Area"
2473,,,45540,310,129752,75304,129752,129752,7583,122169,119426,109213,8313,311,1238,31,320,2743,75304,62907,12397,"The Villages, FL Metro Area"
2474,,,45580,310,27700,12301,27700,27700,633,27067,26181,18009,7851,63,151,1,106,886,12301,11173,1128,"Thomaston, GA Micro Area"
2475,,,45620,310,45798,20668,45798,45798,1577,44221,42942,25994,16259,150,406,9,124,1279,20668,18440,2228,"Thomasville, GA Micro Area"
2476,,,45660,310,55069,23934,55069,55069,2899,52170,50146,48213,1314,66,359,36,158,2024,23934,22017,1917,"Tiffin, OH Micro Area"
2477,,,45700,310,41344,17375,41344,41344,5219,36125,35037,22189,12049,56,650,2,91,1088,17375,15921,1454,"Tifton, GA Micro Area"
2478,,,45740,310,26784,12317,26784,26784,857,25927,24642,21323,2936,73,225,9,76,1285,12317,10618,1699,"Toccoa, GA Micro Area"
2479,,,45780,310,646604,303295,646604,646604,46297,600307,571447,470560,87047,1088,10148,136,2468,28860,303295,269650,33645,"Toledo, OH Metro Area"
2480,,,45820,310,233152,104349,233152,233152,25832,207320,193840,173646,13789,2869,2614,214,708,13480,104349,94837,9512,"Topeka, KS Metro Area"
2481,,,45860,310,185186,87615,185186,185186,14580,170606,163254,155601,2957,268,3434,63,931,7352,87615,77502,10113,"Torrington, CT Micro Area"
2482,,,45900,310,153448,84866,153448,153448,4673,148775,142511,138444,743,1758,1050,45,471,6264,84866,64738,20128,"Traverse City, MI Micro Area"
2483,,,45940,310,387340,150442,387340,387340,84177,303163,291686,168580,72364,427,48330,106,1879,11477,150442,139361,11081,"Trenton-Princeton, NJ Metro Area"
2484,,,45980,310,33009,15977,33009,33009,905,32104,30976,18036,12068,169,577,9,117,1128,15977,13901,2076,"Troy, AL Micro Area"
2485,,,46020,310,102241,53627,102241,102241,10416,91825,86028,82810,416,695,1371,119,617,5797,53627,42774,10853,"Truckee-Grass Valley, CA Micro Area"
2486,,,46060,310,1043433,470132,1043433,1043433,372788,670645,633230,536868,36254,23670,29844,1937,4657,37415,470132,427021,43111,"Tucson, AZ Metro Area"
2487,,,46100,310,107124,47301,107124,107124,4862,102262,97748,91846,4162,279,988,55,418,4514,47301,42246,5055,"Tullahoma-Manchester, TN Micro Area"
2488,,,46140,310,1015331,437257,1015331,1015331,118902,896429,789185,599134,78986,78075,28554,1209,3227,107244,437257,397385,39872,"Tulsa, OK Metro Area"
2489,,,46180,310,163398,72617,163398,163398,5665,157733,153257,118008,33509,263,1110,35,332,4476,72617,64214,8403,"Tupelo, MS Micro Area"
2490,,,46220,310,268674,121710,268674,268674,13561,255113,247733,152203,90767,482,3344,99,838,7380,121710,106925,14785,"Tuscaloosa, AL Metro Area"
2491,,,46300,310,114283,43262,114283,114283,24386,89897,86034,82322,1060,609,1483,223,337,3863,43262,40859,2403,"Twin Falls, ID Metro Area"
2492,,,46340,310,233479,97539,233479,233479,47281,186198,178102,134452,38003,746,4129,77,695,8096,97539,88567,8972,"Tyler, TX Metro Area"
2493,,,46380,310,91601,41370,91601,91601,23933,67668,62772,56205,607,3528,1730,110,592,4896,41370,36280,5090,"Ukiah, CA Micro Area"
2494,,,46420,310,27244,13451,27244,27244,438,26806,25900,17279,8435,56,78,3,49,906,13451,11622,1829,"Union, SC Micro Area"
2495,,,46460,310,30787,14314,30787,30787,1574,29213,28093,24736,3137,50,103,0,67,1120,14314,12928,1386,"Union City, TN Micro Area"
2496,,,46500,310,38714,16862,38714,38714,648,38066,36347,35314,683,79,125,7,139,1719,16862,15638,1224,"Urbana, OH Micro Area"
2497,,,46520,310,1016508,370665,1016508,1016508,92322,924186,725649,175530,19356,1116,429410,97063,3174,198537,370665,336412,34253,"Urban Honolulu, HI Metro Area"
2498,,,46540,310,292264,137254,292264,292264,16721,275543,263759,235637,15671,584,10881,104,882,11784,137254,119164,18090,"Utica-Rome, NY Metro Area"
2499,,,46620,310,24564,10034,24564,24564,17317,7247,6975,6613,107,25,158,6,66,272,10034,8624,1410,"Uvalde, TX Micro Area"
2500,,,46660,310,148126,61597,148126,148126,10490,137636,132325,77295,51915,404,2064,120,527,5311,61597,55422,6175,"Valdosta, GA Metro Area"
2501,,,46700,310,453491,162237,453491,453491,128155,325336,294516,155125,60051,1624,70953,3775,2988,30820,162237,155924,6313,"Vallejo, CA Metro Area"
2502,,,46780,310,28931,12540,28931,28931,1097,27834,26941,26467,257,37,88,13,79,893,12540,11589,951,"Van Wert, OH Micro Area"
2503,,,46820,310,14967,6180,14967,14967,458,14509,13845,12655,235,552,361,4,38,664,6180,5564,616,"Vermillion, SD Micro Area"
2504,,,46860,310,35620,13657,35620,35620,2834,32786,31463,28726,90,2277,157,97,116,1323,13657,11993,1664,"Vernal, UT Micro Area"
2505,,,46900,310,12887,5836,12887,12887,3734,9153,8719,7012,1013,96,566,0,32,434,5836,4944,892,"Vernon, TX Micro Area"
2506,,,46980,310,44722,21452,44722,44722,876,43846,42729,20909,21290,67,364,0,99,1117,21452,18480,2972,"Vicksburg, MS Micro Area"
2507,,,47020,310,98331,42461,98331,98331,45219,53112,50971,43576,5465,232,1415,35,248,2141,42461,37266,5195,"Victoria, TX Metro Area"
2508,,,47080,310,35640,15767,35640,35640,3615,32025,31153,21672,9100,42,241,6,92,872,15767,13662,2105,"Vidalia, GA Micro Area"
2509,,,47180,310,36282,16917,36282,36282,1005,35277,34190,33027,696,67,283,13,104,1087,16917,14783,2134,"Vincennes, IN Micro Area"
2510,,,47220,310,154152,57119,154152,154152,53054,101098,95746,65808,26375,905,2051,12,595,5352,57119,52649,4470,"Vineland-Bridgeton, NJ Metro Area"
2511,,,47240,310,20600,17530,20600,20600,534,20066,18121,16230,795,202,184,9,701,1945,17530,8932,8598,"Vineyard Haven, MA Micro Area"
2512,,,47260,310,1799674,760076,1799674,1799674,134850,1664824,1565451,941693,533432,5357,72643,2597,9729,99373,760076,702160,57916,"Virginia Beach-Norfolk-Newport News, VA-NC Metro Area"
2513,,,47300,310,473117,150652,473117,473117,309895,163222,152452,125022,5332,3458,15997,511,2132,10770,150652,141987,8665,"Visalia, CA Metro Area"
2514,,,47340,310,30976,14037,30976,30976,897,30079,29154,28634,158,126,161,9,66,925,14037,12721,1316,"Wabash, IN Micro Area"
2515,,,47380,310,277547,113237,277547,277547,72552,204995,195379,148400,39838,956,4924,154,1107,9616,113237,102485,10752,"Waco, TX Metro Area"
2516,,,47420,310,23035,10473,23035,23035,785,22250,21516,20621,196,520,131,20,28,734,10473,9445,1028,"Wahpeton, ND-MN Micro Area"
2517,,,47460,310,62584,24971,62584,62584,14206,48378,45311,42580,981,418,918,134,280,3067,24971,23082,1889,"Walla Walla, WA Metro Area"
2518,,,47540,310,46422,19873,46422,46422,781,45641,44303,43643,231,76,242,40,71,1338,19873,18602,1271,"Wapakoneta, OH Micro Area"
2519,,,47580,310,191614,78624,191614,191614,14354,177260,168893,98330,64131,402,5099,130,801,8367,78624,72808,5816,"Warner Robins, GA Metro Area"
2520,,,47620,310,38587,21587,38587,38587,415,38172,36741,36310,144,71,154,5,57,1431,21587,16618,4969,"Warren, PA Micro Area"
2521,,,47660,310,54013,22601,54013,54013,2595,51418,48217,44415,2309,259,821,210,203,3201,22601,20321,2280,"Warrensburg, MO Micro Area"
2522,,,47700,310,80240,38133,80240,80240,7492,72748,70389,67990,682,160,1336,16,205,2359,38133,31196,6937,"Warsaw, IN Micro Area"
2523,,,47780,310,33381,12738,33381,33381,2103,31278,30581,29708,619,38,132,8,76,697,12738,11737,1001,"Washington, IN Micro Area"
2524,,,47820,310,44652,24090,44652,44652,3433,41219,40018,29431,10195,90,164,16,122,1201,24090,19430,4660,"Washington, NC Micro Area"
2525,,,47900,310,6385162,2500128,6385162,6385162,1094950,5290212,4989396,2703319,1535923,11083,694753,3746,40572,300816,2500128,2360771,139357,"Washington-Arlington-Alexandria, DC-VA-MD-WV Metro Area"
2526,,,47920,310,28951,12663,28951,28951,681,28270,27094,26260,521,43,171,11,88,1176,12663,11752,911,"Washington Court House, OH Micro Area"
2527,,,47940,310,168461,74508,168461,168461,7104,161357,155316,136344,13811,255,3632,850,424,6041,74508,68938,5570,"Waterloo-Cedar Falls, IA Metro Area"
2528,,,47980,310,34489,15970,34489,34489,1027,33462,32585,31507,114,686,210,9,59,877,15970,14181,1789,"Watertown, SD Micro Area"
2529,,,48020,310,84900,36376,84900,84900,7068,77832,75262,73325,864,206,646,19,202,2570,36376,33844,2532,"Watertown-Fort Atkinson, WI Micro Area"
2530,,,48060,310,116721,61604,116721,116721,7990,108731,102473,92755,6271,461,2185,300,501,6258,61604,45480,16124,"Watertown-Fort Drum, NY Metro Area"
2531,,,48100,310,25327,9820,25327,25327,10604,14723,14242,11873,2111,55,165,3,35,481,9820,8059,1761,"Wauchula, FL Micro Area"
2532,,,48140,310,166428,75862,166428,166428,4982,161446,156414,145517,1289,654,8548,31,375,5032,75862,68990,6872,"Wausau-Weston, WI Metro Area"
2533,,,48180,310,55967,24218,55967,55967,2610,53357,51686,38678,12300,118,415,18,157,1671,24218,21157,3061,"Waycross, GA Micro Area"
2534,,,48220,310,28513,12932,28513,28513,5384,23129,21320,18483,783,1702,294,1,57,1809,12932,10859,2073,"Weatherford, OK Micro Area"
2535,,,48260,310,116903,56085,116903,116903,1870,115033,109604,103821,4679,176,503,37,388,5429,56085,49945,6140,"Weirton-Steubenville, WV-OH Metro Area"
2536,,,48300,310,122012,54585,122012,122012,36741,85271,80595,77538,370,746,1193,164,584,4676,54585,45711,8874,"Wenatchee, WA Metro Area"
2537,,,48460,310,39750,18048,39750,39750,896,38854,36760,35972,180,265,217,17,109,2094,18048,16117,1931,"West Plains, MO Micro Area"
2538,,,48500,310,18636,8985,18636,18636,186,18450,18111,7196,10785,35,57,1,37,339,8985,7771,1214,"West Point, MS Micro Area"
2539,,,48540,310,139513,67516,139513,139513,1825,137688,132061,126764,3987,184,760,38,328,5627,67516,58608,8908,"Wheeling, WV-OH Metro Area"
2540,,,48580,310,106478,53146,106478,106478,12550,93928,90779,88104,1166,229,1002,10,268,3149,53146,42378,10768,"Whitewater, WI Micro Area"
2541,,,48620,310,647610,275434,647610,647610,91517,556093,518890,439813,47270,5337,23534,560,2376,37203,275434,252298,23136,"Wichita, KS Metro Area"
2542,,,48660,310,148128,64513,148128,148128,27186,120942,113959,95991,13444,1141,2715,140,528,6983,64513,56665,7848,"Wichita Falls, TX Metro Area"
2543,,,48700,310,114188,52625,114188,114188,2374,111814,106883,99687,5672,191,923,27,383,4931,52625,46603,6022,"Williamsport, PA Metro Area"
2544,,,48780,310,40950,20227,40950,40950,3897,37053,34801,30761,2041,1125,612,98,164,2252,20227,16095,4132,"Williston, ND Micro Area"
2545,,,48820,310,43732,19950,43732,43732,5916,37816,36757,33303,2618,115,586,37,98,1059,19950,17079,2871,"Willmar, MN Micro Area"
2546,,,48900,310,285905,143295,285905,285905,22282,263623,252152,211568,34518,873,3787,171,1235,11471,143295,121071,22224,"Wilmington, NC Metro Area"
2547,,,48940,310,42018,17906,42018,42018,765,41253,39538,38247,819,96,205,6,165,1715,17906,16464,1442,"Wilmington, OH Micro Area"
2548,,,48980,310,78784,36252,78784,78784,9024,69760,67354,36106,29842,239,900,10,257,2406,36252,32222,4030,"Wilson, NC Micro Area"
2549,,,49020,310,142632,60615,142632,142632,15821,126811,120906,111017,6583,216,2422,57,611,5905,60615,55089,5526,"Winchester, VA-WV Metro Area"
2550,,,49060,310,34549,15558,34549,34549,3971,30578,28469,26227,865,626,499,179,73,2109,15558,13322,2236,"Winfield, KS Micro Area"
2551,,,49080,310,17285,7658,17285,17285,4511,12774,12117,11032,137,571,152,26,199,657,7658,6575,1083,"Winnemucca, NV Micro Area"
2552,,,49100,310,49671,21716,49671,49671,1889,47782,46211,44178,892,84,933,0,124,1571,21716,20111,1605,"Winona, MN Micro Area"
2553,,,49180,310,675966,301571,675966,675966,77803,598163,573900,442388,114680,1942,12196,292,2402,24263,301571,276135,25436,"Winston-Salem, NC Metro Area"
2554,,,49220,310,74207,34549,74207,74207,2376,71831,69752,67055,547,549,1382,29,190,2079,34549,32238,2311,"Wisconsin Rapids-Marshfield, WI Micro Area"
2555,,,49260,310,24219,11514,24219,24219,3346,20873,19736,18574,367,600,135,0,60,1137,11514,9309,2205,"Woodward, OK Micro Area"
2556,,,49300,310,116894,46555,116894,116894,2755,114139,110092,106930,1755,142,950,32,283,4047,46555,43983,2572,"Wooster, OH Micro Area"
2557,,,49340,310,978529,401354,978529,978529,126361,852168,809002,703051,46286,1472,48070,193,9930,43166,401354,377671,23683,"Worcester, MA-CT Metro Area"
2558,,,49380,310,22290,8394,22290,22290,7271,15019,14603,12147,978,66,1329,41,42,416,8394,7851,543,"Worthington, MN Micro Area"
2559,,,49420,310,256728,90504,256728,256728,130049,126679,118704,103578,1718,9357,2785,221,1045,7975,90504,85882,4622,"Yakima, WA Metro Area"
2560,,,49460,310,23310,10372,23310,23310,1234,22076,21324,20195,312,638,129,9,41,752,10372,9435,937,"Yankton, SD Micro Area"
2561,,,49500,310,86142,42322,86142,86142,85665,477,436,327,40,3,24,4,38,41,42322,33804,8518,"Yauco, PR Metro Area"
2562,,,49620,310,456438,187187,456438,456438,39360,417078,400204,365353,25768,640,6557,118,1768,16874,187187,177553,9634,"York-Hanover, PA Metro Area"
2563,,,49660,310,541243,253211,541243,541243,19881,521362,498903,435715,56999,697,3734,99,1659,22459,253211,229461,23750,"Youngstown-Warren-Boardman, OH-PA Metro Area"
2564,,,49700,310,181208,63957,181208,181208,55088,126120,114935,83116,4605,1896,23597,651,1070,11185,63957,60070,3887,"Yuba City, CA Metro Area"
2565,,,49740,310,203881,92048,203881,203881,130003,73878,69653,61123,3484,1888,2321,215,622,4225,92048,69589,22459,"Yuma, AZ Metro Area"
2566,,,49780,310,86410,38358,86410,86410,1055,85355,80840,76947,2985,138,384,8,378,4515,38358,35091,3267,"Zanesville, OH Micro Area"
2567,,,49820,310,13889,6159,13889,13889,12999,890,844,796,9,7,16,0,16,46,6159,4536,1623,"Zapata, TX Micro Area"
2568,,,1446014454,314,2054736,855875,2054736,2054736,240589,1814147,1711001,1272240,228048,2644,176540,517,31012,103146,855875,800269,55606,"Boston, MA Metro Division"
2569,,,1446015764,314,2441831,985468,2441831,2441831,326092,2115739,2007015,1622343,108077,2196,238934,483,34982,108724,985468,934946,50522,"Cambridge-Newton-Framingham, MA Metro Division"
2570,,,1446040484,314,445065,191044,445065,445065,14171,430894,414281,397698,3510,593,10720,121,1639,16613,191044,177241,13803,"Rockingham County-Strafford County, NH Metro Division"
2571,,,1698016984,314,7267535,3021496,7267535,7267535,1710337,5557198,5356292,3427233,1313964,7612,579224,1323,26936,200906,3021496,2809485,212011,"Chicago-Naperville-Evanston, IL Metro Division"
2572,,,1698020994,314,748811,274829,748811,748811,210319,538492,514214,438246,44662,750,28096,154,2306,24278,274829,262395,12434,"Elgin, IL Metro Division"
2573,,,1698023844,314,718663,305791,718663,718663,122212,596451,570903,429236,128465,1028,9655,158,2361,25548,305791,280716,25075,"Gary, IN Metro Division"
2574,,,1698029404,314,883493,341829,883493,883493,196508,686985,656150,530285,58720,1280,61694,379,3792,30835,341829,320228,21601,"Lake County-Kenosha County, IL-WI Metro Division"
2575,,,1910019124,314,5129966,1988960,5129966,5129966,1538201,3591765,3414214,2074022,829497,16733,470347,2936,20679,177551,1988960,1860810,128150,"Dallas-Plano-Irving, TX Metro Division"
2576,,,1910023104,314,2507421,958229,2507421,2507421,697033,1810388,1714592,1192352,367384,9225,130871,5185,9575,95796,958229,900181,58048,"Fort Worth-Arlington-Grapevine, TX Metro Division"
2577,,,1982019804,314,1793561,790191,1793561,1793561,117649,1675912,1603574,857132,669277,4265,64604,322,7974,72338,790191,709400,80791,"Detroit-Dearborn-Livonia, MI Metro Division"
2578,,,1982047664,314,2598480,1111065,2598480,2598480,102304,2496176,2387738,1942401,283185,5352,146740,631,9429,108438,1111065,1051492,59573,"Warren-Troy-Farmington Hills, MI Metro Division"
2579,,,3108011244,314,3186989,1129785,3186989,3186989,1086834,2100155,1974913,1198655,49304,5298,699124,7714,14818,125242,1129785,1074105,55680,"Anaheim-Santa Ana-Irvine, CA Metro Division"
2580,,,3108031084,314,10014009,3591981,10014009,10014009,4804763,5209246,4896193,2563609,760689,18453,1474237,20522,58683,313053,3591981,3420628,171353,"Los Angeles-Long Beach-Glendale, CA Metro Division"
2581,,,3310022744,314,1944375,860329,1944375,1944375,608703,1335672,1260890,644230,517618,2917,74040,696,21389,74782,860329,756657,103672,"Fort Lauderdale-Pompano Beach-Sunrise, FL Metro Division"
2582,,,3310033124,314,2701767,1074685,2701767,2701767,1856938,844829,798586,361517,378756,1589,41672,385,14667,46243,1074685,967414,107271,"Miami-Miami Beach-Kendall, FL Metro Division"
2583,,,3310048424,314,1492191,705988,1492191,1492191,349933,1142258,1091635,779759,255724,1536,43356,494,10766,50623,705988,607880,98108,"West Palm Beach-Boca Raton-Boynton Beach, FL Metro Division"
2584,,,3562035004,314,2921694,1055672,2921694,2921694,589384,2332310,2256060,1746784,254484,4816,228184,533,21259,76250,1055672,972354,83318,"Nassau County-Suffolk County, NY Metro Division"
2585,,,3562035084,314,2280061,896598,2280061,2280061,514491,1765570,1687713,1055834,460843,2567,146056,373,22040,77857,896598,830309,66289,"Newark, NJ-PA Metro Division"
2586,,,3562035154,314,2489367,1010684,2489367,2489367,398125,2091242,2020912,1491972,166026,2494,342418,469,17533,70330,1010684,909587,101097,"New Brunswick-Lakewood, NJ Metro Division"
2587,,,3562035614,314,12449348,5019430,12449348,12449348,3565627,8883721,8487092,4417586,2117254,23201,1772101,3921,153029,396629,5019430,4693168,326262,"New York-Jersey City-White Plains, NY-NJ Metro Division"
2588,,,3798015804,314,1287639,514742,1287639,1287639,157777,1129862,1077365,799139,201459,1632,67783,438,6914,52497,514742,484404,30338,"Camden, NJ Metro Division"
2589,,,3798033874,314,2037504,810749,2037504,2037504,137824,1899680,1827310,1545295,133178,1826,137957,430,8624,72370,810749,771664,39085,"Montgomery County-Bucks County-Chester County, PA Metro Division"
2590,,,3798037964,314,2180627,956005,2180627,2180627,265049,1915578,1841691,914077,740890,3272,168725,712,14015,73887,956005,873573,82432,"Philadelphia, PA Metro Division"
2591,,,3798048864,314,739281,305451,739281,739281,75501,663780,632578,432029,158937,1306,36903,163,3240,31202,305451,284194,21257,"Wilmington, DE-MD-NJ Metro Division"
2592,,,4186036084,314,2848280,1045300,2848280,2848280,708649,2139631,1984641,927698,257493,6684,755031,18929,18806,154990,1045300,998665,46635,"Oakland-Berkeley-Livermore, CA Metro Division"
2593,,,4186041884,314,1638407,690321,1638407,1638407,328147,1310260,1225845,617208,59772,2591,522003,12084,12187,84415,690321,641268,49053,"San Francisco-San Mateo-Redwood City, CA Metro Division"
2594,,,4186042034,314,262321,111564,262321,262321,49410,212911,198496,173149,6120,555,16175,457,2040,14415,111564,104167,7397,"San Rafael, CA Metro Division"
2595,,,4266042644,314,3097632,1290757,3097632,3097632,338665,2758967,2548005,1759003,176223,19803,550383,24250,18343,210962,1290757,1224592,66165,"Seattle-Bellevue-Kent, WA Metro Division"
2596,,,4266045104,314,921130,359489,921130,921130,111811,809319,728384,569815,63059,9642,62126,18182,5560,80935,359489,339840,19649,"Tacoma-Lakewood, WA Metro Division"
2597,,,4790023224,314,1333778,507916,1333778,1333778,249528,1084250,1022642,614616,219721,1778,175899,594,10034,61608,507916,485289,22627,"Frederick-Gaithersburg-Rockville, MD Metro Division"
2598,,,4790047894,314,5051384,1992212,5051384,5051384,845422,4205962,3966754,2088703,1316202,9305,518854,3152,30538,239208,1992212,1875482,116730,"Washington-Arlington-Alexandria, DC-VA-MD-WV Metro Division"
2599,,,104,330,1190727,570586,1190727,1190727,69825,1120902,1061275,920799,79112,2633,49302,423,9006,59627,570586,498561,72025,"Albany-Schenectady, NY CSA"
2600,,,106,330,1162523,517842,1162523,1162523,567900,594623,559349,442656,23374,60529,25778,858,6154,35274,517842,473398,44444,"Albuquerque-Santa Fe-Las Vegas, NM CSA"
2601,,,107,330,166914,76507,166914,166914,2560,164354,158915,152436,4730,183,1078,21,467,5439,76507,68031,8476,"Altoona-Huntingdon, PA CSA"
2602,,,108,330,311362,134233,311362,311362,89149,222213,210830,180926,17877,1915,8911,77,1124,11383,134233,118517,15716,"Amarillo-Pampa-Borger, TX CSA"
2603,,,118,330,414877,176688,414877,414877,20608,394269,380187,353516,8279,3867,13417,207,901,14082,176688,168263,8425,"Appleton-Oshkosh-Neenah, WI CSA"
2604,,,120,330,546579,271776,546579,546579,45143,501436,479935,447857,21903,1613,5575,732,2255,21501,271776,234110,37666,"Asheville-Marion-Brevard, NC CSA"
2605,,,122,330,6930423,2753914,6930423,6930423,843314,6087109,5829615,3210505,2146031,12151,415477,2713,42738,257494,2753914,2570167,183747,"Atlanta--Athens-Clarke County--Sandy Springs, GA-AL CSA"
2606,,,140,330,222991,105269,222991,222991,19040,203951,191680,185469,864,1401,2535,281,1130,12271,105269,90192,15077,"Bend-Prineville, OR CSA"
2607,,,142,330,1350646,594892,1350646,1350646,72897,1277749,1233891,848434,357839,2931,20388,540,3759,43858,594892,535148,59744,"Birmingham-Hoover-Talladega, AL CSA"
2608,,,144,330,206050,93885,206050,206050,7420,198630,189615,174588,5286,400,8619,41,681,9015,93885,85455,8430,"Bloomington-Bedford, IN CSA"
2609,,,145,330,206769,90775,206769,206769,12383,194386,186059,160958,15780,296,8279,39,707,8327,90775,83492,7283,"Bloomington-Pontiac, IL CSA"
2610,,,146,330,256927,113097,256927,256927,9755,247172,240111,229667,6542,322,2970,60,550,7061,113097,101107,11990,"Bloomsburg-Berwick-Sunbury, PA CSA"
2611,,,147,330,850341,328987,850341,850341,129035,721306,681142,642553,10451,4690,17159,2043,4246,40164,328987,310503,18484,"Boise City-Mountain Home-Ontario, ID-OR CSA"
2612,,,148,330,8466186,3604952,8466186,8466186,990612,7475574,7081207,5928219,483743,13510,549473,1983,104279,394367,3604952,3319384,285568,"Boston-Worcester-Providence, MA-RI-NH-CT CSA"
2613,,,150,330,234410,102348,234410,234410,12882,221528,212628,188011,14932,402,7658,731,894,8900,102348,91111,11237,"Bowling Green-Glasgow, KY CSA"
2614,,,154,330,441181,161675,441181,441181,394291,46890,44892,38912,1850,412,2756,82,880,1998,161675,138221,23454,"Brownsville-Harlingen-Raymondville, TX CSA"
2615,,,160,330,1243944,579055,1243944,1243944,69091,1174853,1129724,919481,147076,9622,49089,253,4203,45129,579055,527319,51736,"Buffalo-Cheektowaga-Olean, NY CSA"
2616,,,161,330,103106,50165,103106,103106,2835,100271,96218,91637,3520,167,620,38,236,4053,50165,43929,6236,"Burlington-Fort Madison-Keokuk, IA-IL-MO CSA"
2617,,,162,330,285369,131637,285369,285369,7362,278007,264689,248520,5739,948,8177,88,1217,13318,131637,117982,13655,"Burlington-South Burlington-Barre, VT CSA"
2618,,,163,330,1176193,659693,1176193,1176193,297522,878671,847113,738020,82707,1934,18547,309,5596,31558,659693,488868,170825,"Cape Coral-Fort Myers-Naples, FL CSA"
2619,,,164,330,135576,60425,135576,135576,3404,132172,125835,111124,12582,306,1475,19,329,6337,60425,54411,6014,"Cape Girardeau-Sikeston, MO-IL CSA"
2620,,,168,330,451939,196666,451939,451939,21680,430259,411799,365439,29569,676,14150,570,1395,18460,196666,183397,13269,"Cedar Rapids-Iowa City, IA CSA"
2621,,,170,330,779969,365953,779969,779969,9609,770360,741538,706687,25513,1527,5635,127,2049,28822,365953,323300,42653,"Charleston-Huntington-Ashland, WV-OH-KY CSA"
2622,,,172,330,2822352,1179478,2822352,2822352,319309,2503043,2395698,1656353,599729,8618,116327,1121,13550,107345,1179478,1098647,80831,"Charlotte-Concord, NC-SC CSA"
2623,,,174,330,1000303,428209,1000303,1000303,98650,901653,861307,755969,85761,2308,13987,437,2845,40346,428209,390605,37604,"Chattanooga-Cleveland-Dalton, TN-GA CSA"
2624,,,176,330,9986960,4107480,9986960,9986960,2274780,7712180,7416100,5108577,1575901,11302,681652,2078,36590,296080,4107480,3819959,287521,"Chicago-Naperville, IL-IN-WI CSA"
2625,,,178,330,2316022,983524,2316022,2316022,96194,2219828,2120313,1765896,272641,3361,67594,1961,8860,99515,983524,914039,69485,"Cincinnati-Wilmington-Maysville, OH-KY-IN CSA"
2626,,,184,330,3633962,1662778,3633962,3633962,179808,3454154,3303868,2668268,531156,5270,84830,755,13589,150286,1662778,1525555,137223,"Cleveland-Akron-Canton, OH CSA"
2627,,,185,330,56956,23040,56956,56956,1455,55501,54485,16675,37334,41,346,0,89,1016,23040,20468,2572,"Cleveland-Indianola, MS CSA"
2628,,,188,330,67621,29585,67621,67621,30193,37428,35032,30380,2956,412,906,53,325,2396,29585,25722,3863,"Clovis-Portales, NM CSA"
2629,,,190,330,260542,112800,260542,260542,9885,250657,236220,204048,21999,704,8075,140,1254,14437,112800,102765,10035,"Columbia-Moberly-Mexico, MO CSA"
2630,,,192,330,951412,425708,951412,951412,60552,890860,856762,502861,327358,2672,19581,695,3595,34098,425708,379912,45796,"Columbia-Orangeburg-Newberry, SC CSA"
2631,,,194,330,503124,218553,503124,503124,33759,469365,448805,255136,174155,1196,15429,899,1990,20560,218553,197647,20906,"Columbus-Auburn-Opelika, GA-AL CSA"
2632,,,198,330,2544048,1080980,2544048,2544048,118334,2425714,2308854,1841518,344006,4351,106877,692,11410,116860,1080980,1001388,79592,"Columbus-Marion-Zanesville, OH CSA"
2633,,,200,330,77515,35867,77515,77515,1509,76006,74109,36559,36670,145,571,17,147,1897,35867,31451,4416,"Columbus-West Point, MS CSA"
2634,,,204,330,525875,230875,525875,525875,322408,203467,192065,163295,15206,1408,10006,379,1771,11402,230875,194651,36224,"Corpus Christi-Kingsville-Alice, TX CSA"
2635,,,206,330,8121108,3163911,8121108,8121108,2313130,5807978,5510215,3607550,1220462,36143,605495,9056,31509,297763,3163911,2947316,216595,"Dallas-Fort Worth, TX-OK CSA"
2636,,,209,330,474019,213885,474019,474019,44880,429139,409239,363798,33445,814,9742,116,1324,19900,213885,195652,18233,"Davenport-Moline, IA-IL CSA"
2637,,,212,330,1088875,490132,1088875,1088875,36201,1052674,1000644,831132,140560,1985,21528,505,4934,52030,490132,450663,39469,"Dayton-Springfield-Kettering, OH CSA"
2638,,,216,330,3623560,1503302,3623560,3623560,838341,2785219,2626299,2265297,165268,16078,156656,5201,17799,158920,1503302,1414008,89294,"Denver-Aurora, CO CSA"
2639,,,217,330,85299,37724,85299,85299,5446,79853,75567,62638,10407,757,1084,316,365,4286,37724,32558,5166,"DeRidder-Fort Polk South, LA CSA"
2640,,,218,330,890322,378019,890322,890322,64826,825496,791800,707615,42787,1807,36210,452,2929,33696,378019,351955,26064,"Des Moines-Ames-West Des Moines, IA CSA"
2641,,,220,330,5424742,2350647,5424742,5424742,271668,5153074,4919597,3553731,1080140,12479,250330,1284,21633,233477,2350647,2176590,174057,"Detroit-Warren-Ann Arbor, MI CSA"
2642,,,221,330,89836,40840,89836,89836,9455,80381,77255,73776,2572,90,554,19,244,3126,40840,37145,3695,"Dixon-Sterling, IL CSA"
2643,,,222,330,200333,93553,200333,200333,9365,190968,182712,134349,44795,754,2067,108,639,8256,93553,82570,10983,"Dothan-Ozark, AL CSA"
2644,,,232,330,217447,92347,217447,217447,5410,212037,204595,193657,2641,920,6775,110,492,7442,92347,86581,5766,"Eau Claire-Menomonie, WI CSA"
2645,,,233,330,134774,70303,134774,134774,38314,96460,92427,89271,667,454,1389,68,578,4033,70303,51151,19152,"Edwards-Glenwood Springs, CO CSA"
2646,,,236,330,177732,86312,177732,177732,4656,173076,164321,153897,6425,401,3042,27,529,8755,86312,74979,11333,"Elmira-Corning, NY CSA"
2647,,,238,330,1088420,408805,1088420,1088420,865059,223361,208559,159062,27593,3834,13160,1642,3268,14802,408805,379599,29206,"El Paso-Las Cruces, TX-NM CSA"
2648,,,240,330,354814,161854,354814,354814,13271,341543,326378,296527,21317,452,6723,84,1275,15165,161854,143301,18553,"Erie-Meadville, PA CSA"
2649,,,244,330,272878,122714,272878,272878,9978,262900,252169,224487,16098,3919,6929,115,621,10731,122714,113048,9666,"Fargo-Wahpeton, ND-MN CSA"
2650,,,246,330,834094,352728,834094,834094,99434,734660,691570,385596,227885,57588,14183,1968,4350,43090,352728,318379,34349,"Fayetteville-Sanford-Lumberton, NC CSA"
2651,,,258,330,645409,275577,645409,645409,45332,600077,575405,506840,45025,1446,19427,199,2468,24672,275577,252447,23130,"Fort Wayne-Huntington-Auburn, IN CSA"
2652,,,260,330,1317395,434300,1317395,1317395,720528,596867,557965,364649,56726,9502,118757,1686,6645,38902,434300,409003,25297,"Fresno-Madera-Hanford, CA CSA"
2653,,,264,330,408945,181495,408945,408945,44105,364840,346664,257260,66997,982,19106,141,2178,18176,181495,163454,18041,"Gainesville-Lake City, FL CSA"
2654,,,266,330,1423632,579116,1423632,1423632,131369,1292263,1232977,1092258,98598,4859,32372,363,4527,59286,579116,536326,42790,"Grand Rapids-Kentwood-Muskegon, MI CSA"
2655,,,267,330,373404,168428,373404,373404,29210,344194,330328,298489,8421,13705,8786,124,803,13866,168428,151507,16921,"Green Bay-Shawano, WI CSA"
2656,,,268,330,1695306,746124,1695306,1695306,188291,1507015,1445906,1030858,355274,5522,46747,644,6861,61109,746124,685951,60173,"Greensboro--Winston-Salem--High Point, NC CSA"
2657,,,272,330,270017,131182,270017,270017,20766,249251,240303,142850,92042,718,3552,132,1009,8948,131182,112376,18806,"Greenville-Kinston-Washington, NC CSA"
2658,,,273,330,1487610,650283,1487610,1487610,118398,1369212,1312751,1024514,250927,2960,28161,769,5420,56461,650283,587680,62603,"Greenville-Spartanburg-Anderson, SC CSA"
2659,,,276,330,1295259,544759,1295259,1295259,111636,1183623,1136537,999305,89070,1670,40859,394,5239,47086,544759,511880,32879,"Harrisburg-York-Lebanon, PA CSA"
2660,,,277,330,261004,109236,261004,261004,24899,236105,226877,207229,14238,379,4048,87,896,9228,109236,100590,8646,"Harrisonburg-Staunton, VA CSA"
2661,,,278,330,1482086,645335,1482086,1482086,218822,1263264,1205411,969974,145651,3539,77319,474,8454,57853,645335,597172,48163,"Hartford-East Hartford, CT CSA"
2662,,,279,330,255844,111157,255844,255844,10500,245344,238361,156118,78387,742,2272,110,732,6983,111157,99045,12112,"Hattiesburg-Laurel, MS CSA"
2663,,,284,330,133220,66505,133220,133220,8312,124908,117260,103460,11484,788,1074,82,372,7648,66505,55470,11035,"Hot Springs-Malvern, AR CSA"
2664,,,288,330,7312270,2821424,7312270,7312270,2724928,4587342,4379824,2495120,1240214,14877,590764,4551,34298,207518,2821424,2577581,243843,"Houston-The Woodlands, TX CSA"
2665,,,290,330,648217,281002,648217,648217,45456,602761,569688,426141,122865,4661,12949,606,2466,33073,281002,259893,21109,"Huntsville-Decatur, AL CSA"
2666,,,292,330,271722,96118,271722,271722,35653,236069,228344,218923,1513,3932,2682,454,840,7725,96118,86605,9513,"Idaho Falls-Rexburg-Blackfoot, ID CSA"
2667,,,294,330,2492514,1059844,2492514,2492514,199559,2292955,2194166,1763861,325444,4193,89056,915,10697,98789,1059844,977557,82287,"Indianapolis-Carmel-Muncie, IN CSA"
2668,,,296,330,152549,67698,152549,152549,8735,143814,135374,117538,5103,361,11505,41,826,8440,67698,60651,7047,"Ithaca-Cortland, NY CSA"
2669,,,297,330,198368,87492,198368,198368,9025,189343,183005,123275,57132,376,1548,35,639,6338,87492,79137,8355,"Jackson-Brownsville, TN CSA"
2670,,,298,330,671607,294830,671607,671607,17715,653892,638405,313822,313286,1016,8451,190,1640,15487,294830,263250,31580,"Jackson-Vicksburg-Brookhaven, MS CSA"
2671,,,300,330,1733937,749164,1733937,1733937,175326,1558611,1479066,1041199,354446,4326,67376,1643,10076,79545,749164,678287,70877,"Jacksonville-St. Marys-Palatka, FL-GA CSA"
2672,,,304,330,514899,245415,514899,514899,14462,500437,481193,462267,11918,1106,4287,115,1500,19244,245415,218496,26919,"Johnson City-Kingsport-Bristol, TN-VA CSA"
2673,,,306,330,207601,102108,207601,207601,3502,204099,197544,188424,7528,146,958,42,446,6555,102108,86578,15530,"Johnstown-Somerset, PA CSA"
2674,,,308,330,179932,76225,179932,179932,9152,170780,163033,138809,21030,499,1921,342,432,7747,76225,70148,6077,"Jonesboro-Paragould, AR CSA"
2675,,,309,330,211694,91023,211694,211694,16692,195002,179147,162789,3070,8808,2443,1461,576,15855,91023,82377,8646,"Joplin-Miami, MO-OK CSA"
2676,,,310,330,501781,221369,501781,501781,30212,471569,445435,383512,46426,1785,11378,105,2229,26134,221369,201649,19720,"Kalamazoo-Battle Creek-Portage, MI CSA"
2677,,,312,330,2528644,1085350,2528644,2528644,248275,2280369,2146102,1774128,271819,11755,73542,5163,9695,134267,1085350,1001294,84056,"Kansas City-Overland Park-Kansas City, MO-KS CSA"
2678,,,313,330,366206,134787,366206,366206,115990,250216,234264,215523,5205,2046,8958,865,1667,15952,134787,128199,6588,"Kennewick-Richland-Walla Walla, WA CSA"
2679,,,314,330,79323,39328,79323,79323,19364,59959,57704,55675,774,225,703,40,287,2255,39328,33546,5782,"Kerrville-Fredericksburg, TX CSA"
2680,,,315,330,1156861,531732,1156861,1156861,66883,1089978,1041733,963525,53639,2824,17373,733,3639,48245,531732,469628,62104,"Knoxville-Morristown-Sevierville, TN CSA"
2681,,,316,330,119620,54457,119620,119620,4246,115374,109879,99593,8208,490,1157,23,408,5495,54457,49059,5398,"Kokomo-Peru, IN CSA"
2682,,,318,330,610330,272072,610330,610330,32198,578132,560027,379660,165684,2520,10022,110,2031,18105,272072,240726,31346,"Lafayette-Opelousas-Morgan City, LA CSA"
2683,,,320,330,256906,108172,256906,256906,26434,230472,218486,191807,11455,463,13770,58,933,11986,108172,98938,9234,"Lafayette-West Lafayette-Frankfort, IN CSA"
2684,,,324,330,254652,111343,254652,254652,12315,242337,233273,167139,60026,1077,3910,142,979,9064,111343,98183,13160,"Lake Charles-Jennings, LA CSA"
2685,,,332,330,2317052,942847,2317052,2317052,709343,1607709,1480995,930115,276498,9107,233000,19094,13181,126714,942847,867651,75196,"Las Vegas-Henderson, NV CSA"
2686,,,336,330,746045,327315,746045,746045,47140,698905,666985,579143,66141,1157,17373,289,2882,31920,327315,300922,26393,"Lexington-Fayette--Richmond--Frankfort, KY CSA"
2687,,,338,330,220087,94864,220087,220087,6078,214009,205898,189553,13154,409,1354,659,769,8111,94864,87414,7450,"Lima-Van Wert-Celina, OH CSA"
2688,,,339,330,361921,152872,361921,361921,26975,334946,319565,288397,13593,1829,14131,177,1438,15381,152872,143726,9146,"Lincoln-Beatrice, NE CSA"
2689,,,340,330,912604,408738,912604,912604,58574,854030,812297,573352,217381,3259,14961,517,2827,41733,408738,368370,40368,"Little Rock-North Little Rock, AR CSA"
2690,,,348,330,18644680,6595294,18644680,18644680,8630090,10014590,9390117,5477462,1143781,46143,2577706,42591,102434,624473,6595294,6205567,389727,"Los Angeles-Long Beach, CA CSA"
2691,,,350,330,1512133,656295,1512133,1512133,93020,1419113,1351655,1102979,203595,3101,34440,1315,6225,67458,656295,608306,47989,"Louisville/Jefferson County--Elizabethtown--Bardstown, KY-IN CSA"
2692,,,352,330,375427,159957,375427,375427,144464,230963,220988,180475,27831,1640,9710,218,1114,9975,159957,142916,17041,"Lubbock-Plainview-Levelland, TX CSA"
2693,,,356,330,425416,182376,425416,425416,22820,402596,387435,208498,167554,824,8753,182,1624,15161,182376,164516,17860,"Macon-Bibb County--Warner Robins, GA CSA"
2694,,,357,330,910246,403390,910246,910246,65898,844348,807975,723585,39561,2770,38732,305,3022,36373,403390,380632,22758,"Madison-Janesville-Beloit, WI CSA"
2695,,,359,330,129478,54320,129478,129478,6192,123286,119424,110477,5663,388,2518,40,338,3862,54320,50891,3429,"Mankato-New Ulm, MN CSA"
2696,,,360,330,219408,96858,219408,219408,4115,215293,206778,192567,11904,314,1244,103,646,8515,96858,89072,7786,"Mansfield-Ashland-Bucyrus, OH CSA"
2697,,,361,330,95879,60919,95879,95879,2071,93808,90640,88573,360,1077,426,21,183,3168,60919,43181,17738,"Marinette-Iron Mountain, WI-MI CSA"
2698,,,362,330,63689,29259,63689,63689,2479,61210,58825,52549,5730,102,295,3,146,2385,29259,26301,2958,"Martin-Union City, TN CSA"
2699,,,364,330,222705,120005,222705,222705,220436,2269,2152,1616,232,10,156,1,137,117,120005,94167,25838,"Mayagüez-San Germán, PR CSA"
2700,,,365,330,936701,317882,936701,936701,864394,72307,69342,54509,3395,643,8704,78,2013,2965,317882,278410,39472,"McAllen-Edinburg, TX CSA"
2701,,,366,330,311349,134987,311349,311349,37436,273913,254645,242962,1942,2658,4163,931,1989,19268,134987,126491,8496,"Medford-Grants Pass, OR CSA"
2702,,,368,330,1360869,575495,1360869,1360869,95634,1265235,1223836,561999,621776,2398,32253,488,4922,41399,575495,525221,50274,"Memphis-Forrest City, TN-MS-AR CSA"
2703,,,370,330,6868652,3007747,6868652,6868652,2946345,3922307,3725541,2253408,1241568,7270,170470,1871,50954,196766,3007747,2637311,370436,"Miami-Port St. Lucie-Fort Lauderdale, FL CSA"
2704,,,372,330,340391,138509,340391,340391,175637,164754,157311,130290,17976,1276,6157,480,1132,7443,138509,120064,18445,"Midland-Odessa, TX CSA"
2705,,,376,330,2053232,905900,2053232,2053232,235796,1817436,1746607,1384314,277481,6468,70251,512,7581,70829,905900,841650,64250,"Milwaukee-Racine-Waukesha, WI CSA"
2706,,,378,330,4078788,1664221,4078788,4078788,265063,3813725,3636600,2971318,354985,21763,270324,1329,16881,177125,1664221,1583984,80237,"Minneapolis-St. Paul, MN-WI CSA"
2707,,,380,330,661964,316301,661964,661964,26249,635715,609353,423465,166754,6136,10558,340,2100,26362,316301,263187,53114,"Mobile-Daphne-Fairhope, AL CSA"
2708,,,384,330,255500,112595,255500,255500,8928,246572,238392,139607,94386,697,3085,44,573,8180,112595,99790,12805,"Monroe-Ruston, LA CSA"
2709,,,388,330,476207,218805,476207,476207,17375,458832,444731,225705,206606,992,9884,181,1363,14101,218805,190338,28467,"Montgomery-Selma-Alexander City, AL CSA"
2710,,,390,330,196243,91335,196243,196243,4878,191365,182462,169530,7913,335,4038,111,535,8903,91335,80553,10782,"Morgantown-Fairmont, WV CSA"
2711,,,393,330,119736,45370,119736,119736,55521,64215,60512,57079,675,893,1282,99,484,3703,45370,40306,5064,"Moses Lake-Othello, WA CSA"
2712,,,394,330,106155,44521,106155,106155,6159,99996,95834,87782,4271,2181,1277,45,278,4162,44521,39955,4566,"Mount Pleasant-Alma, MI CSA"
2713,,,396,330,551126,327948,551126,551126,33949,517177,496518,417631,68810,2028,5726,405,1918,20659,327948,238948,89000,"Myrtle Beach-Conway, SC-NC CSA"
2714,,,400,330,2118233,880654,2118233,2118233,204890,1913343,1828155,1464484,288042,4526,61665,925,8513,85188,880654,821234,59420,"Nashville-Davidson--Murfreesboro, TN CSA"
2715,,,404,330,189854,109399,189854,189854,11204,178650,170489,137362,27730,670,3725,218,784,8161,109399,80110,29289,"New Bern-Morehead City, NC CSA"
2716,,,406,330,1506610,674581,1506610,1506610,157875,1348735,1296537,768330,477758,4571,38204,431,7243,52198,674581,602861,71720,"New Orleans-Metairie-Hammond, LA-MS CSA"
2717,,,408,330,23582649,9401953,23582649,23582649,5723461,17859188,17111239,10769924,3388635,37780,2658294,6157,250449,747949,9401953,8703080,698873,"New York-Newark, NY-NJ-CT-PA CSA"
2718,,,412,330,1054539,585458,1054539,1054539,138305,916234,881876,795125,60385,1939,19595,485,4347,34358,585458,466435,119023,"North Port-Sarasota, FL CSA"
2719,,,416,330,1498149,637698,1498149,1498149,216834,1281315,1153434,894876,145491,58617,46580,1676,6194,127881,637698,579331,58367,"Oklahoma City-Shawnee, OK CSA"
2720,,,420,330,1004771,417136,1004771,1004771,117564,887207,844009,728644,73337,3965,33661,746,3656,43198,417136,390246,26890,"Omaha-Council Bluffs-Fremont, NE-IA CSA"
2721,,,422,330,4222422,1817344,4222422,4222422,1156861,3065561,2897214,2139535,564177,8092,149278,2573,33559,168347,1817344,1613489,203855,"Orlando-Lakeland-Deltona, FL CSA"
2722,,,424,330,135309,63582,135309,135309,5520,129789,123565,111711,10198,327,917,33,379,6224,63582,56562,7020,"Paducah-Mayfield, KY-IL CSA"
2723,,,425,330,149261,70993,149261,149261,1913,147348,141545,138380,1622,266,873,29,375,5803,70993,63657,7336,"Parkersburg-Marietta-Vienna, WV-OH CSA"
2724,,,426,330,546662,237928,546662,546662,33434,513228,482095,370484,89760,4598,13792,794,2667,31133,237928,212113,25815,"Pensacola-Ferry Pass, FL-AL CSA"
2725,,,428,330,7379700,3119160,7379700,7379700,863914,6515786,6245168,4381349,1366990,10711,446462,2027,37629,270618,3119160,2843987,275173,"Philadelphia-Reading-Camden, PA-NJ-DE-MD CSA"
2726,,,429,330,4899104,2018078,4899104,4899104,1482231,3416873,3228574,2630334,266190,94164,204627,10705,22554,188299,2018078,1812554,205524,"Phoenix-Mesa, AZ CSA"
2727,,,430,330,2657149,1257734,2657149,2657149,57921,2599228,2493762,2203220,207418,2769,69594,714,10047,105466,1257734,1143552,114182,"Pittsburgh-New Castle-Weirton, PA-OH-WV CSA"
2728,,,434,330,365233,172116,365233,365233,362849,2384,2199,1542,228,28,170,9,222,185,172116,144458,27658,"Ponce-Yauco-Coamo, PR CSA"
2729,,,438,330,662879,330425,662879,662879,14979,647900,621618,585886,20665,1707,10811,207,2342,26282,330425,278553,51872,"Portland-Lewiston-South Portland, ME CSA"
2730,,,440,330,3280736,1333284,3280736,3280736,472522,2808214,2604749,2269346,79739,23228,194785,20221,17430,203465,1333284,1263512,69772,"Portland-Vancouver-Salem, OR-WA CSA"
2731,,,444,330,217101,92224,217101,217101,75970,141131,133221,123240,4804,1937,1894,168,1178,7910,92224,84966,7258,"Pueblo-Cañon City, CO CSA"
2732,,,446,330,87490,38181,87490,87490,6125,81365,76299,69033,1481,529,4584,187,485,5066,38181,34713,3468,"Pullman-Moscow, WA-ID CSA"
2733,,,448,330,114649,52422,114649,114649,2064,112585,107815,102347,4126,215,704,53,370,4770,52422,46718,5704,"Quincy-Hannibal, IL-MO CSA"
2734,,,450,330,2106463,877771,2106463,2106463,258014,1848449,1765137,1182146,435200,5646,130660,732,10753,83312,877771,821071,56700,"Raleigh-Durham-Cary, NC CSA"
2735,,,452,330,164842,75673,164842,164842,7798,157044,147695,130972,1899,12197,1934,144,549,9349,75673,67718,7955,"Rapid City-Spearfish, SD CSA"
2736,,,454,330,247984,106721,247984,247984,37668,210316,194204,178234,2152,5214,6824,419,1361,16112,106721,97746,8975,"Redding-Red Bluff, CA CSA"
2737,,,456,330,657958,282470,657958,657958,153894,504064,469791,409470,13301,8790,31310,3617,3303,34273,282470,261215,21255,"Reno-Carson City-Fernley, NV CSA"
2738,,,458,330,89951,41638,89951,89951,2768,87183,83336,78703,3302,174,765,14,378,3847,41638,37129,4509,"Richmond-Connersville, IN CSA"
2739,,,462,330,266358,114230,266358,266358,16383,249975,240558,213463,12917,513,12514,330,821,9417,114230,106373,7857,"Rochester-Austin, MN CSA"
2740,,,464,330,1182337,531572,1182337,1182337,92973,1089364,1040768,874710,123223,2530,35721,262,4322,48596,531572,488472,43100,"Rochester-Batavia-Seneca Falls, NY CSA"
2741,,,466,330,435216,189141,435216,435216,61883,373333,354325,298449,44328,783,9140,86,1539,19008,189141,174622,14519,"Rockford-Freeport-Rochelle, IL CSA"
2742,,,468,330,288747,137770,288747,288747,20859,267888,259798,125668,128206,2618,2224,62,1020,8090,137770,119794,17976,"Rocky Mount-Wilson-Roanoke Rapids, NC CSA"
2743,,,472,330,2680831,1051146,2680831,2680831,598725,2082106,1913730,1322720,164343,14254,374935,21103,16375,168376,1051146,971304,79842,"Sacramento-Roseville, CA CSA"
2744,,,474,330,377474,171382,377474,377474,25493,351981,336695,293358,36088,1114,4621,168,1346,15286,171382,157735,13647,"Saginaw-Midland-Bay City, MI CSA"
2745,,,476,330,2924904,1304856,2924904,2924904,108070,2816834,2684088,2075945,507498,5582,82382,996,11685,132746,1304856,1190236,114620,"St. Louis-St. Charles-Farmington, MO-IL CSA"
2746,,,480,330,450577,269503,450577,450577,38814,411763,393953,306241,77053,1234,7478,121,1826,17810,269503,183458,86045,"Salisbury-Cambridge, MD-DE CSA"
2747,,,482,330,2701129,921854,2701129,2701129,434410,2266719,2163360,1998900,34227,13678,72970,32746,10839,103359,921854,865530,56324,"Salt Lake City-Provo-Orem, UT CSA"
2748,,,484,330,2576528,1022018,2576528,2576528,1403856,1172672,1100121,841727,166813,6254,71390,3339,10598,72551,1022018,930799,91219,"San Antonio-New Braunfels-Pearsall, TX CSA"
2749,,,488,330,9714023,3606733,9714023,9714023,2791085,6922938,6450436,3441092,517729,26248,2352258,52925,60184,472502,3606733,3410592,196141,"San Jose-San Francisco-Oakland, CA CSA"
2750,,,490,330,2358201,1140127,2358201,2358201,2330499,27702,25901,17948,3531,231,2264,72,1855,1801,1140127,964319,175808,"San Juan-Bayamón, PR CSA"
2751,,,496,330,597465,253353,597465,597465,46228,551237,526277,322749,183077,1406,15275,1078,2692,24960,253353,226610,26743,"Savannah-Hinesville-Statesboro, GA CSA"
2752,,,497,330,124187,55211,124187,124187,13425,110762,104354,99652,2643,1395,451,18,195,6408,55211,48878,6333,"Scottsboro-Fort Payne, AL CSA"
2753,,,500,330,4953421,2051279,4953421,4953421,551019,4402402,4041873,3009113,259789,42089,651643,49662,29577,360529,2051279,1929118,122161,"Seattle-Tacoma, WA CSA"
2754,,,508,330,430373,198151,430373,430373,20068,410305,394082,218385,166365,1846,5757,245,1484,16223,198151,175494,22657,"Shreveport-Bossier City-Minden, LA CSA"
2755,,,515,330,812199,357616,812199,812199,90284,721915,686397,595407,70828,2630,13907,356,3269,35518,357616,315276,42340,"South Bend-Elkhart-Mishawaka, IN-MI CSA"
2756,,,517,330,34087,21800,34087,34087,1110,32977,32185,31734,175,51,185,3,37,792,21800,15198,6602,"Spencer-Spirit Lake, IA CSA"
2757,,,518,330,757146,320997,757146,757146,45791,711355,664255,619635,11090,11135,14055,4481,3859,47100,320997,298553,22444,"Spokane-Spokane Valley-Coeur d'Alene, WA-ID CSA"
2758,,,522,330,308523,143160,308523,308523,8267,300256,287054,250883,29606,529,4983,76,977,13202,143160,129589,13571,"Springfield-Jacksonville-Lincoln, IL CSA"
2759,,,524,330,238734,103486,238734,238734,8288,230446,222874,203006,7066,198,11823,39,742,7572,103486,91792,11694,"State College-DuBois, PA CSA"
2760,,,525,330,38121,22602,38121,38121,4324,33797,32360,31555,230,165,221,37,152,1437,22602,15740,6862,"Steamboat Springs-Craig, CO CSA"
2761,,,532,330,738305,333024,738305,738305,34497,703808,668831,580278,59578,4056,22032,190,2697,34977,333024,299939,33085,"Syracuse-Auburn, NY CSA"
2762,,,534,330,835489,387363,835489,835489,59449,776040,740205,632099,91486,1308,12102,205,3005,35835,387363,347218,40145,"Toledo-Findlay-Tiffin, OH CSA"
2763,,,536,330,1091102,488861,1091102,1091102,412420,678682,640975,543987,36368,23748,30115,1950,4807,37707,488861,443691,45170,"Tucson-Nogales, AZ CSA"
2764,,,538,330,1134125,490248,1134125,1134125,126761,1007364,885879,669199,86853,95016,30040,1258,3513,121485,490248,443981,46267,"Tulsa-Muskogee-Bartlesville, OK CSA"
2765,,,539,330,198138,88776,198138,198138,6913,191225,185621,145746,37825,324,1290,54,382,5604,88776,78609,10167,"Tupelo-Corinth, MS CSA"
2766,,,540,330,283891,118377,283891,283891,59078,224813,215088,164547,44362,874,4392,95,818,9725,118377,106559,11818,"Tyler-Jacksonville, TX CSA"
2767,,,544,330,118437,53000,118437,118437,55077,63360,60908,51950,5826,266,2527,35,304,2452,53000,44880,8120,"Victoria-Port Lavaca, TX CSA"
2768,,,545,330,1890162,818589,1890162,1890162,139950,1750212,1647404,1004524,551112,5641,73397,2642,10088,102808,818589,739308,79281,"Virginia Beach-Norfolk, VA-NC CSA"
2769,,,548,330,9973383,4006033,9973383,9973383,1364717,8608666,8145631,4782033,2395036,18103,886459,5200,58800,463035,4006033,3749833,256200,"Washington-Baltimore-Arlington, DC-MD-VA-WV-PA CSA"
2770,,,554,330,311012,141559,311012,311012,9978,301034,291933,274784,2739,1445,12182,76,707,9101,141559,130366,11193,"Wausau-Stevens Point-Wisconsin Rapids, WI CSA"
2771,,,556,330,682159,290992,682159,682159,95488,586671,547359,466040,48135,5963,24033,739,2449,39312,290992,265620,25372,"Wichita-Winfield, KS CSA"
2772,,,558,330,151638,71228,151638,151638,3036,148602,142571,134620,6088,242,1134,34,453,6031,71228,61802,9426,"Williamsport-Lock Haven, PA CSA"
2773,,,566,330,643120,299302,643120,643120,21633,621487,595190,529181,59081,858,4079,115,1876,26297,299302,271167,28135,"Youngstown-Warren, OH-PA CSA"
2774,,,710,335,120779,60416,120779,120779,2476,118303,112926,109935,873,477,1232,32,377,5377,60416,52034,8382,"Augusta-Waterville, ME Combined NECTA"
2775,,,715,335,8202931,3485727,8202931,8202931,973533,7229398,6846030,5704128,480675,12843,543135,1895,103354,383368,3485727,3215853,269874,"Boston-Worcester-Providence, MA-RI-NH-CT-ME Combined NECTA"
2776,,,720,335,1939271,801422,1939271,1939271,383765,1555506,1484128,1161308,211934,2394,90132,451,17909,71378,801422,745620,55802,"Bridgeport-New Haven-Stamford, CT Combined NECTA"
2777,,,725,335,102976,50017,102976,102976,2764,100212,95111,90364,989,260,3014,23,461,5101,50017,43164,6853,"Lebanon-Claremont, NH-VT Combined NECTA"
2778,,,770,335,108541,56393,108541,108541,5940,102601,97534,91307,3815,129,1708,16,559,5067,56393,47958,8435,"Pittsfield-North Adams, MA-VT Combined NECTA"
2779,,,775,335,595178,288742,595178,595178,13507,581671,557801,523622,20215,1603,10098,178,2085,23870,288742,249605,39137,"Portland-Lewiston-South Portland, ME Combined NECTA"
2780,,,790,335,1965510,840139,1965510,1965510,339436,1626074,1554290,1274262,174458,2709,92099,529,10233,71784,840139,785946,54193,"Springfield-Hartford-East Hartford, MA-CT Combined NECTA"
2781,,,70450,350,21544,9889,21544,21544,1016,20528,19504,18993,218,34,178,4,77,1024,9889,8933,956,"Athol, MA Micropolitan NECTA"
2782,,,70600,350,79568,40878,79568,79568,1467,78101,74695,72853,485,311,759,23,264,3406,40878,34397,6481,"Augusta, ME Micropolitan NECTA"
2783,,,70750,350,134387,63667,134387,134387,2451,131936,126457,121612,1399,1256,1749,42,399,5479,63667,55995,7672,"Bangor, ME Metropolitan NECTA"
2784,,,70900,350,257646,180544,257646,257646,8874,248772,234156,218162,7047,1203,3466,68,4210,14616,180544,115691,64853,"Barnstable Town, MA Metropolitan NECTA"
2785,,,71050,350,43681,21284,43681,43681,1171,42510,40460,39275,384,96,452,9,244,2050,21284,19220,2064,"Barre, VT Micropolitan NECTA"
2786,,,71350,350,22544,10464,22544,22544,566,21978,20969,20329,290,50,234,4,62,1009,10464,9307,1157,"Bennington, VT Micropolitan NECTA"
2787,,,71500,350,14468,7721,14468,14468,435,14033,13541,12956,419,46,99,1,20,492,7721,6308,1413,"Berlin, NH Micropolitan NECTA"
2788,,,71650,350,5064479,2062287,5064479,5064479,601913,4462566,4225900,3363875,349409,5397,434500,1122,71597,236666,2062287,1950634,111653,"Boston-Cambridge-Newton, MA-NH Metropolitan NECTA"
2789,,,71950,350,930443,374522,930443,930443,184410,746033,713673,556933,99366,863,48194,166,8151,32360,374522,350549,23973,"Bridgeport-Stamford-Norwalk, CT Metropolitan NECTA"
2790,,,72250,350,65211,33988,65211,65211,1526,63685,60948,59069,680,164,784,10,241,2737,33988,28417,5571,"Brunswick, ME Micropolitan NECTA"
2791,,,72400,350,226149,100630,226149,226149,5886,220263,209761,195442,5148,624,7566,64,917,10502,100630,92819,7811,"Burlington-South Burlington, VT Metropolitan NECTA"
2792,,,72500,350,14467,6641,14467,14467,303,14164,13305,12941,81,62,172,3,46,859,6641,6065,576,"Claremont, NH Micropolitan NECTA"
2793,,,72700,350,83853,35218,83853,83853,2169,81684,78536,74114,1832,169,2049,19,353,3148,35218,33333,1885,"Concord, NH Micropolitan NECTA"
2794,,,72850,350,200720,80403,200720,200720,39251,161469,150529,128782,7926,159,9510,48,4104,10940,80403,74950,5453,"Danbury, CT Metropolitan NECTA"
2795,,,73050,350,143449,60798,143449,143449,4104,139345,133077,126203,1495,294,4583,45,457,6268,60798,56349,4449,"Dover-Durham, NH-ME Metropolitan NECTA"
2796,,,73300,350,37595,18249,37595,37595,2286,35309,33588,32313,555,73,445,6,196,1721,18249,16740,1509,"Greenfield Town, MA Micropolitan NECTA"
2797,,,73450,350,1110020,475737,1110020,1110020,178694,931326,890938,694150,125232,1467,63270,247,6572,40388,475737,445435,30302,"Hartford-East Hartford-Middletown, CT Metropolitan NECTA"
2798,,,73750,350,53198,25136,53198,53198,1234,51964,49791,48264,406,92,805,12,212,2173,25136,22153,2983,"Keene, NH Micropolitan NECTA"
2799,,,73900,350,31884,19064,31884,31884,756,31128,29845,29111,224,75,357,8,70,1283,19064,13888,5176,"Laconia, NH Micropolitan NECTA"
2800,,,74350,350,88509,43376,88509,88509,2461,86048,81806,77423,908,198,2842,20,415,4242,43376,37099,6277,"Lebanon, NH-VT Micropolitan NECTA"
2801,,,74500,350,162279,68398,162279,162279,25671,136608,129230,116782,6688,241,3877,37,1605,7378,68398,63699,4699,"Leominster-Gardner, MA Metropolitan NECTA"
2802,,,74650,350,118086,53826,118086,118086,2327,115759,110525,102307,6477,403,900,47,391,5234,53826,48171,5655,"Lewiston-Auburn, ME Metropolitan NECTA"
2803,,,74950,350,217347,89714,217347,217347,16467,200880,192166,176942,6710,369,7178,51,916,8714,89714,85949,3765,"Manchester, NH Metropolitan NECTA"
2804,,,75550,350,167853,73249,167853,167853,26791,141062,128957,116080,5988,377,2181,39,4292,12105,73249,67639,5610,"New Bedford, MA Metropolitan NECTA"
2805,,,75700,350,600964,259894,600964,600964,106304,494660,474813,363551,78987,967,28126,180,3002,19847,259894,239410,20484,"New Haven, CT Metropolitan NECTA"
2806,,,76150,350,24054,11630,24054,24054,1097,22957,21722,20350,589,31,618,1,133,1235,11630,9955,1675,"North Adams, MA-VT Micropolitan NECTA"
2807,,,76450,350,274262,128564,274262,274262,31123,243139,228920,199821,14423,2071,10981,227,1397,14219,128564,112984,15580,"Norwich-New London-Westerly, CT-RI Metropolitan NECTA"
2808,,,76600,350,84487,44763,84487,84487,4843,79644,75812,70957,3226,98,1090,15,426,3832,44763,38003,6760,"Pittsfield, MA Metropolitan NECTA"
2809,,,76750,350,387228,188807,387228,387228,9161,378067,363270,340025,12774,951,8008,114,1398,14797,188807,162750,26057,"Portland-South Portland, ME Metropolitan NECTA"
2810,,,76900,350,145726,71789,145726,145726,3669,142057,136895,132152,929,148,3070,57,539,5162,71789,62379,9410,"Portsmouth, NH-ME Metropolitan NECTA"
2811,,,77200,350,1362996,593419,1362996,1362996,202595,1160401,1095863,966826,64568,3782,46320,354,14013,64538,593419,547950,45469,"Providence-Warwick, RI-MA Metropolitan NECTA"
2812,,,77650,350,38450,21724,38450,38450,865,37585,35572,34690,331,105,329,14,103,2013,21724,17337,4387,"Rutland, VT Micropolitan NECTA"
2813,,,77950,350,24653,12121,24653,24653,493,24160,23058,22221,284,85,406,7,55,1102,12121,10267,1854,"Sanford, ME Micropolitan NECTA"
2814,,,78100,350,732168,307241,732168,732168,141546,590622,564396,487055,46508,984,26490,244,3115,26226,307241,288552,18689,"Springfield, MA-CT Metropolitan NECTA"
2815,,,78400,350,52584,25452,52584,52584,6320,46264,44009,41422,1216,88,1050,27,206,2255,25452,22914,2538,"Torrington, CT Micropolitan NECTA"
2816,,,78500,350,20530,17312,20530,20530,531,19999,18056,16169,792,202,184,9,700,1943,17312,8897,8415,"Vineyard Haven, MA Micropolitan NECTA"
2817,,,78700,350,207144,86603,207144,207144,53800,153344,145113,112042,25655,405,4302,57,2652,8231,86603,80711,5892,"Waterbury, CT Metropolitan NECTA"
2818,,,78850,350,41211,19538,41211,41211,1009,40202,38231,37082,388,166,473,9,113,1971,19538,17637,1901,"Waterville, ME Micropolitan NECTA"
2819,,,79300,350,33143,13460,33143,33143,10590,22553,21359,19322,947,97,844,5,144,1194,13460,12305,1155,"Willimantic, CT Micropolitan NECTA"
2820,,,79600,350,687324,282156,687324,687324,83612,603712,574978,491091,37062,1048,39959,136,5682,28734,282156,265758,16398,"Worcester, MA-CT Metropolitan NECTA"
2821,,,7165071634,355,2831498,1174411,2831498,2831498,309423,2522075,2393048,1782372,245864,2901,325825,686,35400,129027,1174411,1106903,67508,"Boston-Cambridge-Newton, MA NECTA Division"
2822,,,7165072104,355,203320,72531,203320,203320,16573,186747,164405,109990,41087,367,4424,47,8490,22342,72531,69727,2804,"Brockton-Bridgewater Town-Easton, MA NECTA Division"
2823,,,7165073104,355,280071,112129,280071,280071,28911,251160,231136,188228,8459,275,21865,40,12269,20024,112129,107274,4855,"Framingham, MA NECTA Division"
2824,,,7165073604,355,232301,98241,232301,232301,20705,211596,203644,195455,3469,282,3064,44,1330,7952,98241,92240,6001,"Haverhill-Newburyport-Amesbury Town, MA-NH NECTA Division"
2825,,,7165074204,355,203206,74797,203206,203206,92836,110370,106233,92463,5307,208,6902,22,1331,4137,74797,71727,3070,"Lawrence-Methuen Town-North Andover, MA-NH NECTA Division"
2826,,,7165074804,355,322768,122420,322768,322768,34242,288526,275720,211974,15482,270,44063,75,3856,12806,122420,117138,5282,"Lowell-Billerica-Chelmsford, MA-NH NECTA Division"
2827,,,7165074854,355,184619,74138,184619,184619,55219,129400,123144,99560,13007,199,8725,45,1608,6256,74138,70570,3568,"Lynn-Salem-Marblehead, MA NECTA Division"
2828,,,7165075404,355,301986,121953,301986,301986,20634,281352,269092,250904,4318,362,11523,81,1904,12260,121953,117770,4183,"Nashua, NH-MA NECTA Division"
2829,,,7165076524,355,213702,93027,213702,213702,12959,200743,192620,181742,4016,163,4565,35,2099,8123,93027,86365,6662,"Peabody-Beverly-Gloucester, MA NECTA Division"
2830,,,7165076684,355,131700,55595,131700,131700,3146,128554,123392,119020,1581,188,1361,19,1223,5162,55595,50673,4922,"Plymouth-Pembroke-Duxbury, MA NECTA Division"
2831,,,7165078254,355,159308,63045,159308,159308,7265,152043,143466,132167,6819,182,2183,28,2087,8577,63045,60247,2798,"Taunton-Middleborough-Norton, MA NECTA Division"
