,id,name,stco,subreg,H_Occ,H_Tot,H_Vac,P_18p,P_Asian,P_Black,P_Hisp,P_NonHisp,P_Other,P_Tot,P_Two,P_White,geotype,yr
0,09001,"Fairfield County, Connecticut",09001,CT,354084,378479,24395,743170,50751,99992,205351,752068,12263,957419,36937,552125,county,2020
1,09005,"Litchfield County, Connecticut",09005,CT,77502,87615,10113,151879,3434,2957,14580,170606,1262,185186,7352,155601,county,2020
2,09009,"New Haven County, Connecticut",09009,CT,343437,369178,25741,690994,36995,110273,170081,694754,7613,864835,30185,509688,county,2020
3,36005,"Bronx County, New York",36005,NYC,522450,547030,24580,1123075,67766,419393,806463,666191,19866,1472654,28370,130796,county,2020
4,36027,"Dutchess County, New York",36027,MHV,111927,122009,10082,239623,10635,30126,42224,253687,2410,295911,12021,198495,county,2020
5,36047,"Kings County, New York",36047,NYC,1009804,1077654,67850,2140371,370776,729696,516426,2219648,37579,2736074,113170,968427,county,2020
6,36059,"Nassau County, New York",36059,LI,455482,476732,21250,1098884,163165,147216,256425,1139349,13786,1395774,35728,779454,county,2020
7,36061,"New York County, New York",36061,NYC,817782,913926,96144,1461740,219624,199592,402640,1291611,16112,1694251,62989,793294,county,2020
8,36071,"Orange County, New York",36071,MHV,135746,146879,11133,299303,11665,41341,89744,311566,12870,401310,13842,231848,county,2020
9,36079,"Putnam County, New York",36079,LHV,35329,38308,2979,78270,2146,2425,17760,79908,653,97668,2742,71942,county,2020
10,36081,"Queens County, New York",36081,NYC,847210,896333,49123,1949469,656583,381375,667861,1737603,66175,2405464,84112,549358,county,2020
11,36085,"Richmond County, New York",36085,NYC,173202,183692,10490,389393,58753,46835,96960,398787,3900,495747,11318,277981,county,2020
12,36087,"Rockland County, New York",36087,LHV,102948,108068,5120,239516,20413,33775,66451,271878,3877,338329,7700,206113,county,2020
13,36103,"Suffolk County, New York",36103,LI,516872,578940,62068,1214412,65019,107268,332959,1192961,12822,1525920,40522,967330,county,2020
14,36105,"Sullivan County, New York",36105,MHV,30183,49125,18942,61786,1569,6069,14007,64617,786,78624,3502,52691,county,2020
15,36111,"Ulster County, New York",36111,MHV,73321,85853,12532,149457,3778,10152,21119,160732,1569,181851,8538,136695,county,2020
16,36119,"Westchester County, New York",36119,LHV,367296,388963,21667,782442,64907,131010,269334,735123,9818,1004457,31704,497684,county,2020
17,34003,"Bergen County, New Jersey",34003,INJ,350664,367383,16719,755234,157500,49909,204683,751049,7405,955732,24316,511919,county,2020
18,34013,"Essex County, New Jersey",34013,INJ,312913,334896,21983,661508,46957,324081,210353,653375,13485,863728,33727,235125,county,2020
19,34017,"Hudson County, New Jersey",34017,INJ,289408,312706,23298,582751,123424,71385,293019,431835,10512,724854,19984,206530,county,2020
20,34019,"Hunterdon County, New Jersey",34019,ONJ,48978,51687,2709,104020,5677,3030,10929,118018,635,128947,4009,104667,county,2020
21,34021,"Mercer County, New Jersey",34021,ONJ,139361,150442,11081,304672,48330,72364,84177,303163,2412,387340,11477,168580,county,2020
22,34023,"Middlesex County, New Jersey",34023,INJ,300547,315521,14974,680009,227973,78719,193687,669475,8428,863162,21197,333158,county,2020
23,34025,"Monmouth County, New Jersey",34025,ONJ,244630,268912,24282,511670,36008,39178,80730,562885,5145,643615,21729,460825,county,2020
24,34027,"Morris County, New Jersey",34027,INJ,188496,197722,9226,403593,57700,15586,76661,432624,2803,509285,15360,341175,county,2020
25,34029,"Ocean County, New Jersey",34029,ONJ,238812,294429,55617,482600,11339,17649,66329,570900,4533,637229,16801,520578,county,2020
26,34031,"Passaic County, New Jersey",34031,INJ,177075,185367,8292,403816,30209,51859,224030,300088,4254,524118,10224,203542,county,2020
27,34035,"Somerset County, New Jersey",34035,INJ,125598,131822,6224,271204,67098,30480,57379,287982,2390,345361,10603,177411,county,2020
28,34037,"Sussex County, New Jersey",34037,ONJ,55915,62709,6794,116445,2918,2858,14310,129911,868,144221,5020,118247,county,2020
29,34039,"Union County, New Jersey",34039,INJ,200372,209908,9536,440856,31963,112261,195519,379826,6820,575345,17537,211245,county,2020
30,34041,"Warren County, New Jersey",34041,ONJ,43327,46457,3130,87819,2886,5573,12225,97407,624,109632,4069,84255,county,2020
0,CT,Connecticut,,CT,775023,835272,60249,1586043,91180,213222,390012,1617428,21138,2007440,74474,1217414,subregion,2020
1,INJ,Inner New Jersey,,INJ,1945073,2055325,110252,4198971,742824,734280,1455331,3906254,56097,5361585,152948,2220105,subregion,2020
2,LHV,Lower Hudson Valley,,LHV,505573,535339,29766,1100228,87466,167210,353545,1086909,14348,1440454,42146,775739,subregion,2020
3,LI,Long Island,,LI,972354,1055672,83318,2313296,228184,254484,589384,2332310,26608,2921694,76250,1746784,subregion,2020
4,MHV,Mid Hudson Valley,,MHV,351177,403866,52689,750169,27647,87688,167094,790602,17635,957696,37903,619729,subregion,2020
5,NYC,New York City,,NYC,3370448,3618635,248187,7064048,1373502,1776891,2490350,6313840,143632,8804190,299959,2719856,subregion,2020
6,ONJ,Outer New Jersey,,ONJ,771023,874636,103613,1607226,107158,140652,268700,1782284,14217,2050984,63105,1457152,subregion,2020
0,36005CS,BX Central and South,36005,NYC,169664,176934,7270,370194,38360,121583,275049,213671,7689,488720,9834,36205,municipality,2020
1,36005NE,BX North and East,36005,NYC,102721,108236,5515,216423,8026,125441,87739,184807,4184,272546,6824,40332,municipality,2020
2,36005W,BX West,36005,NYC,250065,261860,11795,536458,21380,172369,443675,267713,7993,711388,11712,54259,municipality,2020
3,36047C,BK Central,36047,NYC,219831,233830,13999,478585,22709,360365,58718,536659,8666,595377,32568,112351,municipality,2020
4,36047E,BK East,36047,NYC,105312,111587,6275,229845,16180,162190,96051,207726,5680,303777,13746,9930,municipality,2020
5,36047N,BK North,36047,NYC,181849,196281,14432,372730,27094,90632,135560,330752,6608,466312,17963,188455,municipality,2020
6,36047S,BK Southern,36047,NYC,333754,353658,19904,721546,222461,72951,129656,817911,12537,947567,30650,479312,municipality,2020
7,36047W,BK West,36047,NYC,169058,182298,13240,337665,82332,43558,96441,326600,4088,423041,18243,178379,municipality,2020
8,36061E,MN East Side,36061,NYC,213958,243538,29580,347123,55392,12077,33055,362767,3343,395822,14885,277070,municipality,2020
9,36061L,MN Lower,36061,NYC,163598,182984,19386,293659,76373,18011,52885,281091,2988,333976,13396,170323,municipality,2020
10,36061U,MN Upper,36061,NYC,232977,247817,14840,476093,33681,142810,258287,313746,5991,572033,18636,112628,municipality,2020
11,36061WM,MN West Side and Midtown,36061,NYC,207249,239587,32338,344865,54178,26694,58413,334007,3790,392420,16072,233273,municipality,2020
12,36081NE,QN Northeast,36081,NYC,200522,211569,11047,457353,276442,27810,93934,464143,6103,558077,11465,142323,municipality,2020
13,36081NW,QN Northwest,36081,NYC,371899,394292,22393,810745,235705,40649,381069,609265,11786,990334,25659,295466,municipality,2020
14,36081SE,QN Southeast,36081,NYC,185459,196342,10883,455210,77796,284721,98648,476151,22313,574799,28505,62816,municipality,2020
15,36081SW,QN Southwest,36081,NYC,89330,94130,4800,226161,66640,28195,94210,188044,25973,282254,18483,48753,municipality,2020
16,36085C,SI Central,36085,NYC,48976,51972,2996,112691,25915,4948,20379,121197,1065,141576,2850,86419,municipality,2020
17,36085N,SI North,36085,NYC,64940,69066,4126,145447,20632,40093,58955,130708,1995,189663,5428,62560,municipality,2020
18,36085S,SI South,36085,NYC,59286,62654,3368,131255,12206,1794,17626,146882,840,164508,3040,129002,municipality,2020
0,900104720,"Bethel town, Fairfield County, Connecticut",9001,CT,7653,7980,327,15901,1213,565,2622,17736,426,20358,1123,14409,municipality,2020
1,900108070,"Bridgeport town, Fairfield County, Connecticut",9001,CT,54261,58874,4613,113716,4024,48690,62853,85801,3197,148654,5486,24404,municipality,2020
2,900108980,"Brookfield town, Fairfield County, Connecticut",9001,CT,6695,7116,421,13824,946,299,1470,16058,193,17528,835,13785,municipality,2020
3,900118500,"Danbury town, Fairfield County, Connecticut",9001,CT,31762,33562,1800,68248,5339,5630,28690,57828,3075,86518,5821,37963,municipality,2020
4,900118850,"Darien town, Fairfield County, Connecticut",9001,CT,6814,7265,451,14668,1197,148,1234,20265,109,21499,795,18016,municipality,2020
5,900123890,"Easton town, Fairfield County, Connecticut",9001,CT,2605,2756,151,5790,328,106,444,7161,41,7605,278,6408,municipality,2020
6,900126620,"Fairfield town, Fairfield County, Connecticut",9001,CT,20820,21982,1162,47703,2906,1110,4806,56706,446,61512,2209,50035,municipality,2020
7,900133620,"Greenwich town, Fairfield County, Connecticut",9001,CT,23316,25677,2361,47939,4726,1157,8135,55383,654,63518,2969,45877,municipality,2020
8,900148620,"Monroe town, Fairfield County, Connecticut",9001,CT,6690,6918,228,14549,660,400,1470,17355,109,18825,638,15548,municipality,2020
9,900150580,"New Canaan town, Fairfield County, Connecticut",9001,CT,6923,7502,579,14574,1159,244,1121,19501,98,20622,831,17169,municipality,2020
10,900150860,"New Fairfield town, Fairfield County, Connecticut",9001,CT,4948,5635,687,10729,230,153,1201,12378,112,13579,445,11438,municipality,2020
11,900152980,"Newtown town, Fairfield County, Connecticut",9001,CT,9766,10322,556,21295,734,592,1757,25416,158,27173,982,22950,municipality,2020
12,900156060,"Norwalk town, Fairfield County, Connecticut",9001,CT,36078,38152,2074,72682,4772,11074,27629,63555,768,91184,2627,44314,municipality,2020
13,900163480,"Redding town, Fairfield County, Connecticut",9001,CT,3356,3664,308,6918,243,75,465,8300,72,8765,330,7580,municipality,2020
14,900163970,"Ridgefield town, Fairfield County, Connecticut",9001,CT,8968,9506,538,18659,1261,214,1506,23527,181,25033,915,20956,municipality,2020
15,900168170,"Shelton town, Fairfield County, Connecticut",9001,CT,16356,17174,818,33739,1800,1812,4080,36789,328,40869,1148,31701,municipality,2020
16,900168310,"Sherman town, Fairfield County, Connecticut",9001,CT,1425,1834,409,2925,51,25,159,3368,7,3527,136,3149,municipality,2020
17,900173070,"Stamford town, Fairfield County, Connecticut",9001,CT,53241,56953,3712,108715,11453,16201,37958,97512,1180,135470,3802,64876,municipality,2020
18,900174190,"Stratford town, Fairfield County, Connecticut",9001,CT,20435,21643,1208,41976,1310,9136,11107,41248,476,52355,1919,28407,municipality,2020
19,900177200,"Trumbull town, Fairfield County, Connecticut",9001,CT,12622,13159,537,27767,2509,1642,3505,33322,300,36827,1219,27652,municipality,2020
20,900183430,"Weston town, Fairfield County, Connecticut",9001,CT,3420,3671,251,7470,575,143,631,9723,81,10354,481,8443,municipality,2020
21,900183500,"Westport town, Fairfield County, Connecticut",9001,CT,9720,10567,847,19943,1703,375,1592,25549,167,27141,1135,22169,municipality,2020
22,900186370,"Wilton town, Fairfield County, Connecticut",9001,CT,6210,6567,357,13440,1612,201,916,17587,85,18503,813,14876,municipality,2020
23,900502760,"Barkhamsted town, Litchfield County, Connecticut",9005,CT,1457,1566,109,2964,26,11,84,3563,17,3647,127,3382,municipality,2020
24,900504930,"Bethlehem town, Litchfield County, Connecticut",9005,CT,1398,1605,207,2854,22,31,104,3281,16,3385,108,3104,municipality,2020
25,900508210,"Bridgewater town, Litchfield County, Connecticut",9005,CT,728,863,135,1455,10,14,41,1621,9,1662,68,1520,municipality,2020
26,900510940,"Canaan town, Litchfield County, Connecticut",9005,CT,480,639,159,898,1,15,56,1024,10,1080,23,975,municipality,2020
27,900516050,"Colebrook town, Litchfield County, Connecticut",9005,CT,584,694,110,1160,4,5,31,1330,9,1361,55,1257,municipality,2020
28,900517240,"Cornwall town, Litchfield County, Connecticut",9005,CT,732,1002,270,1355,24,4,61,1506,6,1567,39,1433,municipality,2020
29,900532290,"Goshen town, Litchfield County, Connecticut",9005,CT,1285,1708,423,2607,32,16,120,3030,7,3150,106,2869,municipality,2020
30,900537280,"Harwinton town, Litchfield County, Connecticut",9005,CT,2179,2313,134,4371,31,35,172,5312,21,5484,180,5045,municipality,2020
31,900540290,"Kent town, Litchfield County, Connecticut",9005,CT,1285,1687,402,2538,85,31,156,2863,31,3019,130,2586,municipality,2020
32,900543370,"Litchfield town, Litchfield County, Connecticut",9005,CT,3467,3966,499,6859,114,51,276,7916,25,8192,263,7463,municipality,2020
33,900549460,"Morris town, Litchfield County, Connecticut",9005,CT,933,1253,320,1874,14,12,67,2189,6,2256,64,2093,municipality,2020
34,900551350,"New Hartford town, Litchfield County, Connecticut",9005,CT,2681,2968,287,5413,75,18,177,6481,40,6658,243,6105,municipality,2020
35,900552630,"New Milford town, Litchfield County, Connecticut",9005,CT,10994,11928,934,22380,958,639,3241,24874,320,28115,1442,21515,municipality,2020
36,900553470,"Norfolk town, Litchfield County, Connecticut",9005,CT,715,932,217,1329,18,8,48,1540,6,1588,59,1449,municipality,2020
37,900554030,"North Canaan town, Litchfield County, Connecticut",9005,CT,1399,1582,183,2654,15,36,266,2945,16,3211,131,2747,municipality,2020
38,900560750,"Plymouth town, Litchfield County, Connecticut",9005,CT,4856,5151,295,9619,145,141,739,10932,45,11671,544,10057,municipality,2020
39,900565930,"Roxbury town, Litchfield County, Connecticut",9005,CT,979,1163,184,1930,29,9,70,2190,11,2260,88,2053,municipality,2020
40,900566420,"Salisbury town, Litchfield County, Connecticut",9005,CT,1717,2519,802,3431,78,80,197,3997,44,4194,152,3643,municipality,2020
41,900567960,"Sharon town, Litchfield County, Connecticut",9005,CT,1238,1724,486,2338,44,35,98,2582,30,2680,83,2390,municipality,2020
42,900575730,"Thomaston town, Litchfield County, Connecticut",9005,CT,3145,3340,195,6083,91,58,340,7102,40,7442,276,6637,municipality,2020
43,900576570,"Torrington town, Litchfield County, Connecticut",9005,CT,15490,17040,1550,28966,891,1060,5433,30082,226,35515,1597,26308,municipality,2020
44,900579510,"Warren town, Litchfield County, Connecticut",9005,CT,580,790,210,1106,14,1,56,1295,12,1351,57,1211,municipality,2020
45,900579720,"Washington town, Litchfield County, Connecticut",9005,CT,1526,2056,530,3033,49,24,219,3427,29,3646,108,3217,municipality,2020
46,900580490,"Watertown town, Litchfield County, Connecticut",9005,CT,8742,9137,395,17955,399,399,1390,20715,145,22105,651,19121,municipality,2020
47,900586440,"Winchester town, Litchfield County, Connecticut",9005,CT,4661,5405,744,8553,124,116,684,9540,65,10224,423,8812,municipality,2020
48,900587910,"Woodbury town, Litchfield County, Connecticut",9005,CT,4251,4584,333,8154,141,108,454,9269,76,9723,335,8609,municipality,2020
49,900900000,"County subdivisions not defined, New Haven County, Connecticut",9009,CT,0,0,0,0,0,0,0,0,0,0,0,0,municipality,2020
50,900901220,"Ansonia town, New Haven County, Connecticut",9009,CT,7570,8104,534,14944,382,2474,4493,14425,141,18918,740,10688,municipality,2020
51,900903250,"Beacon Falls town, New Haven County, Connecticut",9009,CT,2485,2618,133,4884,84,124,413,5587,52,6000,201,5126,municipality,2020
52,900904580,"Bethany town, New Haven County, Connecticut",9009,CT,1948,2039,91,4255,248,101,182,5115,28,5297,177,4561,municipality,2020
53,900907310,"Branford town, New Haven County, Connecticut",9009,CT,13069,14180,1111,24215,1311,654,1862,26411,172,28273,847,23427,municipality,2020
54,900914160,"Cheshire town, New Haven County, Connecticut",9009,CT,10041,10401,360,22743,1788,1226,1818,26915,119,28733,900,22882,municipality,2020
55,900919550,"Derby town, New Haven County, Connecticut",9009,CT,5408,5759,351,9986,336,1373,2544,9781,87,12325,390,7595,municipality,2020
56,900922910,"East Haven town, New Haven County, Connecticut",9009,CT,11635,12394,759,23293,1066,1262,5054,22869,141,27923,744,19656,municipality,2020
57,900934950,"Guilford town, New Haven County, Connecticut",9009,CT,8813,9693,880,17617,781,202,1135,20938,74,22073,796,19085,municipality,2020
58,900935650,"Hamden town, New Haven County, Connecticut",9009,CT,23988,25984,1996,50658,3447,14834,7836,53333,505,61169,2163,32384,municipality,2020
59,900944560,"Madison town, New Haven County, Connecticut",9009,CT,6987,8060,1073,14170,562,127,641,17050,83,17691,573,15705,municipality,2020
60,900946520,"Meriden town, New Haven County, Connecticut",9009,CT,24346,26177,1831,47541,1311,5565,22295,38555,404,60850,2171,29104,municipality,2020
61,900946940,"Middlebury town, New Haven County, Connecticut",9009,CT,2859,3047,188,5926,377,67,332,7242,34,7574,204,6560,municipality,2020
62,900947535,"Milford town, New Haven County, Connecticut",9009,CT,22338,23749,1411,43544,2840,1531,4111,47933,334,52044,1811,41417,municipality,2020
63,900949950,"Naugatuck town, New Haven County, Connecticut",9009,CT,12432,13239,807,24872,749,2195,4871,26648,599,31519,1739,21366,municipality,2020
64,900952070,"New Haven town, New Haven County, Connecticut",9009,CT,52263,57525,5262,105010,9044,40788,41068,92955,1273,134023,4840,37010,municipality,2020
65,900953890,"North Branford town, New Haven County, Connecticut",9009,CT,5323,5633,310,11085,234,145,670,12874,40,13544,318,12137,municipality,2020
66,900954870,"North Haven town, New Haven County, Connecticut",9009,CT,9546,9981,435,19771,1468,889,1490,22763,136,24253,639,19631,municipality,2020
67,900957600,"Orange town, New Haven County, Connecticut",9009,CT,5282,5480,198,11239,1458,259,715,13565,69,14280,453,11326,municipality,2020
68,900958300,"Oxford town, New Haven County, Connecticut",9009,CT,4774,5022,248,10182,218,128,681,12025,57,12706,368,11254,municipality,2020
69,900962290,"Prospect town, New Haven County, Connecticut",9009,CT,3627,3762,135,7583,94,206,426,8975,45,9401,299,8331,municipality,2020
70,900967610,"Seymour town, New Haven County, Connecticut",9009,CT,6779,7112,333,13486,421,668,1752,14996,92,16748,517,13298,municipality,2020
71,900969640,"Southbury town, New Haven County, Connecticut",9009,CT,8587,9270,683,16530,556,200,830,19049,96,19879,572,17625,municipality,2020
72,900978740,"Wallingford town, New Haven County, Connecticut",9009,CT,18104,18938,834,36256,1809,842,4770,39626,235,44396,1343,35397,municipality,2020
73,900980070,"Waterbury town, New Haven County, Connecticut",9009,CT,44425,48392,3967,86056,2349,22269,45281,69122,2137,114403,4607,37760,municipality,2020
74,900982870,"West Haven town, New Haven County, Connecticut",9009,CT,21409,22735,1326,45116,2609,11485,13177,42407,477,55584,1876,25960,municipality,2020
75,900987560,"Wolcott town, New Haven County, Connecticut",9009,CT,6141,6408,267,13063,250,395,1087,15055,102,16142,530,13778,municipality,2020
76,900987700,"Woodbridge town, New Haven County, Connecticut",9009,CT,3258,3476,218,6969,1203,264,547,8540,81,9087,367,6625,municipality,2020
77,3400300700,"Allendale borough, Bergen County, New Jersey",34003,INJ,2327,2450,123,5219,837,42,456,6392,25,6848,227,5261,municipality,2020
78,3400301090,"Alpine borough, Bergen County, New Jersey",34003,INJ,587,676,89,1403,593,54,121,1641,5,1762,40,949,municipality,2020
79,3400305170,"Bergenfield borough, Bergen County, New Jersey",34003,INJ,9097,9387,290,21956,7222,1894,9121,19200,274,28321,532,9278,municipality,2020
80,3400306490,"Bogota borough, Bergen County, New Jersey",34003,INJ,2939,3026,87,6984,748,585,4506,4272,110,8778,215,2614,municipality,2020
81,3400310480,"Carlstadt borough, Bergen County, New Jersey",34003,INJ,2429,2563,134,5202,608,132,1582,4790,51,6372,144,3855,municipality,2020
82,3400313570,"Cliffside Park borough, Bergen County, New Jersey",34003,INJ,10735,11435,700,21106,3784,656,8954,16739,382,25693,732,11185,municipality,2020
83,3400313810,"Closter borough, Bergen County, New Jersey",34003,INJ,2762,2891,129,6451,3009,83,725,7869,32,8594,249,4496,municipality,2020
84,3400315820,"Cresskill borough, Bergen County, New Jersey",34003,INJ,3015,3157,142,6768,2865,90,630,8525,41,9155,224,5305,municipality,2020
85,3400317530,"Demarest borough, Bergen County, New Jersey",34003,INJ,1598,1680,82,3692,1562,41,270,4711,26,4981,141,2941,municipality,2020
86,3400318400,"Dumont borough, Bergen County, New Jersey",34003,INJ,6408,6572,164,14251,3081,503,3883,13980,107,17863,442,9847,municipality,2020
87,3400319510,"East Rutherford borough, Bergen County, New Jersey",34003,INJ,4306,4585,279,8234,1612,456,2556,7466,129,10022,241,5028,municipality,2020
88,3400320020,"Edgewater borough, Bergen County, New Jersey",34003,INJ,6742,7315,573,11617,5071,772,1959,12377,101,14336,499,5934,municipality,2020
89,3400321300,"Elmwood Park borough, Bergen County, New Jersey",34003,INJ,7652,7949,297,17199,2367,1494,5898,15524,263,21422,472,10928,municipality,2020
90,3400321450,"Emerson borough, Bergen County, New Jersey",34003,INJ,2482,2600,118,5755,709,108,948,6342,19,7290,178,5328,municipality,2020
91,3400321480,"Englewood city, Bergen County, New Jersey",34003,INJ,10909,11563,654,23213,2863,7180,9639,19669,369,29308,760,8497,municipality,2020
92,3400321510,"Englewood Cliffs borough, Bergen County, New Jersey",34003,INJ,1846,1961,115,4229,2534,107,341,5001,21,5342,138,2201,municipality,2020
93,3400322470,"Fair Lawn borough, Bergen County, New Jersey",34003,INJ,12243,12649,406,27012,4468,784,5369,29558,224,34927,777,23305,municipality,2020
94,3400322560,"Fairview borough, Bergen County, New Jersey",34003,INJ,5021,5291,270,11686,694,240,10018,5007,265,15025,295,3513,municipality,2020
95,3400324420,"Fort Lee borough, Bergen County, New Jersey",34003,INJ,18451,19861,1410,33322,16949,1192,5376,34815,266,40191,920,15488,municipality,2020
96,3400324990,"Franklin Lakes borough, Bergen County, New Jersey",34003,INJ,3722,4051,329,8563,1051,172,786,10293,53,11079,262,8755,municipality,2020
97,3400325770,"Garfield city, Bergen County, New Jersey",34003,INJ,11773,12407,634,25237,985,1684,12781,19874,276,32655,531,16398,municipality,2020
98,3400326640,"Glen Rock borough, Bergen County, New Jersey",34003,INJ,3934,4041,107,8691,1617,163,848,11285,26,12133,442,9037,municipality,2020
99,3400328680,"Hackensack city, Bergen County, New Jersey",34003,INJ,19132,20290,1158,37982,4734,9558,19220,26810,504,46030,961,11053,municipality,2020
100,3400330150,"Harrington Park borough, Bergen County, New Jersey",34003,INJ,1594,1643,49,3588,1049,35,299,4442,14,4741,109,3235,municipality,2020
101,3400330420,"Hasbrouck Heights borough, Bergen County, New Jersey",34003,INJ,4535,4715,180,9672,1421,333,2551,9574,81,12125,273,7466,municipality,2020
102,3400330540,"Haworth borough, Bergen County, New Jersey",34003,INJ,1104,1148,44,2553,545,51,191,3152,12,3343,128,2416,municipality,2020
103,3400331920,"Hillsdale borough, Bergen County, New Jersey",34003,INJ,3502,3635,133,7819,742,115,1138,9005,51,10143,236,7861,municipality,2020
104,3400332310,"Ho-Ho-Kus borough, Bergen County, New Jersey",34003,INJ,1416,1473,57,3099,321,26,302,3956,20,4258,114,3475,municipality,2020
105,3400340020,"Leonia borough, Bergen County, New Jersey",34003,INJ,3359,3476,117,7277,3876,202,1669,7635,34,9304,267,3256,municipality,2020
106,3400340680,"Little Ferry borough, Bergen County, New Jersey",34003,INJ,4351,4527,176,9052,2717,469,3468,7519,100,10987,221,4012,municipality,2020
107,3400341100,"Lodi borough, Bergen County, New Jersey",34003,INJ,9971,10414,443,21004,2194,2020,10838,15368,215,26206,526,10413,municipality,2020
108,3400342090,"Lyndhurst township, Bergen County, New Jersey",34003,INJ,9069,9516,447,18388,1587,688,6081,16438,232,22519,543,13388,municipality,2020
109,3400342750,"Mahwah township, Bergen County, New Jersey",34003,INJ,9727,10109,382,21363,2830,686,2204,23283,198,25487,729,18840,municipality,2020
110,3400344880,"Maywood borough, Bergen County, New Jersey",34003,INJ,3717,3829,112,8080,1442,605,2567,7513,96,10080,227,5143,municipality,2020
111,3400346110,"Midland Park borough, Bergen County, New Jersey",34003,INJ,2750,2887,137,5585,241,70,734,6280,40,7014,180,5749,municipality,2020
112,3400347610,"Montvale borough, Bergen County, New Jersey",34003,INJ,3016,3115,99,6492,1324,121,683,7753,18,8436,221,6069,municipality,2020
113,3400347700,"Moonachie borough, Bergen County, New Jersey",34003,INJ,1120,1149,29,2486,351,20,1292,1841,27,3133,52,1391,municipality,2020
114,3400351660,"New Milford borough, Bergen County, New Jersey",34003,INJ,6276,6432,156,13576,3420,796,3304,13619,145,16923,428,8830,municipality,2020
115,3400352320,"North Arlington borough, Bergen County, New Jersey",34003,INJ,6525,6749,224,13447,1173,257,5109,11348,175,16457,498,9245,municipality,2020
116,3400353430,"Northvale borough, Bergen County, New Jersey",34003,INJ,1641,1700,59,3761,1278,55,569,4192,13,4761,132,2714,municipality,2020
117,3400353610,"Norwood borough, Bergen County, New Jersey",34003,INJ,1943,2032,89,4430,1809,74,418,5223,12,5641,132,3196,municipality,2020
118,3400353850,"Oakland borough, Bergen County, New Jersey",34003,INJ,4356,4561,205,9951,605,119,1210,11538,43,12748,401,10370,municipality,2020
119,3400354870,"Old Tappan borough, Bergen County, New Jersey",34003,INJ,1982,2083,101,4550,1600,59,380,5508,18,5888,158,3673,municipality,2020
120,3400354990,"Oradell borough, Bergen County, New Jersey",34003,INJ,2782,2850,68,6295,1277,73,734,7510,46,8244,225,5889,municipality,2020
121,3400355770,"Palisades Park borough, Bergen County, New Jersey",34003,INJ,7314,7668,354,16938,11900,262,4862,15430,109,20292,256,2903,municipality,2020
122,3400355950,"Paramus borough, Bergen County, New Jersey",34003,INJ,8448,8786,338,21591,6966,459,2810,23888,138,26698,769,15556,municipality,2020
123,3400356130,"Park Ridge borough, Bergen County, New Jersey",34003,INJ,3310,3435,125,7111,631,91,936,7947,35,8883,218,6972,municipality,2020
124,3400361680,"Ramsey borough, Bergen County, New Jersey",34003,INJ,5488,5670,182,11422,1134,127,1374,13424,69,14798,383,11711,municipality,2020
125,3400362910,"Ridgefield borough, Bergen County, New Jersey",34003,INJ,4050,4237,187,9330,3319,200,3343,8158,121,11501,237,4281,municipality,2020
126,3400362940,"Ridgefield Park village, Bergen County, New Jersey",34003,INJ,4986,5269,283,10601,1460,649,6189,7035,102,13224,347,4477,municipality,2020
127,3400363000,"Ridgewood village, Bergen County, New Jersey",34003,INJ,8490,8814,324,18458,4556,353,2069,23910,118,25979,1097,17786,municipality,2020
128,3400363360,"River Edge borough, Bergen County, New Jersey",34003,INJ,4191,4337,146,9064,3434,283,1339,10710,58,12049,286,6649,municipality,2020
129,3400363690,"River Vale township, Bergen County, New Jersey",34003,INJ,3536,3644,108,7717,993,117,731,9178,39,9909,273,7756,municipality,2020
130,3400363990,"Rochelle Park township, Bergen County, New Jersey",34003,INJ,2151,2227,76,4811,602,208,1575,4239,31,5814,144,3254,municipality,2020
131,3400364170,"Rockleigh borough, Bergen County, New Jersey",34003,INJ,69,81,12,350,27,10,33,374,1,407,9,327,municipality,2020
132,3400365280,"Rutherford borough, Bergen County, New Jersey",34003,INJ,7061,7370,309,15044,2688,631,3395,15439,157,18834,721,11242,municipality,2020
133,3400365340,"Saddle Brook township, Bergen County, New Jersey",34003,INJ,5378,5618,240,11586,1219,442,2748,11546,70,14294,261,9554,municipality,2020
134,3400365400,"Saddle River borough, Bergen County, New Jersey",34003,INJ,1246,1458,212,2801,451,65,181,3191,27,3372,98,2550,municipality,2020
135,3400368970,"South Hackensack township, Bergen County, New Jersey",34003,INJ,922,950,28,2124,172,135,1256,1445,19,2701,51,1068,municipality,2020
136,3400372360,"Teaneck township, Bergen County, New Jersey",34003,INJ,13784,14430,646,31768,4378,9180,8848,32398,644,41246,1351,16845,municipality,2020
137,3400372420,"Tenafly borough, Bergen County, New Jersey",34003,INJ,4913,5184,271,10863,4711,240,1137,14272,107,15409,495,8719,municipality,2020
138,3400372480,"Teterboro borough, Bergen County, New Jersey",34003,INJ,25,26,1,44,1,7,25,36,0,61,2,26,municipality,2020
139,3400375140,"Upper Saddle River borough, Bergen County, New Jersey",34003,INJ,2658,2785,127,6252,1240,129,579,7774,35,8353,250,6120,municipality,2020
140,3400376400,"Waldwick borough, Bergen County, New Jersey",34003,INJ,3577,3691,114,7680,640,126,1315,8743,37,10058,239,7701,municipality,2020
141,3400376490,"Wallington borough, Bergen County, New Jersey",34003,INJ,4825,5108,283,9712,694,320,2299,9569,108,11868,161,8286,municipality,2020
142,3400377135,"Washington township, Bergen County, New Jersey",34003,INJ,3278,3375,97,7352,566,87,800,8485,35,9285,212,7585,municipality,2020
143,3400380270,"Westwood borough, Bergen County, New Jersey",34003,INJ,4515,4716,201,8982,928,448,1651,9631,45,11282,349,7861,municipality,2020
144,3400382300,"Woodcliff Lake borough, Bergen County, New Jersey",34003,INJ,2114,2235,121,4695,536,46,407,5721,31,6128,153,4955,municipality,2020
145,3400382570,"Wood-Ridge borough, Bergen County, New Jersey",34003,INJ,3920,4057,137,8131,1617,337,1738,8399,80,10137,224,6141,municipality,2020
146,3400383050,"Wyckoff township, Bergen County, New Jersey",34003,INJ,5569,5769,200,12567,872,93,1315,15270,30,16585,508,13767,municipality,2020
147,3401304695,"Belleville township, Essex County, New Jersey",34013,INJ,14282,14970,688,30732,4201,3092,19181,19041,585,38222,853,10310,municipality,2020
148,3401306260,"Bloomfield township, Essex County, New Jersey",34013,INJ,20810,21714,904,42750,4495,9941,16197,36908,801,53105,2003,19668,municipality,2020
149,3401309250,"Caldwell borough, Essex County, New Jersey",34013,INJ,3538,3669,131,7479,545,419,1313,7714,63,9027,216,6471,municipality,2020
150,3401311200,"Cedar Grove township, Essex County, New Jersey",34013,INJ,4754,5042,288,10510,1016,305,1465,11515,85,12980,355,9754,municipality,2020
151,3401313045,"City of Orange township, Essex County, New Jersey",34013,INJ,12788,13590,802,26070,262,21627,9983,24464,354,34447,1148,1073,municipality,2020
152,3401319390,"East Orange city, Essex County, New Jersey",34013,INJ,27410,30357,2947,53596,501,54689,9032,60580,740,69612,3262,1388,municipality,2020
153,3401321840,"Essex Fells borough, Essex County, New Jersey",34013,INJ,750,806,56,1677,104,24,137,2107,4,2244,86,1889,municipality,2020
154,3401322385,"Fairfield township, Essex County, New Jersey",34013,INJ,2747,2826,79,6179,355,38,733,7139,25,7872,159,6562,municipality,2020
155,3401326610,"Glen Ridge borough, Essex County, New Jersey",34013,INJ,2529,2592,63,5441,587,289,558,7244,48,7802,495,5825,municipality,2020
156,3401334450,"Irvington township, Essex County, New Jersey",34013,INJ,22638,24984,2346,46115,413,48208,8985,52191,520,61176,2067,983,municipality,2020
157,3401340890,"Livingston township, Essex County, New Jersey",34013,INJ,10337,10719,382,23323,9014,953,1583,29747,193,31330,775,18812,municipality,2020
158,3401343800,"Maplewood township, Essex County, New Jersey",34013,INJ,8866,9269,403,18776,951,7740,2182,23502,200,25684,1441,13170,municipality,2020
159,3401346380,"Millburn township, Essex County, New Jersey",34013,INJ,6908,7241,333,15287,7123,458,973,20737,163,21710,846,12147,municipality,2020
160,3401347500,"Montclair township, Essex County, New Jersey",34013,INJ,15555,16304,749,31380,2045,9008,4304,36617,491,40921,2480,22593,municipality,2020
161,3401351000,"Newark city, Essex County, New Jersey",34013,INJ,108789,118163,9374,235126,4871,147905,113374,198175,8014,311549,12469,24916,municipality,2020
162,3401352620,"North Caldwell borough, Essex County, New Jersey",34013,INJ,2258,2364,106,5043,518,85,405,6289,13,6694,197,5476,municipality,2020
163,3401353680,"Nutley township, Essex County, New Jersey",34013,INJ,11887,12340,453,24072,3518,928,5858,24285,229,30143,746,18864,municipality,2020
164,3401364590,"Roseland borough, Essex County, New Jersey",34013,INJ,2523,2607,84,5137,551,192,437,5862,30,6299,185,4904,municipality,2020
165,3401369274,"South Orange Village township, Essex County, New Jersey",34013,INJ,5940,6306,366,14560,1228,3803,1604,16880,295,18484,1044,10510,municipality,2020
166,3401375815,"Verona township, Essex County, New Jersey",34013,INJ,5862,6150,288,11319,696,323,1431,13141,65,14572,466,11591,municipality,2020
167,3401378510,"West Caldwell township, Essex County, New Jersey",34013,INJ,4004,4137,133,8597,440,138,971,10041,60,11012,339,9064,municipality,2020
168,3401379800,"West Orange township, Essex County, New Jersey",34013,INJ,17738,18746,1008,38339,3523,13916,9647,39196,507,48843,2095,19155,municipality,2020
169,3401703580,"Bayonne city, Hudson County, New Jersey",34017,INJ,27867,29727,1860,55847,7011,7116,22101,49585,735,71686,2026,32697,municipality,2020
170,3401719360,"East Newark borough, Hudson County, New Jersey",34017,INJ,889,920,31,2057,257,54,1619,975,84,2594,69,511,municipality,2020
171,3401728650,"Guttenberg town, Hudson County, New Jersey",34017,INJ,4920,5142,222,9593,1064,343,7868,4149,132,12017,184,2426,municipality,2020
172,3401730210,"Harrison town, Hudson County, New Jersey",34017,INJ,8111,8594,483,16104,4946,722,7759,11691,547,19450,786,4690,municipality,2020
173,3401732250,"Hoboken city, Hudson County, New Jersey",34017,INJ,28175,30202,2027,51022,6518,2106,8542,51877,516,60419,2080,40657,municipality,2020
174,3401736000,"Jersey City city, Hudson County, New Jersey",34017,INJ,119517,130992,11475,235745,81425,54199,72777,219672,4943,292449,9481,69624,municipality,2020
175,3401736510,"Kearny town, Hudson County, New Jersey",34017,INJ,14639,15392,753,33499,2034,1246,20465,21534,1345,41999,2020,14889,municipality,2020
176,3401752470,"North Bergen township, Hudson County, New Jersey",34017,INJ,23426,25079,1653,51265,4269,1403,44900,18461,696,63361,858,11235,municipality,2020
177,3401766570,"Secaucus town, Hudson County, New Jersey",34017,INJ,8840,9316,476,18118,7167,922,4700,17481,148,22181,484,8760,municipality,2020
178,3401774630,"Union City city, Hudson County, New Jersey",34017,INJ,24511,26455,1944,53100,2394,1355,56509,12080,706,68589,770,6855,municipality,2020
179,3401777930,"Weehawken township, Hudson County, New Jersey",34017,INJ,7969,9089,1120,14362,2594,685,5665,11532,154,17197,562,7537,municipality,2020
180,3401779610,"West New York town, Hudson County, New Jersey",34017,INJ,20544,21798,1254,42039,3745,1234,40114,12798,506,52912,664,6649,municipality,2020
181,3401900550,"Alexandria township, Hunterdon County, New Jersey",34019,ONJ,1751,1857,106,3865,105,65,287,4522,32,4809,152,4168,municipality,2020
182,3401905650,"Bethlehem township, Hunterdon County, New Jersey",34019,ONJ,1347,1406,59,2973,92,40,209,3536,14,3745,123,3267,municipality,2020
183,3401906370,"Bloomsbury borough, Hunterdon County, New Jersey",34019,ONJ,340,371,31,658,13,25,54,738,5,792,24,671,municipality,2020
184,3401909280,"Califon borough, Hunterdon County, New Jersey",34019,ONJ,404,429,25,797,15,1,41,964,6,1005,41,901,municipality,2020
185,3401913720,"Clinton town, Hunterdon County, New Jersey",34019,ONJ,1114,1157,43,2162,235,50,281,2492,14,2773,78,2115,municipality,2020
186,3401913750,"Clinton township, Hunterdon County, New Jersey",34019,ONJ,4658,4888,230,10940,768,757,1071,12434,75,13505,443,10391,municipality,2020
187,3401917170,"Delaware township, Hunterdon County, New Jersey",34019,ONJ,1795,1952,157,3796,64,39,264,4296,23,4560,164,4006,municipality,2020
188,3401918820,"East Amwell township, Hunterdon County, New Jersey",34019,ONJ,1548,1628,80,3277,64,35,217,3700,31,3917,103,3467,municipality,2020
189,3401923700,"Flemington borough, Hunterdon County, New Jersey",34019,ONJ,1853,1974,121,3591,317,133,1928,2948,39,4876,109,2350,municipality,2020
190,3401924870,"Franklin township, Hunterdon County, New Jersey",34019,ONJ,1172,1257,85,2671,58,28,214,3053,21,3267,118,2828,municipality,2020
191,3401925350,"Frenchtown borough, Hunterdon County, New Jersey",34019,ONJ,629,677,48,1110,23,16,104,1266,14,1370,57,1156,municipality,2020
192,3401926550,"Glen Gardner borough, Hunterdon County, New Jersey",34019,ONJ,785,835,50,1364,18,62,141,1541,17,1682,46,1398,municipality,2020
193,3401929460,"Hampton borough, Hunterdon County, New Jersey",34019,ONJ,612,650,38,1169,34,31,126,1312,8,1438,53,1186,municipality,2020
194,3401931320,"High Bridge borough, Hunterdon County, New Jersey",34019,ONJ,1424,1517,93,2785,113,51,340,3206,8,3546,106,2928,municipality,2020
195,3401932460,"Holland township, Hunterdon County, New Jersey",34019,ONJ,2001,2099,98,4181,44,31,220,4957,11,5177,177,4694,municipality,2020
196,3401937065,"Kingwood township, Hunterdon County, New Jersey",34019,ONJ,1476,1606,130,3098,40,42,143,3659,13,3802,128,3436,municipality,2020
197,3401938610,"Lambertville city, Hunterdon County, New Jersey",34019,ONJ,2093,2265,172,3563,62,75,525,3614,25,4139,115,3337,municipality,2020
198,3401939630,"Lebanon borough, Hunterdon County, New Jersey",34019,ONJ,795,828,33,1380,70,70,144,1521,3,1665,50,1328,municipality,2020
199,3401939660,"Lebanon township, Hunterdon County, New Jersey",34019,ONJ,2368,2505,137,5011,123,64,356,5839,30,6195,200,5422,municipality,2020
200,3401946260,"Milford borough, Hunterdon County, New Jersey",34019,ONJ,524,556,32,996,12,17,83,1149,6,1232,32,1082,municipality,2020
201,3401961920,"Raritan township, Hunterdon County, New Jersey",34019,ONJ,8613,8911,298,18411,2104,588,1899,21548,117,23447,750,17989,municipality,2020
202,3401962250,"Readington township, Hunterdon County, New Jersey",34019,ONJ,6271,6552,281,13050,744,213,1217,14911,56,16128,455,13443,municipality,2020
203,3401970980,"Stockton borough, Hunterdon County, New Jersey",34019,ONJ,233,255,22,430,8,0,10,485,1,495,13,463,municipality,2020
204,3401972510,"Tewksbury township, Hunterdon County, New Jersey",34019,ONJ,2185,2386,201,4765,232,54,332,5538,35,5870,198,5019,municipality,2020
205,3401974420,"Union township, Hunterdon County, New Jersey",34019,ONJ,1840,1917,77,5553,258,481,543,5964,25,6507,174,5026,municipality,2020
206,3401978230,"West Amwell township, Hunterdon County, New Jersey",34019,ONJ,1147,1209,62,2424,61,62,180,2825,6,3005,100,2596,municipality,2020
207,3402119780,"East Windsor township, Mercer County, New Jersey",34021,ONJ,11158,11690,532,23696,6780,2653,7750,22295,229,30045,723,11910,municipality,2020
208,3402122185,"Ewing township, Mercer County, New Jersey",34021,ONJ,13889,15637,1748,31710,1938,11364,4868,32396,290,37264,1217,17587,municipality,2020
209,3402129310,"Hamilton township, Mercer County, New Jersey",34021,ONJ,36125,37716,1591,74558,4121,11724,18279,74018,429,92297,2545,55199,municipality,2020
210,3402131620,"Hightstown borough, Mercer County, New Jersey",34021,ONJ,2097,2216,119,4552,333,402,2166,3734,47,5900,213,2739,municipality,2020
211,3402133150,"Hopewell borough, Mercer County, New Jersey",34021,ONJ,787,828,41,1511,27,32,84,1834,8,1918,82,1685,municipality,2020
212,3402133180,"Hopewell township, Mercer County, New Jersey",34021,ONJ,6367,6748,381,13641,2035,586,1039,16452,105,17491,618,13108,municipality,2020
213,3402139510,"Lawrence township, Mercer County, New Jersey",34021,ONJ,12550,13268,718,27031,5883,3755,3687,29390,192,33077,1190,18370,municipality,2020
214,3402157600,"Pennington borough, Mercer County, New Jersey",34021,ONJ,1028,1088,60,2109,83,45,88,2714,10,2802,110,2466,municipality,2020
215,3402160900,"Princeton borough, Mercer County, New Jersey",34021,ONJ,9373,10380,1007,25204,6732,1742,3014,27667,221,30681,1526,17446,municipality,2020
216,3402163850,"Robbinsville township, Mercer County, New Jersey",34021,ONJ,5479,5687,208,11449,4307,469,790,14686,94,15476,480,9336,municipality,2020
217,3402174000,"Trenton city, Mercer County, New Jersey",34021,ONJ,30139,34322,4183,67089,592,38386,40905,49966,608,90871,1870,8510,municipality,2020
218,3402180240,"West Windsor township, Mercer County, New Jersey",34021,ONJ,10369,10862,493,22122,15499,1206,1507,28011,179,29518,903,10224,municipality,2020
219,3402310750,"Carteret borough, Middlesex County, New Jersey",34023,INJ,8387,8809,422,19575,5756,3820,9340,15986,268,25326,556,5586,municipality,2020
220,3402315550,"Cranbury township, Middlesex County, New Jersey",34023,INJ,1323,1388,65,2940,803,108,183,3659,20,3842,116,2612,municipality,2020
221,3402318490,"Dunellen borough, Middlesex County, New Jersey",34023,INJ,2620,2727,107,5802,430,669,2820,4817,98,7637,230,3390,municipality,2020
222,3402319000,"East Brunswick township, Middlesex County, New Jersey",34023,INJ,17302,18088,786,38727,13894,2113,4758,44957,356,49715,1409,27185,municipality,2020
223,3402320230,"Edison township, Middlesex County, New Jersey",34023,INJ,36852,38493,1641,82850,57687,7764,10771,96817,875,107588,2187,28304,municipality,2020
224,3402330840,"Helmetta borough, Middlesex County, New Jersey",34023,INJ,1052,1091,39,2023,119,99,282,2173,17,2455,92,1846,municipality,2020
225,3402331470,"Highland Park borough, Middlesex County, New Jersey",34023,INJ,6320,6669,349,12023,2643,1258,2251,12821,189,15072,519,8212,municipality,2020
226,3402334890,"Jamesburg borough, Middlesex County, New Jersey",34023,INJ,2115,2228,113,4497,267,401,1843,3940,44,5783,185,3043,municipality,2020
227,3402345690,"Metuchen borough, Middlesex County, New Jersey",34023,INJ,5822,6053,231,11600,2825,645,1510,13539,101,15049,709,9259,municipality,2020
228,3402345900,"Middlesex borough, Middlesex County, New Jersey",34023,INJ,5302,5472,170,11498,1159,902,3751,10885,79,14636,414,8331,municipality,2020
229,3402346620,"Milltown borough, Middlesex County, New Jersey",34023,INJ,2613,2707,94,5460,246,178,810,6227,34,7037,214,5555,municipality,2020
230,3402347280,"Monroe township, Middlesex County, New Jersey",34023,INJ,20289,21504,1215,40168,12892,1655,2746,45848,260,48594,856,30185,municipality,2020
231,3402351210,"New Brunswick city, Middlesex County, New Jersey",34023,INJ,15387,17509,2122,43015,5722,6278,31376,23890,814,55266,754,10322,municipality,2020
232,3402352560,"North Brunswick township, Middlesex County, New Jersey",34023,INJ,15025,15585,560,34695,11212,7737,10676,33229,523,43905,1143,12614,municipality,2020
233,3402354705,"Old Bridge township, Middlesex County, New Jersey",34023,INJ,25059,26067,1008,54192,10119,4671,9276,57600,511,66876,1905,40394,municipality,2020
234,3402358200,"Perth Amboy city, Middlesex County, New Jersey",34023,INJ,17136,17855,719,41049,610,3483,46149,9287,501,55436,540,4153,municipality,2020
235,3402359010,"Piscataway township, Middlesex County, New Jersey",34023,INJ,18071,18904,833,50242,23973,11771,8276,52528,985,60804,1548,14251,municipality,2020
236,3402359280,"Plainsboro township, Middlesex County, New Jersey",34023,INJ,9720,10281,561,18815,13578,1579,1449,22635,176,24084,606,6696,municipality,2020
237,3402365790,"Sayreville borough, Middlesex County, New Jersey",34023,INJ,16910,17695,785,35845,7611,5743,7868,37477,467,45345,1290,22366,municipality,2020
238,3402368550,"South Amboy city, Middlesex County, New Jersey",34023,INJ,3740,3906,166,7565,470,529,2093,7318,59,9411,312,5948,municipality,2020
239,3402368790,"South Brunswick township, Middlesex County, New Jersey",34023,INJ,16014,16647,633,36320,22604,3405,3510,43533,286,47043,1140,16098,municipality,2020
240,3402369390,"South Plainfield borough, Middlesex County, New Jersey",34023,INJ,8217,8432,215,19329,4579,2496,4555,19783,345,24338,775,11588,municipality,2020
241,3402369420,"South River borough, Middlesex County, New Jersey",34023,INJ,5694,5977,283,12700,826,1000,4198,11920,445,16118,845,8804,municipality,2020
242,3402369810,"Spotswood borough, Middlesex County, New Jersey",34023,INJ,3196,3297,101,6646,523,272,917,7246,29,8163,278,6144,municipality,2020
243,3402382000,"Woodbridge township, Middlesex County, New Jersey",34023,INJ,36381,38137,1756,82433,27425,10143,22279,81360,946,103639,2574,40272,municipality,2020
244,3402500000,"County subdivisions not defined, Monmouth County, New Jersey",34025,ONJ,0,0,0,0,0,0,0,0,0,0,0,0,municipality,2020
245,3402500070,"Aberdeen township, Monmouth County, New Jersey",34025,ONJ,7697,7967,270,15591,1116,1883,2642,16687,136,19329,732,12820,municipality,2020
246,3402500730,"Allenhurst borough, Monmouth County, New Jersey",34025,ONJ,199,369,170,402,3,4,19,453,0,472,11,435,municipality,2020
247,3402500760,"Allentown borough, Monmouth County, New Jersey",34025,ONJ,694,724,30,1374,28,64,92,1642,13,1734,60,1477,municipality,2020
248,3402501960,"Asbury Park city, Monmouth County, New Jersey",34025,ONJ,7087,8274,1187,12254,162,5059,4079,11109,97,15188,507,5284,municipality,2020
249,3402502110,"Atlantic Highlands borough, Monmouth County, New Jersey",34025,ONJ,1949,2092,143,3637,78,54,363,4051,5,4414,166,3748,municipality,2020
250,3402502440,"Avon-by-the-Sea borough, Monmouth County, New Jersey",34025,ONJ,902,1334,432,1690,20,22,141,1792,3,1933,45,1702,municipality,2020
251,3402504930,"Belmar borough, Monmouth County, New Jersey",34025,ONJ,2867,4066,1199,5105,71,100,963,4944,39,5907,129,4605,municipality,2020
252,3402506970,"Bradley Beach borough, Monmouth County, New Jersey",34025,ONJ,2157,3221,1064,3731,57,82,880,3402,22,4282,122,3119,municipality,2020
253,3402507750,"Brielle borough, Monmouth County, New Jersey",34025,ONJ,1949,2176,227,3994,34,69,226,4756,25,4982,128,4500,municipality,2020
254,3402514560,"Colts Neck township, Monmouth County, New Jersey",34025,ONJ,3307,3451,144,7651,495,105,614,9343,43,9957,231,8469,municipality,2020
255,3402516660,"Deal borough, Monmouth County, New Jersey",34025,ONJ,347,925,578,723,6,6,120,780,14,900,23,731,municipality,2020
256,3402519840,"Eatontown borough, Monmouth County, New Jersey",34025,ONJ,5842,6182,340,11159,1316,1644,2005,11592,236,13597,824,7572,municipality,2020
257,3402521570,"Englishtown borough, Monmouth County, New Jersey",34025,ONJ,789,820,31,1809,207,66,368,1978,10,2346,65,1630,municipality,2020
258,3402522440,"Fair Haven borough, Monmouth County, New Jersey",34025,ONJ,1994,2074,80,4303,92,66,241,6028,17,6269,189,5664,municipality,2020
259,3402522950,"Farmingdale borough, Monmouth County, New Jersey",34025,ONJ,616,630,14,1201,40,80,167,1337,2,1504,67,1148,municipality,2020
260,3402525200,"Freehold borough, Monmouth County, New Jersey",34025,ONJ,4143,4394,251,9480,330,1110,6649,5889,97,12538,292,4060,municipality,2020
261,3402525230,"Freehold township, Monmouth County, New Jersey",34025,ONJ,12897,13500,603,28150,2585,1506,3636,31733,175,35369,1068,26399,municipality,2020
262,3402530690,"Hazlet township, Monmouth County, New Jersey",34025,ONJ,7179,7492,313,16245,682,330,2292,17833,102,20125,546,16173,municipality,2020
263,3402531500,"Highlands borough, Monmouth County, New Jersey",34025,ONJ,2425,2931,506,4076,55,80,343,4278,34,4621,181,3928,municipality,2020
264,3402532640,"Holmdel township, Monmouth County, New Jersey",34025,ONJ,5787,6038,251,13374,3555,189,989,16411,76,17400,597,11994,municipality,2020
265,3402533300,"Howell township, Monmouth County, New Jersey",34025,ONJ,18906,19694,788,41880,2621,1958,6359,47178,313,53537,1741,40545,municipality,2020
266,3402534200,"Interlaken borough, Monmouth County, New Jersey",34025,ONJ,362,400,38,707,4,1,19,809,10,828,26,768,municipality,2020
267,3402536480,"Keansburg borough, Monmouth County, New Jersey",34025,ONJ,3808,4361,553,7543,265,921,1932,7823,46,9755,455,6136,municipality,2020
268,3402536810,"Keyport borough, Monmouth County, New Jersey",34025,ONJ,3202,3427,225,5927,226,387,1572,5632,30,7204,235,4754,municipality,2020
269,3402537560,"Lake Como borough, Monmouth County, New Jersey",34025,ONJ,778,1081,303,1429,33,73,336,1361,9,1697,47,1199,municipality,2020
270,3402540770,"Little Silver borough, Monmouth County, New Jersey",34025,ONJ,2196,2323,127,4588,138,25,261,5870,14,6131,189,5504,municipality,2020
271,3402541010,"Loch Arbour village, Monmouth County, New Jersey",34025,ONJ,94,154,60,190,6,0,8,216,1,224,3,206,municipality,2020
272,3402541310,"Long Branch city, Monmouth County, New Jersey",34025,ONJ,12391,14944,2553,24709,588,3177,10332,21335,1571,31667,2866,13133,municipality,2020
273,3402542990,"Manalapan township, Monmouth County, New Jersey",34025,ONJ,14325,14850,525,32109,3561,876,3188,37717,202,40905,938,32140,municipality,2020
274,3402543050,"Manasquan borough, Monmouth County, New Jersey",34025,ONJ,2462,3412,950,4865,48,10,417,5521,5,5938,123,5335,municipality,2020
275,3402544070,"Marlboro township, Monmouth County, New Jersey",34025,ONJ,13774,14215,441,32004,9020,728,2323,39179,181,41502,817,28433,municipality,2020
276,3402544520,"Matawan borough, Monmouth County, New Jersey",34025,ONJ,3849,4010,161,7597,594,725,1431,8134,82,9565,374,6359,municipality,2020
277,3402545990,"Middletown township, Monmouth County, New Jersey",34025,ONJ,24710,25859,1149,52717,1867,823,5112,61994,282,67106,1880,57142,municipality,2020
278,3402546560,"Millstone township, Monmouth County, New Jersey",34025,ONJ,3324,3428,104,8123,627,415,844,9532,56,10376,323,8111,municipality,2020
279,3402547130,"Monmouth Beach borough, Monmouth County, New Jersey",34025,ONJ,1452,2006,554,2689,36,9,122,3052,25,3174,74,2908,municipality,2020
280,3402549890,"Neptune township, Monmouth County, New Jersey",34025,ONJ,11466,13278,1812,23173,770,9419,4052,24009,170,28061,1092,12558,municipality,2020
281,3402549920,"Neptune City borough, Monmouth County, New Jersey",34025,ONJ,2109,2251,142,3943,92,627,644,3982,21,4626,201,3041,municipality,2020
282,3402554270,"Ocean township, Monmouth County, New Jersey",34025,ONJ,11249,12257,1008,22250,1636,2507,3007,24665,306,27672,946,19270,municipality,2020
283,3402554570,"Oceanport borough, Monmouth County, New Jersey",34025,ONJ,2346,2469,123,4927,70,85,611,5539,56,6150,173,5155,municipality,2020
284,3402562430,"Red Bank borough, Monmouth County, New Jersey",34025,ONJ,5423,5863,440,10210,231,966,4890,8046,55,12936,336,6458,municipality,2020
285,3402564410,"Roosevelt borough, Monmouth County, New Jersey",34025,ONJ,307,331,24,677,12,23,103,705,8,808,32,630,municipality,2020
286,3402565130,"Rumson borough, Monmouth County, New Jersey",34025,ONJ,2398,2624,226,5184,106,21,308,7035,37,7343,236,6635,municipality,2020
287,3402566240,"Sea Bright borough, Monmouth County, New Jersey",34025,ONJ,793,1200,407,1326,34,13,78,1371,9,1449,44,1271,municipality,2020
288,3402566330,"Sea Girt borough, Monmouth County, New Jersey",34025,ONJ,786,1305,519,1623,4,9,56,1810,7,1866,19,1771,municipality,2020
289,3402567350,"Shrewsbury borough, Monmouth County, New Jersey",34025,ONJ,1456,1509,53,3207,97,61,165,4019,33,4184,128,3700,municipality,2020
290,3402567365,"Shrewsbury township, Monmouth County, New Jersey",34025,ONJ,505,544,39,893,88,148,217,859,5,1076,61,557,municipality,2020
291,3402570110,"Spring Lake borough, Monmouth County, New Jersey",34025,ONJ,1225,2107,882,2399,36,11,86,2703,12,2789,53,2591,municipality,2020
292,3402570140,"Spring Lake Heights borough, Monmouth County, New Jersey",34025,ONJ,2428,2998,570,4170,54,23,221,4669,13,4890,116,4463,municipality,2020
293,3402573020,"Tinton Falls borough, Monmouth County, New Jersey",34025,ONJ,8500,8972,472,16011,1041,1610,1694,17487,110,19181,641,14085,municipality,2020
294,3402574540,"Union Beach borough, Monmouth County, New Jersey",34025,ONJ,2036,2183,147,4565,125,111,726,4997,41,5723,221,4499,municipality,2020
295,3402574900,"Upper Freehold township, Monmouth County, New Jersey",34025,ONJ,2471,2604,133,5586,460,161,454,6819,41,7273,207,5950,municipality,2020
296,3402576460,"Wall township, Monmouth County, New Jersey",34025,ONJ,10121,10838,717,21495,443,461,1559,24966,97,26525,723,23242,municipality,2020
297,3402579310,"West Long Branch borough, Monmouth County, New Jersey",34025,ONJ,2551,2755,204,7005,143,275,774,7813,151,8587,426,6818,municipality,2020
298,3402706610,"Boonton town, Morris County, New Jersey",34027,INJ,3412,3555,143,7045,953,444,1409,7406,47,8815,362,5600,municipality,2020
299,3402706640,"Boonton township, Morris County, New Jersey",34027,INJ,1504,1583,79,3466,275,47,275,4105,13,4380,144,3626,municipality,2020
300,3402709040,"Butler borough, Morris County, New Jersey",34027,INJ,3258,3403,145,6510,284,123,1409,6638,20,8047,224,5987,municipality,2020
301,3402712100,"Chatham borough, Morris County, New Jersey",34027,INJ,3057,3224,167,6513,847,89,675,8537,52,9212,390,7159,municipality,2020
302,3402712130,"Chatham township, Morris County, New Jersey",34027,INJ,3963,4155,192,7978,1387,81,514,10469,61,10983,391,8549,municipality,2020
303,3402712580,"Chester borough, Morris County, New Jersey",34027,INJ,633,660,27,1302,60,5,281,1400,2,1681,57,1276,municipality,2020
304,3402712610,"Chester township, Morris County, New Jersey",34027,INJ,2575,2736,161,5874,381,90,539,7174,30,7713,296,6377,municipality,2020
305,3402717650,"Denville township, Morris County, New Jersey",34027,INJ,6442,6834,392,13549,1351,317,1280,15827,68,17107,606,13485,municipality,2020
306,3402718070,"Dover town, Morris County, New Jersey",34027,INJ,5752,5972,220,14544,423,783,14209,4251,127,18460,192,2726,municipality,2020
307,3402719210,"East Hanover township, Morris County, New Jersey",34027,INJ,3935,4040,105,9102,1425,141,876,10229,34,11105,179,8450,municipality,2020
308,3402723910,"Florham Park borough, Morris County, New Jersey",34027,INJ,4468,4768,300,10365,1075,725,929,11656,54,12585,392,9410,municipality,2020
309,3402729550,"Hanover township, Morris County, New Jersey",34027,INJ,5694,5928,234,11895,1948,325,1046,13631,55,14677,423,10880,municipality,2020
310,3402729700,"Harding township, Morris County, New Jersey",34027,INJ,1419,1569,150,3106,180,41,179,3692,11,3871,155,3305,municipality,2020
311,3402734980,"Jefferson township, Morris County, New Jersey",34027,INJ,7840,8566,726,16553,860,356,1998,18540,153,20538,566,16605,municipality,2020
312,3402737110,"Kinnelon borough, Morris County, New Jersey",34027,INJ,3405,3571,166,7722,610,91,728,9238,46,9966,299,8192,municipality,2020
313,3402740290,"Lincoln Park borough, Morris County, New Jersey",34027,INJ,4063,4181,118,9013,719,332,1469,9446,69,10915,286,8040,municipality,2020
314,3402741362,"Long Hill township, Morris County, New Jersey",34027,INJ,3118,3240,122,6746,693,73,912,7717,76,8629,299,6576,municipality,2020
315,3402742510,"Madison borough, Morris County, New Jersey",34027,INJ,5705,5989,284,13046,1262,463,2004,14933,102,16937,624,12482,municipality,2020
316,3402745330,"Mendham borough, Morris County, New Jersey",34027,INJ,1762,1867,105,3858,161,29,293,4688,31,4981,146,4321,municipality,2020
317,3402745360,"Mendham township, Morris County, New Jersey",34027,INJ,1986,2105,119,4469,347,93,330,5686,41,6016,276,4929,municipality,2020
318,3402746860,"Mine Hill township, Morris County, New Jersey",34027,INJ,1477,1523,46,3293,210,191,1283,2732,33,4015,120,2178,municipality,2020
319,3402747670,"Montville township, Morris County, New Jersey",34027,INJ,7901,8206,305,17573,4811,319,1578,20872,125,22450,608,15009,municipality,2020
320,3402748090,"Morris township, Morris County, New Jersey",34027,INJ,8587,8993,406,18357,1368,1019,2378,20596,135,22974,821,17253,municipality,2020
321,3402748210,"Morris Plains borough, Morris County, New Jersey",34027,INJ,2432,2527,95,4875,487,219,590,5563,15,6153,167,4675,municipality,2020
322,3402748300,"Morristown town, Morris County, New Jersey",34027,INJ,8482,9213,731,16670,961,1961,7367,12813,167,20180,526,9198,municipality,2020
323,3402748480,"Mountain Lakes borough, Morris County, New Jersey",34027,INJ,1376,1429,53,3141,694,19,247,4225,18,4472,209,3285,municipality,2020
324,3402748690,"Mount Arlington borough, Morris County, New Jersey",34027,INJ,2651,2915,264,5050,334,197,719,5190,28,5909,153,4478,municipality,2020
325,3402749080,"Mount Olive township, Morris County, New Jersey",34027,INJ,11079,11597,518,22474,3025,1807,4460,24426,156,28886,1039,18399,municipality,2020
326,3402750130,"Netcong borough, Morris County, New Jersey",34027,INJ,1434,1490,56,2736,118,151,817,2558,23,3375,104,2162,municipality,2020
327,3402756460,"Parsippany-Troy Hills township, Morris County, New Jersey",34027,INJ,21346,22146,800,45284,21694,1911,5631,50531,400,56162,1566,24960,municipality,2020
328,3402758110,"Pequannock township, Morris County, New Jersey",34027,INJ,6379,6688,309,12695,395,98,1224,14347,48,15571,345,13461,municipality,2020
329,3402761890,"Randolph township, Morris County, New Jersey",34027,INJ,9354,9676,322,20247,3185,740,3791,22713,133,26504,905,17750,municipality,2020
330,3402763300,"Riverdale borough, Morris County, New Jersey",34027,INJ,1929,2009,80,3481,219,88,411,3696,10,4107,110,3269,municipality,2020
331,3402764050,"Rockaway borough, Morris County, New Jersey",34027,INJ,2561,2645,84,5326,553,187,1355,5243,41,6598,189,4273,municipality,2020
332,3402764080,"Rockaway township, Morris County, New Jersey",34027,INJ,9643,10140,497,20341,1918,731,3995,21346,103,25341,790,17804,municipality,2020
333,3402764980,"Roxbury township, Morris County, New Jersey",34027,INJ,8356,8682,326,18268,1292,647,3340,19610,119,22950,687,16865,municipality,2020
334,3402775890,"Victory Gardens borough, Morris County, New Jersey",34027,INJ,571,584,13,1189,41,142,1185,397,14,1582,23,177,municipality,2020
335,3402777240,"Washington township, Morris County, New Jersey",34027,INJ,6343,6577,234,14133,760,286,1359,16838,84,18197,499,15209,municipality,2020
336,3402780390,"Wharton borough, Morris County, New Jersey",34027,INJ,2604,2736,132,5804,394,225,3576,3665,59,7241,192,2795,municipality,2020
337,3402900000,"County subdivisions not defined, Ocean County, New Jersey",34029,ONJ,0,0,0,0,0,0,0,0,0,0,0,0,municipality,2020
338,3402903050,"Barnegat township, Ocean County, New Jersey",34029,ONJ,9758,10724,966,19798,471,987,2460,21836,90,24296,827,19461,municipality,2020
339,3402903130,"Barnegat Light borough, Ocean County, New Jersey",34029,ONJ,321,1257,936,596,1,0,21,619,3,640,14,601,municipality,2020
340,3402903520,"Bay Head borough, Ocean County, New Jersey",34029,ONJ,434,1024,590,803,11,5,27,903,5,930,17,865,municipality,2020
341,3402903940,"Beach Haven borough, Ocean County, New Jersey",34029,ONJ,485,2600,2115,927,0,2,102,925,1,1027,16,906,municipality,2020
342,3402904180,"Beachwood borough, Ocean County, New Jersey",34029,ONJ,3719,3860,141,8320,147,239,1290,9569,41,10859,377,8765,municipality,2020
343,3402905305,"Berkeley township, Ocean County, New Jersey",34029,ONJ,21040,24629,3589,38217,637,1079,3680,40074,173,43754,1129,37056,municipality,2020
344,3402907420,"Brick township, Ocean County, New Jersey",34029,ONJ,30119,33863,3744,60946,1347,2071,8218,65402,340,73620,2306,59338,municipality,2020
345,3402918670,"Eagleswood township, Ocean County, New Jersey",34029,ONJ,676,797,121,1384,10,8,116,1606,13,1722,56,1519,municipality,2020
346,3402930390,"Harvey Cedars borough, Ocean County, New Jersey",34029,ONJ,198,1178,980,351,2,0,6,385,0,391,2,381,municipality,2020
347,3402934530,"Island Heights borough, Ocean County, New Jersey",34029,ONJ,722,841,119,1373,14,8,55,1595,16,1650,70,1487,municipality,2020
348,3402934680,"Jackson township, Ocean County, New Jersey",34029,ONJ,20470,21626,1156,44652,1558,2769,7543,51001,438,58544,1841,44395,municipality,2020
349,3402937380,"Lacey township, Ocean County, New Jersey",34029,ONJ,11086,12483,1397,23126,334,223,2000,26655,122,28655,885,25091,municipality,2020
350,3402937770,"Lakehurst borough, Ocean County, New Jersey",34029,ONJ,908,979,71,2044,76,236,505,2131,13,2636,126,1680,municipality,2020
351,3402938550,"Lakewood township, Ocean County, New Jersey",34029,ONJ,31850,34726,2876,70393,699,3290,15768,119390,2154,135158,1859,111388,municipality,2020
352,3402939390,"Lavallette borough, Ocean County, New Jersey",34029,ONJ,924,3078,2154,1642,7,8,60,1727,4,1787,51,1657,municipality,2020
353,3402940560,"Little Egg Harbor township, Ocean County, New Jersey",34029,ONJ,8715,10812,2097,17275,225,367,1541,19243,90,20784,702,17859,municipality,2020
354,3402941250,"Long Beach township, Ocean County, New Jersey",34029,ONJ,1593,8832,7239,2908,29,2,102,3051,10,3153,57,2953,municipality,2020
355,3402943140,"Manchester township, Ocean County, New Jersey",34029,ONJ,24287,26764,2477,41110,1017,1845,3503,41612,179,45115,1129,37442,municipality,2020
356,3402943380,"Mantoloking borough, Ocean County, New Jersey",34029,ONJ,158,498,340,296,4,1,15,316,2,331,4,305,municipality,2020
357,3402954300,"Ocean township, Ocean County, New Jersey",34029,ONJ,3979,4715,736,7659,71,72,407,8428,38,8835,243,8004,municipality,2020
358,3402954450,"Ocean Gate borough, Ocean County, New Jersey",34029,ONJ,851,1153,302,1613,5,46,156,1776,8,1932,94,1623,municipality,2020
359,3402958590,"Pine Beach borough, Ocean County, New Jersey",34029,ONJ,840,931,91,1733,29,17,133,2006,8,2139,76,1876,municipality,2020
360,3402959790,"Plumsted township, Ocean County, New Jersey",34029,ONJ,2996,3139,143,6512,58,107,677,7395,40,8072,358,6832,municipality,2020
361,3402959880,"Point Pleasant borough, Ocean County, New Jersey",34029,ONJ,7506,8485,979,15053,154,58,1327,17614,67,18941,443,16892,municipality,2020
362,3402959910,"Point Pleasant Beach borough, Ocean County, New Jersey",34029,ONJ,2045,3397,1352,4043,57,28,475,4291,13,4766,109,4084,municipality,2020
363,3402966450,"Seaside Heights borough, Ocean County, New Jersey",34029,ONJ,1148,2870,1722,1971,36,136,566,1874,15,2440,114,1573,municipality,2020
364,3402966480,"Seaside Park borough, Ocean County, New Jersey",34029,ONJ,772,2586,1814,1328,9,4,55,1381,7,1436,29,1332,municipality,2020
365,3402967110,"Ship Bottom borough, Ocean County, New Jersey",34029,ONJ,549,1938,1389,982,11,1,72,1026,6,1098,20,988,municipality,2020
366,3402969510,"South Toms River borough, Ocean County, New Jersey",34029,ONJ,1081,1141,60,2652,75,528,1040,2603,25,3643,197,1778,municipality,2020
367,3402970320,"Stafford township, Ocean County, New Jersey",34029,ONJ,11073,14399,3326,22886,420,316,2468,26149,68,28617,803,24542,municipality,2020
368,3402971640,"Surf City borough, Ocean County, New Jersey",34029,ONJ,644,2468,1824,1121,8,1,44,1199,5,1243,16,1169,municipality,2020
369,3402973125,"Toms River township, Ocean County, New Jersey",34029,ONJ,36291,44526,8235,75913,3780,3155,11593,83845,521,95438,2718,73671,municipality,2020
370,3402974210,"Tuckerton borough, Ocean County, New Jersey",34029,ONJ,1574,2110,536,2973,37,40,304,3273,18,3577,113,3065,municipality,2020
371,3403106340,"Bloomingdale borough, Passaic County, New Jersey",34031,INJ,3112,3267,155,6457,273,114,1186,6591,54,7777,236,5914,municipality,2020
372,3403113690,"Clifton city, Passaic County, New Jersey",34031,INJ,31968,33325,1357,71555,8414,3899,36159,54137,710,90296,1864,39250,municipality,2020
373,3403129070,"Haledon borough, Passaic County, New Jersey",34031,INJ,3017,3117,100,6973,631,1063,4476,4576,102,9052,186,2594,municipality,2020
374,3403130570,"Hawthorne borough, Passaic County, New Jersey",34031,INJ,7624,7946,322,15788,532,591,4778,14859,120,19637,487,13129,municipality,2020
375,3403140620,"Little Falls township, Passaic County, New Jersey",34031,INJ,4721,4947,226,11354,723,834,2264,11096,74,13360,349,9116,municipality,2020
376,3403153040,"North Haledon borough, Passaic County, New Jersey",34031,INJ,3054,3141,87,7447,349,290,1129,7798,31,8927,202,6926,municipality,2020
377,3403156550,"Passaic city, Passaic County, New Jersey",34031,INJ,20595,21513,918,49265,2599,4005,51584,18953,791,70537,740,10818,municipality,2020
378,3403157000,"Paterson city, Passaic County, New Jersey",34031,INJ,50326,52885,2559,118285,7991,36667,98863,60869,1463,159732,2225,12523,municipality,2020
379,3403160090,"Pompton Lakes borough, Passaic County, New Jersey",34031,INJ,4200,4349,149,8877,594,170,2174,8953,72,11127,333,7784,municipality,2020
380,3403161170,"Prospect Park borough, Passaic County, New Jersey",34031,INJ,1932,2017,85,4690,294,1023,3752,2620,59,6372,91,1153,municipality,2020
381,3403163150,"Ringwood borough, Passaic County, New Jersey",34031,INJ,4180,4364,184,9356,196,167,1084,10651,157,11735,431,9700,municipality,2020
382,3403173140,"Totowa borough, Passaic County, New Jersey",34031,INJ,3899,4026,127,9016,838,247,2408,8657,49,11065,226,7297,municipality,2020
383,3403176730,"Wanaque borough, Passaic County, New Jersey",34031,INJ,4392,4597,205,9399,543,305,1659,9658,89,11317,350,8371,municipality,2020
384,3403177840,"Wayne township, Passaic County, New Jersey",34031,INJ,19165,19808,643,44041,5167,1639,6439,48399,244,54838,1352,39997,municipality,2020
385,3403179460,"West Milford township, Passaic County, New Jersey",34031,INJ,9638,10570,932,20354,378,320,2259,22603,177,24862,833,20895,municipality,2020
386,3403182423,"Woodland Park borough, Passaic County, New Jersey",34031,INJ,5252,5495,243,10959,687,525,3816,9668,62,13484,319,8075,municipality,2020
387,3403504450,"Bedminster township, Somerset County, New Jersey",34035,INJ,4222,4483,261,7066,882,153,804,7468,36,8272,237,6160,municipality,2020
388,3403505560,"Bernards township, Somerset County, New Jersey",34035,INJ,10197,10665,468,21148,6708,447,1595,26235,110,27830,930,18040,municipality,2020
389,3403505590,"Bernardsville borough, Somerset County, New Jersey",34035,INJ,2756,2953,197,5886,343,49,1272,6621,32,7893,270,5927,municipality,2020
390,3403506790,"Bound Brook borough, Somerset County, New Jersey",34035,INJ,4181,4389,208,9285,483,976,6374,5614,226,11988,287,3642,municipality,2020
391,3403507180,"Branchburg township, Somerset County, New Jersey",34035,INJ,5660,5843,183,11948,1609,438,1116,13824,65,14940,491,11221,municipality,2020
392,3403507720,"Bridgewater township, Somerset County, New Jersey",34035,INJ,16044,16739,695,35926,11080,1268,4517,41460,271,45977,1294,27547,municipality,2020
393,3403522890,"Far Hills borough, Somerset County, New Jersey",34035,INJ,372,418,46,768,42,8,107,817,3,924,19,745,municipality,2020
394,3403524900,"Franklin township, Somerset County, New Jersey",34035,INJ,25860,27335,1475,55465,15835,16531,11938,56426,591,68364,2064,21405,municipality,2020
395,3403527510,"Green Brook township, Somerset County, New Jersey",34035,INJ,2436,2510,74,5716,1743,313,843,6438,39,7281,209,4134,municipality,2020
396,3403531890,"Hillsborough township, Somerset County, New Jersey",34035,INJ,15296,15955,659,33356,9889,2040,4067,39209,252,43276,1403,25625,municipality,2020
397,3403543620,"Manville borough, Somerset County, New Jersey",34035,INJ,4092,4290,198,8705,337,514,3464,7489,67,10953,316,6255,municipality,2020
398,3403546590,"Millstone borough, Somerset County, New Jersey",34035,INJ,153,168,15,334,9,7,34,414,1,448,17,380,municipality,2020
399,3403547580,"Montgomery township, Somerset County, New Jersey",34035,INJ,8003,8390,387,17642,9352,721,1314,22376,103,23690,809,11391,municipality,2020
400,3403553280,"North Plainfield borough, Somerset County, New Jersey",34035,INJ,7715,8055,340,17606,1064,4390,11548,11260,247,22808,561,4998,municipality,2020
401,3403557300,"Peapack and Gladstone borough, Somerset County, New Jersey",34035,INJ,887,937,50,1967,50,60,319,2239,7,2558,61,2061,municipality,2020
402,3403561980,"Raritan borough, Somerset County, New Jersey",34035,INJ,2993,3167,174,6238,1558,247,1672,6163,32,7835,206,4120,municipality,2020
403,3403564320,"Rocky Hill borough, Somerset County, New Jersey",34035,INJ,278,298,20,553,36,3,70,673,5,743,25,604,municipality,2020
404,3403568460,"Somerville borough, Somerset County, New Jersey",34035,INJ,5050,5387,337,9985,1433,1201,3113,9233,98,12346,428,6073,municipality,2020
405,3403568730,"South Bound Brook borough, Somerset County, New Jersey",34035,INJ,1854,1941,87,3915,395,528,1537,3326,43,4863,148,2212,municipality,2020
406,3403576940,"Warren township, Somerset County, New Jersey",34035,INJ,5374,5614,240,12543,3249,277,1156,14767,105,15923,567,10569,municipality,2020
407,3403577600,"Watchung borough, Somerset County, New Jersey",34035,INJ,2175,2285,110,5152,1001,309,519,5930,57,6449,261,4302,municipality,2020
408,3403701330,"Andover borough, Sussex County, New Jersey",34037,ONJ,254,277,23,498,5,17,59,536,3,595,27,484,municipality,2020
409,3403701360,"Andover township, Sussex County, New Jersey",34037,ONJ,2102,2219,117,4976,211,187,530,5466,47,5996,194,4827,municipality,2020
410,3403707300,"Branchville borough, Sussex County, New Jersey",34037,ONJ,334,372,38,631,17,8,53,738,2,791,29,682,municipality,2020
411,3403709160,"Byram township, Sussex County, New Jersey",34037,ONJ,2946,3292,346,6384,128,132,683,7345,47,8028,282,6756,municipality,2020
412,3403724810,"Frankford township, Sussex County, New Jersey",34037,ONJ,2084,2550,466,4401,75,42,297,5005,28,5302,175,4685,municipality,2020
413,3403724930,"Franklin borough, Sussex County, New Jersey",34037,ONJ,2047,2177,130,3978,78,108,661,4251,34,4912,209,3822,municipality,2020
414,3403725140,"Fredon township, Sussex County, New Jersey",34037,ONJ,1192,1256,64,2629,58,20,181,3054,16,3235,94,2866,municipality,2020
415,3403727420,"Green township, Sussex County, New Jersey",34037,ONJ,1244,1291,47,2811,62,65,306,3321,26,3627,97,3071,municipality,2020
416,3403729220,"Hamburg borough, Sussex County, New Jersey",34037,ONJ,1452,1539,87,2693,94,98,318,2948,19,3266,134,2603,municipality,2020
417,3403729490,"Hampton township, Sussex County, New Jersey",34037,ONJ,1996,2186,190,4021,79,26,267,4626,24,4893,162,4335,municipality,2020
418,3403729850,"Hardyston township, Sussex County, New Jersey",34037,ONJ,3371,3847,476,6733,215,244,647,7478,46,8125,268,6705,municipality,2020
419,3403732910,"Hopatcong borough, Sussex County, New Jersey",34037,ONJ,5724,6393,669,11897,353,423,2544,11818,119,14362,436,10487,municipality,2020
420,3403737440,"Lafayette township, Sussex County, New Jersey",34037,ONJ,881,921,40,1924,13,20,164,2194,18,2358,60,2083,municipality,2020
421,3403747430,"Montague township, Sussex County, New Jersey",34037,ONJ,1560,1832,272,3110,69,71,370,3422,27,3792,147,3108,municipality,2020
422,3403751930,"Newton town, Sussex County, New Jersey",34037,ONJ,3400,3687,287,6731,292,432,1363,7011,51,8374,342,5894,municipality,2020
423,3403754660,"Ogdensburg borough, Sussex County, New Jersey",34037,ONJ,873,927,54,1837,28,20,265,1993,12,2258,98,1835,municipality,2020
424,3403765700,"Sandyston township, Sussex County, New Jersey",34037,ONJ,806,979,173,1612,31,9,101,1876,8,1977,73,1755,municipality,2020
425,3403769690,"Sparta township, Sussex County, New Jersey",34037,ONJ,7032,7614,582,14988,620,309,1570,18030,102,19600,700,16299,municipality,2020
426,3403770380,"Stanhope borough, Sussex County, New Jersey",34037,ONJ,1432,1507,75,2890,93,74,492,3034,25,3526,118,2724,municipality,2020
427,3403770890,"Stillwater township, Sussex County, New Jersey",34037,ONJ,1609,1943,334,3305,38,23,202,3802,21,4004,111,3609,municipality,2020
428,3403771670,"Sussex borough, Sussex County, New Jersey",34037,ONJ,901,1013,112,1637,26,47,284,1740,7,2024,84,1576,municipality,2020
429,3403775740,"Vernon township, Sussex County, New Jersey",34037,ONJ,8612,10538,1926,17995,206,331,2163,20195,121,22358,775,18762,municipality,2020
430,3403776640,"Walpack township, Sussex County, New Jersey",34037,ONJ,5,5,0,4,0,0,2,5,0,7,0,5,municipality,2020
431,3403776790,"Wantage township, Sussex County, New Jersey",34037,ONJ,4058,4344,286,8760,127,152,788,10023,65,10811,405,9274,municipality,2020
432,3403905320,"Berkeley Heights township, Union County, New Jersey",34039,INJ,4484,4660,176,10097,2065,242,1140,12145,90,13285,470,9278,municipality,2020
433,3403913150,"Clark township, Union County, New Jersey",34039,INJ,5919,6114,195,12424,644,231,1945,13599,53,15544,325,12346,municipality,2020
434,3403915640,"Cranford township, Union County, New Jersey",34039,INJ,8891,9264,373,18391,903,653,2443,21404,116,23847,786,18946,municipality,2020
435,3403921000,"Elizabeth city, Union County, New Jersey",34039,INJ,46314,48439,2125,102537,2757,22261,90233,47065,2315,137298,3179,16553,municipality,2020
436,3403922860,"Fanwood borough, Union County, New Jersey",34039,INJ,2725,2829,104,5781,713,386,729,7045,16,7774,326,5604,municipality,2020
437,3403925800,"Garwood borough, Union County, New Jersey",34039,INJ,1920,2016,96,3663,119,69,670,3784,33,4454,127,3436,municipality,2020
438,3403931980,"Hillside township, Union County, New Jersey",34039,INJ,7517,7844,327,17624,498,11327,5189,17267,562,22456,1093,3787,municipality,2020
439,3403936690,"Kenilworth borough, Union County, New Jersey",34039,INJ,2932,3019,87,6619,435,219,1933,6494,48,8427,268,5524,municipality,2020
440,3403940350,"Linden city, Union County, New Jersey",34039,INJ,15609,16452,843,34514,1484,11722,15055,28683,579,43738,1154,13744,municipality,2020
441,3403948510,"Mountainside borough, Union County, New Jersey",34039,INJ,2399,2564,165,5457,466,134,667,6353,52,7020,203,5498,municipality,2020
442,3403951810,"New Providence borough, Union County, New Jersey",34039,INJ,5071,5497,426,10216,2171,241,1251,12399,69,13650,489,9429,municipality,2020
443,3403959190,"Plainfield city, Union County, New Jersey",34039,INJ,16308,17125,817,39581,500,19034,29792,24794,746,54586,1131,3383,municipality,2020
444,3403961530,"Rahway city, Union County, New Jersey",34039,INJ,11544,12363,819,23805,1622,8892,8867,20689,272,29556,990,8913,municipality,2020
445,3403964620,"Roselle borough, Union County, New Jersey",34039,INJ,8008,8431,423,17964,580,10800,7900,14795,266,22695,675,2474,municipality,2020
446,3403964650,"Roselle Park borough, Union County, New Jersey",34039,INJ,5213,5346,133,10980,1271,1186,5293,8674,144,13967,348,5725,municipality,2020
447,3403966060,"Scotch Plains township, Union County, New Jersey",34039,INJ,8807,9103,296,18760,2610,2365,2579,22389,159,24968,958,16297,municipality,2020
448,3403970020,"Springfield township, Union County, New Jersey",34039,INJ,6820,7105,285,13626,1541,1504,2235,14943,139,17178,619,11140,municipality,2020
449,3403971430,"Summit city, Union County, New Jersey",34039,INJ,7905,8365,460,16582,2371,895,3313,19406,139,22719,985,15016,municipality,2020
450,3403974480,"Union township, Union County, New Jersey",34039,INJ,20672,21571,899,48674,6472,19296,11899,47829,847,59728,2068,19146,municipality,2020
451,3403979040,"Westfield town, Union County, New Jersey",34039,INJ,10622,11095,473,22351,2735,790,2247,28785,170,31032,1271,23819,municipality,2020
452,3403981650,"Winfield township, Union County, New Jersey",34039,INJ,692,706,14,1210,6,14,139,1284,5,1423,72,1187,municipality,2020
453,3404100670,"Allamuchy township, Warren County, New Jersey",34041,ONJ,2358,2467,109,4417,181,227,465,4870,35,5335,169,4258,municipality,2020
454,3404101030,"Alpha borough, Warren County, New Jersey",34041,ONJ,972,1047,75,1886,41,65,211,2117,5,2328,71,1935,municipality,2020
455,3404104990,"Belvidere town, Warren County, New Jersey",34041,ONJ,1031,1143,112,1983,20,28,198,2322,19,2520,89,2166,municipality,2020
456,3404106160,"Blairstown township, Warren County, New Jersey",34041,ONJ,2106,2245,139,4669,74,67,332,5372,53,5704,192,4986,municipality,2020
457,3404124960,"Franklin township, Warren County, New Jersey",34041,ONJ,1124,1219,95,2406,92,54,174,2794,18,2968,111,2519,municipality,2020
458,3404125320,"Frelinghuysen township, Warren County, New Jersey",34041,ONJ,780,833,53,1763,11,26,124,2075,4,2199,78,1956,municipality,2020
459,3404128260,"Greenwich township, Warren County, New Jersey",34041,ONJ,1798,1868,70,4165,416,474,546,4927,25,5473,220,3792,municipality,2020
460,3404128710,"Hackettstown town, Warren County, New Jersey",34041,ONJ,3769,3945,176,8129,402,341,2393,7855,55,10248,276,6781,municipality,2020
461,3404129820,"Hardwick township, Warren County, New Jersey",34041,ONJ,578,612,34,1296,11,12,105,1493,3,1598,53,1414,municipality,2020
462,3404130090,"Harmony township, Warren County, New Jersey",34041,ONJ,993,1066,73,2043,21,29,57,2446,10,2503,81,2305,municipality,2020
463,3404133060,"Hope township, Warren County, New Jersey",34041,ONJ,743,806,63,1522,16,8,139,1696,9,1835,69,1594,municipality,2020
464,3404133930,"Independence township, Warren County, New Jersey",34041,ONJ,2325,2439,114,4511,122,143,444,5025,28,5469,189,4543,municipality,2020
465,3404137320,"Knowlton township, Warren County, New Jersey",34041,ONJ,1103,1197,94,2393,37,22,197,2697,14,2894,155,2469,municipality,2020
466,3404140110,"Liberty township, Warren County, New Jersey",34041,ONJ,1022,1144,122,2176,41,40,156,2514,20,2670,90,2323,municipality,2020
467,3404141490,"Lopatcong township, Warren County, New Jersey",34041,ONJ,3588,3859,271,7141,440,714,803,7973,76,8776,247,6496,municipality,2020
468,3404143320,"Mansfield township, Warren County, New Jersey",34041,ONJ,3139,3351,212,6284,251,408,1153,6628,49,7781,321,5599,municipality,2020
469,3404155530,"Oxford township, Warren County, New Jersey",34041,ONJ,967,1040,73,1922,24,47,186,2258,4,2444,128,2055,municipality,2020
470,3404158350,"Phillipsburg town, Warren County, New Jersey",34041,ONJ,6024,6659,635,11423,219,1907,2552,12697,75,15249,810,9686,municipality,2020
471,3404159820,"Pohatcong township, Warren County, New Jersey",34041,ONJ,1310,1428,118,2653,43,89,215,3026,15,3241,148,2731,municipality,2020
472,3404177270,"Washington borough, Warren County, New Jersey",34041,ONJ,3002,3219,217,5778,230,540,1002,6297,57,7299,272,5198,municipality,2020
473,3404177300,"Washington township, Warren County, New Jersey",34041,ONJ,2426,2553,127,5225,153,238,533,5959,33,6492,208,5327,municipality,2020
474,3404180570,"White township, Warren County, New Jersey",34041,ONJ,2169,2317,148,4034,41,94,240,4366,17,4606,92,4122,municipality,2020
475,3600508510,"Bronx borough, Bronx County, New York",36005,NYC,522450,547030,24580,1123075,67766,419393,806463,666191,19866,1472654,28370,130796,municipality,2020
476,3602701693,"Amenia town, Dutchess County, New York",36027,MHV,1622,1962,340,3130,70,87,425,3344,33,3769,180,2974,municipality,2020
477,3602705100,"Beacon city, Dutchess County, New York",36027,MHV,5780,6262,482,11176,290,1741,2686,11083,161,13769,687,8204,municipality,2020
478,3602705452,"Beekman town, Dutchess County, New York",36027,MHV,4409,4874,465,11512,356,1485,1881,12291,67,14172,431,9952,municipality,2020
479,3602716408,"Clinton town, Dutchess County, New York",36027,MHV,1593,1901,308,3355,56,75,196,3841,14,4037,175,3521,municipality,2020
480,3602720819,"Dover town, Dutchess County, New York",36027,MHV,3182,3505,323,6610,266,372,1638,6777,44,8415,359,5736,municipality,2020
481,3602721996,"East Fishkill town, Dutchess County, New York",36027,MHV,10206,10829,623,23121,1254,1130,3679,26028,215,29707,1026,22403,municipality,2020
482,3602725978,"Fishkill town, Dutchess County, New York",36027,MHV,9039,9521,482,20557,1180,3160,3822,20404,177,24226,749,15138,municipality,2020
483,3602737209,"Hyde Park town, Dutchess County, New York",36027,MHV,7921,8433,512,17431,810,1594,1989,19032,148,21021,1075,15405,municipality,2020
484,3602740299,"La Grange town, Dutchess County, New York",36027,MHV,5617,5897,280,12529,707,842,1783,14192,121,15975,670,11852,municipality,2020
485,3602747207,"Milan town, Dutchess County, New York",36027,MHV,957,1202,245,1871,30,32,131,2114,20,2245,120,1912,municipality,2020
486,3602751891,"North East town, Dutchess County, New York",36027,MHV,1223,1543,320,2464,53,48,419,2552,12,2971,121,2318,municipality,2020
487,3602756825,"Pawling town, Dutchess County, New York",36027,MHV,3117,3518,401,6518,133,201,1178,6834,58,8012,246,6196,municipality,2020
488,3602758156,"Pine Plains town, Dutchess County, New York",36027,MHV,946,1175,229,1817,30,18,126,2092,11,2218,112,1921,municipality,2020
489,3602758695,"Pleasant Valley town, Dutchess County, New York",36027,MHV,3921,4151,230,7847,184,384,866,8933,89,9799,459,7817,municipality,2020
490,3602759641,"Poughkeepsie city, Dutchess County, New York",36027,MHV,13139,14604,1465,24676,505,11165,7105,24472,290,31577,1659,10853,municipality,2020
491,3602759652,"Poughkeepsie town, Dutchess County, New York",36027,MHV,15857,16878,1021,37129,2802,5115,6794,38677,541,45471,1813,28406,municipality,2020
492,3602760905,"Red Hook town, Dutchess County, New York",36027,MHV,3926,4415,489,8158,299,148,733,9220,44,9953,348,8381,municipality,2020
493,3602761357,"Rhinebeck town, Dutchess County, New York",36027,MHV,3320,3787,467,6553,154,97,506,7090,45,7596,284,6510,municipality,2020
494,3602770662,"Stanford town, Dutchess County, New York",36027,MHV,1494,1859,365,3082,43,135,277,3405,25,3682,129,3073,municipality,2020
495,3602776166,"Union Vale town, Dutchess County, New York",36027,MHV,1587,1766,179,3689,78,74,312,4246,26,4558,142,3926,municipality,2020
496,3602778157,"Wappinger town, Dutchess County, New York",36027,MHV,11183,11657,474,22727,1270,2120,5228,22988,244,28216,1023,18331,municipality,2020
497,3602778388,"Washington town, Dutchess County, New York",36027,MHV,1888,2270,382,3671,65,103,450,4072,25,4522,213,3666,municipality,2020
498,3604710022,"Brooklyn borough, Kings County, New York",36047,NYC,1009804,1077654,67850,2140371,370776,729696,516426,2219648,37579,2736074,113170,968427,municipality,2020
499,3601011,"Albertson CDP, New York",36059,LI,1795,1857,62,4201,1700,25,468,4752,46,5220,114,2867,municipality,2020
500,3602968,"Atlantic Beach village, New York",36059,LI,763,1046,283,1505,28,3,83,1624,16,1707,44,1533,municipality,2020
501,3604143,"Baldwin CDP, New York",36059,LI,10702,11092,390,26928,1576,12989,7588,26331,598,33919,1337,9831,municipality,2020
502,3604550,"Barnum Island CDP, New York",36059,LI,1026,1062,36,2207,156,69,504,2086,38,2590,61,1762,municipality,2020
503,3604803,"Baxter Estates village, New York",36059,LI,394,425,31,791,74,7,173,818,4,991,33,700,municipality,2020
504,3604891,"Bay Park CDP, New York",36059,LI,845,888,43,1703,28,42,228,1889,12,2117,41,1766,municipality,2020
505,3605034,"Bayville village, New York",36059,LI,2518,2691,173,5513,140,32,704,6044,25,6748,156,5691,municipality,2020
506,3605639,"Bellerose village, New York",36059,LI,384,388,4,918,62,36,121,1052,15,1173,43,896,municipality,2020
507,3605661,"Bellerose Terrace CDP, New York",36059,LI,670,692,22,1817,782,151,655,1674,63,2329,77,601,municipality,2020
508,3605738,"Bellmore CDP, New York",36059,LI,5572,5776,204,12819,737,242,1570,14727,57,16297,454,13237,municipality,2020
509,3606387,"Bethpage CDP, New York",36059,LI,5810,6072,262,13417,2066,151,1735,14923,78,16658,336,12292,municipality,2020
510,3610132,"Brookville village, New York",36059,LI,625,661,36,2506,390,45,152,2787,10,2939,69,2273,municipality,2020
511,3612419,"Carle Place CDP, New York",36059,LI,1825,1908,83,4043,488,148,740,4265,50,5005,145,3434,municipality,2020
512,3613233,"Cedarhurst village, New York",36059,LI,2265,2413,148,5016,189,151,1040,6334,74,7374,117,5803,municipality,2020
513,3613618,"Centre Island village, New York",36059,LI,160,229,69,334,19,2,31,376,1,407,3,351,municipality,2020
514,3618597,"Cove Neck village, New York",36059,LI,125,138,13,218,0,0,18,275,2,293,9,264,municipality,2020
515,3621578,"East Atlantic Beach CDP, New York",36059,LI,860,994,134,1843,18,8,128,1973,9,2101,40,1898,municipality,2020
516,3622260,"East Hills village, New York",36059,LI,2218,2294,76,5274,888,85,303,6981,34,7284,166,5808,municipality,2020
517,3622480,"East Massapequa CDP, New York",36059,LI,6884,7112,228,16066,486,2415,2775,17079,156,19854,548,13474,municipality,2020
518,3622502,"East Meadow CDP, New York",36059,LI,12361,12951,590,30442,6758,1668,6048,31748,367,37796,916,22039,municipality,2020
519,3622623,"East Norwich CDP, New York",36059,LI,968,998,30,2205,111,26,222,2570,8,2792,63,2362,municipality,2020
520,3622876,"East Rockaway village, New York",36059,LI,3814,4000,186,8157,327,296,1451,8708,47,10159,249,7789,municipality,2020
521,3623217,"East Williston village, New York",36059,LI,828,864,36,1958,340,5,150,2495,7,2645,83,2060,municipality,2020
522,3624273,"Elmont CDP, New York",36059,LI,9896,10270,374,28191,5290,15460,8024,27241,901,35265,1308,4282,municipality,2020
523,3625384,"Farmingdale village, New York",36059,LI,3627,3868,241,7196,618,280,1291,7175,70,8466,188,6019,municipality,2020
524,3626264,"Floral Park village, New York",36059,LI,5746,5961,215,12714,1889,262,2067,14105,99,16172,360,11495,municipality,2020
525,3626352,"Flower Hill village, New York",36059,LI,1473,1529,56,3556,904,32,280,4514,36,4794,119,3423,municipality,2020
526,3627309,"Franklin Square CDP, New York",36059,LI,9903,10231,328,24938,3947,1385,5979,24924,341,30903,647,18604,municipality,2020
527,3627485,"Freeport village, New York",36059,LI,13501,14137,636,34879,792,12830,21312,23160,649,44472,1257,7632,municipality,2020
528,3628178,"Garden City village, New York",36059,LI,7513,7715,202,17677,1589,212,1486,21786,129,23272,512,19344,municipality,2020
529,3628189,"Garden City Park CDP, New York",36059,LI,2499,2592,93,6396,3742,223,999,6986,95,7985,224,2702,municipality,2020
530,3628200,"Garden City South CDP, New York",36059,LI,1401,1454,53,3282,348,42,475,3644,17,4119,77,3160,municipality,2020
531,3629113,"Glen Cove city, New York",36059,LI,10099,10793,694,23159,1449,1595,9752,18613,236,28365,558,14775,municipality,2020
532,3629245,"Glen Head CDP, New York",36059,LI,1718,1787,69,3774,330,32,546,4291,28,4837,115,3786,municipality,2020
533,3629421,"Glenwood Landing CDP, New York",36059,LI,1375,1422,47,3087,236,25,355,3593,28,3948,92,3212,municipality,2020
534,3630169,"Great Neck village, New York",36059,LI,3620,3883,263,8142,1497,145,1204,9941,103,11145,429,7767,municipality,2020
535,3630191,"Great Neck Estates village, New York",36059,LI,879,937,58,2195,563,16,122,2868,32,2990,98,2159,municipality,2020
536,3630202,"Great Neck Gardens CDP, New York",36059,LI,380,397,17,887,390,3,30,1238,5,1268,28,812,municipality,2020
537,3630213,"Great Neck Plaza village, New York",36059,LI,3702,3954,252,6218,1960,135,626,6856,43,7482,195,4523,municipality,2020
538,3630598,"Greenvale CDP, New York",36059,LI,344,373,29,849,270,8,118,951,12,1069,39,622,municipality,2020
539,3632094,"Harbor Hills CDP, New York",36059,LI,177,188,11,395,45,0,5,557,3,562,21,488,municipality,2020
540,3632105,"Harbor Isle CDP, New York",36059,LI,473,497,24,1139,22,26,145,1291,7,1436,35,1201,municipality,2020
541,3633139,"Hempstead village, New York",36059,LI,16299,16954,655,44564,1242,23041,29640,29529,785,59169,1394,3067,municipality,2020
542,3634198,"Herricks CDP, New York",36059,LI,1330,1380,50,3501,2522,27,196,4202,57,4398,109,1487,municipality,2020
543,3634286,"Hewlett CDP, New York",36059,LI,2532,2698,166,5582,630,303,1086,6176,61,7262,193,4989,municipality,2020
544,3634297,"Hewlett Bay Park village, New York",36059,LI,140,144,4,358,40,7,20,474,4,494,23,400,municipality,2020
545,3634308,"Hewlett Harbor village, New York",36059,LI,418,442,24,1009,59,13,59,1231,5,1290,30,1124,municipality,2020
546,3634319,"Hewlett Neck village, New York",36059,LI,149,161,12,395,22,12,30,539,8,569,6,491,municipality,2020
547,3634374,"Hicksville CDP, New York",36059,LI,13477,13889,412,35802,14178,1129,8003,35866,408,43869,1078,19073,municipality,2020
548,3637583,"Inwood CDP, New York",36059,LI,3180,3355,175,8159,431,1920,5997,5343,127,11340,185,2680,municipality,2020
549,3637847,"Island Park village, New York",36059,LI,1725,1851,126,3983,203,149,1645,3283,77,4928,125,2729,municipality,2020
550,3638539,"Jericho CDP, New York",36059,LI,4597,4818,221,11140,7168,301,595,14213,87,14808,288,6369,municipality,2020
551,3639309,"Kensington village, New York",36059,LI,430,457,27,939,282,4,15,1211,10,1226,38,877,municipality,2020
552,3639694,"Kings Point village, New York",36059,LI,1293,1416,123,4381,307,88,214,5405,27,5619,303,4680,municipality,2020
553,3640937,"Lake Success village, New York",36059,LI,820,858,38,2125,1587,12,103,2725,20,2828,67,1039,municipality,2020
554,3641003,"Lakeview CDP, New York",36059,LI,1567,1625,58,4732,157,4249,1123,4954,143,6077,253,152,municipality,2020
555,3641432,"Lattingtown village, New York",36059,LI,614,708,94,1445,81,5,117,1764,9,1881,56,1613,municipality,2020
556,3641487,"Laurel Hollow village, New York",36059,LI,594,630,36,1426,168,15,92,1848,7,1940,55,1603,municipality,2020
557,3641553,"Lawrence village, New York",36059,LI,2185,2432,247,4936,93,85,308,6501,116,6809,112,6095,municipality,2020
558,3642081,"Levittown CDP, New York",36059,LI,16634,17123,489,41214,5900,675,8617,43141,354,51758,1359,34853,municipality,2020
559,3642279,"Lido Beach CDP, New York",36059,LI,1161,1302,141,2300,52,10,148,2571,4,2719,51,2454,municipality,2020
560,3643192,"Locust Valley CDP, New York",36059,LI,1268,1339,71,2753,124,90,861,2710,23,3571,65,2408,municipality,2020
561,3643335,"Long Beach city, New York",36059,LI,15360,16771,1411,29730,1107,1820,5370,29659,336,35029,865,25531,municipality,2020
562,3643874,"Lynbrook village, New York",36059,LI,7459,7798,339,16101,1270,1345,3847,16591,177,20438,589,13210,municipality,2020
563,3644787,"Malverne village, New York",36059,LI,3068,3159,91,6929,488,464,1116,7444,120,8560,209,6163,municipality,2020
564,3644792,"Malverne Park Oaks CDP, New York",36059,LI,186,194,8,436,47,60,63,475,16,538,18,334,municipality,2020
565,3644897,"Manhasset CDP, New York",36059,LI,2790,2947,157,6307,1863,597,868,7308,28,8176,214,4606,municipality,2020
566,3644908,"Manhasset Hills CDP, New York",36059,LI,1119,1154,35,2842,1974,32,237,3412,48,3649,71,1287,municipality,2020
567,3645106,"Manorhaven village, New York",36059,LI,2534,2699,165,5319,995,106,2487,4469,42,6956,131,3195,municipality,2020
568,3645986,"Massapequa CDP, New York",36059,LI,7152,7375,223,16885,432,112,1586,19769,59,21355,505,18661,municipality,2020
569,3645997,"Massapequa Park village, New York",36059,LI,5759,5913,154,13441,306,78,1235,15874,74,17109,311,15105,municipality,2020
570,3646107,"Matinecock village, New York",36059,LI,284,323,39,680,46,1,77,770,0,847,13,710,municipality,2020
571,3646668,"Merrick CDP, New York",36059,LI,7436,7672,236,17139,928,339,2066,19974,139,22040,494,18074,municipality,2020
572,3647405,"Mill Neck village, New York",36059,LI,349,414,65,838,67,20,132,922,1,1054,32,802,municipality,2020
573,3647636,"Mineola village, New York",36059,LI,8311,8776,465,17149,2860,528,4071,16729,216,20800,625,12500,municipality,2020
574,3649231,"Munsey Park village, New York",36059,LI,821,842,21,1960,378,29,149,2660,10,2809,102,2141,municipality,2020
575,3649330,"Muttontown village, New York",36059,LI,1057,1141,84,2786,1189,54,159,3353,16,3512,67,2027,municipality,2020
576,3650067,"New Cassel CDP, New York",36059,LI,3185,3402,217,10499,422,4895,7917,6282,99,14199,199,667,municipality,2020
577,3650397,"New Hyde Park village, New York",36059,LI,3260,3376,116,8167,4063,176,1413,8844,118,10257,234,4253,municipality,2020
578,3651517,"North Bellmore CDP, New York",36059,LI,6723,6866,143,16241,1470,645,2374,18209,133,20583,518,15443,municipality,2020
579,3653022,"North Hills village, New York",36059,LI,2290,2500,210,4710,1878,53,151,5313,27,5464,110,3245,municipality,2020
580,3653231,"North Lynbrook CDP, New York",36059,LI,233,234,1,611,68,70,113,634,4,747,24,468,municipality,2020
581,3653253,"North Massapequa CDP, New York",36059,LI,5963,6103,140,14292,459,107,1541,16288,48,17829,305,15369,municipality,2020
582,3653264,"North Merrick CDP, New York",36059,LI,4023,4137,114,9467,668,305,1332,10906,88,12238,279,9566,municipality,2020
583,3653275,"North New Hyde Park CDP, New York",36059,LI,4887,5024,137,12558,7238,108,1230,14427,204,15657,289,6588,municipality,2020
584,3653748,"North Valley Stream CDP, New York",36059,LI,5447,5638,191,14821,3515,8111,2677,15520,492,18197,767,2635,municipality,2020
585,3653792,"North Wantagh CDP, New York",36059,LI,4174,4282,108,9493,375,138,1416,10515,74,11931,255,9673,municipality,2020
586,3654441,"Oceanside CDP, New York",36059,LI,11212,11552,340,25795,1181,658,4529,28108,237,32637,773,25259,municipality,2020
587,3654551,"Old Bethpage CDP, New York",36059,LI,2390,2836,446,5168,597,17,340,6063,17,6403,139,5293,municipality,2020
588,3654562,"Old Brookville village, New York",36059,LI,692,718,26,1600,260,31,120,1900,17,2020,34,1558,municipality,2020
589,3654705,"Old Westbury village, New York",36059,LI,1080,1209,129,3605,977,586,318,3971,26,4289,148,2234,municipality,2020
590,3655992,"Oyster Bay CDP, New York",36059,LI,2831,2964,133,5701,236,228,1396,5653,29,7049,167,4993,municipality,2020
591,3656011,"Oyster Bay Cove village, New York",36059,LI,695,759,64,1782,270,22,113,2152,16,2265,70,1774,municipality,2020
592,3658409,"Plainedge CDP, New York",36059,LI,2863,2941,78,7691,815,172,1093,8424,66,9517,194,7177,municipality,2020
593,3658442,"Plainview CDP, New York",36059,LI,8861,9207,346,20888,5548,131,1598,25502,128,27100,561,19134,municipality,2020
594,3658475,"Plandome village, New York",36059,LI,411,445,34,1031,165,9,67,1381,7,1448,31,1169,municipality,2020
595,3658486,"Plandome Heights village, New York",36059,LI,327,333,6,734,185,0,71,938,11,1009,24,718,municipality,2020
596,3658497,"Plandome Manor village, New York",36059,LI,252,272,20,620,91,2,50,743,5,793,7,638,municipality,2020
597,3658849,"Point Lookout CDP, New York",36059,LI,668,855,187,1313,18,8,62,1465,4,1527,28,1407,municipality,2020
598,3659520,"Port Washington CDP, New York",36059,LI,5925,6269,344,12733,1502,312,2524,14229,76,16753,592,11747,municipality,2020
599,3659531,"Port Washington North village, New York",36059,LI,1324,1377,53,2509,296,28,297,2863,27,3160,77,2435,municipality,2020
600,3663264,"Rockville Centre village, New York",36059,LI,9669,9991,322,20321,617,1314,3029,22987,129,26016,608,20319,municipality,2020
601,3663506,"Roosevelt CDP, New York",36059,LI,4242,4441,199,13678,169,8519,8406,9660,216,18066,413,343,municipality,2020
602,3663770,"Roslyn village, New York",36059,LI,1309,1441,132,2496,465,44,513,2475,20,2988,74,1872,municipality,2020
603,3663792,"Roslyn Estates village, New York",36059,LI,391,407,16,1010,169,10,42,1276,7,1318,28,1062,municipality,2020
604,3663803,"Roslyn Harbor village, New York",36059,LI,330,379,49,845,196,4,63,1004,3,1067,45,756,municipality,2020
605,3663814,"Roslyn Heights CDP, New York",36059,LI,2108,2218,110,5074,2239,375,700,6047,61,6747,169,3203,municipality,2020
606,3664232,"Russell Gardens village, New York",36059,LI,314,339,25,776,418,3,30,948,11,978,24,492,municipality,2020
607,3664430,"Saddle Rock village, New York",36059,LI,281,293,12,708,94,1,18,971,9,989,27,840,municipality,2020
608,3664441,"Saddle Rock Estates CDP, New York",36059,LI,130,139,9,306,41,3,1,427,11,428,17,355,municipality,2020
609,3664842,"Salisbury CDP, New York",36059,LI,3989,4106,117,10015,2383,321,2484,10134,96,12618,340,6994,municipality,2020
610,3665035,"Sands Point village, New York",36059,LI,878,947,69,2043,261,32,117,2595,9,2712,44,2249,municipality,2020
611,3666047,"Sea Cliff village, New York",36059,LI,1954,2086,132,4002,148,82,475,4587,17,5062,180,4160,municipality,2020
612,3666058,"Seaford CDP, New York",36059,LI,5293,5475,182,12148,428,111,1239,14012,68,15251,354,13051,municipality,2020
613,3666102,"Searingtown CDP, New York",36059,LI,1556,1607,51,3973,2647,58,197,4847,35,5044,121,1986,municipality,2020
614,3669001,"South Farmingdale CDP, New York",36059,LI,4765,4902,137,11568,773,284,2078,12267,82,14345,306,10822,municipality,2020
615,3669023,"South Floral Park village, New York",36059,LI,507,534,27,1370,240,834,384,1357,35,1741,90,158,municipality,2020
616,3669188,"South Hempstead CDP, New York",36059,LI,1029,1074,45,2562,79,506,836,2570,45,3406,88,1852,municipality,2020
617,3669892,"South Valley Stream CDP, New York",36059,LI,1995,2063,68,4957,1376,1674,793,5593,181,6386,237,2125,municipality,2020
618,3671267,"Stewart Manor village, New York",36059,LI,691,709,18,1577,149,39,256,1736,12,1992,56,1480,municipality,2020
619,3672554,"Syosset CDP, New York",36059,LI,6033,6293,260,14373,6944,118,971,18288,95,19259,486,10645,municipality,2020
620,3673605,"Thomaston village, New York",36059,LI,984,1024,40,2124,1265,37,121,2638,28,2759,63,1245,municipality,2020
621,3676089,"Uniondale CDP, New York",36059,LI,7850,8255,405,26236,1119,11543,12934,19539,376,32473,857,5644,municipality,2020
622,3676287,"University Gardens CDP, New York",36059,LI,1642,1706,64,3479,2119,60,323,4035,24,4358,130,1702,municipality,2020
623,3676331,"Upper Brookville village, New York",36059,LI,557,612,55,1404,278,31,87,1699,13,1786,54,1323,municipality,2020
624,3676705,"Valley Stream village, New York",36059,LI,12494,12925,431,31915,6503,9343,10672,29962,1119,40634,1547,11450,municipality,2020
625,3678146,"Wantagh CDP, New York",36059,LI,6062,6228,166,14446,495,59,1399,17214,71,18613,378,16211,municipality,2020
626,3679444,"Westbury village, New York",36059,LI,5083,5265,182,12777,1481,2741,5143,10721,178,15864,446,5875,municipality,2020
627,3680225,"West Hempstead CDP, New York",36059,LI,6093,6315,222,15294,1438,2249,3956,15879,308,19835,562,11322,municipality,2020
628,3682117,"Williston Park village, New York",36059,LI,2691,2787,96,6052,1448,81,753,6838,65,7591,219,5025,municipality,2020
629,3682744,"Woodbury CDP, New York",36059,LI,3155,3402,247,7510,1611,127,532,8803,45,9335,139,6881,municipality,2020
630,3682942,"Woodmere CDP, New York",36059,LI,5199,5485,286,12467,586,757,960,17709,284,18669,291,15791,municipality,2020
631,3682986,"Woodsburgh village, New York",36059,LI,293,306,13,665,33,3,28,869,12,897,10,811,municipality,2020
632,3605929113,"Glen Cove city, Nassau County, New York",36059,LI,10099,10793,694,23159,1449,1595,9752,18613,236,28365,558,14775,municipality,2020
633,3605934000,"Hempstead town, Nassau County, New York",36059,LI,250261,260524,10263,620910,59525,125839,174883,618526,9584,793409,21112,402466,municipality,2020
634,3605943335,"Long Beach city, Nassau County, New York",36059,LI,15360,16771,1411,29730,1107,1820,5370,29659,336,35029,865,25531,municipality,2020
635,3605953000,"North Hempstead town, Nassau County, New York",36059,LI,79546,83729,4183,185502,54700,11312,35083,202556,1952,237639,6424,128168,municipality,2020
636,3605956000,"Oyster Bay town, Nassau County, New York",36059,LI,100216,104915,4699,239583,46384,6650,31337,269995,1678,301332,6769,208514,municipality,2020
637,3606144919,"Manhattan borough, New York County, New York",36061,NYC,817782,913926,96144,1461740,219624,199592,402640,1291611,16112,1694251,62989,793294,municipality,2020
638,3607107003,"Blooming Grove town, Orange County, New York",36071,MHV,6253,6944,691,14050,401,1387,3913,14898,459,18811,670,11981,municipality,2020
639,3607115308,"Chester town, Orange County, New York",36071,MHV,4356,4590,234,9793,498,1058,2446,10200,122,12646,457,8065,municipality,2020
640,3607118300,"Cornwall town, Orange County, New York",36071,MHV,4923,5240,317,10058,408,414,1664,11220,116,12884,521,9761,municipality,2020
641,3607118916,"Crawford town, Orange County, New York",36071,MHV,3339,3549,210,7160,138,346,1370,7760,71,9130,358,6847,municipality,2020
642,3607119961,"Deerpark town, Orange County, New York",36071,MHV,2954,3319,365,6119,328,211,657,6852,67,7509,395,5851,municipality,2020
643,3607129553,"Goshen town, Orange County, New York",36071,MHV,4832,5226,394,11595,473,888,3133,11438,96,14571,377,9604,municipality,2020
644,3607130631,"Greenville town, Orange County, New York",36071,MHV,1613,1725,112,3621,54,144,626,4063,53,4689,160,3652,municipality,2020
645,3607131907,"Hamptonburgh town, Orange County, New York",36071,MHV,1778,1877,99,4300,203,175,797,4692,39,5489,189,4086,municipality,2020
646,3607134550,"Highlands town, Orange County, New York",36071,MHV,3156,3554,398,10256,598,1333,2066,10873,153,12939,554,8235,municipality,2020
647,3607147042,"Middletown city, Orange County, New York",36071,MHV,11011,11980,969,23028,1130,6304,13243,17102,349,30345,1083,8236,municipality,2020
648,3607147713,"Minisink town, Orange County, New York",36071,MHV,1579,1659,80,3532,45,127,618,4003,37,4621,137,3657,municipality,2020
649,3607147999,"Monroe town, Orange County, New York",36071,MHV,12853,13628,775,29432,1199,1588,5807,48534,8930,54341,1359,35458,municipality,2020
650,3607148153,"Montgomery town, Orange County, New York",36071,MHV,8367,8920,553,18134,389,1663,4320,19002,183,23322,970,15797,municipality,2020
651,3607148857,"Mount Hope town, Orange County, New York",36071,MHV,1869,2059,190,5301,298,756,1143,5394,75,6537,186,4079,municipality,2020
652,3607150034,"Newburgh city, Orange County, New York",36071,MHV,9771,11099,1328,20845,246,7545,15085,13771,261,28856,886,4833,municipality,2020
653,3607150045,"Newburgh town, Orange County, New York",36071,MHV,11745,12406,661,25742,929,4095,7066,24919,300,31985,1185,18410,municipality,2020
654,3607150848,"New Windsor town, Orange County, New York",36071,MHV,10500,11156,656,21835,1059,3969,7100,20705,239,27805,970,14468,municipality,2020
655,3607159388,"Port Jervis city, Orange County, New York",36071,MHV,3542,3992,450,6690,181,727,1311,7464,163,8775,550,5843,municipality,2020
656,3607175781,"Tuxedo town, Orange County, New York",36071,MHV,1441,1660,219,3164,191,182,466,3345,26,3811,115,2831,municipality,2020
657,3607177992,"Wallkill town, Orange County, New York",36071,MHV,11371,12047,676,24203,1289,5709,8492,21994,408,30486,1124,13464,municipality,2020
658,3607178366,"Warwick town, Orange County, New York",36071,MHV,12115,13315,1200,25808,622,1268,4429,27598,258,32027,1037,24413,municipality,2020
659,3607178839,"Wawayanda town, Orange County, New York",36071,MHV,2593,2758,165,5863,190,451,1335,6199,55,7534,231,5272,municipality,2020
660,3607182755,"Woodbury town, Orange County, New York",36071,MHV,3785,4176,391,8774,796,1001,2657,9540,410,12197,328,7005,municipality,2020
661,3607912529,"Carmel town, Putnam County, New York",36079,LHV,11897,12578,681,26674,698,752,5301,28275,199,33576,795,25831,municipality,2020
662,3607939331,"Kent town, Putnam County, New York",36079,LHV,4866,5429,563,10395,270,359,2818,10082,100,12900,390,8963,municipality,2020
663,3607956748,"Patterson town, Putnam County, New York",36079,LHV,3786,4101,315,9500,253,447,2557,8984,73,11541,339,7872,municipality,2020
664,3607957584,"Philipstown town, Putnam County, New York",36079,LHV,3847,4325,478,7888,208,150,916,8915,60,9831,410,8087,municipality,2020
665,3607960147,"Putnam Valley town, Putnam County, New York",36079,LHV,4237,4817,580,9354,251,292,1852,9910,86,11762,422,8859,municipality,2020
666,3607968924,"Southeast town, Putnam County, New York",36079,LHV,6696,7058,362,14459,466,425,4316,13742,135,18058,386,12330,municipality,2020
667,3608160323,"Queens borough, Queens County, New York",36081,NYC,847210,896333,49123,1949469,656583,381375,667861,1737603,66175,2405464,84112,549358,municipality,2020
668,3608570915,"Staten Island borough, Richmond County, New York",36085,NYC,173202,183692,10490,389393,58753,46835,96960,398787,3900,495747,11318,277981,municipality,2020
669,3608715968,"Clarkstown town, Rockland County, New York",36087,LHV,29489,30629,1140,68454,10152,8298,16275,70580,678,86855,2171,49281,municipality,2020
670,3608732765,"Haverstraw town, Rockland County, New York",36087,LHV,12646,13178,532,29629,1713,5434,18556,20531,303,39087,741,12340,municipality,2020
671,3608755211,"Orangetown town, Rockland County, New York",36087,LHV,17945,18986,1041,39240,3480,2577,6428,42227,311,48655,1397,34462,municipality,2020
672,3608760510,"Ramapo town, Rockland County, New York",36087,LHV,37722,39869,2147,90360,4563,16555,21984,126935,2485,148919,2995,100337,municipality,2020
673,3608771674,"Stony Point town, Rockland County, New York",36087,LHV,5146,5406,260,11833,505,911,3208,11605,100,14813,396,9693,municipality,2020
674,3601594,"Amagansett CDP, New York",36103,LI,770,1776,1006,1511,18,35,186,1638,24,1824,39,1522,municipality,2020
675,3602044,"Amityville village, New York",36103,LI,3846,4015,169,8105,163,876,1761,7739,72,9500,225,6403,municipality,2020
676,3602374,"Aquebogue CDP, New York",36103,LI,969,1164,195,2079,26,52,476,2071,8,2547,66,1919,municipality,2020
677,3602737,"Asharoken village, New York",36103,LI,231,296,65,512,6,2,31,561,10,592,11,532,municipality,2020
678,3603408,"Babylon village, New York",36103,LI,4544,4732,188,9741,294,199,1067,11121,59,12188,348,10221,municipality,2020
679,3604055,"Baiting Hollow CDP, New York",36103,LI,1081,1656,575,2283,21,67,309,2454,18,2763,58,2290,municipality,2020
680,3604913,"Bayport CDP, New York",36103,LI,3245,3506,261,6846,142,161,754,7855,40,8609,211,7301,municipality,2020
681,3604935,"Bay Shore CDP, New York",36103,LI,9667,10126,459,22561,1236,5044,11127,18117,382,29244,795,10660,municipality,2020
682,3605039,"Baywood CDP, New York",36103,LI,2210,2266,56,6060,301,1019,3470,4256,111,7726,264,2561,municipality,2020
683,3605672,"Belle Terre village, New York",36103,LI,287,312,25,660,42,8,54,754,5,808,27,672,municipality,2020
684,3605771,"Bellport village, New York",36103,LI,938,1170,232,1840,34,46,118,2085,9,2203,72,1924,municipality,2020
685,3607069,"Blue Point CDP, New York",36103,LI,2029,2132,103,4180,87,42,287,4869,26,5156,115,4599,municipality,2020
686,3607157,"Bohemia CDP, New York",36103,LI,3581,3720,139,7907,349,170,1040,8812,17,9852,202,8074,municipality,2020
687,3608026,"Brentwood CDP, New York",36103,LI,13658,14127,469,46299,1134,6766,47072,15315,804,62387,795,5816,municipality,2020
688,3608136,"Bridgehampton CDP, New York",36103,LI,1136,2632,1496,2356,71,199,417,2536,16,2953,90,2160,municipality,2020
689,3608323,"Brightwaters village, New York",36103,LI,1135,1160,25,2451,46,82,250,2931,3,3181,82,2718,municipality,2020
690,3609000,"Brookhaven CDP, New York",36103,LI,1097,1177,80,2754,34,190,303,3027,23,3330,94,2686,municipality,2020
691,3611781,"Calverton CDP, New York",36103,LI,2779,3016,237,4986,47,414,1095,4839,34,5934,141,4203,municipality,2020
692,3613376,"Centereach CDP, New York",36103,LI,10008,10405,397,24667,2658,964,5147,25833,177,30980,859,21175,municipality,2020
693,3613420,"Center Moriches CDP, New York",36103,LI,2770,2960,190,6249,109,243,1129,6917,30,8046,227,6308,municipality,2020
694,3613442,"Centerport CDP, New York",36103,LI,2171,2272,101,4677,108,20,306,5516,38,5822,169,5181,municipality,2020
695,3613552,"Central Islip CDP, New York",36103,LI,9870,10344,474,27835,1085,7005,21856,14858,573,36714,781,5414,municipality,2020
696,3616958,"Cold Spring Harbor CDP, New York",36103,LI,975,1020,45,2286,119,10,203,2861,13,3064,98,2621,municipality,2020
697,3617530,"Commack CDP, New York",36103,LI,12009,12312,303,28798,2536,632,2914,33622,221,36536,765,29468,municipality,2020
698,3618146,"Copiague CDP, New York",36103,LI,7684,8024,340,18791,524,1836,9634,13795,205,23429,487,10743,municipality,2020
699,3618157,"Coram CDP, New York",36103,LI,15234,16060,826,32506,2197,4703,7454,32766,308,40220,1395,24163,municipality,2020
700,3619466,"Cutchogue CDP, New York",36103,LI,1400,2121,721,2910,28,36,417,3020,12,3437,58,2886,municipality,2020
701,3619972,"Deer Park CDP, New York",36103,LI,9510,9839,329,22826,3322,3982,5206,23631,341,28837,786,15200,municipality,2020
702,3620379,"Dering Harbor village, New York",36103,LI,17,34,17,39,4,0,16,34,1,50,5,24,municipality,2020
703,3620687,"Dix Hills CDP, New York",36103,LI,8016,8315,299,20346,4397,1410,2224,23956,272,26180,778,17099,municipality,2020
704,3621985,"East Farmingdale CDP, New York",36103,LI,2177,2275,98,5376,528,785,1706,4911,53,6617,161,3384,municipality,2020
705,3622183,"East Hampton village, New York",36103,LI,668,1774,1106,1293,24,24,177,1340,7,1517,32,1253,municipality,2020
706,3622200,"East Hampton North CDP, New York",36103,LI,1889,2856,967,4217,75,219,2396,2981,46,5377,117,2524,municipality,2020
707,3622315,"East Islip CDP, New York",36103,LI,4769,4918,149,11081,302,209,1454,12477,71,13931,328,11567,municipality,2020
708,3622447,"East Marion CDP, New York",36103,LI,494,946,452,927,11,11,109,939,9,1048,27,881,municipality,2020
709,3622546,"East Moriches CDP, New York",36103,LI,2120,2349,229,4713,84,112,571,5375,38,5946,140,5001,municipality,2020
710,3622612,"East Northport CDP, New York",36103,LI,6996,7246,250,15945,591,205,2120,17928,93,20048,500,16539,municipality,2020
711,3622733,"East Patchogue CDP, New York",36103,LI,8221,8612,391,17575,522,982,4975,16605,144,21580,660,14297,municipality,2020
712,3622810,"Eastport CDP, New York",36103,LI,907,1015,108,1893,19,32,300,1919,14,2219,68,1786,municipality,2020
713,3622832,"East Quogue CDP, New York",36103,LI,2152,3104,952,4420,77,36,1029,4528,27,5557,120,4268,municipality,2020
714,3622980,"East Shoreham CDP, New York",36103,LI,2181,2248,67,5307,183,121,647,6194,38,6841,232,5620,municipality,2020
715,3623316,"Eatons Neck CDP, New York",36103,LI,507,570,63,1110,22,5,60,1274,5,1334,25,1217,municipality,2020
716,3624405,"Elwood CDP, New York",36103,LI,3730,3846,116,9115,941,535,1387,10039,59,11426,314,8190,municipality,2020
717,3625417,"Farmingville CDP, New York",36103,LI,4706,4845,139,11792,709,510,2659,12324,113,14983,472,10520,municipality,2020
718,3625839,"Fire Island CDP, New York",36103,LI,393,3357,2964,668,17,29,99,678,19,777,28,585,municipality,2020
719,3625923,"Fishers Island CDP, New York",36103,LI,180,609,429,352,11,3,32,392,4,424,22,352,municipality,2020
720,3626121,"Flanders CDP, New York",36103,LI,1492,1714,222,3810,37,421,2764,2334,44,5098,125,1707,municipality,2020
721,3626946,"Fort Salonga CDP, New York",36103,LI,3299,3430,131,7805,227,75,619,9033,31,9652,250,8450,municipality,2020
722,3628997,"Gilgo-Oak Beach-Captree CDP, New York",36103,LI,224,405,181,438,20,7,26,475,2,501,5,441,municipality,2020
723,3629509,"Gordon Heights CDP, New York",36103,LI,1059,1131,72,2932,91,1478,1479,2502,101,3981,183,649,municipality,2020
724,3630235,"Great River CDP, New York",36103,LI,798,842,44,1691,36,29,155,1850,1,2005,32,1752,municipality,2020
725,3630543,"Greenlawn CDP, New York",36103,LI,4524,4669,145,10677,773,1660,2420,11241,92,13661,387,8329,municipality,2020
726,3630576,"Greenport village, New York",36103,LI,950,1277,327,1998,25,197,957,1626,20,2583,84,1300,municipality,2020
727,3630581,"Greenport West CDP, New York",36103,LI,1056,1658,602,1988,29,85,388,1894,11,2282,40,1729,municipality,2020
728,3631445,"Halesite CDP, New York",36103,LI,1034,1099,65,2097,60,41,176,2351,18,2527,63,2169,municipality,2020
729,3631896,"Hampton Bays CDP, New York",36103,LI,5669,7879,2210,12251,177,167,5715,9513,136,15228,274,8759,municipality,2020
730,3632732,"Hauppauge CDP, New York",36103,LI,7180,7384,204,16164,1481,503,2080,18003,111,20083,468,15440,municipality,2020
731,3632963,"Head of the Harbor village, New York",36103,LI,475,537,62,1235,59,4,177,1343,12,1520,56,1212,municipality,2020
732,3635056,"Holbrook CDP, New York",36103,LI,9439,9714,275,21274,1194,701,3166,23321,156,26487,547,20723,municipality,2020
733,3635254,"Holtsville CDP, New York",36103,LI,6448,6646,198,15190,1040,455,2728,16209,105,18937,479,14130,municipality,2020
734,3636233,"Huntington CDP, New York",36103,LI,7920,8341,421,16354,568,368,1458,18187,103,19645,536,16612,municipality,2020
735,3637022,"Huntington Bay village, New York",36103,LI,552,593,41,1249,29,5,56,1390,16,1446,39,1301,municipality,2020
736,3637044,"Huntington Station CDP, New York",36103,LI,10517,10943,426,26642,1588,3012,15793,19085,289,34878,808,13388,municipality,2020
737,3637840,"Islandia village, New York",36103,LI,1044,1087,43,2981,219,437,1135,2432,33,3567,92,1651,municipality,2020
738,3637869,"Islip CDP, New York",36103,LI,6407,6605,198,14701,635,889,3574,14844,144,18418,473,12703,municipality,2020
739,3638022,"Islip Terrace CDP, New York",36103,LI,1698,1774,76,4205,147,146,836,4487,48,5323,123,4023,municipality,2020
740,3638253,"Jamesport CDP, New York",36103,LI,689,1126,437,1384,7,22,177,1432,1,1609,21,1381,municipality,2020
741,3639672,"Kings Park CDP, New York",36103,LI,6311,6564,253,13924,554,179,1414,15671,74,17085,365,14499,municipality,2020
742,3640530,"Lake Grove village, New York",36103,LI,3910,4078,168,9067,920,277,1252,9820,36,11072,288,8299,municipality,2020
743,3640838,"Lake Ronkonkoma CDP, New York",36103,LI,6645,7223,578,14952,1086,687,2588,16031,161,18619,537,13560,municipality,2020
744,3641465,"Laurel CDP, New York",36103,LI,550,800,250,1225,15,6,249,1246,14,1495,29,1182,municipality,2020
745,3642554,"Lindenhurst village, New York",36103,LI,9260,9712,452,21992,729,629,4458,22690,147,27148,637,20548,municipality,2020
746,3643005,"Lloyd Harbor village, New York",36103,LI,1150,1246,96,2700,136,9,206,3365,17,3571,103,3100,municipality,2020
747,3645139,"Manorville CDP, New York",36103,LI,5159,5364,205,11251,253,326,1428,12889,63,14317,433,11814,municipality,2020
748,3646074,"Mastic CDP, New York",36103,LI,4557,4792,235,11658,390,1440,4605,10799,177,15404,601,8191,municipality,2020
749,3646085,"Mastic Beach CDP, New York",36103,LI,4677,5198,521,10750,208,1771,3160,11039,161,14199,705,8194,municipality,2020
750,3646140,"Mattituck CDP, New York",36103,LI,1805,2527,722,3635,39,65,516,3806,16,4322,100,3586,municipality,2020
751,3646404,"Medford CDP, New York",36103,LI,8095,8416,321,19402,758,1545,5973,18274,171,24247,720,15080,municipality,2020
752,3646514,"Melville CDP, New York",36103,LI,7368,7777,409,15804,1997,794,1288,17996,93,19284,458,14654,municipality,2020
753,3646976,"Middle Island CDP, New York",36103,LI,4375,4588,213,8692,282,1308,1290,9256,103,10546,337,7226,municipality,2020
754,3647306,"Miller Place CDP, New York",36103,LI,4001,4157,156,9096,348,178,882,10841,49,11723,275,9991,municipality,2020
755,3648054,"Montauk CDP, New York",36103,LI,1804,4487,2683,3638,62,86,804,3514,41,4318,130,3195,municipality,2020
756,3648450,"Moriches CDP, New York",36103,LI,1361,1460,99,2490,54,321,390,2636,29,3026,131,2101,municipality,2020
757,3649066,"Mount Sinai CDP, New York",36103,LI,4131,4339,208,9177,599,157,984,10639,60,11623,267,9556,municipality,2020
758,3649424,"Napeague CDP, New York",36103,LI,179,480,301,303,11,7,29,339,4,368,10,307,municipality,2020
759,3649825,"Nesconset CDP, New York",36103,LI,4560,4707,147,10476,838,208,1186,12021,88,13207,312,10575,municipality,2020
760,3650727,"New Suffolk CDP, New York",36103,LI,187,316,129,331,2,1,38,365,3,403,5,354,municipality,2020
761,3651286,"Nissequogue village, New York",36103,LI,578,625,47,1287,40,6,78,1486,13,1564,35,1392,municipality,2020
762,3651396,"North Amityville CDP, New York",36103,LI,5304,5628,324,14230,280,8834,6899,11744,356,18643,596,1678,municipality,2020
763,3651418,"Northampton CDP, New York",36103,LI,227,246,19,573,10,141,324,439,11,763,15,262,municipality,2020
764,3651440,"North Babylon CDP, New York",36103,LI,6229,6430,201,14491,1007,1732,3381,14546,165,17927,488,11154,municipality,2020
765,3651495,"North Bay Shore CDP, New York",36103,LI,4579,4742,163,14617,940,2663,13376,6243,263,19619,345,2032,municipality,2020
766,3651528,"North Bellport CDP, New York",36103,LI,3484,3670,186,8944,322,2532,4451,7449,197,11900,515,3883,municipality,2020
767,3652078,"North Great River CDP, New York",36103,LI,1505,1535,30,3459,94,137,728,3538,23,4266,87,3197,municipality,2020
768,3652188,"North Haven village, New York",36103,LI,464,732,268,947,18,8,47,1115,7,1162,20,1062,municipality,2020
769,3653198,"North Lindenhurst CDP, New York",36103,LI,3861,4016,155,9506,445,719,3390,8610,105,12000,301,7040,municipality,2020
770,3653319,"North Patchogue CDP, New York",36103,LI,2314,2421,107,5380,131,179,1792,4959,51,6751,151,4447,municipality,2020
771,3653396,"Northport village, New York",36103,LI,2983,3128,145,6059,146,53,401,6946,25,7347,159,6563,municipality,2020
772,3653561,"North Sea CDP, New York",36103,LI,2158,3587,1429,4392,125,60,1080,4381,79,5461,171,3946,municipality,2020
773,3653775,"Northville CDP, New York",36103,LI,620,813,193,1349,18,19,224,1342,2,1566,33,1270,municipality,2020
774,3653852,"Northwest Harbor CDP, New York",36103,LI,1912,3512,1600,3866,110,83,863,3774,70,4637,133,3378,municipality,2020
775,3654056,"Noyack CDP, New York",36103,LI,1797,2832,1035,3573,76,60,578,3747,19,4325,111,3481,municipality,2020
776,3654144,"Oakdale CDP, New York",36103,LI,3109,3240,131,6219,103,86,517,6913,21,7430,153,6550,municipality,2020
777,3654430,"Ocean Beach village, New York",36103,LI,76,591,515,137,0,2,10,143,3,153,5,133,municipality,2020
778,3654617,"Old Field village, New York",36103,LI,334,365,31,746,74,2,42,851,13,893,24,738,municipality,2020
779,3655321,"Orient CDP, New York",36103,LI,470,800,330,875,10,2,41,958,7,999,19,920,municipality,2020
780,3656660,"Patchogue village, New York",36103,LI,5456,5776,320,10302,242,662,3520,8888,68,12408,312,7604,municipality,2020
781,3656968,"Peconic CDP, New York",36103,LI,300,495,195,596,6,13,83,609,6,692,16,568,municipality,2020
782,3659157,"Poquott village, New York",36103,LI,364,374,10,747,91,8,43,860,1,903,17,743,municipality,2020
783,3659355,"Port Jefferson village, New York",36103,LI,3291,3471,180,6590,537,109,712,7250,53,7962,293,6258,municipality,2020
784,3659377,"Port Jefferson Station CDP, New York",36103,LI,2859,2985,126,6293,512,302,1570,6380,41,7950,248,5277,municipality,2020
785,3660408,"Quiogue CDP, New York",36103,LI,364,625,261,785,20,40,279,734,13,1013,32,629,municipality,2020
786,3660422,"Quogue village, New York",36103,LI,688,1613,925,1375,58,41,134,1528,23,1662,38,1368,municipality,2020
787,3661142,"Remsenburg-Speonk CDP, New York",36103,LI,1200,1644,444,2498,35,36,351,2759,9,3110,80,2599,municipality,2020
788,3661665,"Ridge CDP, New York",36103,LI,5877,6336,459,11205,333,723,1145,12126,58,13271,351,10661,municipality,2020
789,3661973,"Riverhead CDP, New York",36103,LI,5365,5763,398,11880,225,1716,5674,9319,139,14993,386,6853,municipality,2020
790,3662066,"Riverside CDP, New York",36103,LI,838,910,72,2417,26,539,1176,1706,36,2882,51,1054,municipality,2020
791,3663319,"Rocky Point CDP, New York",36103,LI,4826,5285,459,10562,239,171,1651,11982,49,13633,450,11073,municipality,2020
792,3663473,"Ronkonkoma CDP, New York",36103,LI,6496,6701,205,15096,1166,548,2814,16141,240,18955,546,13641,municipality,2020
793,3664452,"Sagaponack village, New York",36103,LI,305,718,413,627,28,9,60,710,19,770,30,624,municipality,2020
794,3664485,"Sag Harbor village, New York",36103,LI,1202,2013,811,2296,35,206,301,2471,29,2772,101,2100,municipality,2020
795,3664584,"St. James CDP, New York",36103,LI,4729,4921,192,10871,513,117,1037,12450,34,13487,286,11500,municipality,2020
796,3664881,"Saltaire village, New York",36103,LI,31,432,401,99,2,0,3,110,0,113,3,105,municipality,2020
797,3665409,"Sayville CDP, New York",36103,LI,5935,6228,293,13269,283,186,1148,15421,71,16569,392,14489,municipality,2020
798,3666212,"Selden CDP, New York",36103,LI,6838,7167,329,16787,1495,885,4129,17133,157,21262,583,14013,municipality,2020
799,3666481,"Setauket-East Setauket CDP, New York",36103,LI,5304,5569,265,11917,1562,177,1056,13928,82,14984,475,11632,municipality,2020
800,3666828,"Shelter Island CDP, New York",36103,LI,703,1145,442,1354,18,13,181,1421,2,1602,59,1329,municipality,2020
801,3666850,"Shelter Island Heights CDP, New York",36103,LI,761,1552,791,1408,24,8,92,1509,2,1601,51,1424,municipality,2020
802,3667048,"Shinnecock Hills CDP, New York",36103,LI,845,1537,692,1796,51,45,702,1580,16,2282,64,1404,municipality,2020
803,3667070,"Shirley CDP, New York",36103,LI,8262,8782,520,20416,724,1907,6200,20160,268,26360,993,16268,municipality,2020
804,3667191,"Shoreham village, New York",36103,LI,188,232,44,453,13,11,45,516,1,561,24,467,municipality,2020
805,3667851,"Smithtown CDP, New York",36103,LI,8495,8800,305,20459,1007,351,2484,23145,131,25629,690,20966,municipality,2020
806,3668374,"Sound Beach CDP, New York",36103,LI,2728,2943,215,5845,136,125,758,6658,40,7416,246,6111,municipality,2020
807,3668462,"Southampton village, New York",36103,LI,1701,3438,1737,3765,129,236,792,3758,53,4550,122,3218,municipality,2020
808,3669254,"South Huntington CDP, New York",36103,LI,3290,3418,128,7790,773,210,1428,8133,39,9561,247,6864,municipality,2020
809,3669452,"Southold CDP, New York",36103,LI,2617,4222,1605,5132,78,66,779,5261,24,6040,152,4941,municipality,2020
810,3670387,"Springs CDP, New York",36103,LI,2973,4482,1509,6474,128,112,2728,5358,36,8086,199,4883,municipality,2020
811,3671608,"Stony Brook CDP, New York",36103,LI,4831,5033,202,10926,1667,217,826,12641,68,13467,379,10310,municipality,2020
812,3671620,"Stony Brook University CDP, New York",36103,LI,72,115,43,10302,1829,3516,1748,8661,118,10409,540,2658,municipality,2020
813,3673352,"Terryville CDP, New York",36103,LI,3853,4006,153,9116,430,392,2411,9061,86,11472,263,7890,municipality,2020
814,3675572,"Tuckahoe CDP, New York",36103,LI,628,995,367,1259,35,83,342,1163,21,1505,37,987,municipality,2020
815,3677519,"Village of the Branch village, New York",36103,LI,563,573,10,1359,49,23,92,1643,7,1735,43,1521,municipality,2020
816,3677772,"Wading River CDP, New York",36103,LI,2789,3223,434,6101,102,160,690,7041,35,7731,232,6512,municipality,2020
817,3677805,"Wainscott CDP, New York",36103,LI,386,916,530,755,23,17,142,762,10,904,24,688,municipality,2020
818,3678575,"Water Mill CDP, New York",36103,LI,958,2125,1167,2057,93,28,189,2317,18,2506,99,2079,municipality,2020
819,3679246,"West Babylon CDP, New York",36103,LI,14523,15139,616,34632,1455,5291,8202,35011,331,43213,1207,26727,municipality,2020
820,3679301,"West Bay Shore CDP, New York",36103,LI,1742,1809,67,3750,137,133,495,4130,20,4625,160,3680,municipality,2020
821,3680170,"Westhampton CDP, New York",36103,LI,1291,2206,915,2932,45,80,654,2967,28,3621,77,2737,municipality,2020
822,3680181,"Westhampton Beach village, New York",36103,LI,858,2455,1597,1755,49,33,319,1831,11,2150,44,1694,municipality,2020
823,3680186,"West Hampton Dunes village, New York",36103,LI,28,271,243,105,2,0,5,121,0,126,0,119,municipality,2020
824,3680258,"West Hills CDP, New York",36103,LI,1968,2024,56,4467,377,108,530,4855,22,5385,117,4231,municipality,2020
825,3680302,"West Islip CDP, New York",36103,LI,8763,9021,258,21447,528,166,2659,24389,60,27048,557,23078,municipality,2020
826,3680885,"West Sayville CDP, New York",36103,LI,1765,2109,344,3948,72,45,342,4530,13,4872,118,4282,municipality,2020
827,3681419,"Wheatley Heights CDP, New York",36103,LI,1442,1493,51,3942,395,2619,878,4262,79,5140,250,919,municipality,2020
828,3683294,"Wyandanch CDP, New York",36103,LI,3290,3548,258,9372,163,6352,5487,7503,187,12990,350,451,municipality,2020
829,3683426,"Yaphank CDP, New York",36103,LI,2280,2480,200,4900,145,278,793,5181,62,5974,221,4475,municipality,2020
830,3610304000,"Babylon town, Suffolk County, New York",36103,LI,71907,75270,3363,173514,9329,33874,52142,166081,2103,218223,5844,114931,municipality,2020
831,3610310000,"Brookhaven town, Suffolk County, New York",36103,LI,167187,178581,11394,388658,23108,30287,83528,402245,3523,485773,15328,329999,municipality,2020
832,3610322194,"East Hampton town, Suffolk County, New York",36103,LI,11118,21163,10045,23159,474,770,7531,20854,255,28385,748,18607,municipality,2020
833,3610337000,"Huntington town, Suffolk County, New York",36103,LI,70014,73073,3059,162582,13598,8667,31403,172724,1284,204127,5225,143950,municipality,2020
834,3610338000,"Islip town, Suffolk County, New York",36103,LI,105002,111346,6344,265143,11001,26931,118903,221035,3179,339938,7307,172617,municipality,2020
835,3610359106,"Poospatuck Reservation, Suffolk County, New York",36103,LI,150,159,9,322,0,55,87,349,215,436,45,34,municipality,2020
836,3610361984,"Riverhead town, Suffolk County, New York",36103,LI,13879,16310,2431,29170,436,2193,8262,27640,232,35902,898,23881,municipality,2020
837,3610366839,"Shelter Island town, Suffolk County, New York",36103,LI,1481,2731,1250,2801,46,21,289,2964,5,3253,115,2777,municipality,2020
838,3610367059,"Shinnecock Reservation, Suffolk County, New York",36103,LI,300,349,49,616,2,30,47,772,684,819,28,28,municipality,2020
839,3610368000,"Smithtown town, Suffolk County, New York",36103,LI,40018,41415,1397,92863,5585,1662,9979,106317,612,116296,2756,95702,municipality,2020
840,3610368473,"Southampton town, Suffolk County, New York",36103,LI,25806,42770,16964,55611,1185,2293,17178,51858,604,69036,1672,46104,municipality,2020
841,3610369463,"Southold town, Suffolk County, New York",36103,LI,10010,15773,5763,19973,255,485,3610,20122,126,23732,556,18700,municipality,2020
842,3610506310,"Bethel town, Sullivan County, New York",36105,MHV,1766,3703,1937,3362,32,94,503,3456,34,3959,144,3152,municipality,2020
843,3610511759,"Callicoon town, Sullivan County, New York",36105,MHV,1280,1852,572,2508,63,31,232,2757,14,2989,115,2534,municipality,2020
844,3610516661,"Cochecton town, Sullivan County, New York",36105,MHV,653,1042,389,1184,9,22,80,1368,7,1448,58,1272,municipality,2020
845,3610520104,"Delaware town, Sullivan County, New York",36105,MHV,927,1458,531,1796,22,140,171,2032,15,2203,76,1779,municipality,2020
846,3610525241,"Fallsburg town, Sullivan County, New York",36105,MHV,4148,8830,4682,10992,306,1811,3845,10347,184,14192,460,7586,municipality,2020
847,3610526528,"Forestburgh town, Sullivan County, New York",36105,MHV,347,552,205,690,23,18,38,770,4,808,30,695,municipality,2020
848,3610527573,"Fremont town, Sullivan County, New York",36105,MHV,537,1197,660,990,10,20,72,1089,13,1161,32,1014,municipality,2020
849,3610534473,"Highland town, Sullivan County, New York",36105,MHV,1004,1722,718,1866,17,27,144,2052,12,2196,78,1918,municipality,2020
850,3610542235,"Liberty town, Sullivan County, New York",36105,MHV,3916,5450,1534,7793,173,685,2789,7370,83,10159,517,5912,municipality,2020
851,3610543786,"Lumberland town, Sullivan County, New York",36105,MHV,911,1547,636,1817,31,32,201,2042,17,2243,118,1844,municipality,2020
852,3610544809,"Mamakating town, Sullivan County, New York",36105,MHV,4731,6157,1426,9621,189,428,1573,11082,124,12655,708,9633,municipality,2020
853,3610549847,"Neversink town, Sullivan County, New York",36105,MHV,1411,2020,609,2713,41,43,222,3144,16,3366,117,2927,municipality,2020
854,3610563176,"Rockland town, Sullivan County, New York",36105,MHV,1420,2432,1012,2634,54,49,322,2968,23,3290,159,2683,municipality,2020
855,3610573627,"Thompson town, Sullivan County, New York",36105,MHV,6478,10023,3545,12656,572,2638,3719,12831,232,16550,844,8545,municipality,2020
856,3610575759,"Tusten town, Sullivan County, New York",36105,MHV,654,1140,486,1164,27,31,96,1309,8,1405,46,1197,municipality,2020
857,3611120247,"Denning town, Ulster County, New York",36111,MHV,219,501,282,426,3,12,30,463,8,493,40,400,municipality,2020
858,3611124691,"Esopus town, Ulster County, New York",36111,MHV,3668,4089,421,7856,111,401,603,8945,46,9548,473,7914,municipality,2020
859,3611128255,"Gardiner town, Ulster County, New York",36111,MHV,2302,2672,370,4563,96,83,452,5158,39,5610,283,4657,municipality,2020
860,3611132116,"Hardenburgh town, Ulster County, New York",36111,MHV,101,301,200,186,13,1,14,207,0,221,1,192,municipality,2020
861,3611137143,"Hurley town, Ulster County, New York",36111,MHV,2718,3079,361,5166,114,107,356,5822,57,6178,257,5287,municipality,2020
862,3611139727,"Kingston city, Ulster County, New York",36111,MHV,10407,11571,1164,19217,630,2956,4107,19962,193,24069,1560,14623,municipality,2020
863,3611139738,"Kingston town, Ulster County, New York",36111,MHV,422,477,55,770,9,10,64,869,9,933,45,796,municipality,2020
864,3611142994,"Lloyd town, Ulster County, New York",36111,MHV,4438,4785,347,8996,324,681,1157,9976,89,11133,453,8429,municipality,2020
865,3611145458,"Marbletown town, Ulster County, New York",36111,MHV,2503,3080,577,4782,112,66,310,5348,44,5658,255,4871,municipality,2020
866,3611145722,"Marlborough town, Ulster County, New York",36111,MHV,3426,3794,368,6969,99,494,1022,7690,35,8712,298,6764,municipality,2020
867,3611150562,"New Paltz town, Ulster County, New York",36111,MHV,4906,5358,452,12341,775,751,1835,12572,258,14407,542,10246,municipality,2020
868,3611154749,"Olive town, Ulster County, New York",36111,MHV,1923,2564,641,3565,59,47,248,3978,40,4226,192,3640,municipality,2020
869,3611158552,"Plattekill town, Ulster County, New York",36111,MHV,4032,4412,380,8272,87,521,2055,8369,104,10424,490,7167,municipality,2020
870,3611163011,"Rochester town, Ulster County, New York",36111,MHV,3046,4062,1016,5902,107,130,495,6777,60,7272,362,6118,municipality,2020
871,3611163737,"Rosendale town, Ulster County, New York",36111,MHV,2570,2931,361,4845,72,111,361,5421,50,5782,275,4913,municipality,2020
872,3611165299,"Saugerties town, Ulster County, New York",36111,MHV,8300,9370,1070,15713,280,386,1468,17570,94,19038,898,15912,municipality,2020
873,3611166597,"Shandaken town, Ulster County, New York",36111,MHV,1419,2482,1063,2436,51,36,230,2636,49,2866,144,2356,municipality,2020
874,3611166674,"Shawangunk town, Ulster County, New York",36111,MHV,4053,4418,365,11313,165,1082,1863,11700,88,13563,428,9937,municipality,2020
875,3611175935,"Ulster town, Ulster County, New York",36111,MHV,5229,5714,485,10438,320,592,1176,11484,103,12660,622,9847,municipality,2020
876,3611178828,"Wawarsing town, Ulster County, New York",36111,MHV,4504,5943,1439,10240,193,1569,2925,9846,144,12771,639,7301,municipality,2020
877,3611183052,"Woodstock town, Ulster County, New York",36111,MHV,3135,4250,1115,5461,158,116,348,5939,59,6287,281,5325,municipality,2020
878,3611905320,"Bedford town, Westchester County, New York",36119,LHV,5758,6314,556,13389,589,726,2910,14399,127,17309,533,12424,municipality,2020
879,3611918410,"Cortlandt town, Westchester County, New York",36119,LHV,15288,16229,941,33695,1679,2494,8547,33998,322,42545,1562,27941,municipality,2020
880,3611921820,"Eastchester town, Westchester County, New York",36119,LHV,13595,14410,815,26385,3200,1036,3117,31524,214,34641,1222,25852,municipality,2020
881,3611930367,"Greenburgh town, Westchester County, New York",36119,LHV,35776,37565,1789,74939,11602,10141,16821,78576,863,95397,3670,52300,municipality,2020
882,3611932413,"Harrison town, Westchester County, New York",36119,LHV,8747,9274,527,21601,3231,745,4402,23816,196,28218,864,18780,municipality,2020
883,3611942136,"Lewisboro town, Westchester County, New York",36119,LHV,4495,4867,372,9562,435,191,969,11296,79,12265,484,10107,municipality,2020
884,3611944842,"Mamaroneck town, Westchester County, New York",36119,LHV,11423,11969,546,23362,1544,921,5671,26087,283,31758,1249,22090,municipality,2020
885,3611948895,"Mount Kisco town, Westchester County, New York",36119,LHV,4271,4465,194,8720,513,439,4569,6390,88,10959,274,5076,municipality,2020
886,3611949011,"Mount Pleasant town, Westchester County, New York",36119,LHV,14595,15221,626,34534,2501,1260,9259,35177,270,44436,1216,29930,municipality,2020
887,3611949121,"Mount Vernon city, Westchester County, New York",36119,LHV,28286,30350,2064,58572,1398,44655,14003,59890,1620,73893,3140,9077,municipality,2020
888,3611950078,"New Castle town, Westchester County, New York",36119,LHV,5918,6160,242,13155,2144,267,1243,17068,132,18311,701,13824,municipality,2020
889,3611950617,"New Rochelle city, Westchester County, New York",36119,LHV,28702,30531,1829,63189,3859,14324,26257,53469,1002,79726,2275,32009,municipality,2020
890,3611951693,"North Castle town, Westchester County, New York",36119,LHV,4098,4310,212,9335,793,196,1448,10960,60,12408,400,9511,municipality,2020
891,3611953517,"North Salem town, Westchester County, New York",36119,LHV,1887,2126,239,4191,120,83,594,4649,30,5243,146,4270,municipality,2020
892,3611955541,"Ossining town, Westchester County, New York",36119,LHV,14077,14975,898,31785,2195,4096,14493,25568,284,40061,1061,17932,municipality,2020
893,3611956979,"Peekskill city, Westchester County, New York",36119,LHV,9813,10464,651,20104,725,4693,11160,14271,272,25431,861,7720,municipality,2020
894,3611957012,"Pelham town, Westchester County, New York",36119,LHV,4323,4490,167,9331,844,717,1656,11422,188,13078,643,9030,municipality,2020
895,3611959685,"Pound Ridge town, Westchester County, New York",36119,LHV,1860,2076,216,4009,165,65,344,4738,22,5082,222,4264,municipality,2020
896,3611964309,"Rye city, Westchester County, New York",36119,LHV,5654,6038,384,11682,1185,189,1388,15204,73,16592,705,13052,municipality,2020
897,3611964320,"Rye town, Westchester County, New York",36119,LHV,16909,17678,769,38058,1961,1757,23918,25695,494,49613,1267,20216,municipality,2020
898,3611965442,"Scarsdale town, Westchester County, New York",36119,LHV,5510,5747,237,12603,3816,220,922,17331,134,18253,912,12249,municipality,2020
899,3611968308,"Somers town, Westchester County, New York",36119,LHV,8457,9010,553,17390,776,278,1907,19634,71,21541,597,17912,municipality,2020
900,3611981677,"White Plains city, Westchester County, New York",36119,LHV,24162,25494,1332,48238,4747,6746,19426,40133,589,59559,1809,26242,municipality,2020
901,3611984000,"Yonkers city, Westchester County, New York",36119,LHV,80548,85528,4980,166003,12915,33509,89065,122504,2197,211569,4913,68970,municipality,2020
902,3611984077,"Yorktown town, Westchester County, New York",36119,LHV,13144,13672,528,28610,1970,1262,5245,31324,208,36569,978,26906,municipality,2020
0,0.0,United States,,,126817580,140498736,13681156,258343281,19618719,39940338,62080044,269369237,4563550,331449281,13548983,191697647,nation,2020
