,COUNTY,H_Occ,H_Tot,H_Vac,P_Asian,P_Black,P_Hisp,P_NonHisp,P_Other,P_Tot,P_White,STATE,SUMLEV,id,name
10,001,7653,7980,327,1213,565,2622,17736,1549,20358,14409,09,60,900104720,Bethel town
11,001,54261,58874,4613,4024,48690,62853,85801,8683,148654,24404,09,60,900108070,Bridgeport town
12,001,6695,7116,421,946,299,1470,16058,1028,17528,13785,09,60,900108980,Brookfield town
13,001,31762,33562,1800,5339,5630,28690,57828,8896,86518,37963,09,60,900118500,Danbury town
14,001,6814,7265,451,1197,148,1234,20265,904,21499,18016,09,60,900118850,Darien town
15,001,2605,2756,151,328,106,444,7161,319,7605,6408,09,60,900123890,Easton town
16,001,20820,21982,1162,2906,1110,4806,56706,2655,61512,50035,09,60,900126620,Fairfield town
17,001,23316,25677,2361,4726,1157,8135,55383,3623,63518,45877,09,60,900133620,Greenwich town
18,001,6690,6918,228,660,400,1470,17355,747,18825,15548,09,60,900148620,Monroe town
19,001,6923,7502,579,1159,244,1121,19501,929,20622,17169,09,60,900150580,New Canaan town
20,001,4948,5635,687,230,153,1201,12378,557,13579,11438,09,60,900150860,New Fairfield town
21,001,9766,10322,556,734,592,1757,25416,1140,27173,22950,09,60,900152980,Newtown town
22,001,36078,38152,2074,4772,11074,27629,63555,3395,91184,44314,09,60,900156060,Norwalk town
23,001,3356,3664,308,243,75,465,8300,402,8765,7580,09,60,900163480,Redding town
24,001,8968,9506,538,1261,214,1506,23527,1096,25033,20956,09,60,900163970,Ridgefield town
25,001,16356,17174,818,1800,1812,4080,36789,1476,40869,31701,09,60,900168170,Shelton town
26,001,1425,1834,409,51,25,159,3368,143,3527,3149,09,60,900168310,Sherman town
27,001,53241,56953,3712,11453,16201,37958,97512,4982,135470,64876,09,60,900173070,Stamford town
28,001,20435,21643,1208,1310,9136,11107,41248,2395,52355,28407,09,60,900174190,Stratford town
29,001,12622,13159,537,2509,1642,3505,33322,1519,36827,27652,09,60,900177200,Trumbull town
30,001,3420,3671,251,575,143,631,9723,562,10354,8443,09,60,900183430,Weston town
31,001,9720,10567,847,1703,375,1592,25549,1302,27141,22169,09,60,900183500,Westport town
32,001,6210,6567,357,1612,201,916,17587,898,18503,14876,09,60,900186370,Wilton town
62,005,1457,1566,109,26,11,84,3563,144,3647,3382,09,60,900502760,Barkhamsted town
63,005,1398,1605,207,22,31,104,3281,124,3385,3104,09,60,900504930,Bethlehem town
64,005,728,863,135,10,14,41,1621,77,1662,1520,09,60,900508210,Bridgewater town
65,005,480,639,159,1,15,56,1024,33,1080,975,09,60,900510940,Canaan town
66,005,584,694,110,4,5,31,1330,64,1361,1257,09,60,900516050,Colebrook town
67,005,732,1002,270,24,4,61,1506,45,1567,1433,09,60,900517240,Cornwall town
68,005,1285,1708,423,32,16,120,3030,113,3150,2869,09,60,900532290,Goshen town
69,005,2179,2313,134,31,35,172,5312,201,5484,5045,09,60,900537280,Harwinton town
70,005,1285,1687,402,85,31,156,2863,161,3019,2586,09,60,900540290,Kent town
71,005,3467,3966,499,114,51,276,7916,288,8192,7463,09,60,900543370,Litchfield town
72,005,933,1253,320,14,12,67,2189,70,2256,2093,09,60,900549460,Morris town
73,005,2681,2968,287,75,18,177,6481,283,6658,6105,09,60,900551350,New Hartford town
74,005,10994,11928,934,958,639,3241,24874,1762,28115,21515,09,60,900552630,New Milford town
75,005,715,932,217,18,8,48,1540,65,1588,1449,09,60,900553470,Norfolk town
76,005,1399,1582,183,15,36,266,2945,147,3211,2747,09,60,900554030,North Canaan town
77,005,4856,5151,295,145,141,739,10932,589,11671,10057,09,60,900560750,Plymouth town
78,005,979,1163,184,29,9,70,2190,99,2260,2053,09,60,900565930,Roxbury town
79,005,1717,2519,802,78,80,197,3997,196,4194,3643,09,60,900566420,Salisbury town
80,005,1238,1724,486,44,35,98,2582,113,2680,2390,09,60,900567960,Sharon town
81,005,3145,3340,195,91,58,340,7102,316,7442,6637,09,60,900575730,Thomaston town
82,005,15490,17040,1550,891,1060,5433,30082,1823,35515,26308,09,60,900576570,Torrington town
83,005,580,790,210,14,1,56,1295,69,1351,1211,09,60,900579510,Warren town
84,005,1526,2056,530,49,24,219,3427,137,3646,3217,09,60,900579720,Washington town
85,005,8742,9137,395,399,399,1390,20715,796,22105,19121,09,60,900580490,Watertown town
86,005,4661,5405,744,124,116,684,9540,488,10224,8812,09,60,900586440,Winchester town
87,005,4251,4584,333,141,108,454,9269,411,9723,8609,09,60,900587910,Woodbury town
104,009,0,0,0,0,0,0,0,0,0,0,09,60,900900000,County subdivisions not defined
105,009,7570,8104,534,382,2474,4493,14425,881,18918,10688,09,60,900901220,Ansonia town
106,009,2485,2618,133,84,124,413,5587,253,6000,5126,09,60,900903250,Beacon Falls town
107,009,1948,2039,91,248,101,182,5115,205,5297,4561,09,60,900904580,Bethany town
108,009,13069,14180,1111,1311,654,1862,26411,1019,28273,23427,09,60,900907310,Branford town
109,009,10041,10401,360,1788,1226,1818,26915,1019,28733,22882,09,60,900914160,Cheshire town
110,009,5408,5759,351,336,1373,2544,9781,477,12325,7595,09,60,900919550,Derby town
111,009,11635,12394,759,1066,1262,5054,22869,885,27923,19656,09,60,900922910,East Haven town
112,009,8813,9693,880,781,202,1135,20938,870,22073,19085,09,60,900934950,Guilford town
113,009,23988,25984,1996,3447,14834,7836,53333,2668,61169,32384,09,60,900935650,Hamden town
114,009,6987,8060,1073,562,127,641,17050,656,17691,15705,09,60,900944560,Madison town
115,009,24346,26177,1831,1311,5565,22295,38555,2575,60850,29104,09,60,900946520,Meriden town
116,009,2859,3047,188,377,67,332,7242,238,7574,6560,09,60,900946940,Middlebury town
117,009,22338,23749,1411,2840,1531,4111,47933,2145,52044,41417,09,60,900947535,Milford town
118,009,12432,13239,807,749,2195,4871,26648,2338,31519,21366,09,60,900949950,Naugatuck town
119,009,52263,57525,5262,9044,40788,41068,92955,6113,134023,37010,09,60,900952070,New Haven town
120,009,5323,5633,310,234,145,670,12874,358,13544,12137,09,60,900953890,North Branford town
121,009,9546,9981,435,1468,889,1490,22763,775,24253,19631,09,60,900954870,North Haven town
122,009,5282,5480,198,1458,259,715,13565,522,14280,11326,09,60,900957600,Orange town
123,009,4774,5022,248,218,128,681,12025,425,12706,11254,09,60,900958300,Oxford town
124,009,3627,3762,135,94,206,426,8975,344,9401,8331,09,60,900962290,Prospect town
125,009,6779,7112,333,421,668,1752,14996,609,16748,13298,09,60,900967610,Seymour town
126,009,8587,9270,683,556,200,830,19049,668,19879,17625,09,60,900969640,Southbury town
127,009,18104,18938,834,1809,842,4770,39626,1578,44396,35397,09,60,900978740,Wallingford town
128,009,44425,48392,3967,2349,22269,45281,69122,6744,114403,37760,09,60,900980070,Waterbury town
129,009,21409,22735,1326,2609,11485,13177,42407,2353,55584,25960,09,60,900982870,West Haven town
130,009,6141,6408,267,250,395,1087,15055,632,16142,13778,09,60,900987560,Wolcott town
131,009,3258,3476,218,1203,264,547,8540,448,9087,6625,09,60,900987700,Woodbridge town
106,005,522450,547030,24580,67766,419393,806463,666191,48236,1472654,130796,36,60,3600508510,Bronx borough
321,027,1622,1962,340,70,87,425,3344,213,3769,2974,36,60,3602701693,Amenia town
322,027,5780,6262,482,290,1741,2686,11083,848,13769,8204,36,60,3602705100,Beacon city
323,027,4409,4874,465,356,1485,1881,12291,498,14172,9952,36,60,3602705452,Beekman town
324,027,1593,1901,308,56,75,196,3841,189,4037,3521,36,60,3602716408,Clinton town
325,027,3182,3505,323,266,372,1638,6777,403,8415,5736,36,60,3602720819,Dover town
326,027,10206,10829,623,1254,1130,3679,26028,1241,29707,22403,36,60,3602721996,East Fishkill town
327,027,9039,9521,482,1180,3160,3822,20404,926,24226,15138,36,60,3602725978,Fishkill town
328,027,7921,8433,512,810,1594,1989,19032,1223,21021,15405,36,60,3602737209,Hyde Park town
329,027,5617,5897,280,707,842,1783,14192,791,15975,11852,36,60,3602740299,LaGrange town
330,027,957,1202,245,30,32,131,2114,140,2245,1912,36,60,3602747207,Milan town
331,027,1223,1543,320,53,48,419,2552,133,2971,2318,36,60,3602751891,North East town
332,027,3117,3518,401,133,201,1178,6834,304,8012,6196,36,60,3602756825,Pawling town
333,027,946,1175,229,30,18,126,2092,123,2218,1921,36,60,3602758156,Pine Plains town
334,027,3921,4151,230,184,384,866,8933,548,9799,7817,36,60,3602758695,Pleasant Valley town
335,027,13139,14604,1465,505,11165,7105,24472,1949,31577,10853,36,60,3602759641,Poughkeepsie city
336,027,15857,16878,1021,2802,5115,6794,38677,2354,45471,28406,36,60,3602759652,Poughkeepsie town
337,027,3926,4415,489,299,148,733,9220,392,9953,8381,36,60,3602760905,Red Hook town
338,027,3320,3787,467,154,97,506,7090,329,7596,6510,36,60,3602761357,Rhinebeck town
339,027,1494,1859,365,43,135,277,3405,154,3682,3073,36,60,3602770662,Stanford town
340,027,1587,1766,179,78,74,312,4246,168,4558,3926,36,60,3602776166,Union Vale town
341,027,11183,11657,474,1270,2120,5228,22988,1267,28216,18331,36,60,3602778157,Wappinger town
342,027,1888,2270,382,65,103,450,4072,238,4522,3666,36,60,3602778388,Washington town
506,047,1009804,1077654,67850,370776,729696,516426,2219648,150749,2736074,968427,36,60,3604710022,Brooklyn borough
590,059,10099,10793,694,1449,1595,9752,18613,794,28365,14775,36,60,3605929113,Glen Cove city
591,059,250261,260524,10263,59525,125839,174883,618526,30696,793409,402466,36,60,3605934000,Hempstead town
592,059,15360,16771,1411,1107,1820,5370,29659,1201,35029,25531,36,60,3605943335,Long Beach city
593,059,79546,83729,4183,54700,11312,35083,202556,8376,237639,128168,36,60,3605953000,North Hempstead town
594,059,100216,104915,4699,46384,6650,31337,269995,8447,301332,208514,36,60,3605956000,Oyster Bay town
595,061,817782,913926,96144,219624,199592,402640,1291611,79101,1694251,793294,36,60,3606144919,Manhattan borough
681,071,6253,6944,691,401,1387,3913,14898,1129,18811,11981,36,60,3607107003,Blooming Grove town
682,071,4356,4590,234,498,1058,2446,10200,579,12646,8065,36,60,3607115308,Chester town
683,071,4923,5240,317,408,414,1664,11220,637,12884,9761,36,60,3607118300,Cornwall town
684,071,3339,3549,210,138,346,1370,7760,429,9130,6847,36,60,3607118916,Crawford town
685,071,2954,3319,365,328,211,657,6852,462,7509,5851,36,60,3607119961,Deerpark town
686,071,4832,5226,394,473,888,3133,11438,473,14571,9604,36,60,3607129553,Goshen town
687,071,1613,1725,112,54,144,626,4063,213,4689,3652,36,60,3607130631,Greenville town
688,071,1778,1877,99,203,175,797,4692,228,5489,4086,36,60,3607131907,Hamptonburgh town
689,071,3156,3554,398,598,1333,2066,10873,707,12939,8235,36,60,3607134550,Highlands town
690,071,11011,11980,969,1130,6304,13243,17102,1432,30345,8236,36,60,3607147042,Middletown city
691,071,1579,1659,80,45,127,618,4003,174,4621,3657,36,60,3607147713,Minisink town
692,071,7016,7421,405,1186,1531,5342,16045,1054,21387,12274,36,60,3607147999,Monroe town
693,071,8367,8920,553,389,1663,4320,19002,1153,23322,15797,36,60,3607148153,Montgomery town
694,071,1869,2059,190,298,756,1143,5394,261,6537,4079,36,60,3607148857,Mount Hope town
695,071,9771,11099,1328,246,7545,15085,13771,1147,28856,4833,36,60,3607150034,Newburgh city
696,071,11745,12406,661,929,4095,7066,24919,1485,31985,18410,36,60,3607150045,Newburgh town
697,071,10500,11156,656,1059,3969,7100,20705,1209,27805,14468,36,60,3607150848,New Windsor town
698,071,5837,6207,370,13,57,465,32489,9235,32954,23184,36,60,3607156185,Palm Tree town
699,071,3542,3992,450,181,727,1311,7464,713,8775,5843,36,60,3607159388,Port Jervis city
700,071,1441,1660,219,191,182,466,3345,141,3811,2831,36,60,3607175781,Tuxedo town
701,071,11371,12047,676,1289,5709,8492,21994,1532,30486,13464,36,60,3607177992,Wallkill town
702,071,12115,13315,1200,622,1268,4429,27598,1295,32027,24413,36,60,3607178366,Warwick town
703,071,2593,2758,165,190,451,1335,6199,286,7534,5272,36,60,3607178839,Wawayanda town
704,071,3785,4176,391,796,1001,2657,9540,738,12197,7005,36,60,3607182755,Woodbury town
766,079,11897,12578,681,698,752,5301,28275,994,33576,25831,36,60,3607912529,Carmel town
767,079,4866,5429,563,270,359,2818,10082,490,12900,8963,36,60,3607939331,Kent town
768,079,3786,4101,315,253,447,2557,8984,412,11541,7872,36,60,3607956748,Patterson town
769,079,3847,4325,478,208,150,916,8915,470,9831,8087,36,60,3607957584,Philipstown town
770,079,4237,4817,580,251,292,1852,9910,508,11762,8859,36,60,3607960147,Putnam Valley town
771,079,6696,7058,362,466,425,4316,13742,521,18058,12330,36,60,3607968924,Southeast town
772,081,847210,896333,49123,656583,381375,667861,1737603,150287,2405464,549358,36,60,3608160323,Queens borough
789,085,173202,183692,10490,58753,46835,96960,398787,15218,495747,277981,36,60,3608570915,Staten Island borough
790,087,29489,30629,1140,10152,8298,16275,70580,2849,86855,49281,36,60,3608715968,Clarkstown town
791,087,12646,13178,532,1713,5434,18556,20531,1044,39087,12340,36,60,3608732765,Haverstraw town
792,087,17945,18986,1041,3480,2577,6428,42227,1708,48655,34462,36,60,3608755211,Orangetown town
793,087,37722,39869,2147,4563,16555,21984,126935,5480,148919,100337,36,60,3608760510,Ramapo town
794,087,5146,5406,260,505,911,3208,11605,496,14813,9693,36,60,3608771674,Stony Point town
924,103,71907,75270,3363,9329,33874,52142,166081,7947,218223,114931,36,60,3610304000,Babylon town
925,103,167187,178581,11394,23108,30287,83528,402245,18851,485773,329999,36,60,3610310000,Brookhaven town
926,103,11118,21163,10045,474,770,7531,20854,1003,28385,18607,36,60,3610322194,East Hampton town
927,103,70014,73073,3059,13598,8667,31403,172724,6509,204127,143950,36,60,3610337000,Huntington town
928,103,105002,111346,6344,11001,26931,118903,221035,10486,339938,172617,36,60,3610338000,Islip town
929,103,150,159,9,0,55,87,349,260,436,34,36,60,3610359106,Poospatuck Reservation
930,103,13879,16310,2431,436,2193,8262,27640,1130,35902,23881,36,60,3610361984,Riverhead town
931,103,1481,2731,1250,46,21,289,2964,120,3253,2777,36,60,3610366839,Shelter Island town
932,103,300,349,49,2,30,47,772,712,819,28,36,60,3610367059,Shinnecock Reservation
933,103,40018,41415,1397,5585,1662,9979,106317,3368,116296,95702,36,60,3610368000,Smithtown town
934,103,25806,42770,16964,1185,2293,17178,51858,2276,69036,46104,36,60,3610368473,Southampton town
935,103,10010,15773,5763,255,485,3610,20122,682,23732,18700,36,60,3610369463,Southold town
936,105,1766,3703,1937,32,94,503,3456,178,3959,3152,36,60,3610506310,Bethel town
937,105,1280,1852,572,63,31,232,2757,129,2989,2534,36,60,3610511759,Callicoon town
938,105,653,1042,389,9,22,80,1368,65,1448,1272,36,60,3610516661,Cochecton town
939,105,927,1458,531,22,140,171,2032,91,2203,1779,36,60,3610520104,Delaware town
940,105,4148,8830,4682,306,1811,3845,10347,644,14192,7586,36,60,3610525241,Fallsburg town
941,105,347,552,205,23,18,38,770,34,808,695,36,60,3610526528,Forestburgh town
942,105,537,1197,660,10,20,72,1089,45,1161,1014,36,60,3610527573,Fremont town
943,105,1004,1722,718,17,27,144,2052,90,2196,1918,36,60,3610534473,Highland town
944,105,3916,5450,1534,173,685,2789,7370,600,10159,5912,36,60,3610542235,Liberty town
945,105,911,1547,636,31,32,201,2042,135,2243,1844,36,60,3610543786,Lumberland town
946,105,4731,6157,1426,189,428,1573,11082,832,12655,9633,36,60,3610544809,Mamakating town
947,105,1411,2020,609,41,43,222,3144,133,3366,2927,36,60,3610549847,Neversink town
948,105,1420,2432,1012,54,49,322,2968,182,3290,2683,36,60,3610563176,Rockland town
949,105,6478,10023,3545,572,2638,3719,12831,1076,16550,8545,36,60,3610573627,Thompson town
950,105,654,1140,486,27,31,96,1309,54,1405,1197,36,60,3610575759,Tusten town
970,111,219,501,282,3,12,30,463,48,493,400,36,60,3611120247,Denning town
971,111,3668,4089,421,111,401,603,8945,519,9548,7914,36,60,3611124691,Esopus town
972,111,2302,2672,370,96,83,452,5158,322,5610,4657,36,60,3611128255,Gardiner town
973,111,101,301,200,13,1,14,207,1,221,192,36,60,3611132116,Hardenburgh town
974,111,2718,3079,361,114,107,356,5822,314,6178,5287,36,60,3611137143,Hurley town
975,111,10407,11571,1164,630,2956,4107,19962,1753,24069,14623,36,60,3611139727,Kingston city
976,111,422,477,55,9,10,64,869,54,933,796,36,60,3611139738,Kingston town
977,111,4438,4785,347,324,681,1157,9976,542,11133,8429,36,60,3611142994,Lloyd town
978,111,2503,3080,577,112,66,310,5348,299,5658,4871,36,60,3611145458,Marbletown town
979,111,3426,3794,368,99,494,1022,7690,333,8712,6764,36,60,3611145722,Marlborough town
980,111,4906,5358,452,775,751,1835,12572,800,14407,10246,36,60,3611150562,New Paltz town
981,111,1923,2564,641,59,47,248,3978,232,4226,3640,36,60,3611154749,Olive town
982,111,4032,4412,380,87,521,2055,8369,594,10424,7167,36,60,3611158552,Plattekill town
983,111,3046,4062,1016,107,130,495,6777,422,7272,6118,36,60,3611163011,Rochester town
984,111,2570,2931,361,72,111,361,5421,325,5782,4913,36,60,3611163737,Rosendale town
985,111,8300,9370,1070,280,386,1468,17570,992,19038,15912,36,60,3611165299,Saugerties town
986,111,1419,2482,1063,51,36,230,2636,193,2866,2356,36,60,3611166597,Shandaken town
987,111,4053,4418,365,165,1082,1863,11700,516,13563,9937,36,60,3611166674,Shawangunk town
988,111,5229,5714,485,320,592,1176,11484,725,12660,9847,36,60,3611175935,Ulster town
989,111,4504,5943,1439,193,1569,2925,9846,783,12771,7301,36,60,3611178828,Wawarsing town
990,111,3135,4250,1115,158,116,348,5939,340,6287,5325,36,60,3611183052,Woodstock town
1036,119,5758,6314,556,589,726,2910,14399,660,17309,12424,36,60,3611905320,Bedford town
1037,119,15288,16229,941,1679,2494,8547,33998,1884,42545,27941,36,60,3611918410,Cortlandt town
1038,119,13595,14410,815,3200,1036,3117,31524,1436,34641,25852,36,60,3611921820,Eastchester town
1039,119,35776,37565,1789,11602,10141,16821,78576,4533,95397,52300,36,60,3611930367,Greenburgh town
1040,119,8747,9274,527,3231,745,4402,23816,1060,28218,18780,36,60,3611932413,Harrison town
1041,119,4495,4867,372,435,191,969,11296,563,12265,10107,36,60,3611942136,Lewisboro town
1042,119,11423,11969,546,1544,921,5671,26087,1532,31758,22090,36,60,3611944842,Mamaroneck town
1043,119,4271,4465,194,513,439,4569,6390,362,10959,5076,36,60,3611948895,Mount Kisco town
1044,119,14595,15221,626,2501,1260,9259,35177,1486,44436,29930,36,60,3611949011,Mount Pleasant town
1045,119,28286,30350,2064,1398,44655,14003,59890,4760,73893,9077,36,60,3611949121,Mount Vernon city
1046,119,5918,6160,242,2144,267,1243,17068,833,18311,13824,36,60,3611950078,New Castle town
1047,119,28702,30531,1829,3859,14324,26257,53469,3277,79726,32009,36,60,3611950617,New Rochelle city
1048,119,4098,4310,212,793,196,1448,10960,460,12408,9511,36,60,3611951693,North Castle town
1049,119,1887,2126,239,120,83,594,4649,176,5243,4270,36,60,3611953517,North Salem town
1050,119,14077,14975,898,2195,4096,14493,25568,1345,40061,17932,36,60,3611955541,Ossining town
1051,119,9813,10464,651,725,4693,11160,14271,1133,25431,7720,36,60,3611956979,Peekskill city
1052,119,4323,4490,167,844,717,1656,11422,831,13078,9030,36,60,3611957012,Pelham town
1053,119,1860,2076,216,165,65,344,4738,244,5082,4264,36,60,3611959685,Pound Ridge town
1054,119,5654,6038,384,1185,189,1388,15204,778,16592,13052,36,60,3611964309,Rye city
1055,119,16909,17678,769,1961,1757,23918,25695,1761,49613,20216,36,60,3611964320,Rye town
1056,119,5510,5747,237,3816,220,922,17331,1046,18253,12249,36,60,3611965442,Scarsdale town
1057,119,8457,9010,553,776,278,1907,19634,668,21541,17912,36,60,3611968308,Somers town
1058,119,24162,25494,1332,4747,6746,19426,40133,2398,59559,26242,36,60,3611981677,White Plains city
1059,119,80548,85528,4980,12915,33509,89065,122504,7110,211569,68970,36,60,3611984000,Yonkers city
1060,119,13144,13672,528,1970,1262,5245,31324,1186,36569,26906,36,60,3611984077,Yorktown town
23888,000,1795,1857,62,1700,25,468,4752,160,5220,2867,36,160,3601011,Albertson CDP
23899,000,770,1776,1006,18,35,186,1638,63,1824,1522,36,160,3601594,Amagansett CDP
23902,000,3846,4015,169,163,876,1761,7739,297,9500,6403,36,160,3602044,Amityville village
23911,000,969,1164,195,26,52,476,2071,74,2547,1919,36,160,3602374,Aquebogue CDP
23918,000,231,296,65,6,2,31,561,21,592,532,36,160,3602737,Asharoken village
23920,000,763,1046,283,28,3,83,1624,60,1707,1533,36,160,3602968,Atlantic Beach village
23928,000,4544,4732,188,294,199,1067,11121,407,12188,10221,36,160,3603408,Babylon village
23930,000,1081,1656,575,21,67,309,2454,76,2763,2290,36,160,3604055,Baiting Hollow CDP
23931,000,10702,11092,390,1576,12989,7588,26331,1935,33919,9831,36,160,3604143,Baldwin CDP
23939,000,1026,1062,36,156,69,504,2086,99,2590,1762,36,160,3604550,Barnum Island CDP
23944,000,394,425,31,74,7,173,818,37,991,700,36,160,3604803,Baxter Estates village
23945,000,845,888,43,28,42,228,1889,53,2117,1766,36,160,3604891,Bay Park CDP
23946,000,3245,3506,261,142,161,754,7855,251,8609,7301,36,160,3604913,Bayport CDP
23947,000,9667,10126,459,1236,5044,11127,18117,1177,29244,10660,36,160,3604935,Bay Shore CDP
23948,000,2518,2691,173,140,32,704,6044,181,6748,5691,36,160,3605034,Bayville village
23949,000,2210,2266,56,301,1019,3470,4256,375,7726,2561,36,160,3605039,Baywood CDP
23955,000,384,388,4,62,36,121,1052,58,1173,896,36,160,3605639,Bellerose village
23956,000,670,692,22,782,151,655,1674,140,2329,601,36,160,3605661,Bellerose Terrace CDP
23957,000,287,312,25,42,8,54,754,32,808,672,36,160,3605672,Belle Terre village
23959,000,5572,5776,204,737,242,1570,14727,511,16297,13237,36,160,3605738,Bellmore CDP
23960,000,938,1170,232,34,46,118,2085,81,2203,1924,36,160,3605771,Bellport village
23964,000,5810,6072,262,2066,151,1735,14923,414,16658,12292,36,160,3606387,Bethpage CDP
23977,000,2029,2132,103,87,42,287,4869,141,5156,4599,36,160,3607069,Blue Point CDP
23978,000,3581,3720,139,349,170,1040,8812,219,9852,8074,36,160,3607157,Bohemia CDP
23984,000,13658,14127,469,1134,6766,47072,15315,1599,62387,5816,36,160,3608026,Brentwood CDP
23990,000,1136,2632,1496,71,199,417,2536,106,2953,2160,36,160,3608136,Bridgehampton CDP
23995,000,1135,1160,25,46,82,250,2931,85,3181,2718,36,160,3608323,Brightwaters village
24001,000,1097,1177,80,34,190,303,3027,117,3330,2686,36,160,3609000,Brookhaven CDP
24003,000,625,661,36,390,45,152,2787,79,2939,2273,36,160,3610132,Brookville village
24018,000,2779,3016,237,47,414,1095,4839,175,5934,4203,36,160,3611781,Calverton CDP
24031,000,25,35,10,0,0,4,44,1,48,43,36,160,3612402,Captree CDP
24032,000,1825,1908,83,488,148,740,4265,195,5005,3434,36,160,3612419,Carle Place CDP
24046,000,2265,2413,148,189,151,1040,6334,191,7374,5803,36,160,3613233,Cedarhurst village
24049,000,10008,10405,397,2658,964,5147,25833,1036,30980,21175,36,160,3613376,Centereach CDP
24050,000,2770,2960,190,109,243,1129,6917,257,8046,6308,36,160,3613420,Center Moriches CDP
24051,000,2171,2272,101,108,20,306,5516,207,5822,5181,36,160,3613442,Centerport CDP
24053,000,9870,10344,474,1085,7005,21856,14858,1354,36714,5414,36,160,3613552,Central Islip CDP
24055,000,160,229,69,19,2,31,376,4,407,351,36,160,3613618,Centre Island village
24093,000,975,1020,45,119,10,203,2861,111,3064,2621,36,160,3616958,Cold Spring Harbor CDP
24096,000,12009,12312,303,2536,632,2914,33622,986,36536,29468,36,160,3617530,Commack CDP
24108,000,7684,8024,340,524,1836,9634,13795,692,23429,10743,36,160,3618146,Copiague CDP
24109,000,15234,16060,826,2197,4703,7454,32766,1703,40220,24163,36,160,3618157,Coram CDP
24117,000,125,138,13,0,0,18,275,11,293,264,36,160,3618597,Cove Neck village
24131,000,1400,2121,721,28,36,417,3020,70,3437,2886,36,160,3619466,Cutchogue CDP
24138,000,9510,9839,329,3322,3982,5206,23631,1127,28837,15200,36,160,3619972,Deer Park CDP
24147,000,17,34,17,4,0,16,34,6,50,24,36,160,3620379,Dering Harbor village
24151,000,8016,8315,299,4397,1410,2224,23956,1050,26180,17099,36,160,3620687,Dix Hills CDP
24165,000,860,994,134,18,8,128,1973,49,2101,1898,36,160,3621578,East Atlantic Beach CDP
24170,000,2177,2275,98,528,785,1706,4911,214,6617,3384,36,160,3621985,East Farmingdale CDP
24174,000,668,1774,1106,24,24,177,1340,39,1517,1253,36,160,3622183,East Hampton village
24175,000,1889,2856,967,75,219,2396,2981,163,5377,2524,36,160,3622200,East Hampton North CDP
24177,000,2218,2294,76,888,85,303,6981,200,7284,5808,36,160,3622260,East Hills village
24178,000,4769,4918,149,302,209,1454,12477,399,13931,11567,36,160,3622315,East Islip CDP
24181,000,494,946,452,11,11,109,939,36,1048,881,36,160,3622447,East Marion CDP
24182,000,6884,7112,228,486,2415,2775,17079,704,19854,13474,36,160,3622480,East Massapequa CDP
24183,000,12361,12951,590,6758,1668,6048,31748,1283,37796,22039,36,160,3622502,East Meadow CDP
24184,000,2120,2349,229,84,112,571,5375,178,5946,5001,36,160,3622546,East Moriches CDP
24186,000,6996,7246,250,591,205,2120,17928,593,20048,16539,36,160,3622612,East Northport CDP
24187,000,968,998,30,111,26,222,2570,71,2792,2362,36,160,3622623,East Norwich CDP
24188,000,8221,8612,391,522,982,4975,16605,804,21580,14297,36,160,3622733,East Patchogue CDP
24189,000,907,1015,108,19,32,300,1919,82,2219,1786,36,160,3622810,Eastport CDP
24190,000,2152,3104,952,77,36,1029,4528,147,5557,4268,36,160,3622832,East Quogue CDP
24193,000,3814,4000,186,327,296,1451,8708,296,10159,7789,36,160,3622876,East Rockaway village
24194,000,3891,4038,147,1216,110,799,10199,389,10998,8484,36,160,3622964,East Setauket CDP
24195,000,2181,2248,67,183,121,647,6194,270,6841,5620,36,160,3622980,East Shoreham CDP
24197,000,828,864,36,340,5,150,2495,90,2645,2060,36,160,3623217,East Williston village
24199,000,507,570,63,22,5,60,1274,30,1334,1217,36,160,3623316,Eatons Neck CDP
24214,000,9896,10270,374,5290,15460,8024,27241,2209,35265,4282,36,160,3624273,Elmont CDP
24216,000,3730,3846,116,941,535,1387,10039,373,11426,8190,36,160,3624405,Elwood CDP
24230,000,3627,3868,241,618,280,1291,7175,258,8466,6019,36,160,3625384,Farmingdale village
24231,000,4706,4845,139,709,510,2659,12324,585,14983,10520,36,160,3625417,Farmingville CDP
24236,000,393,3357,2964,17,29,99,678,47,777,585,36,160,3625839,Fire Island CDP
24238,000,180,609,429,11,3,32,392,26,424,352,36,160,3625923,Fishers Island CDP
24241,000,1492,1714,222,37,421,2764,2334,169,5098,1707,36,160,3626121,Flanders CDP
24243,000,5746,5961,215,1889,262,2067,14105,459,16172,11495,36,160,3626264,Floral Park village
24245,000,1473,1529,56,904,32,280,4514,155,4794,3423,36,160,3626352,Flower Hill village
24257,000,3299,3430,131,227,75,619,9033,281,9652,8450,36,160,3626946,Fort Salonga CDP
24261,000,9903,10231,328,3947,1385,5979,24924,988,30903,18604,36,160,3627309,Franklin Square CDP
24265,000,13501,14137,636,792,12830,21312,23160,1906,44472,7632,36,160,3627485,Freeport village
24276,000,7513,7715,202,1589,212,1486,21786,641,23272,19344,36,160,3628178,Garden City village
24277,000,2499,2592,93,3742,223,999,6986,319,7985,2702,36,160,3628189,Garden City Park CDP
24278,000,1401,1454,53,348,42,475,3644,94,4119,3160,36,160,3628200,Garden City South CDP
24289,000,86,137,51,2,2,2,183,6,185,173,36,160,3628990,Gilgo CDP
24292,000,10099,10793,694,1449,1595,9752,18613,794,28365,14775,36,160,3629113,Glen Cove city
24293,000,1718,1787,69,330,32,546,4291,143,4837,3786,36,160,3629245,Glen Head CDP
24297,000,1375,1422,47,236,25,355,3593,120,3948,3212,36,160,3629421,Glenwood Landing CDP
24300,000,1059,1131,72,91,1478,1479,2502,284,3981,649,36,160,3629509,Gordon Heights CDP
24310,000,3620,3883,263,1497,145,1204,9941,532,11145,7767,36,160,3630169,Great Neck village
24311,000,879,937,58,563,16,122,2868,130,2990,2159,36,160,3630191,Great Neck Estates village
24312,000,380,397,17,390,3,30,1238,33,1268,812,36,160,3630202,Great Neck Gardens CDP
24313,000,3702,3954,252,1960,135,626,6856,238,7482,4523,36,160,3630213,Great Neck Plaza village
24314,000,798,842,44,36,29,155,1850,33,2005,1752,36,160,3630235,Great River CDP
24318,000,4524,4669,145,773,1660,2420,11241,479,13661,8329,36,160,3630543,Greenlawn CDP
24319,000,950,1277,327,25,197,957,1626,104,2583,1300,36,160,3630576,Greenport village
24320,000,1056,1658,602,29,85,388,1894,51,2282,1729,36,160,3630581,Greenport West CDP
24321,000,344,373,29,270,8,118,951,51,1069,622,36,160,3630598,Greenvale CDP
24334,000,1034,1099,65,60,41,176,2351,81,2527,2169,36,160,3631445,Halesite CDP
24342,000,5669,7879,2210,177,167,5715,9513,410,15228,8759,36,160,3631896,Hampton Bays CDP
24348,000,177,188,11,45,0,5,557,24,562,488,36,160,3632094,Harbor Hills CDP
24349,000,473,497,24,22,26,145,1291,42,1436,1201,36,160,3632105,Harbor Isle CDP
24357,000,7180,7384,204,1481,503,2080,18003,579,20083,15440,36,160,3632732,Hauppauge CDP
24361,000,475,537,62,59,4,177,1343,68,1520,1212,36,160,3632963,Head of the Harbor village
24363,000,16299,16954,655,1242,23041,29640,29529,2179,59169,3067,36,160,3633139,Hempstead village
24368,000,1330,1380,50,2522,27,196,4202,166,4398,1487,36,160,3634198,Herricks CDP
24371,000,2532,2698,166,630,303,1086,6176,254,7262,4989,36,160,3634286,Hewlett CDP
24372,000,140,144,4,40,7,20,474,27,494,400,36,160,3634297,Hewlett Bay Park village
24373,000,418,442,24,59,13,59,1231,35,1290,1124,36,160,3634308,Hewlett Harbor village
24374,000,149,161,12,22,12,30,539,14,569,491,36,160,3634319,Hewlett Neck village
24375,000,13477,13889,412,14178,1129,8003,35866,1486,43869,19073,36,160,3634374,Hicksville CDP
24386,000,9439,9714,275,1194,701,3166,23321,703,26487,20723,36,160,3635056,Holbrook CDP
24390,000,6448,6646,198,1040,455,2728,16209,584,18937,14130,36,160,3635254,Holtsville CDP
24405,000,7920,8341,421,568,368,1458,18187,639,19645,16612,36,160,3636233,Huntington CDP
24406,000,552,593,41,29,5,56,1390,55,1446,1301,36,160,3637022,Huntington Bay village
24407,000,10517,10943,426,1588,3012,15793,19085,1097,34878,13388,36,160,3637044,Huntington Station CDP
24413,000,3180,3355,175,431,1920,5997,5343,312,11340,2680,36,160,3637583,Inwood CDP
24416,000,1044,1087,43,219,437,1135,2432,125,3567,1651,36,160,3637840,Islandia village
24417,000,1725,1851,126,203,149,1645,3283,202,4928,2729,36,160,3637847,Island Park village
24418,000,6407,6605,198,635,889,3574,14844,617,18418,12703,36,160,3637869,Islip CDP
24419,000,1698,1774,76,147,146,836,4487,171,5323,4023,36,160,3638022,Islip Terrace CDP
24422,000,689,1126,437,7,22,177,1432,22,1609,1381,36,160,3638253,Jamesport CDP
24429,000,4597,4818,221,7168,301,595,14213,375,14808,6369,36,160,3638539,Jericho CDP
24439,000,430,457,27,282,4,15,1211,48,1226,877,36,160,3639309,Kensington village
24444,000,6311,6564,253,554,179,1414,15671,439,17085,14499,36,160,3639672,Kings Park CDP
24445,000,1293,1416,123,307,88,214,5405,330,5619,4680,36,160,3639694,Kings Point village
24456,000,3910,4078,168,920,277,1252,9820,324,11072,8299,36,160,3640530,Lake Grove village
24463,000,6645,7223,578,1086,687,2588,16031,698,18619,13560,36,160,3640838,Lake Ronkonkoma CDP
24464,000,820,858,38,1587,12,103,2725,87,2828,1039,36,160,3640937,Lake Success village
24465,000,1567,1625,58,157,4249,1123,4954,396,6077,152,36,160,3641003,Lakeview CDP
24472,000,614,708,94,81,5,117,1764,65,1881,1613,36,160,3641432,Lattingtown village
24473,000,550,800,250,15,6,249,1246,43,1495,1182,36,160,3641465,Laurel CDP
24474,000,594,630,36,168,15,92,1848,62,1940,1603,36,160,3641487,Laurel Hollow village
24476,000,2185,2432,247,93,85,308,6501,228,6809,6095,36,160,3641553,Lawrence village
24480,000,16634,17123,489,5900,675,8617,43141,1713,51758,34853,36,160,3642081,Levittown CDP
24483,000,1161,1302,141,52,10,148,2571,55,2719,2454,36,160,3642279,Lido Beach CDP
24489,000,9260,9712,452,729,629,4458,22690,784,27148,20548,36,160,3642554,Lindenhurst village
24498,000,1150,1246,96,136,9,206,3365,120,3571,3100,36,160,3643005,Lloyd Harbor village
24501,000,1268,1339,71,124,90,861,2710,88,3571,2408,36,160,3643192,Locust Valley CDP
24503,000,15360,16771,1411,1107,1820,5370,29659,1201,35029,25531,36,160,3643335,Long Beach city
24509,000,7459,7798,339,1270,1345,3847,16591,766,20438,13210,36,160,3643874,Lynbrook village
24525,000,3068,3159,91,488,464,1116,7444,329,8560,6163,36,160,3644787,Malverne village
24526,000,186,194,8,47,60,63,475,34,538,334,36,160,3644792,Malverne Park Oaks CDP
24529,000,2790,2947,157,1863,597,868,7308,242,8176,4606,36,160,3644897,Manhasset CDP
24530,000,1119,1154,35,1974,32,237,3412,119,3649,1287,36,160,3644908,Manhasset Hills CDP
24533,000,2534,2699,165,995,106,2487,4469,173,6956,3195,36,160,3645106,Manorhaven village
24534,000,5159,5364,205,253,326,1428,12889,496,14317,11814,36,160,3645139,Manorville CDP
24543,000,7152,7375,223,432,112,1586,19769,564,21355,18661,36,160,3645986,Massapequa CDP
24544,000,5759,5913,154,306,78,1235,15874,385,17109,15105,36,160,3645997,Massapequa Park village
24546,000,4557,4792,235,390,1440,4605,10799,778,15404,8191,36,160,3646074,Mastic CDP
24547,000,4677,5198,521,208,1771,3160,11039,866,14199,8194,36,160,3646085,Mastic Beach CDP
24548,000,284,323,39,46,1,77,770,13,847,710,36,160,3646107,Matinecock village
24549,000,1805,2527,722,39,65,516,3806,116,4322,3586,36,160,3646140,Mattituck CDP
24556,000,8095,8416,321,758,1545,5973,18274,891,24247,15080,36,160,3646404,Medford CDP
24559,000,7368,7777,409,1997,794,1288,17996,551,19284,14654,36,160,3646514,Melville CDP
24562,000,7436,7672,236,928,339,2066,19974,633,22040,18074,36,160,3646668,Merrick CDP
24566,000,4375,4588,213,282,1308,1290,9256,440,10546,7226,36,160,3646976,Middle Island CDP
24572,000,4001,4157,156,348,178,882,10841,324,11723,9991,36,160,3647306,Miller Place CDP
24574,000,349,414,65,67,20,132,922,33,1054,802,36,160,3647405,Mill Neck village
24579,000,8311,8776,465,2860,528,4071,16729,841,20800,12500,36,160,3647636,Mineola village
24587,000,1804,4487,2683,62,86,804,3514,171,4318,3195,36,160,3648054,Montauk CDP
24595,000,1361,1460,99,54,321,390,2636,160,3026,2101,36,160,3648450,Moriches CDP
24605,000,4131,4339,208,599,157,984,10639,327,11623,9556,36,160,3649066,Mount Sinai CDP
24609,000,821,842,21,378,29,149,2660,112,2809,2141,36,160,3649231,Munsey Park village
24611,000,1057,1141,84,1189,54,159,3353,83,3512,2027,36,160,3649330,Muttontown village
24615,000,179,480,301,11,7,29,339,14,368,307,36,160,3649424,Napeague CDP
24625,000,4560,4707,147,838,208,1186,12021,400,13207,10575,36,160,3649825,Nesconset CDP
24631,000,3185,3402,217,422,4895,7917,6282,298,14199,667,36,160,3650067,New Cassel CDP
24639,000,3260,3376,116,4063,176,1413,8844,352,10257,4253,36,160,3650397,New Hyde Park village
24644,000,187,316,129,2,1,38,365,8,403,354,36,160,3650727,New Suffolk CDP
24652,000,578,625,47,40,6,78,1486,48,1564,1392,36,160,3651286,Nissequogue village
24655,000,5304,5628,324,280,8834,6899,11744,952,18643,1678,36,160,3651396,North Amityville CDP
24656,000,227,246,19,10,141,324,439,26,763,262,36,160,3651418,Northampton CDP
24657,000,6229,6430,201,1007,1732,3381,14546,653,17927,11154,36,160,3651440,North Babylon CDP
24660,000,4579,4742,163,940,2663,13376,6243,608,19619,2032,36,160,3651495,North Bay Shore CDP
24661,000,6723,6866,143,1470,645,2374,18209,651,20583,15443,36,160,3651517,North Bellmore CDP
24662,000,3484,3670,186,322,2532,4451,7449,712,11900,3883,36,160,3651528,North Bellport CDP
24670,000,1505,1535,30,94,137,728,3538,110,4266,3197,36,160,3652078,North Great River CDP
24671,000,464,732,268,18,8,47,1115,27,1162,1062,36,160,3652188,North Haven village
24672,000,2290,2500,210,1878,53,151,5313,137,5464,3245,36,160,3653022,North Hills village
24674,000,3861,4016,155,445,719,3390,8610,406,12000,7040,36,160,3653198,North Lindenhurst CDP
24675,000,233,234,1,68,70,113,634,28,747,468,36,160,3653231,North Lynbrook CDP
24676,000,5963,6103,140,459,107,1541,16288,353,17829,15369,36,160,3653253,North Massapequa CDP
24677,000,4023,4137,114,668,305,1332,10906,367,12238,9566,36,160,3653264,North Merrick CDP
24678,000,4887,5024,137,7238,108,1230,14427,493,15657,6588,36,160,3653275,North New Hyde Park CDP
24679,000,2314,2421,107,131,179,1792,4959,202,6751,4447,36,160,3653319,North Patchogue CDP
24680,000,2983,3128,145,146,53,401,6946,184,7347,6563,36,160,3653396,Northport village
24682,000,2158,3587,1429,125,60,1080,4381,250,5461,3946,36,160,3653561,North Sea CDP
24685,000,5447,5638,191,3515,8111,2677,15520,1259,18197,2635,36,160,3653748,North Valley Stream CDP
24687,000,620,813,193,18,19,224,1342,35,1566,1270,36,160,3653775,Northville CDP
24688,000,4174,4282,108,375,138,1416,10515,329,11931,9673,36,160,3653792,North Wantagh CDP
24689,000,1912,3512,1600,110,83,863,3774,203,4637,3378,36,160,3653852,Northwest Harbor CDP
24693,000,1797,2832,1035,76,60,578,3747,130,4325,3481,36,160,3654056,Noyack CDP
24696,000,113,233,120,18,5,20,248,0,268,225,36,160,3654111,Oak Beach CDP
24697,000,3109,3240,131,103,86,517,6913,174,7430,6550,36,160,3654144,Oakdale CDP
24699,000,76,591,515,0,2,10,143,8,153,133,36,160,3654430,Ocean Beach village
24700,000,11212,11552,340,1181,658,4529,28108,1010,32637,25259,36,160,3654441,Oceanside CDP
24704,000,2390,2836,446,597,17,340,6063,156,6403,5293,36,160,3654551,Old Bethpage CDP
24705,000,692,718,26,260,31,120,1900,51,2020,1558,36,160,3654562,Old Brookville village
24706,000,334,365,31,74,2,42,851,37,893,738,36,160,3654617,Old Field village
24708,000,1080,1209,129,977,586,318,3971,174,4289,2234,36,160,3654705,Old Westbury village
24717,000,470,800,330,10,2,41,958,26,999,920,36,160,3655321,Orient CDP
24729,000,2831,2964,133,236,228,1396,5653,196,7049,4993,36,160,3655992,Oyster Bay CDP
24730,000,695,759,64,270,22,113,2152,86,2265,1774,36,160,3656011,Oyster Bay Cove village
24740,000,5456,5776,320,242,662,3520,8888,380,12408,7604,36,160,3656660,Patchogue village
24746,000,300,495,195,6,13,83,609,22,692,568,36,160,3656968,Peconic CDP
24768,000,2863,2941,78,815,172,1093,8424,260,9517,7177,36,160,3658409,Plainedge CDP
24769,000,8861,9207,346,5548,131,1598,25502,689,27100,19134,36,160,3658442,Plainview CDP
24770,000,411,445,34,165,9,67,1381,38,1448,1169,36,160,3658475,Plandome village
24771,000,327,333,6,185,0,71,938,35,1009,718,36,160,3658486,Plandome Heights village
24772,000,252,272,20,91,2,50,743,12,793,638,36,160,3658497,Plandome Manor village
24780,000,668,855,187,18,8,62,1465,32,1527,1407,36,160,3658849,Point Lookout CDP
24783,000,364,374,10,91,8,43,860,18,903,743,36,160,3659157,Poquott village
24790,000,3291,3471,180,537,109,712,7250,346,7962,6258,36,160,3659355,Port Jefferson village
24791,000,2859,2985,126,512,302,1570,6380,289,7950,5277,36,160,3659377,Port Jefferson Station CDP
24796,000,5925,6269,344,1502,312,2524,14229,668,16753,11747,36,160,3659520,Port Washington CDP
24797,000,1324,1377,53,296,28,297,2863,104,3160,2435,36,160,3659531,Port Washington North village
24808,000,364,625,261,20,40,279,734,45,1013,629,36,160,3660408,Quiogue CDP
24809,000,688,1613,925,58,41,134,1528,61,1662,1368,36,160,3660422,Quogue village
24821,000,1200,1644,444,35,36,351,2759,89,3110,2599,36,160,3661142,Remsenburg-Speonk CDP
24831,000,5877,6336,459,333,723,1145,12126,409,13271,10661,36,160,3661665,Ridge CDP
24834,000,5365,5763,398,225,1716,5674,9319,525,14993,6853,36,160,3661973,Riverhead CDP
24836,000,838,910,72,26,539,1176,1706,87,2882,1054,36,160,3662066,Riverside CDP
24840,000,9669,9991,322,617,1314,3029,22987,737,26016,20319,36,160,3663264,Rockville Centre village
24841,000,4826,5285,459,239,171,1651,11982,499,13633,11073,36,160,3663319,Rocky Point CDP
24846,000,6496,6701,205,1166,548,2814,16141,786,18955,13641,36,160,3663473,Ronkonkoma CDP
24847,000,4242,4441,199,169,8519,8406,9660,629,18066,343,36,160,3663506,Roosevelt CDP
24850,000,1309,1441,132,465,44,513,2475,94,2988,1872,36,160,3663770,Roslyn village
24851,000,391,407,16,169,10,42,1276,35,1318,1062,36,160,3663792,Roslyn Estates village
24852,000,330,379,49,196,4,63,1004,48,1067,756,36,160,3663803,Roslyn Harbor village
24853,000,2108,2218,110,2239,375,700,6047,230,6747,3203,36,160,3663814,Roslyn Heights CDP
24861,000,314,339,25,418,3,30,948,35,978,492,36,160,3664232,Russell Gardens village
24865,000,281,293,12,94,1,18,971,36,989,840,36,160,3664430,Saddle Rock village
24866,000,130,139,9,41,3,1,427,28,428,355,36,160,3664441,Saddle Rock Estates CDP
24867,000,305,718,413,28,9,60,710,49,770,624,36,160,3664452,Sagaponack village
24868,000,1202,2013,811,35,206,301,2471,130,2772,2100,36,160,3664485,Sag Harbor village
24870,000,4729,4921,192,513,117,1037,12450,320,13487,11500,36,160,3664584,St. James CDP
24876,000,3989,4106,117,2383,321,2484,10134,436,12618,6994,36,160,3664842,Salisbury CDP
24879,000,31,432,401,2,0,3,110,3,113,105,36,160,3664881,Saltaire village
24883,000,878,947,69,261,32,117,2595,53,2712,2249,36,160,3665035,Sands Point village
24891,000,5935,6228,293,283,186,1148,15421,463,16569,14489,36,160,3665409,Sayville CDP
24906,000,1954,2086,132,148,82,475,4587,197,5062,4160,36,160,3666047,Sea Cliff village
24907,000,5293,5475,182,428,111,1239,14012,422,15251,13051,36,160,3666058,Seaford CDP
24908,000,1556,1607,51,2647,58,197,4847,156,5044,1986,36,160,3666102,Searingtown CDP
24909,000,6838,7167,329,1495,885,4129,17133,740,21262,14013,36,160,3666212,Selden CDP
24912,000,1413,1531,118,346,67,257,3729,168,3986,3148,36,160,3666465,Setauket CDP
24914,000,703,1145,442,18,13,181,1421,61,1602,1329,36,160,3666828,Shelter Island CDP
24915,000,761,1552,791,24,8,92,1509,53,1601,1424,36,160,3666850,Shelter Island Heights CDP
24920,000,845,1537,692,51,45,702,1580,80,2282,1404,36,160,3667048,Shinnecock Hills CDP
24921,000,8262,8782,520,724,1907,6200,20160,1261,26360,16268,36,160,3667070,Shirley CDP
24923,000,188,232,44,13,11,45,516,25,561,467,36,160,3667191,Shoreham village
24939,000,8495,8800,305,1007,351,2484,23145,821,25629,20966,36,160,3667851,Smithtown CDP
24945,000,2728,2943,215,136,125,758,6658,286,7416,6111,36,160,3668374,Sound Beach CDP
24946,000,1701,3438,1737,129,236,792,3758,175,4550,3218,36,160,3668462,Southampton village
24953,000,4765,4902,137,773,284,2078,12267,388,14345,10822,36,160,3669001,South Farmingdale CDP
24954,000,507,534,27,240,834,384,1357,125,1741,158,36,160,3669023,South Floral Park village
24956,000,1029,1074,45,79,506,836,2570,133,3406,1852,36,160,3669188,South Hempstead CDP
24958,000,3290,3418,128,773,210,1428,8133,286,9561,6864,36,160,3669254,South Huntington CDP
24964,000,2617,4222,1605,78,66,779,5261,176,6040,4941,36,160,3669452,Southold CDP
24966,000,1995,2063,68,1376,1674,793,5593,418,6386,2125,36,160,3669892,South Valley Stream CDP
24974,000,2973,4482,1509,128,112,2728,5358,235,8086,4883,36,160,3670387,Springs CDP
24982,000,691,709,18,149,39,256,1736,68,1992,1480,36,160,3671267,Stewart Manor village
24986,000,4831,5033,202,1667,217,826,12641,447,13467,10310,36,160,3671608,Stony Brook CDP
24987,000,72,115,43,1829,3516,1748,8661,658,10409,2658,36,160,3671620,Stony Brook University CDP
24996,000,6033,6293,260,6944,118,971,18288,581,19259,10645,36,160,3672554,Syosset CDP
25002,000,3853,4006,153,430,392,2411,9061,349,11472,7890,36,160,3673352,Terryville CDP
25006,000,984,1024,40,1265,37,121,2638,91,2759,1245,36,160,3673605,Thomaston village
25021,000,628,995,367,35,83,342,1163,58,1505,987,36,160,3675572,Tuckahoe CDP
25030,000,7850,8255,405,1119,11543,12934,19539,1233,32473,5644,36,160,3676089,Uniondale CDP
25034,000,1642,1706,64,2119,60,323,4035,154,4358,1702,36,160,3676287,University Gardens CDP
25035,000,557,612,55,278,31,87,1699,67,1786,1323,36,160,3676331,Upper Brookville village
25044,000,12494,12925,431,6503,9343,10672,29962,2666,40634,11450,36,160,3676705,Valley Stream village
25054,000,563,573,10,49,23,92,1643,50,1735,1521,36,160,3677519,Village of the Branch village
25059,000,2789,3223,434,102,160,690,7041,267,7731,6512,36,160,3677772,Wading River CDP
25061,000,386,916,530,23,17,142,762,34,904,688,36,160,3677805,Wainscott CDP
25070,000,6062,6228,166,495,59,1399,17214,449,18613,16211,36,160,3678146,Wantagh CDP
25082,000,958,2125,1167,93,28,189,2317,117,2506,2079,36,160,3678575,Water Mill CDP
25097,000,14523,15139,616,1455,5291,8202,35011,1538,43213,26727,36,160,3679246,West Babylon CDP
25098,000,1742,1809,67,137,133,495,4130,180,4625,3680,36,160,3679301,West Bay Shore CDP
25099,000,5083,5265,182,1481,2741,5143,10721,624,15864,5875,36,160,3679444,Westbury village
25109,000,1291,2206,915,45,80,654,2967,105,3621,2737,36,160,3680170,Westhampton CDP
25110,000,858,2455,1597,49,33,319,1831,55,2150,1694,36,160,3680181,Westhampton Beach village
25111,000,28,271,243,2,0,5,121,0,126,119,36,160,3680186,West Hampton Dunes village
25113,000,6093,6315,222,1438,2249,3956,15879,870,19835,11322,36,160,3680225,West Hempstead CDP
25114,000,1968,2024,56,377,108,530,4855,139,5385,4231,36,160,3680258,West Hills CDP
25116,000,8763,9021,258,528,166,2659,24389,617,27048,23078,36,160,3680302,West Islip CDP
25125,000,1765,2109,344,72,45,342,4530,131,4872,4282,36,160,3680885,West Sayville CDP
25130,000,1442,1493,51,395,2619,878,4262,329,5140,919,36,160,3681419,Wheatley Heights CDP
25139,000,2691,2787,96,1448,81,753,6838,284,7591,5025,36,160,3682117,Williston Park village
25151,000,3155,3402,247,1611,127,532,8803,184,9335,6881,36,160,3682744,Woodbury CDP
25153,000,5199,5485,286,586,757,960,17709,575,18669,15791,36,160,3682942,Woodmere CDP
25155,000,293,306,13,33,3,28,869,22,897,811,36,160,3682986,Woodsburgh village
25161,000,3290,3548,258,163,6352,5487,7503,537,12990,451,36,160,3683294,Wyandanch CDP
25164,000,2280,2480,200,145,278,793,5181,283,5974,4475,36,160,3683426,Yaphank CDP
46,003,2327,2450,123,837,42,456,6392,252,6848,5261,34,60,3400300700,Allendale borough
47,003,587,676,89,593,54,121,1641,45,1762,949,34,60,3400301090,Alpine borough
48,003,9097,9387,290,7222,1894,9121,19200,806,28321,9278,34,60,3400305170,Bergenfield borough
49,003,2939,3026,87,748,585,4506,4272,325,8778,2614,34,60,3400306490,Bogota borough
50,003,2429,2563,134,608,132,1582,4790,195,6372,3855,34,60,3400310480,Carlstadt borough
51,003,10735,11435,700,3784,656,8954,16739,1114,25693,11185,34,60,3400313570,Cliffside Park borough
52,003,2762,2891,129,3009,83,725,7869,281,8594,4496,34,60,3400313810,Closter borough
53,003,3015,3157,142,2865,90,630,8525,265,9155,5305,34,60,3400315820,Cresskill borough
54,003,1598,1680,82,1562,41,270,4711,167,4981,2941,34,60,3400317530,Demarest borough
55,003,6408,6572,164,3081,503,3883,13980,549,17863,9847,34,60,3400318400,Dumont borough
56,003,4306,4585,279,1612,456,2556,7466,370,10022,5028,34,60,3400319510,East Rutherford borough
57,003,6742,7315,573,5071,772,1959,12377,600,14336,5934,34,60,3400320020,Edgewater borough
58,003,7652,7949,297,2367,1494,5898,15524,735,21422,10928,34,60,3400321300,Elmwood Park borough
59,003,2482,2600,118,709,108,948,6342,197,7290,5328,34,60,3400321450,Emerson borough
60,003,10909,11563,654,2863,7180,9639,19669,1129,29308,8497,34,60,3400321480,Englewood city
61,003,1846,1961,115,2534,107,341,5001,159,5342,2201,34,60,3400321510,Englewood Cliffs borough
62,003,12243,12649,406,4468,784,5369,29558,1001,34927,23305,34,60,3400322470,Fair Lawn borough
63,003,5021,5291,270,694,240,10018,5007,560,15025,3513,34,60,3400322560,Fairview borough
64,003,18451,19861,1410,16949,1192,5376,34815,1186,40191,15488,34,60,3400324420,Fort Lee borough
65,003,3722,4051,329,1051,172,786,10293,315,11079,8755,34,60,3400324990,Franklin Lakes borough
66,003,11773,12407,634,985,1684,12781,19874,807,32655,16398,34,60,3400325770,Garfield city
67,003,3934,4041,107,1617,163,848,11285,468,12133,9037,34,60,3400326640,Glen Rock borough
68,003,19132,20290,1158,4734,9558,19220,26810,1465,46030,11053,34,60,3400328680,Hackensack city
69,003,1594,1643,49,1049,35,299,4442,123,4741,3235,34,60,3400330150,Harrington Park borough
70,003,4535,4715,180,1421,333,2551,9574,354,12125,7466,34,60,3400330420,Hasbrouck Heights borough
71,003,1104,1148,44,545,51,191,3152,140,3343,2416,34,60,3400330540,Haworth borough
72,003,3502,3635,133,742,115,1138,9005,287,10143,7861,34,60,3400331920,Hillsdale borough
73,003,1416,1473,57,321,26,302,3956,134,4258,3475,34,60,3400332310,Ho-Ho-Kus borough
74,003,3359,3476,117,3876,202,1669,7635,301,9304,3256,34,60,3400340020,Leonia borough
75,003,4351,4527,176,2717,469,3468,7519,321,10987,4012,34,60,3400340680,Little Ferry borough
76,003,9971,10414,443,2194,2020,10838,15368,741,26206,10413,34,60,3400341100,Lodi borough
77,003,9069,9516,447,1587,688,6081,16438,775,22519,13388,34,60,3400342090,Lyndhurst township
78,003,9727,10109,382,2830,686,2204,23283,927,25487,18840,34,60,3400342750,Mahwah township
79,003,3717,3829,112,1442,605,2567,7513,323,10080,5143,34,60,3400344880,Maywood borough
80,003,2750,2887,137,241,70,734,6280,220,7014,5749,34,60,3400346110,Midland Park borough
81,003,3016,3115,99,1324,121,683,7753,239,8436,6069,34,60,3400347610,Montvale borough
82,003,1120,1149,29,351,20,1292,1841,79,3133,1391,34,60,3400347700,Moonachie borough
83,003,6276,6432,156,3420,796,3304,13619,573,16923,8830,34,60,3400351660,New Milford borough
84,003,6525,6749,224,1173,257,5109,11348,673,16457,9245,34,60,3400352320,North Arlington borough
85,003,1641,1700,59,1278,55,569,4192,145,4761,2714,34,60,3400353430,Northvale borough
86,003,1943,2032,89,1809,74,418,5223,144,5641,3196,34,60,3400353610,Norwood borough
87,003,4356,4561,205,605,119,1210,11538,444,12748,10370,34,60,3400353850,Oakland borough
88,003,1982,2083,101,1600,59,380,5508,176,5888,3673,34,60,3400354870,Old Tappan borough
89,003,2782,2850,68,1277,73,734,7510,271,8244,5889,34,60,3400354990,Oradell borough
90,003,7314,7668,354,11900,262,4862,15430,365,20292,2903,34,60,3400355770,Palisades Park borough
91,003,8448,8786,338,6966,459,2810,23888,907,26698,15556,34,60,3400355950,Paramus borough
92,003,3310,3435,125,631,91,936,7947,253,8883,6972,34,60,3400356130,Park Ridge borough
93,003,5488,5670,182,1134,127,1374,13424,452,14798,11711,34,60,3400361680,Ramsey borough
94,003,4050,4237,187,3319,200,3343,8158,358,11501,4281,34,60,3400362910,Ridgefield borough
95,003,4986,5269,283,1460,649,6189,7035,449,13224,4477,34,60,3400362940,Ridgefield Park village
96,003,8490,8814,324,4556,353,2069,23910,1215,25979,17786,34,60,3400363000,Ridgewood village
97,003,4191,4337,146,3434,283,1339,10710,344,12049,6649,34,60,3400363360,River Edge borough
98,003,3536,3644,108,993,117,731,9178,312,9909,7756,34,60,3400363690,River Vale township
99,003,2151,2227,76,602,208,1575,4239,175,5814,3254,34,60,3400363990,Rochelle Park township
100,003,69,81,12,27,10,33,374,10,407,327,34,60,3400364170,Rockleigh borough
101,003,7061,7370,309,2688,631,3395,15439,878,18834,11242,34,60,3400365280,Rutherford borough
102,003,5378,5618,240,1219,442,2748,11546,331,14294,9554,34,60,3400365340,Saddle Brook township
103,003,1246,1458,212,451,65,181,3191,125,3372,2550,34,60,3400365400,Saddle River borough
104,003,922,950,28,172,135,1256,1445,70,2701,1068,34,60,3400368970,South Hackensack township
105,003,13784,14430,646,4378,9180,8848,32398,1995,41246,16845,34,60,3400372360,Teaneck township
106,003,4913,5184,271,4711,240,1137,14272,602,15409,8719,34,60,3400372420,Tenafly borough
107,003,25,26,1,1,7,25,36,2,61,26,34,60,3400372480,Teterboro borough
108,003,2658,2785,127,1240,129,579,7774,285,8353,6120,34,60,3400375140,Upper Saddle River borough
109,003,3577,3691,114,640,126,1315,8743,276,10058,7701,34,60,3400376400,Waldwick borough
110,003,4825,5108,283,694,320,2299,9569,269,11868,8286,34,60,3400376490,Wallington borough
111,003,3278,3375,97,566,87,800,8485,247,9285,7585,34,60,3400377135,Washington township
112,003,4515,4716,201,928,448,1651,9631,394,11282,7861,34,60,3400380270,Westwood borough
113,003,2114,2235,121,536,46,407,5721,184,6128,4955,34,60,3400382300,Woodcliff Lake borough
114,003,3920,4057,137,1617,337,1738,8399,304,10137,6141,34,60,3400382570,Wood-Ridge borough
115,003,5569,5769,200,872,93,1315,15270,538,16585,13767,34,60,3400383050,Wyckoff township
225,013,14282,14970,688,4201,3092,19181,19041,1438,38222,10310,34,60,3401304695,Belleville township
226,013,20810,21714,904,4495,9941,16197,36908,2804,53105,19668,34,60,3401306260,Bloomfield township
227,013,3538,3669,131,545,419,1313,7714,279,9027,6471,34,60,3401309250,Caldwell borough
228,013,4754,5042,288,1016,305,1465,11515,440,12980,9754,34,60,3401311200,Cedar Grove township
229,013,12788,13590,802,262,21627,9983,24464,1502,34447,1073,34,60,3401313045,City of Orange township
230,013,27410,30357,2947,501,54689,9032,60580,4002,69612,1388,34,60,3401319390,East Orange city
231,013,750,806,56,104,24,137,2107,90,2244,1889,34,60,3401321840,Essex Fells borough
232,013,2747,2826,79,355,38,733,7139,184,7872,6562,34,60,3401322385,Fairfield township
233,013,2529,2592,63,587,289,558,7244,543,7802,5825,34,60,3401326610,Glen Ridge borough
234,013,22638,24984,2346,413,48208,8985,52191,2587,61176,983,34,60,3401334450,Irvington township
235,013,10337,10719,382,9014,953,1583,29747,968,31330,18812,34,60,3401340890,Livingston township
236,013,8866,9269,403,951,7740,2182,23502,1641,25684,13170,34,60,3401343800,Maplewood township
237,013,6908,7241,333,7123,458,973,20737,1009,21710,12147,34,60,3401346380,Millburn township
238,013,15555,16304,749,2045,9008,4304,36617,2971,40921,22593,34,60,3401347500,Montclair township
239,013,108789,118163,9374,4871,147905,113374,198175,20483,311549,24916,34,60,3401351000,Newark city
240,013,2258,2364,106,518,85,405,6289,210,6694,5476,34,60,3401352620,North Caldwell borough
241,013,11887,12340,453,3518,928,5858,24285,975,30143,18864,34,60,3401353680,Nutley township
242,013,2523,2607,84,551,192,437,5862,215,6299,4904,34,60,3401364590,Roseland borough
243,013,5940,6306,366,1228,3803,1604,16880,1339,18484,10510,34,60,3401369274,South Orange Village township
244,013,5862,6150,288,696,323,1431,13141,531,14572,11591,34,60,3401375815,Verona township
245,013,4004,4137,133,440,138,971,10041,399,11012,9064,34,60,3401378510,West Caldwell township
246,013,17738,18746,1008,3523,13916,9647,39196,2602,48843,19155,34,60,3401379800,West Orange township
271,017,27867,29727,1860,7011,7116,22101,49585,2761,71686,32697,34,60,3401703580,Bayonne city
272,017,889,920,31,257,54,1619,975,153,2594,511,34,60,3401719360,East Newark borough
273,017,4920,5142,222,1064,343,7868,4149,316,12017,2426,34,60,3401728650,Guttenberg town
274,017,8111,8594,483,4946,722,7759,11691,1333,19450,4690,34,60,3401730210,Harrison town
275,017,28175,30202,2027,6518,2106,8542,51877,2596,60419,40657,34,60,3401732250,Hoboken city
276,017,119517,130992,11475,81425,54199,72777,219672,14424,292449,69624,34,60,3401736000,Jersey City city
277,017,14639,15392,753,2034,1246,20465,21534,3365,41999,14889,34,60,3401736510,Kearny town
278,017,23426,25079,1653,4269,1403,44900,18461,1554,63361,11235,34,60,3401752470,North Bergen township
279,017,8840,9316,476,7167,922,4700,17481,632,22181,8760,34,60,3401766570,Secaucus town
280,017,24511,26455,1944,2394,1355,56509,12080,1476,68589,6855,34,60,3401774630,Union City city
281,017,7969,9089,1120,2594,685,5665,11532,716,17197,7537,34,60,3401777930,Weehawken township
282,017,20544,21798,1254,3745,1234,40114,12798,1170,52912,6649,34,60,3401779610,West New York town
283,019,1751,1857,106,105,65,287,4522,184,4809,4168,34,60,3401900550,Alexandria township
284,019,1347,1406,59,92,40,209,3536,137,3745,3267,34,60,3401905650,Bethlehem township
285,019,340,371,31,13,25,54,738,29,792,671,34,60,3401906370,Bloomsbury borough
286,019,404,429,25,15,1,41,964,47,1005,901,34,60,3401909280,Califon borough
287,019,1114,1157,43,235,50,281,2492,92,2773,2115,34,60,3401913720,Clinton town
288,019,4658,4888,230,768,757,1071,12434,518,13505,10391,34,60,3401913750,Clinton township
289,019,1795,1952,157,64,39,264,4296,187,4560,4006,34,60,3401917170,Delaware township
290,019,1548,1628,80,64,35,217,3700,134,3917,3467,34,60,3401918820,East Amwell township
291,019,1853,1974,121,317,133,1928,2948,148,4876,2350,34,60,3401923700,Flemington borough
292,019,1172,1257,85,58,28,214,3053,139,3267,2828,34,60,3401924870,Franklin township
293,019,629,677,48,23,16,104,1266,71,1370,1156,34,60,3401925350,Frenchtown borough
294,019,785,835,50,18,62,141,1541,63,1682,1398,34,60,3401926550,Glen Gardner borough
295,019,612,650,38,34,31,126,1312,61,1438,1186,34,60,3401929460,Hampton borough
296,019,1424,1517,93,113,51,340,3206,114,3546,2928,34,60,3401931320,High Bridge borough
297,019,2001,2099,98,44,31,220,4957,188,5177,4694,34,60,3401932460,Holland township
298,019,1476,1606,130,40,42,143,3659,141,3802,3436,34,60,3401937065,Kingwood township
299,019,2093,2265,172,62,75,525,3614,140,4139,3337,34,60,3401938610,Lambertville city
300,019,795,828,33,70,70,144,1521,53,1665,1328,34,60,3401939630,Lebanon borough
301,019,2368,2505,137,123,64,356,5839,230,6195,5422,34,60,3401939660,Lebanon township
302,019,524,556,32,12,17,83,1149,38,1232,1082,34,60,3401946260,Milford borough
303,019,8613,8911,298,2104,588,1899,21548,867,23447,17989,34,60,3401961920,Raritan township
304,019,6271,6552,281,744,213,1217,14911,511,16128,13443,34,60,3401962250,Readington township
305,019,233,255,22,8,0,10,485,14,495,463,34,60,3401970980,Stockton borough
306,019,2185,2386,201,232,54,332,5538,233,5870,5019,34,60,3401972510,Tewksbury township
307,019,1840,1917,77,258,481,543,5964,199,6507,5026,34,60,3401974420,Union township
308,019,1147,1209,62,61,62,180,2825,106,3005,2596,34,60,3401978230,West Amwell township
309,021,11158,11690,532,6780,2653,7750,22295,952,30045,11910,34,60,3402119780,East Windsor township
310,021,13889,15637,1748,1938,11364,4868,32396,1507,37264,17587,34,60,3402122185,Ewing township
311,021,36125,37716,1591,4121,11724,18279,74018,2974,92297,55199,34,60,3402129310,Hamilton township
312,021,2097,2216,119,333,402,2166,3734,260,5900,2739,34,60,3402131620,Hightstown borough
313,021,787,828,41,27,32,84,1834,90,1918,1685,34,60,3402133150,Hopewell borough
314,021,6367,6748,381,2035,586,1039,16452,723,17491,13108,34,60,3402133180,Hopewell township
315,021,12550,13268,718,5883,3755,3687,29390,1382,33077,18370,34,60,3402139510,Lawrence township
316,021,1028,1088,60,83,45,88,2714,120,2802,2466,34,60,3402157600,Pennington borough
317,021,9373,10380,1007,6732,1742,3014,27667,1747,30681,17446,34,60,3402160900,Princeton
318,021,5479,5687,208,4307,469,790,14686,574,15476,9336,34,60,3402163850,Robbinsville township
319,021,30139,34322,4183,592,38386,40905,49966,2478,90871,8510,34,60,3402174000,Trenton city
320,021,10369,10862,493,15499,1206,1507,28011,1082,29518,10224,34,60,3402180240,West Windsor township
321,023,8387,8809,422,5756,3820,9340,15986,824,25326,5586,34,60,3402310750,Carteret borough
322,023,1323,1388,65,803,108,183,3659,136,3842,2612,34,60,3402315550,Cranbury township
323,023,2620,2727,107,430,669,2820,4817,328,7637,3390,34,60,3402318490,Dunellen borough
324,023,17302,18088,786,13894,2113,4758,44957,1765,49715,27185,34,60,3402319000,East Brunswick township
325,023,36852,38493,1641,57687,7764,10771,96817,3062,107588,28304,34,60,3402320230,Edison township
326,023,1052,1091,39,119,99,282,2173,109,2455,1846,34,60,3402330840,Helmetta borough
327,023,6320,6669,349,2643,1258,2251,12821,708,15072,8212,34,60,3402331470,Highland Park borough
328,023,2115,2228,113,267,401,1843,3940,229,5783,3043,34,60,3402334890,Jamesburg borough
329,023,5822,6053,231,2825,645,1510,13539,810,15049,9259,34,60,3402345690,Metuchen borough
330,023,5302,5472,170,1159,902,3751,10885,493,14636,8331,34,60,3402345900,Middlesex borough
331,023,2613,2707,94,246,178,810,6227,248,7037,5555,34,60,3402346620,Milltown borough
332,023,20289,21504,1215,12892,1655,2746,45848,1116,48594,30185,34,60,3402347280,Monroe township
333,023,15387,17509,2122,5722,6278,31376,23890,1568,55266,10322,34,60,3402351210,New Brunswick city
334,023,15025,15585,560,11212,7737,10676,33229,1666,43905,12614,34,60,3402352560,North Brunswick township
335,023,25059,26067,1008,10119,4671,9276,57600,2416,66876,40394,34,60,3402354705,Old Bridge township
336,023,17136,17855,719,610,3483,46149,9287,1041,55436,4153,34,60,3402358200,Perth Amboy city
337,023,18071,18904,833,23973,11771,8276,52528,2533,60804,14251,34,60,3402359010,Piscataway township
338,023,9720,10281,561,13578,1579,1449,22635,782,24084,6696,34,60,3402359280,Plainsboro township
339,023,16910,17695,785,7611,5743,7868,37477,1757,45345,22366,34,60,3402365790,Sayreville borough
340,023,3740,3906,166,470,529,2093,7318,371,9411,5948,34,60,3402368550,South Amboy city
341,023,16014,16647,633,22604,3405,3510,43533,1426,47043,16098,34,60,3402368790,South Brunswick township
342,023,8217,8432,215,4579,2496,4555,19783,1120,24338,11588,34,60,3402369390,South Plainfield borough
343,023,5694,5977,283,826,1000,4198,11920,1290,16118,8804,34,60,3402369420,South River borough
344,023,3196,3297,101,523,272,917,7246,307,8163,6144,34,60,3402369810,Spotswood borough
345,023,36381,38137,1756,27425,10143,22279,81360,3520,103639,40272,34,60,3402382000,Woodbridge township
346,025,0,0,0,0,0,0,0,0,0,0,34,60,3402500000,County subdivisions not defined
347,025,7697,7967,270,1116,1883,2642,16687,868,19329,12820,34,60,3402500070,Aberdeen township
348,025,199,369,170,3,4,19,453,11,472,435,34,60,3402500730,Allenhurst borough
349,025,694,724,30,28,64,92,1642,73,1734,1477,34,60,3402500760,Allentown borough
350,025,7087,8274,1187,162,5059,4079,11109,604,15188,5284,34,60,3402501960,Asbury Park city
351,025,1949,2092,143,78,54,363,4051,171,4414,3748,34,60,3402502110,Atlantic Highlands borough
352,025,902,1334,432,20,22,141,1792,48,1933,1702,34,60,3402502440,Avon-by-the-Sea borough
353,025,2867,4066,1199,71,100,963,4944,168,5907,4605,34,60,3402504930,Belmar borough
354,025,2157,3221,1064,57,82,880,3402,144,4282,3119,34,60,3402506970,Bradley Beach borough
355,025,1949,2176,227,34,69,226,4756,153,4982,4500,34,60,3402507750,Brielle borough
356,025,3307,3451,144,495,105,614,9343,274,9957,8469,34,60,3402514560,Colts Neck township
357,025,347,925,578,6,6,120,780,37,900,731,34,60,3402516660,Deal borough
358,025,5842,6182,340,1316,1644,2005,11592,1060,13597,7572,34,60,3402519840,Eatontown borough
359,025,789,820,31,207,66,368,1978,75,2346,1630,34,60,3402521570,Englishtown borough
360,025,1994,2074,80,92,66,241,6028,206,6269,5664,34,60,3402522440,Fair Haven borough
361,025,616,630,14,40,80,167,1337,69,1504,1148,34,60,3402522950,Farmingdale borough
362,025,4143,4394,251,330,1110,6649,5889,389,12538,4060,34,60,3402525200,Freehold borough
363,025,12897,13500,603,2585,1506,3636,31733,1243,35369,26399,34,60,3402525230,Freehold township
364,025,7179,7492,313,682,330,2292,17833,648,20125,16173,34,60,3402530690,Hazlet township
365,025,2425,2931,506,55,80,343,4278,215,4621,3928,34,60,3402531500,Highlands borough
366,025,5787,6038,251,3555,189,989,16411,673,17400,11994,34,60,3402532640,Holmdel township
367,025,18906,19694,788,2621,1958,6359,47178,2054,53537,40545,34,60,3402533300,Howell township
368,025,362,400,38,4,1,19,809,36,828,768,34,60,3402534200,Interlaken borough
369,025,3808,4361,553,265,921,1932,7823,501,9755,6136,34,60,3402536480,Keansburg borough
370,025,3202,3427,225,226,387,1572,5632,265,7204,4754,34,60,3402536810,Keyport borough
371,025,778,1081,303,33,73,336,1361,56,1697,1199,34,60,3402537560,Lake Como borough
372,025,2196,2323,127,138,25,261,5870,203,6131,5504,34,60,3402540770,Little Silver borough
373,025,94,154,60,6,0,8,216,4,224,206,34,60,3402541010,Loch Arbour village
374,025,12391,14944,2553,588,3177,10332,21335,4437,31667,13133,34,60,3402541310,Long Branch city
375,025,14325,14850,525,3561,876,3188,37717,1140,40905,32140,34,60,3402542990,Manalapan township
376,025,2462,3412,950,48,10,417,5521,128,5938,5335,34,60,3402543050,Manasquan borough
377,025,13774,14215,441,9020,728,2323,39179,998,41502,28433,34,60,3402544070,Marlboro township
378,025,3849,4010,161,594,725,1431,8134,456,9565,6359,34,60,3402544520,Matawan borough
379,025,24710,25859,1149,1867,823,5112,61994,2162,67106,57142,34,60,3402545990,Middletown township
380,025,3324,3428,104,627,415,844,9532,379,10376,8111,34,60,3402546560,Millstone township
381,025,1452,2006,554,36,9,122,3052,99,3174,2908,34,60,3402547130,Monmouth Beach borough
382,025,11466,13278,1812,770,9419,4052,24009,1262,28061,12558,34,60,3402549890,Neptune township
383,025,2109,2251,142,92,627,644,3982,222,4626,3041,34,60,3402549920,Neptune City borough
384,025,11249,12257,1008,1636,2507,3007,24665,1252,27672,19270,34,60,3402554270,Ocean township
385,025,2346,2469,123,70,85,611,5539,229,6150,5155,34,60,3402554570,Oceanport borough
386,025,5423,5863,440,231,966,4890,8046,391,12936,6458,34,60,3402562430,Red Bank borough
387,025,307,331,24,12,23,103,705,40,808,630,34,60,3402564410,Roosevelt borough
388,025,2398,2624,226,106,21,308,7035,273,7343,6635,34,60,3402565130,Rumson borough
389,025,793,1200,407,34,13,78,1371,53,1449,1271,34,60,3402566240,Sea Bright borough
390,025,786,1305,519,4,9,56,1810,26,1866,1771,34,60,3402566330,Sea Girt borough
391,025,1456,1509,53,97,61,165,4019,161,4184,3700,34,60,3402567350,Shrewsbury borough
392,025,505,544,39,88,148,217,859,66,1076,557,34,60,3402567365,Shrewsbury township
393,025,1225,2107,882,36,11,86,2703,65,2789,2591,34,60,3402570110,Spring Lake borough
394,025,2428,2998,570,54,23,221,4669,129,4890,4463,34,60,3402570140,Spring Lake Heights borough
395,025,8500,8972,472,1041,1610,1694,17487,751,19181,14085,34,60,3402573020,Tinton Falls borough
396,025,2036,2183,147,125,111,726,4997,262,5723,4499,34,60,3402574540,Union Beach borough
397,025,2471,2604,133,460,161,454,6819,248,7273,5950,34,60,3402574900,Upper Freehold township
398,025,10121,10838,717,443,461,1559,24966,820,26525,23242,34,60,3402576460,Wall township
399,025,2551,2755,204,143,275,774,7813,577,8587,6818,34,60,3402579310,West Long Branch borough
400,027,3412,3555,143,953,444,1409,7406,409,8815,5600,34,60,3402706610,Boonton town
401,027,1504,1583,79,275,47,275,4105,157,4380,3626,34,60,3402706640,Boonton township
402,027,3258,3403,145,284,123,1409,6638,244,8047,5987,34,60,3402709040,Butler borough
403,027,3057,3224,167,847,89,675,8537,442,9212,7159,34,60,3402712100,Chatham borough
404,027,3963,4155,192,1387,81,514,10469,452,10983,8549,34,60,3402712130,Chatham township
405,027,633,660,27,60,5,281,1400,59,1681,1276,34,60,3402712580,Chester borough
406,027,2575,2736,161,381,90,539,7174,326,7713,6377,34,60,3402712610,Chester township
407,027,6442,6834,392,1351,317,1280,15827,674,17107,13485,34,60,3402717650,Denville township
408,027,5752,5972,220,423,783,14209,4251,319,18460,2726,34,60,3402718070,Dover town
409,027,3935,4040,105,1425,141,876,10229,213,11105,8450,34,60,3402719210,East Hanover township
410,027,4468,4768,300,1075,725,929,11656,446,12585,9410,34,60,3402723910,Florham Park borough
411,027,5694,5928,234,1948,325,1046,13631,478,14677,10880,34,60,3402729550,Hanover township
412,027,1419,1569,150,180,41,179,3692,166,3871,3305,34,60,3402729700,Harding township
413,027,7840,8566,726,860,356,1998,18540,719,20538,16605,34,60,3402734980,Jefferson township
414,027,3405,3571,166,610,91,728,9238,345,9966,8192,34,60,3402737110,Kinnelon borough
415,027,4063,4181,118,719,332,1469,9446,355,10915,8040,34,60,3402740290,Lincoln Park borough
416,027,3118,3240,122,693,73,912,7717,375,8629,6576,34,60,3402741362,Long Hill township
417,027,5705,5989,284,1262,463,2004,14933,726,16937,12482,34,60,3402742510,Madison borough
418,027,1762,1867,105,161,29,293,4688,177,4981,4321,34,60,3402745330,Mendham borough
419,027,1986,2105,119,347,93,330,5686,317,6016,4929,34,60,3402745360,Mendham township
420,027,1477,1523,46,210,191,1283,2732,153,4015,2178,34,60,3402746860,Mine Hill township
421,027,7901,8206,305,4811,319,1578,20872,733,22450,15009,34,60,3402747670,Montville township
422,027,8587,8993,406,1368,1019,2378,20596,956,22974,17253,34,60,3402748090,Morris township
423,027,2432,2527,95,487,219,590,5563,182,6153,4675,34,60,3402748210,Morris Plains borough
424,027,8482,9213,731,961,1961,7367,12813,693,20180,9198,34,60,3402748300,Morristown town
425,027,1376,1429,53,694,19,247,4225,227,4472,3285,34,60,3402748480,Mountain Lakes borough
426,027,2651,2915,264,334,197,719,5190,181,5909,4478,34,60,3402748690,Mount Arlington borough
427,027,11079,11597,518,3025,1807,4460,24426,1195,28886,18399,34,60,3402749080,Mount Olive township
428,027,1434,1490,56,118,151,817,2558,127,3375,2162,34,60,3402750130,Netcong borough
429,027,21346,22146,800,21694,1911,5631,50531,1966,56162,24960,34,60,3402756460,Parsippany-Troy Hills township
430,027,6379,6688,309,395,98,1224,14347,393,15571,13461,34,60,3402758110,Pequannock township
431,027,9354,9676,322,3185,740,3791,22713,1038,26504,17750,34,60,3402761890,Randolph township
432,027,1929,2009,80,219,88,411,3696,120,4107,3269,34,60,3402763300,Riverdale borough
433,027,2561,2645,84,553,187,1355,5243,230,6598,4273,34,60,3402764050,Rockaway borough
434,027,9643,10140,497,1918,731,3995,21346,893,25341,17804,34,60,3402764080,Rockaway township
435,027,8356,8682,326,1292,647,3340,19610,806,22950,16865,34,60,3402764980,Roxbury township
436,027,571,584,13,41,142,1185,397,37,1582,177,34,60,3402775890,Victory Gardens borough
437,027,6343,6577,234,760,286,1359,16838,583,18197,15209,34,60,3402777240,Washington township
438,027,2604,2736,132,394,225,3576,3665,251,7241,2795,34,60,3402780390,Wharton borough
439,029,0,0,0,0,0,0,0,0,0,0,34,60,3402900000,County subdivisions not defined
440,029,9758,10724,966,471,987,2460,21836,917,24296,19461,34,60,3402903050,Barnegat township
441,029,321,1257,936,1,0,21,619,17,640,601,34,60,3402903130,Barnegat Light borough
442,029,434,1024,590,11,5,27,903,22,930,865,34,60,3402903520,Bay Head borough
443,029,485,2600,2115,0,2,102,925,17,1027,906,34,60,3402903940,Beach Haven borough
444,029,3719,3860,141,147,239,1290,9569,418,10859,8765,34,60,3402904180,Beachwood borough
445,029,21040,24629,3589,637,1079,3680,40074,1302,43754,37056,34,60,3402905305,Berkeley township
446,029,30119,33863,3744,1347,2071,8218,65402,2646,73620,59338,34,60,3402907420,Brick township
447,029,676,797,121,10,8,116,1606,69,1722,1519,34,60,3402918670,Eagleswood township
448,029,198,1178,980,2,0,6,385,2,391,381,34,60,3402930390,Harvey Cedars borough
449,029,722,841,119,14,8,55,1595,86,1650,1487,34,60,3402934530,Island Heights borough
450,029,20470,21626,1156,1558,2769,7543,51001,2279,58544,44395,34,60,3402934680,Jackson township
451,029,11086,12483,1397,334,223,2000,26655,1007,28655,25091,34,60,3402937380,Lacey township
452,029,908,979,71,76,236,505,2131,139,2636,1680,34,60,3402937770,Lakehurst borough
453,029,31850,34726,2876,699,3290,15768,119390,4013,135158,111388,34,60,3402938550,Lakewood township
454,029,924,3078,2154,7,8,60,1727,55,1787,1657,34,60,3402939390,Lavallette borough
455,029,8715,10812,2097,225,367,1541,19243,792,20784,17859,34,60,3402940560,Little Egg Harbor township
456,029,1593,8832,7239,29,2,102,3051,67,3153,2953,34,60,3402941250,Long Beach township
457,029,24287,26764,2477,1017,1845,3503,41612,1308,45115,37442,34,60,3402943140,Manchester township
458,029,158,498,340,4,1,15,316,6,331,305,34,60,3402943380,Mantoloking borough
459,029,3979,4715,736,71,72,407,8428,281,8835,8004,34,60,3402954300,Ocean township
460,029,851,1153,302,5,46,156,1776,102,1932,1623,34,60,3402954450,Ocean Gate borough
461,029,840,931,91,29,17,133,2006,84,2139,1876,34,60,3402958590,Pine Beach borough
462,029,2996,3139,143,58,107,677,7395,398,8072,6832,34,60,3402959790,Plumsted township
463,029,7506,8485,979,154,58,1327,17614,510,18941,16892,34,60,3402959880,Point Pleasant borough
464,029,2045,3397,1352,57,28,475,4291,122,4766,4084,34,60,3402959910,Point Pleasant Beach borough
465,029,1148,2870,1722,36,136,566,1874,129,2440,1573,34,60,3402966450,Seaside Heights borough
466,029,772,2586,1814,9,4,55,1381,36,1436,1332,34,60,3402966480,Seaside Park borough
467,029,549,1938,1389,11,1,72,1026,26,1098,988,34,60,3402967110,Ship Bottom borough
468,029,1081,1141,60,75,528,1040,2603,222,3643,1778,34,60,3402969510,South Toms River borough
469,029,11073,14399,3326,420,316,2468,26149,871,28617,24542,34,60,3402970320,Stafford township
470,029,644,2468,1824,8,1,44,1199,21,1243,1169,34,60,3402971640,Surf City borough
471,029,36291,44526,8235,3780,3155,11593,83845,3239,95438,73671,34,60,3402973125,Toms River township
472,029,1574,2110,536,37,40,304,3273,131,3577,3065,34,60,3402974210,Tuckerton borough
473,031,3112,3267,155,273,114,1186,6591,290,7777,5914,34,60,3403106340,Bloomingdale borough
474,031,31968,33325,1357,8414,3899,36159,54137,2574,90296,39250,34,60,3403113690,Clifton city
475,031,3017,3117,100,631,1063,4476,4576,288,9052,2594,34,60,3403129070,Haledon borough
476,031,7624,7946,322,532,591,4778,14859,607,19637,13129,34,60,3403130570,Hawthorne borough
477,031,4721,4947,226,723,834,2264,11096,423,13360,9116,34,60,3403140620,Little Falls township
478,031,3054,3141,87,349,290,1129,7798,233,8927,6926,34,60,3403153040,North Haledon borough
479,031,20595,21513,918,2599,4005,51584,18953,1531,70537,10818,34,60,3403156550,Passaic city
480,031,50326,52885,2559,7991,36667,98863,60869,3688,159732,12523,34,60,3403157000,Paterson city
481,031,4200,4349,149,594,170,2174,8953,405,11127,7784,34,60,3403160090,Pompton Lakes borough
482,031,1932,2017,85,294,1023,3752,2620,150,6372,1153,34,60,3403161170,Prospect Park borough
483,031,4180,4364,184,196,167,1084,10651,588,11735,9700,34,60,3403163150,Ringwood borough
484,031,3899,4026,127,838,247,2408,8657,275,11065,7297,34,60,3403173140,Totowa borough
485,031,4392,4597,205,543,305,1659,9658,439,11317,8371,34,60,3403176730,Wanaque borough
486,031,19165,19808,643,5167,1639,6439,48399,1596,54838,39997,34,60,3403177840,Wayne township
487,031,9638,10570,932,378,320,2259,22603,1010,24862,20895,34,60,3403179460,West Milford township
488,031,5252,5495,243,687,525,3816,9668,381,13484,8075,34,60,3403182423,Woodland Park borough
504,035,4222,4483,261,882,153,804,7468,273,8272,6160,34,60,3403504450,Bedminster township
505,035,10197,10665,468,6708,447,1595,26235,1040,27830,18040,34,60,3403505560,Bernards township
506,035,2756,2953,197,343,49,1272,6621,302,7893,5927,34,60,3403505590,Bernardsville borough
507,035,4181,4389,208,483,976,6374,5614,513,11988,3642,34,60,3403506790,Bound Brook borough
508,035,5660,5843,183,1609,438,1116,13824,556,14940,11221,34,60,3403507180,Branchburg township
509,035,16044,16739,695,11080,1268,4517,41460,1565,45977,27547,34,60,3403507720,Bridgewater township
510,035,372,418,46,42,8,107,817,22,924,745,34,60,3403522890,Far Hills borough
511,035,25860,27335,1475,15835,16531,11938,56426,2655,68364,21405,34,60,3403524900,Franklin township
512,035,2436,2510,74,1743,313,843,6438,248,7281,4134,34,60,3403527510,Green Brook township
513,035,15296,15955,659,9889,2040,4067,39209,1655,43276,25625,34,60,3403531890,Hillsborough township
514,035,4092,4290,198,337,514,3464,7489,383,10953,6255,34,60,3403543620,Manville borough
515,035,153,168,15,9,7,34,414,18,448,380,34,60,3403546590,Millstone borough
516,035,8003,8390,387,9352,721,1314,22376,912,23690,11391,34,60,3403547580,Montgomery township
517,035,7715,8055,340,1064,4390,11548,11260,808,22808,4998,34,60,3403553280,North Plainfield borough
518,035,887,937,50,50,60,319,2239,68,2558,2061,34,60,3403557300,Peapack and Gladstone borough
519,035,2993,3167,174,1558,247,1672,6163,238,7835,4120,34,60,3403561980,Raritan borough
520,035,278,298,20,36,3,70,673,30,743,604,34,60,3403564320,Rocky Hill borough
521,035,5050,5387,337,1433,1201,3113,9233,526,12346,6073,34,60,3403568460,Somerville borough
522,035,1854,1941,87,395,528,1537,3326,191,4863,2212,34,60,3403568730,South Bound Brook borough
523,035,5374,5614,240,3249,277,1156,14767,672,15923,10569,34,60,3403576940,Warren township
524,035,2175,2285,110,1001,309,519,5930,318,6449,4302,34,60,3403577600,Watchung borough
525,037,254,277,23,5,17,59,536,30,595,484,34,60,3403701330,Andover borough
526,037,2102,2219,117,211,187,530,5466,241,5996,4827,34,60,3403701360,Andover township
527,037,334,372,38,17,8,53,738,31,791,682,34,60,3403707300,Branchville borough
528,037,2946,3292,346,128,132,683,7345,329,8028,6756,34,60,3403709160,Byram township
529,037,2084,2550,466,75,42,297,5005,203,5302,4685,34,60,3403724810,Frankford township
530,037,2047,2177,130,78,108,661,4251,243,4912,3822,34,60,3403724930,Franklin borough
531,037,1192,1256,64,58,20,181,3054,110,3235,2866,34,60,3403725140,Fredon township
532,037,1244,1291,47,62,65,306,3321,123,3627,3071,34,60,3403727420,Green township
533,037,1452,1539,87,94,98,318,2948,153,3266,2603,34,60,3403729220,Hamburg borough
534,037,1996,2186,190,79,26,267,4626,186,4893,4335,34,60,3403729490,Hampton township
535,037,3371,3847,476,215,244,647,7478,314,8125,6705,34,60,3403729850,Hardyston township
536,037,5724,6393,669,353,423,2544,11818,555,14362,10487,34,60,3403732910,Hopatcong borough
537,037,881,921,40,13,20,164,2194,78,2358,2083,34,60,3403737440,Lafayette township
538,037,1560,1832,272,69,71,370,3422,174,3792,3108,34,60,3403747430,Montague township
539,037,3400,3687,287,292,432,1363,7011,393,8374,5894,34,60,3403751930,Newton town
540,037,873,927,54,28,20,265,1993,110,2258,1835,34,60,3403754660,Ogdensburg borough
541,037,806,979,173,31,9,101,1876,81,1977,1755,34,60,3403765700,Sandyston township
542,037,7032,7614,582,620,309,1570,18030,802,19600,16299,34,60,3403769690,Sparta township
543,037,1432,1507,75,93,74,492,3034,143,3526,2724,34,60,3403770380,Stanhope borough
544,037,1609,1943,334,38,23,202,3802,132,4004,3609,34,60,3403770890,Stillwater township
545,037,901,1013,112,26,47,284,1740,91,2024,1576,34,60,3403771670,Sussex borough
546,037,8612,10538,1926,206,331,2163,20195,896,22358,18762,34,60,3403775740,Vernon township
547,037,5,5,0,0,0,2,5,0,7,5,34,60,3403776640,Walpack township
548,037,4058,4344,286,127,152,788,10023,470,10811,9274,34,60,3403776790,Wantage township
549,039,4484,4660,176,2065,242,1140,12145,560,13285,9278,34,60,3403905320,Berkeley Heights township
550,039,5919,6114,195,644,231,1945,13599,378,15544,12346,34,60,3403913150,Clark township
551,039,8891,9264,373,903,653,2443,21404,902,23847,18946,34,60,3403915640,Cranford township
552,039,46314,48439,2125,2757,22261,90233,47065,5494,137298,16553,34,60,3403921000,Elizabeth city
553,039,2725,2829,104,713,386,729,7045,342,7774,5604,34,60,3403922860,Fanwood borough
554,039,1920,2016,96,119,69,670,3784,160,4454,3436,34,60,3403925800,Garwood borough
555,039,7517,7844,327,498,11327,5189,17267,1655,22456,3787,34,60,3403931980,Hillside township
556,039,2932,3019,87,435,219,1933,6494,316,8427,5524,34,60,3403936690,Kenilworth borough
557,039,15609,16452,843,1484,11722,15055,28683,1733,43738,13744,34,60,3403940350,Linden city
558,039,2399,2564,165,466,134,667,6353,255,7020,5498,34,60,3403948510,Mountainside borough
559,039,5071,5497,426,2171,241,1251,12399,558,13650,9429,34,60,3403951810,New Providence borough
560,039,16308,17125,817,500,19034,29792,24794,1877,54586,3383,34,60,3403959190,Plainfield city
561,039,11544,12363,819,1622,8892,8867,20689,1262,29556,8913,34,60,3403961530,Rahway city
562,039,8008,8431,423,580,10800,7900,14795,941,22695,2474,34,60,3403964620,Roselle borough
563,039,5213,5346,133,1271,1186,5293,8674,492,13967,5725,34,60,3403964650,Roselle Park borough
564,039,8807,9103,296,2610,2365,2579,22389,1117,24968,16297,34,60,3403966060,Scotch Plains township
565,039,6820,7105,285,1541,1504,2235,14943,758,17178,11140,34,60,3403970020,Springfield township
566,039,7905,8365,460,2371,895,3313,19406,1124,22719,15016,34,60,3403971430,Summit city
567,039,20672,21571,899,6472,19296,11899,47829,2915,59728,19146,34,60,3403974480,Union township
568,039,10622,11095,473,2735,790,2247,28785,1441,31032,23819,34,60,3403979040,Westfield town
569,039,692,706,14,6,14,139,1284,77,1423,1187,34,60,3403981650,Winfield township
570,041,2358,2467,109,181,227,465,4870,204,5335,4258,34,60,3404100670,Allamuchy township
571,041,972,1047,75,41,65,211,2117,76,2328,1935,34,60,3404101030,Alpha borough
572,041,1031,1143,112,20,28,198,2322,108,2520,2166,34,60,3404104990,Belvidere town
573,041,2106,2245,139,74,67,332,5372,245,5704,4986,34,60,3404106160,Blairstown township
574,041,1124,1219,95,92,54,174,2794,129,2968,2519,34,60,3404124960,Franklin township
575,041,780,833,53,11,26,124,2075,82,2199,1956,34,60,3404125320,Frelinghuysen township
576,041,1798,1868,70,416,474,546,4927,245,5473,3792,34,60,3404128260,Greenwich township
577,041,3769,3945,176,402,341,2393,7855,331,10248,6781,34,60,3404128710,Hackettstown town
578,041,578,612,34,11,12,105,1493,56,1598,1414,34,60,3404129820,Hardwick township
579,041,993,1066,73,21,29,57,2446,91,2503,2305,34,60,3404130090,Harmony township
580,041,743,806,63,16,8,139,1696,78,1835,1594,34,60,3404133060,Hope township
581,041,2325,2439,114,122,143,444,5025,217,5469,4543,34,60,3404133930,Independence township
582,041,1103,1197,94,37,22,197,2697,169,2894,2469,34,60,3404137320,Knowlton township
583,041,1022,1144,122,41,40,156,2514,110,2670,2323,34,60,3404140110,Liberty township
584,041,3588,3859,271,440,714,803,7973,323,8776,6496,34,60,3404141490,Lopatcong township
585,041,3139,3351,212,251,408,1153,6628,370,7781,5599,34,60,3404143320,Mansfield township
586,041,967,1040,73,24,47,186,2258,132,2444,2055,34,60,3404155530,Oxford township
587,041,6024,6659,635,219,1907,2552,12697,885,15249,9686,34,60,3404158350,Phillipsburg town
588,041,1310,1428,118,43,89,215,3026,163,3241,2731,34,60,3404159820,Pohatcong township
589,041,3002,3219,217,230,540,1002,6297,329,7299,5198,34,60,3404177270,Washington borough
590,041,2426,2553,127,153,238,533,5959,241,6492,5327,34,60,3404177300,Washington township
591,041,2169,2317,148,41,94,240,4366,109,4606,4122,34,60,3404180570,White township
